Quarter,Quarter Sort Val,College,Department,Major,NewFreshman-M,NewFreshman-F,NewFreshman-Total,Freshman-M,Freshman-F,Freshman-Total,Sophomore-M,Sophomore-F,Sophomore-Total,Junior-M,Junior-F,Junior-Total,Senior-M,Senior-F,Senior-Total,Special-M,Special-F,Special-Total,Total-M,Total-F,Total
fa12,123,MARSHALL,ANTH,Anth-Arch,0,1,1,0,0,0,0,1,1,1,1,2,1,2,3,0,0,0,2,5,7
fa12,123,MARSHALL,ANTH,Anth-Biol,0,0,0,0,0,0,0,0,0,0,6,6,4,4,8,0,0,0,4,10,14
fa12,123,MARSHALL,ANTH,Anth-Soci,0,2,2,0,0,0,0,1,1,0,2,2,0,4,4,0,0,0,0,9,9
fa12,123,MARSHALL,BENG,Bioen:Binf,2,4,6,1,0,1,1,0,1,2,2,4,3,2,5,0,0,0,9,8,17
fa12,123,MARSHALL,BENG,Bioeng:PM,0,0,0,0,0,0,0,0,0,0,1,1,3,3,6,0,0,0,3,4,7
fa12,123,MARSHALL,BENG,BioengBiot,6,2,8,0,0,0,1,1,2,4,6,10,15,8,23,0,0,0,26,17,43
fa12,123,MARSHALL,BENG,Bioengin,0,2,2,0,0,0,3,2,5,4,3,7,4,2,6,0,0,0,11,9,20
fa12,123,MARSHALL,BIOL,Bioc/CellB,9,19,28,1,1,2,3,10,13,9,15,24,28,43,71,0,0,0,50,88,138
fa12,123,MARSHALL,BIOL,BiolBioinf,1,0,1,0,0,0,0,0,0,0,0,0,1,0,1,0,0,0,2,0,2
fa12,123,MARSHALL,BIOL,Ec/Beh/Evo,0,0,0,0,0,0,0,0,0,2,2,4,2,2,4,0,0,0,4,4,8
fa12,123,MARSHALL,BIOL,Genl Biol,6,20,26,1,0,1,2,6,8,8,18,26,32,60,92,0,0,0,49,104,153
fa12,123,MARSHALL,BIOL,Human Bio,17,40,57,1,0,1,13,17,30,14,34,48,41,58,99,0,0,0,86,149,235
fa12,123,MARSHALL,BIOL,Microbiol,1,0,1,0,0,0,0,3,3,1,4,5,5,7,12,0,0,0,7,14,21
fa12,123,MARSHALL,BIOL,Molec Biol,4,2,6,0,0,0,0,1,1,0,1,1,3,2,5,0,0,0,7,6,13
fa12,123,MARSHALL,BIOL,PhyslNeuro,8,18,26,0,1,1,2,6,8,4,10,14,24,17,41,0,0,0,38,52,90
fa12,123,MARSHALL,CENG,Chem Engin,5,13,18,0,0,0,4,7,11,16,5,21,19,11,30,0,0,0,44,36,80
fa12,123,MARSHALL,CGS,CritGendSt,0,0,0,0,0,0,0,1,1,0,0,0,0,0,0,0,0,0,0,1,1
fa12,123,MARSHALL,CHEM,Bioch/Chem,9,15,24,0,1,1,4,6,10,13,17,30,18,32,50,0,0,0,44,71,115
fa12,123,MARSHALL,CHEM,Bioinform,0,0,0,0,0,0,0,1,1,1,0,1,0,0,0,0,0,0,1,1,2
fa12,123,MARSHALL,CHEM,Chem Phys,0,0,0,0,0,0,0,0,0,0,0,0,2,0,2,0,0,0,2,0,2
fa12,123,MARSHALL,CHEM,Chemistry,5,6,11,0,0,0,1,3,4,9,5,14,12,11,23,0,0,0,27,25,52
fa12,123,MARSHALL,CHEM,Envir Chem,0,0,0,1,0,1,0,0,0,0,0,0,1,1,2,0,0,0,2,1,3
fa12,123,MARSHALL,CHEM,Pharm Chem,4,8,12,0,0,0,0,5,5,2,11,13,14,20,34,0,0,0,20,44,64
fa12,123,MARSHALL,CHIN,Chinese St,0,0,0,0,0,0,0,0,0,0,0,0,1,0,1,0,0,0,1,0,1
fa12,123,MARSHALL,CLAS,Classic St,0,0,0,0,0,0,0,0,0,0,0,0,0,1,1,0,0,0,0,1,1
fa12,123,MARSHALL,COGS,Cog Sci,2,3,5,0,0,0,2,6,8,5,5,10,5,7,12,0,0,0,14,21,35
fa12,123,MARSHALL,COGS,CogSc/ClAs,0,0,0,0,1,1,0,1,1,0,0,0,1,5,6,0,0,0,1,7,8
fa12,123,MARSHALL,COGS,CogSc/Comp,0,0,0,0,0,0,0,0,0,1,0,1,1,0,1,0,0,0,2,0,2
fa12,123,MARSHALL,COGS,CogSc/HCI,0,1,1,0,0,0,1,3,4,1,3,4,5,3,8,0,0,0,7,10,17
fa12,123,MARSHALL,COGS,CogSc/HCog,0,1,1,0,0,0,1,2,3,0,1,1,0,0,0,0,0,0,1,4,5
fa12,123,MARSHALL,COGS,CogSc/Neur,0,2,2,0,0,0,1,1,2,3,8,11,8,11,19,0,0,0,12,22,34
fa12,123,MARSHALL,COMM,Communic,7,10,17,0,1,1,2,11,13,13,54,67,16,55,71,0,0,0,38,131,169
fa12,123,MARSHALL,CSE,Comp Sci,24,6,30,2,0,2,18,3,21,36,4,40,37,16,53,0,0,0,117,29,146
fa12,123,MARSHALL,CSE,CompEngCSE,13,0,13,0,0,0,3,3,6,8,1,9,13,1,14,0,0,0,37,5,42
fa12,123,MARSHALL,CSE,CompScBinf,1,0,1,0,0,0,0,0,0,2,1,3,3,0,3,0,0,0,6,1,7
fa12,123,MARSHALL,ECE,CompEngECE,6,0,6,0,0,0,1,0,1,2,0,2,2,1,3,0,0,0,11,1,12
fa12,123,MARSHALL,ECE,Electr Eng,15,8,23,0,0,0,4,1,5,18,1,19,33,4,37,0,0,0,70,14,84
fa12,123,MARSHALL,ECE,EleEng&Soc,0,0,0,0,0,0,0,0,0,0,0,0,1,0,1,0,0,0,1,0,1
fa12,123,MARSHALL,ECE,Engin Phys,1,0,1,0,0,0,0,0,0,0,0,0,0,0,0,0,0,0,1,0,1
fa12,123,MARSHALL,ECE,Pr-EngPhys,1,0,1,0,0,0,0,0,0,0,0,0,0,0,0,0,0,0,1,0,1
fa12,123,MARSHALL,ECON,Ec-Mth&Ecn,4,6,10,1,0,1,5,1,6,5,4,9,7,6,13,0,0,0,22,17,39
fa12,123,MARSHALL,ECON,Econ-MgtSc,6,5,11,2,1,3,5,11,16,36,30,66,51,38,89,0,0,0,100,85,185
fa12,123,MARSHALL,ECON,Economics,23,17,40,0,0,0,18,11,29,72,66,138,69,60,129,0,0,0,182,154,336
fa12,123,MARSHALL,ESYS,EnvSys(EB),2,1,3,0,0,0,2,2,4,2,4,6,6,18,24,0,0,0,12,25,37
fa12,123,MARSHALL,ESYS,EnvSys(EC),0,0,0,0,0,0,0,0,0,1,0,1,2,1,3,0,0,0,3,1,4
fa12,123,MARSHALL,ESYS,EnvSys(EP),1,0,1,0,0,0,0,0,0,1,0,1,0,2,2,0,0,0,2,2,4
fa12,123,MARSHALL,ESYS,EnvSys(ES),1,1,2,0,0,0,0,0,0,0,0,0,2,2,4,0,0,0,3,3,6
fa12,123,MARSHALL,ETHN,Ethnic St,0,0,0,0,0,0,0,0,0,1,4,5,3,3,6,0,0,0,4,7,11
fa12,123,MARSHALL,HDP,Human Dev,0,0,0,0,0,0,0,0,0,2,8,10,4,33,37,0,0,0,6,41,47
fa12,123,MARSHALL,HDP,Pr-HumnDev,0,2,2,0,3,3,2,16,18,2,16,18,1,4,5,0,0,0,5,41,46
fa12,123,MARSHALL,HIST,History,1,1,2,0,0,0,3,1,4,11,5,16,16,15,31,0,0,0,31,22,53
fa12,123,MARSHALL,INTL,Int-5yrEC,0,0,0,0,0,0,0,0,0,0,0,0,0,1,1,0,0,0,0,1,1
fa12,123,MARSHALL,INTL,IntSt-Anth,0,0,0,0,0,0,0,1,1,0,1,1,0,1,1,0,0,0,0,3,3
fa12,123,MARSHALL,INTL,IntSt-Econ,0,1,1,0,0,0,2,7,9,2,13,15,8,8,16,0,0,0,12,29,41
fa12,123,MARSHALL,INTL,IntSt-Hist,0,0,0,0,0,0,0,0,0,1,0,1,0,2,2,0,0,0,1,2,3
fa12,123,MARSHALL,INTL,IntSt-Ling,0,1,1,0,0,0,0,1,1,1,1,2,1,0,1,0,0,0,2,3,5
fa12,123,MARSHALL,INTL,IntSt-PolS,0,2,2,0,0,0,1,2,3,4,7,11,5,15,20,0,0,0,10,26,36
fa12,123,MARSHALL,INTL,IntSt-Soc,0,2,2,1,0,1,0,3,3,4,4,8,1,6,7,0,0,0,6,15,21
fa12,123,MARSHALL,JAPN,JapaneseSt,0,0,0,0,0,0,0,0,0,0,1,1,0,0,0,0,0,0,0,1,1
fa12,123,MARSHALL,JUDA,Judaic Stu,0,1,1,0,0,0,0,0,0,0,0,0,0,0,0,0,0,0,0,1,1
fa12,123,MARSHALL,LATI,LatinAm St,0,1,1,0,0,0,0,0,0,0,1,1,0,0,0,0,0,0,0,2,2
fa12,123,MARSHALL,LING,Lang Stu,0,0,0,0,0,0,0,0,0,0,2,2,1,1,2,0,0,0,1,3,4
fa12,123,MARSHALL,LING,Ling-CogLn,0,2,2,0,0,0,0,1,1,0,0,0,0,1,1,0,0,0,0,4,4
fa12,123,MARSHALL,LING,Ling-LSoc,0,1,1,0,0,0,0,0,0,0,1,1,0,1,1,0,0,0,0,3,3
fa12,123,MARSHALL,LING,Linguistcs,0,0,0,0,0,0,0,0,0,3,2,5,3,1,4,0,0,0,6,3,9
fa12,123,MARSHALL,LIT,Ital Lit,0,0,0,0,0,0,1,0,1,0,0,0,0,0,0,0,0,0,1,0,1
fa12,123,MARSHALL,LIT,Lit/Compos,0,1,1,0,0,0,0,0,0,0,0,0,0,0,0,0,0,0,0,1,1
fa12,123,MARSHALL,LIT,Lit/CultSt,0,0,0,0,0,0,0,0,0,0,0,0,0,1,1,0,0,0,0,1,1
fa12,123,MARSHALL,LIT,Lit/Engl,0,2,2,0,0,0,1,1,2,2,2,4,4,4,8,0,0,0,7,9,16
fa12,123,MARSHALL,LIT,Lit/Writng,2,4,6,0,0,0,0,0,0,1,2,3,5,6,11,0,0,0,8,12,20
fa12,123,MARSHALL,LIT,Pre-Lit/Wr,0,0,0,0,0,0,0,0,0,0,0,0,1,0,1,0,0,0,1,0,1
fa12,123,MARSHALL,LIT,Spanish Lt,0,0,0,0,0,0,0,0,0,0,0,0,1,2,3,0,0,0,1,2,3
fa12,123,MARSHALL,MAE,Aerosp Eng,2,0,2,0,0,0,5,0,5,4,2,6,14,5,19,0,0,0,25,7,32
fa12,123,MARSHALL,MAE,Engin Sci,0,0,0,0,0,0,0,1,1,1,0,1,1,0,1,0,0,0,2,1,3
fa12,123,MARSHALL,MAE,Envir Eng,6,3,9,1,0,1,1,0,1,4,2,6,8,3,11,0,0,0,20,8,28
fa12,123,MARSHALL,MAE,Mech Engin,3,0,3,0,0,0,6,1,7,7,1,8,31,8,39,0,0,0,47,10,57
fa12,123,MARSHALL,MATH,Appld Math,1,3,4,0,0,0,4,5,9,2,2,4,2,2,4,0,0,0,9,12,21
fa12,123,MARSHALL,MATH,Math/SecEd,0,0,0,0,0,0,0,0,0,0,1,1,3,2,5,0,0,0,3,3,6
fa12,123,MARSHALL,MATH,Mathematcs,4,4,8,0,0,0,0,2,2,4,7,11,7,3,10,0,0,0,15,16,31
fa12,123,MARSHALL,MATH,Mth-CompSc,1,1,2,0,0,0,0,0,0,2,1,3,2,0,2,0,0,0,5,2,7
fa12,123,MARSHALL,MATH,Mth-Mth&Ec,4,4,8,0,0,0,3,0,3,2,2,4,7,7,14,0,0,0,16,13,29
fa12,123,MARSHALL,MATH,Mth/ApldSc,2,1,3,0,0,0,0,0,0,0,0,0,2,0,2,0,0,0,4,1,5
fa12,123,MARSHALL,MATH,Pr-Math CS,1,0,1,0,0,0,0,0,0,0,0,0,0,0,0,0,0,0,1,0,1
fa12,123,MARSHALL,MATH,Prob&Stats,1,0,1,1,0,1,0,1,1,1,0,1,0,3,3,0,0,0,3,4,7
fa12,123,MARSHALL,MUS,Mu-CompArt,0,0,0,0,0,0,1,0,1,0,0,0,0,1,1,0,0,0,1,1,2
fa12,123,MARSHALL,MUS,Music,0,0,0,0,0,0,0,0,0,2,0,2,3,2,5,0,0,0,5,2,7
fa12,123,MARSHALL,MUS,Music Hum,0,1,1,0,0,0,0,0,0,0,0,0,0,0,0,0,0,0,0,1,1
fa12,123,MARSHALL,NENG,NanoEng,10,2,12,1,0,1,0,0,0,6,3,9,7,1,8,0,0,0,24,6,30
fa12,123,MARSHALL,PHIL,Philosophy,1,0,1,0,0,0,0,0,0,4,0,4,6,2,8,0,0,0,11,2,13
fa12,123,MARSHALL,PHYS,Biophysics,0,0,0,0,0,0,0,0,0,0,0,0,2,2,4,0,0,0,2,2,4
fa12,123,MARSHALL,PHYS,GenPys/SEd,0,0,0,0,0,0,0,1,1,1,0,1,0,0,0,0,0,0,1,1,2
fa12,123,MARSHALL,PHYS,Phy/ErthSc,0,0,0,0,0,0,0,0,0,0,0,0,1,0,1,0,0,0,1,0,1
fa12,123,MARSHALL,PHYS,Phys/Astro,1,0,1,0,0,0,0,0,0,2,0,2,1,1,2,0,0,0,4,1,5
fa12,123,MARSHALL,PHYS,Phys/Comp,0,0,0,0,0,0,1,0,1,0,0,0,0,1,1,0,0,0,1,1,2
fa12,123,MARSHALL,PHYS,Physics,2,2,4,0,0,0,0,0,0,1,1,2,6,2,8,0,0,0,9,5,14
fa12,123,MARSHALL,POLI,Polit Sci,1,4,5,0,1,1,5,3,8,17,9,26,18,19,37,0,0,0,41,36,77
fa12,123,MARSHALL,POLI,PolSc-Amer,1,1,2,0,0,0,2,0,2,1,4,5,6,2,8,0,0,0,10,7,17
fa12,123,MARSHALL,POLI,PolSc-Comp,0,0,0,0,0,0,1,0,1,0,1,1,0,1,1,0,0,0,1,2,3
fa12,123,MARSHALL,POLI,PolSc-Intl,0,1,1,0,0,0,2,2,4,7,4,11,13,14,27,0,0,0,22,21,43
fa12,123,MARSHALL,POLI,PolSc-PLaw,2,4,6,1,0,1,4,7,11,2,5,7,7,2,9,0,0,0,16,18,34
fa12,123,MARSHALL,POLI,PolSc-PPol,2,0,2,0,0,0,1,0,1,2,3,5,2,1,3,0,0,0,7,4,11
fa12,123,MARSHALL,POLI,PolSc-Thry,0,0,0,0,0,0,0,0,0,3,4,7,1,0,1,0,0,0,4,4,8
fa12,123,MARSHALL,PSYC,Psychology,5,26,31,2,6,8,9,21,30,21,61,82,48,93,141,0,0,0,85,207,292
fa12,123,MARSHALL,SE,Engin Sci,1,0,1,0,0,0,0,0,0,1,0,1,0,0,0,0,0,0,2,0,2
fa12,123,MARSHALL,SE,Struct Eng,7,2,9,1,0,1,6,4,10,12,7,19,36,9,45,0,0,0,62,22,84
fa12,123,MARSHALL,SIO,Earth Sci,0,0,0,0,0,0,0,0,0,0,0,0,3,2,5,0,0,0,3,2,5
fa12,123,MARSHALL,SIO,Marine Bio,0,4,4,0,0,0,0,0,0,1,3,4,1,0,1,0,0,0,2,7,9
fa12,123,MARSHALL,SOC,SocAmSt,0,0,0,0,0,0,0,0,0,0,0,0,1,0,1,0,0,0,1,0,1
fa12,123,MARSHALL,SOC,SocCulCom,0,0,0,0,0,0,0,0,0,0,0,0,0,2,2,0,0,0,0,2,2
fa12,123,MARSHALL,SOC,SocEconSoc,0,0,0,0,0,0,0,0,0,1,2,3,1,1,2,0,0,0,2,3,5
fa12,123,MARSHALL,SOC,SocIntlStu,0,0,0,0,0,0,0,0,0,1,0,1,0,0,0,0,0,0,1,0,1
fa12,123,MARSHALL,SOC,Sociology,2,3,5,0,0,0,3,2,5,13,29,42,12,26,38,0,0,0,30,60,90
fa12,123,MARSHALL,SOC,SocLawSoc,0,0,0,0,0,0,0,1,1,1,0,1,0,4,4,0,0,0,1,5,6
fa12,123,MARSHALL,SOC,SocSciMed,0,0,0,0,0,0,0,0,0,1,1,2,2,6,8,0,0,0,3,7,10
fa12,123,MARSHALL,SOC,SocSolneq,0,0,0,0,0,0,0,1,1,1,1,2,1,3,4,0,0,0,2,5,7
fa12,123,MARSHALL,THEA,Dance,0,0,0,0,0,0,1,0,1,1,0,1,0,2,2,0,0,0,2,2,4
fa12,123,MARSHALL,THEA,Theatre,0,1,1,0,0,0,1,1,2,2,3,5,2,1,3,0,0,0,5,6,11
fa12,123,MARSHALL,UNAF,UndecHumAr,2,6,8,0,0,0,0,0,0,0,0,0,0,0,0,0,0,0,2,6,8
fa12,123,MARSHALL,UNAF,Undeclared,32,62,94,2,1,3,6,8,14,5,3,8,0,0,0,0,0,0,45,74,119
fa12,123,MARSHALL,UNAF,UndecPhysS,6,4,10,0,0,0,1,3,4,0,0,0,0,0,0,0,0,0,7,7,14
fa12,123,MARSHALL,UNAF,UndecSocSc,8,14,22,1,0,1,0,0,0,0,1,1,0,0,0,0,0,0,9,15,24
fa12,123,MARSHALL,USP,Urb Stu&Pl,0,1,1,0,0,0,1,1,2,5,7,12,6,13,19,0,0,0,12,22,34
fa12,123,MARSHALL,VIS,Art Hst/Cr,0,0,0,0,0,0,0,1,1,0,0,0,0,3,3,0,0,0,0,4,4
fa12,123,MARSHALL,VIS,Media,0,0,0,0,0,0,1,0,1,10,2,12,11,4,15,0,0,0,22,6,28
fa12,123,MARSHALL,VIS,Studio VA,1,1,2,0,0,0,0,0,0,1,4,5,0,4,4,0,0,0,2,9,11
fa12,123,MARSHALL,VIS,VA-CompArt,0,0,0,0,0,0,0,0,0,0,1,1,2,1,3,0,0,0,2,2,4
fa12,123,MUIR,ANTH,Anth-Arch,0,0,0,0,0,0,0,3,3,2,4,6,1,3,4,0,0,0,3,10,13
fa12,123,MUIR,ANTH,Anth-Biol,0,1,1,0,1,1,1,0,1,1,5,6,0,3,3,0,0,0,2,10,12
fa12,123,MUIR,ANTH,Anth-Soci,0,4,4,0,0,0,0,1,1,1,5,6,3,5,8,0,0,0,4,15,19
fa12,123,MUIR,BENG,Bioen:Binf,3,4,7,0,0,0,0,0,0,1,1,2,2,0,2,0,0,0,6,5,11
fa12,123,MUIR,BENG,Bioeng:PM,0,0,0,0,0,0,0,0,0,0,0,0,6,1,7,0,0,0,6,1,7
fa12,123,MUIR,BENG,BioengBiot,6,1,7,0,0,0,1,1,2,1,3,4,7,5,12,0,0,0,15,10,25
fa12,123,MUIR,BENG,Bioengin,7,1,8,0,0,0,1,2,3,2,4,6,12,6,18,0,0,0,22,13,35
fa12,123,MUIR,BENG,Pr-BioenPM,0,0,0,0,0,0,1,0,1,0,0,0,1,0,1,0,0,0,2,0,2
fa12,123,MUIR,BIOL,Bioc/CellB,17,17,34,0,0,0,3,9,12,12,8,20,26,34,60,0,0,0,58,68,126
fa12,123,MUIR,BIOL,BiolBioinf,1,0,1,0,0,0,0,1,1,0,0,0,0,1,1,0,0,0,1,2,3
fa12,123,MUIR,BIOL,Ec/Beh/Evo,4,2,6,0,0,0,2,0,2,2,9,11,4,12,16,0,0,0,12,23,35
fa12,123,MUIR,BIOL,Genl Biol,17,24,41,0,2,2,5,10,15,10,21,31,26,62,88,0,0,0,58,119,177
fa12,123,MUIR,BIOL,Human Bio,13,44,57,0,1,1,11,22,33,17,34,51,30,55,85,0,0,0,71,156,227
fa12,123,MUIR,BIOL,Microbiol,2,0,2,1,0,1,0,0,0,2,2,4,5,6,11,0,0,0,10,8,18
fa12,123,MUIR,BIOL,Molec Biol,8,5,13,0,0,0,0,3,3,0,6,6,7,5,12,0,0,0,15,19,34
fa12,123,MUIR,BIOL,PhyslNeuro,8,14,22,1,1,2,2,10,12,13,12,25,27,22,49,0,0,0,51,59,110
fa12,123,MUIR,CENG,Chem Engin,10,5,15,0,0,0,4,6,10,13,6,19,15,10,25,0,0,0,42,27,69
fa12,123,MUIR,CGS,CritGendSt,0,0,0,0,0,0,0,3,3,0,2,2,0,0,0,0,0,0,0,5,5
fa12,123,MUIR,CHEM,Bioch/Chem,6,9,15,0,1,1,2,12,14,13,14,27,29,17,46,0,0,0,50,53,103
fa12,123,MUIR,CHEM,Chem Educ,0,0,0,0,0,0,0,0,0,0,0,0,0,1,1,0,0,0,0,1,1
fa12,123,MUIR,CHEM,Chemistry,2,3,5,0,0,0,2,0,2,7,3,10,9,6,15,0,0,0,20,12,32
fa12,123,MUIR,CHEM,Envir Chem,0,1,1,0,1,1,1,0,1,0,0,0,3,1,4,0,0,0,4,3,7
fa12,123,MUIR,CHEM,MolecSynth,0,0,0,0,0,0,0,1,1,0,2,2,2,0,2,0,0,0,2,3,5
fa12,123,MUIR,CHEM,Pharm Chem,6,9,15,0,1,1,2,5,7,16,6,22,13,23,36,0,0,0,37,44,81
fa12,123,MUIR,CHIN,Chinese St,0,0,0,0,0,0,0,0,0,0,2,2,1,1,2,0,0,0,1,3,4
fa12,123,MUIR,CLAS,Classic St,0,0,0,0,0,0,0,0,0,0,0,0,0,1,1,0,0,0,0,1,1
fa12,123,MUIR,COGS,Cog Sci,3,6,9,0,2,2,1,4,5,6,12,18,8,9,17,0,0,0,18,33,51
fa12,123,MUIR,COGS,CogSc/ClAs,0,0,0,0,0,0,0,0,0,0,4,4,0,6,6,0,0,0,0,10,10
fa12,123,MUIR,COGS,CogSc/Comp,0,0,0,0,0,0,2,0,2,2,1,3,1,0,1,0,0,0,5,1,6
fa12,123,MUIR,COGS,CogSc/HCI,0,0,0,0,0,0,2,1,3,2,4,6,5,6,11,0,0,0,9,11,20
fa12,123,MUIR,COGS,CogSc/HCog,0,0,0,0,0,0,0,0,0,2,3,5,0,1,1,0,0,0,2,4,6
fa12,123,MUIR,COGS,CogSc/Neur,0,3,3,0,0,0,3,1,4,2,10,12,14,20,34,0,0,0,19,34,53
fa12,123,MUIR,COMM,Communic,1,12,13,1,4,5,1,12,13,16,38,54,12,35,47,0,0,0,31,101,132
fa12,123,MUIR,CSE,Comp Sci,28,7,35,3,2,5,8,6,14,32,7,39,59,17,76,0,0,0,130,39,169
fa12,123,MUIR,CSE,CompEngCSE,9,1,10,1,0,1,1,0,1,12,1,13,13,2,15,0,0,0,36,4,40
fa12,123,MUIR,CSE,CompScBinf,1,0,1,0,0,0,0,0,0,4,0,4,2,0,2,0,0,0,7,0,7
fa12,123,MUIR,ECE,CompEngECE,9,0,9,0,0,0,0,0,0,1,1,2,3,0,3,0,0,0,13,1,14
fa12,123,MUIR,ECE,Electr Eng,21,2,23,1,0,1,4,1,5,19,7,26,23,3,26,0,0,0,68,13,81
fa12,123,MUIR,ECE,Engin Phys,2,0,2,0,0,0,0,0,0,0,0,0,1,0,1,0,0,0,3,0,3
fa12,123,MUIR,ECON,Ec-Mth&Ecn,3,1,4,2,0,2,1,2,3,9,3,12,3,3,6,0,0,0,18,9,27
fa12,123,MUIR,ECON,Econ-MgtSc,6,7,13,1,3,4,10,14,24,19,16,35,41,33,74,0,0,0,77,73,150
fa12,123,MUIR,ECON,Economics,12,17,29,3,2,5,15,11,26,44,34,78,68,30,98,0,0,0,142,94,236
fa12,123,MUIR,ESYS,EnvSys(EB),2,5,7,0,1,1,0,1,1,5,15,20,6,22,28,0,0,0,13,44,57
fa12,123,MUIR,ESYS,EnvSys(EC),1,0,1,0,1,1,0,0,0,1,0,1,0,1,1,0,0,0,2,2,4
fa12,123,MUIR,ESYS,EnvSys(EP),1,3,4,0,0,0,0,0,0,1,0,1,0,5,5,0,0,0,2,8,10
fa12,123,MUIR,ESYS,EnvSys(ES),2,1,3,0,0,0,1,0,1,0,1,1,1,4,5,0,0,0,4,6,10
fa12,123,MUIR,ETHN,Ethnic St,0,0,0,0,0,0,0,0,0,2,1,3,2,4,6,0,0,0,4,5,9
fa12,123,MUIR,HDP,Human Dev,0,0,0,0,0,0,1,0,1,1,8,9,5,23,28,0,0,0,7,31,38
fa12,123,MUIR,HDP,Pr-HumnDev,1,2,3,0,2,2,1,11,12,4,13,17,2,7,9,0,0,0,8,35,43
fa12,123,MUIR,HIST,History,4,1,5,0,0,0,1,1,2,5,6,11,10,6,16,0,0,0,20,14,34
fa12,123,MUIR,INTL,IntSt-Anth,0,0,0,0,0,0,0,0,0,1,0,1,0,1,1,0,0,0,1,1,2
fa12,123,MUIR,INTL,IntSt-Econ,1,0,1,1,0,1,1,1,2,4,3,7,3,18,21,0,0,0,10,22,32
fa12,123,MUIR,INTL,IntSt-Hist,0,0,0,0,0,0,0,0,0,0,0,0,2,0,2,0,0,0,2,0,2
fa12,123,MUIR,INTL,IntSt-Ling,0,0,0,0,0,0,0,0,0,0,2,2,0,1,1,0,0,0,0,3,3
fa12,123,MUIR,INTL,IntSt-Lit,0,0,0,0,0,0,0,0,0,0,0,0,0,1,1,0,0,0,0,1,1
fa12,123,MUIR,INTL,IntSt-PolS,0,2,2,0,0,0,0,5,5,3,8,11,3,8,11,0,0,0,6,23,29
fa12,123,MUIR,INTL,IntSt-Soc,0,1,1,0,0,0,1,4,5,0,3,3,1,5,6,0,0,0,2,13,15
fa12,123,MUIR,ITAL,Italian St,0,1,1,0,0,0,0,0,0,0,0,0,0,0,0,0,0,0,0,1,1
fa12,123,MUIR,JAPN,JapaneseSt,0,1,1,0,0,0,0,0,0,1,0,1,2,1,3,0,0,0,3,2,5
fa12,123,MUIR,LATI,LatinAm St,0,0,0,0,0,0,0,0,0,0,0,0,1,0,1,0,0,0,1,0,1
fa12,123,MUIR,LING,Lang Stu,0,0,0,0,0,0,0,0,0,0,1,1,0,0,0,0,0,0,0,1,1
fa12,123,MUIR,LING,Ling-CogLn,0,0,0,0,0,0,2,2,4,0,3,3,1,1,2,0,0,0,3,6,9
fa12,123,MUIR,LING,Ling-LSoc,0,0,0,0,0,0,0,0,0,0,0,0,1,4,5,0,0,0,1,4,5
fa12,123,MUIR,LING,Linguistcs,0,0,0,0,0,0,0,1,1,5,0,5,4,1,5,0,0,0,9,2,11
fa12,123,MUIR,LIT,Lit/Compos,0,0,0,0,0,0,0,0,0,1,1,2,0,0,0,0,0,0,1,1,2
fa12,123,MUIR,LIT,Lit/CultSt,0,2,2,0,0,0,0,1,1,0,0,0,0,0,0,0,0,0,0,3,3
fa12,123,MUIR,LIT,Lit/Engl,0,0,0,0,0,0,0,1,1,3,7,10,2,8,10,0,0,0,5,16,21
fa12,123,MUIR,LIT,Lit/World,0,0,0,0,0,0,0,0,0,0,0,0,0,1,1,0,0,0,0,1,1
fa12,123,MUIR,LIT,Lit/Writng,1,6,7,0,1,1,0,5,5,3,4,7,8,10,18,0,0,0,12,26,38
fa12,123,MUIR,LIT,Pre-Lit/Wr,0,0,0,0,0,0,0,0,0,0,0,0,1,0,1,0,0,0,1,0,1
fa12,123,MUIR,LIT,Spanish Lt,0,0,0,0,0,0,0,1,1,1,2,3,1,2,3,0,0,0,2,5,7
fa12,123,MUIR,MAE,Aerosp Eng,5,0,5,0,0,0,6,0,6,7,3,10,15,3,18,0,0,0,33,6,39
fa12,123,MUIR,MAE,Engin Sci,0,0,0,1,0,1,0,0,0,3,0,3,3,1,4,0,0,0,7,1,8
fa12,123,MUIR,MAE,Envir Eng,7,2,9,0,0,0,5,3,8,7,6,13,10,8,18,0,0,0,29,19,48
fa12,123,MUIR,MAE,Mech Engin,7,3,10,0,0,0,4,0,4,7,2,9,23,3,26,0,0,0,41,8,49
fa12,123,MUIR,MATH,Appld Math,1,5,6,3,0,3,2,1,3,0,1,1,2,5,7,0,0,0,8,12,20
fa12,123,MUIR,MATH,Math/SecEd,0,0,0,0,0,0,0,3,3,3,4,7,0,2,2,0,0,0,3,9,12
fa12,123,MUIR,MATH,Mathematcs,4,2,6,1,1,2,0,2,2,8,4,12,7,1,8,0,0,0,20,10,30
fa12,123,MUIR,MATH,Mth-CompSc,0,0,0,0,0,0,2,0,2,1,0,1,1,0,1,0,0,0,4,0,4
fa12,123,MUIR,MATH,Mth-Mth&Ec,3,1,4,1,0,1,0,3,3,4,2,6,3,3,6,0,0,0,11,9,20
fa12,123,MUIR,MATH,Mth/ApldSc,0,0,0,0,0,0,0,0,0,0,0,0,1,0,1,0,0,0,1,0,1
fa12,123,MUIR,MATH,Pr-Math CS,1,0,1,0,0,0,0,0,0,0,0,0,0,0,0,0,0,0,1,0,1
fa12,123,MUIR,MATH,Prob&Stats,0,0,0,0,0,0,1,0,1,0,0,0,3,0,3,0,0,0,4,0,4
fa12,123,MUIR,MUS,Mu-CompArt,0,0,0,0,0,0,1,0,1,3,1,4,5,0,5,0,0,0,9,1,10
fa12,123,MUIR,MUS,Music,2,0,2,1,0,1,1,2,3,2,1,3,0,1,1,0,0,0,6,4,10
fa12,123,MUIR,MUS,Music Hum,0,0,0,0,0,0,0,0,0,1,0,1,0,0,0,0,0,0,1,0,1
fa12,123,MUIR,NENG,NanoEng,5,3,8,0,0,0,3,1,4,11,1,12,6,3,9,0,0,0,25,8,33
fa12,123,MUIR,PHIL,Philosophy,0,0,0,0,0,0,0,0,0,4,1,5,9,4,13,0,0,0,13,5,18
fa12,123,MUIR,PHYS,Biophysics,1,0,1,0,0,0,0,0,0,4,1,5,3,1,4,0,0,0,8,2,10
fa12,123,MUIR,PHYS,Phy/ErthSc,0,0,0,0,0,0,0,0,0,0,0,0,0,1,1,0,0,0,0,1,1
fa12,123,MUIR,PHYS,Phys/Astro,2,1,3,0,0,0,0,0,0,0,0,0,3,2,5,0,0,0,5,3,8
fa12,123,MUIR,PHYS,Phys/Mtrls,0,0,0,0,0,0,0,0,0,0,0,0,1,0,1,0,0,0,1,0,1
fa12,123,MUIR,PHYS,Physics,2,1,3,0,0,0,0,0,0,5,0,5,7,0,7,0,0,0,14,1,15
fa12,123,MUIR,POLI,Polit Sci,0,2,2,0,0,0,5,1,6,13,15,28,20,13,33,0,0,0,38,31,69
fa12,123,MUIR,POLI,PolSc-Amer,1,2,3,0,0,0,0,0,0,2,1,3,4,3,7,0,0,0,7,6,13
fa12,123,MUIR,POLI,PolSc-Intl,0,1,1,0,0,0,2,4,6,3,9,12,8,8,16,0,0,0,13,22,35
fa12,123,MUIR,POLI,PolSc-PLaw,1,1,2,1,0,1,2,1,3,7,3,10,2,5,7,0,0,0,13,10,23
fa12,123,MUIR,POLI,PolSc-PPol,0,0,0,0,0,0,0,2,2,2,0,2,1,0,1,0,0,0,3,2,5
fa12,123,MUIR,POLI,PolSc-Thry,0,0,0,0,0,0,1,0,1,0,1,1,1,0,1,0,0,0,2,1,3
fa12,123,MUIR,PSYC,Psychology,10,34,44,1,5,6,8,45,53,28,65,93,27,100,127,0,0,0,74,249,323
fa12,123,MUIR,RELI,Relig/Stu,0,0,0,0,0,0,0,0,0,0,1,1,1,0,1,0,0,0,1,1,2
fa12,123,MUIR,RUSS,Russ&SovSt,0,0,0,0,0,0,0,0,0,0,2,2,0,0,0,0,0,0,0,2,2
fa12,123,MUIR,SE,Engin Sci,1,0,1,0,0,0,0,0,0,0,0,0,1,0,1,0,0,0,2,0,2
fa12,123,MUIR,SE,Struct Eng,5,7,12,2,1,3,7,2,9,18,9,27,26,10,36,0,0,0,58,29,87
fa12,123,MUIR,SIO,Earth Sci,1,1,2,0,0,0,1,1,2,1,3,4,4,2,6,0,0,0,7,7,14
fa12,123,MUIR,SIO,ErSc-Geol,0,0,0,0,0,0,0,0,0,0,0,0,1,0,1,0,0,0,1,0,1
fa12,123,MUIR,SIO,Marine Bio,0,1,1,0,1,1,0,6,6,2,2,4,2,0,2,0,0,0,4,10,14
fa12,123,MUIR,SOC,SocAmSt,0,0,0,0,0,0,0,0,0,0,1,1,1,0,1,0,0,0,1,1,2
fa12,123,MUIR,SOC,SocCulCom,0,0,0,0,0,0,0,0,0,1,0,1,1,2,3,0,0,0,2,2,4
fa12,123,MUIR,SOC,SocEconSoc,0,0,0,0,0,0,0,0,0,0,0,0,1,1,2,0,0,0,1,1,2
fa12,123,MUIR,SOC,SocIntlStu,0,0,0,0,0,0,0,0,0,0,0,0,0,1,1,0,0,0,0,1,1
fa12,123,MUIR,SOC,Sociology,1,0,1,1,1,2,0,2,2,7,22,29,12,17,29,0,0,0,21,42,63
fa12,123,MUIR,SOC,SocLawSoc,0,0,0,0,0,0,0,4,4,0,2,2,2,4,6,0,0,0,2,10,12
fa12,123,MUIR,SOC,SocSciMed,0,0,0,0,0,0,0,1,1,0,1,1,1,4,5,0,0,0,1,6,7
fa12,123,MUIR,SOC,SocSolneq,0,0,0,0,0,0,0,0,0,0,3,3,0,1,1,0,0,0,0,4,4
fa12,123,MUIR,THEA,Dance,0,1,1,0,0,0,0,1,1,0,1,1,0,4,4,0,0,0,0,7,7
fa12,123,MUIR,THEA,Theatre,0,1,1,2,2,4,0,1,1,4,6,10,4,7,11,0,0,0,10,17,27
fa12,123,MUIR,TWS,ThirdWldSt,0,0,0,0,0,0,0,0,0,0,1,1,0,0,0,0,0,0,0,1,1
fa12,123,MUIR,UNAF,UndecHumAr,1,6,7,0,0,0,1,1,2,0,0,0,0,0,0,0,0,0,2,7,9
fa12,123,MUIR,UNAF,Undeclared,40,64,104,4,7,11,13,15,28,10,5,15,0,0,0,0,0,0,67,91,158
fa12,123,MUIR,UNAF,UndecPhysS,5,6,11,1,0,1,3,1,4,0,0,0,0,0,0,0,0,0,9,7,16
fa12,123,MUIR,UNAF,UndecSocSc,1,11,12,0,0,0,0,0,0,0,1,1,0,0,0,0,0,0,1,12,13
fa12,123,MUIR,USP,Urb Stu&Pl,0,0,0,1,0,1,0,1,1,8,4,12,8,7,15,0,0,0,17,12,29
fa12,123,MUIR,VIS,Art Hst/Cr,0,0,0,0,0,0,1,1,2,0,1,1,0,4,4,0,0,0,1,6,7
fa12,123,MUIR,VIS,Media,1,2,3,0,0,0,0,0,0,9,8,17,10,14,24,0,0,0,20,24,44
fa12,123,MUIR,VIS,Studio VA,0,1,1,0,0,0,0,1,1,0,3,3,3,4,7,0,0,0,3,9,12
fa12,123,MUIR,VIS,VA-CompArt,0,1,1,0,0,0,1,0,1,3,2,5,0,3,3,0,0,0,4,6,10
fa12,123,REVELLE,ANTH,Anth-Arch,0,2,2,0,0,0,0,0,0,0,1,1,0,1,1,0,0,0,0,4,4
fa12,123,REVELLE,ANTH,Anth-Biol,1,3,4,0,0,0,0,1,1,1,1,2,2,1,3,0,0,0,4,6,10
fa12,123,REVELLE,ANTH,Anth-Soci,1,0,1,0,0,0,0,1,1,2,2,4,0,1,1,0,0,0,3,4,7
fa12,123,REVELLE,BENG,Bioen:Binf,2,2,4,0,1,1,2,1,3,2,3,5,4,3,7,0,0,0,10,10,20
fa12,123,REVELLE,BENG,Bioeng:PM,0,0,0,0,0,0,0,0,0,0,0,0,4,2,6,0,0,0,4,2,6
fa12,123,REVELLE,BENG,BioengBiot,13,2,15,1,0,1,4,5,9,4,3,7,21,10,31,0,0,0,43,20,63
fa12,123,REVELLE,BENG,Bioengin,8,4,12,0,1,1,3,6,9,7,5,12,7,5,12,0,0,0,25,21,46
fa12,123,REVELLE,BIOL,Bioc/CellB,24,16,40,0,2,2,3,10,13,14,18,32,46,39,85,0,0,0,87,85,172
fa12,123,REVELLE,BIOL,BiolBioinf,1,1,2,0,0,0,0,1,1,0,0,0,2,0,2,0,0,0,3,2,5
fa12,123,REVELLE,BIOL,Ec/Beh/Evo,2,1,3,0,0,0,0,1,1,2,2,4,3,9,12,0,0,0,7,13,20
fa12,123,REVELLE,BIOL,Genl Biol,23,28,51,0,2,2,2,10,12,14,15,29,30,68,98,0,0,0,69,123,192
fa12,123,REVELLE,BIOL,Human Bio,31,49,80,2,1,3,13,25,38,18,40,58,66,78,144,0,0,0,130,193,323
fa12,123,REVELLE,BIOL,Microbiol,4,3,7,0,0,0,2,1,3,3,1,4,5,9,14,0,0,0,14,14,28
fa12,123,REVELLE,BIOL,Molec Biol,6,6,12,0,0,0,0,2,2,2,4,6,5,11,16,0,0,0,13,23,36
fa12,123,REVELLE,BIOL,PhyslNeuro,19,17,36,1,1,2,1,10,11,9,8,17,21,41,62,0,0,0,51,77,128
fa12,123,REVELLE,CENG,Chem Engin,37,12,49,1,0,1,8,3,11,19,5,24,21,14,35,0,0,0,86,34,120
fa12,123,REVELLE,CGS,CritGendSt,0,0,0,0,0,0,0,0,0,0,0,0,1,1,2,0,0,0,1,1,2
fa12,123,REVELLE,CHEM,Bioch/Chem,14,11,25,0,2,2,12,12,24,13,15,28,24,23,47,0,0,0,63,63,126
fa12,123,REVELLE,CHEM,Bioinform,0,0,0,0,0,0,0,1,1,0,0,0,0,0,0,0,0,0,0,1,1
fa12,123,REVELLE,CHEM,Chem Educ,0,0,0,0,0,0,0,0,0,0,0,0,0,2,2,0,0,0,0,2,2
fa12,123,REVELLE,CHEM,Chem Phys,1,0,1,0,0,0,1,0,1,0,0,0,1,0,1,0,0,0,3,0,3
fa12,123,REVELLE,CHEM,Chemistry,10,10,20,1,1,2,3,4,7,5,3,8,13,12,25,0,0,0,32,30,62
fa12,123,REVELLE,CHEM,Envir Chem,0,2,2,0,0,0,0,0,0,0,1,1,0,3,3,0,0,0,0,6,6
fa12,123,REVELLE,CHEM,MolecSynth,0,0,0,0,0,0,0,0,0,0,1,1,0,0,0,0,0,0,0,1,1
fa12,123,REVELLE,CHEM,Pharm Chem,7,19,26,0,2,2,7,8,15,13,14,27,19,46,65,0,0,0,46,89,135
fa12,123,REVELLE,CHIN,Chinese St,0,1,1,0,0,0,0,0,0,0,0,0,0,0,0,0,0,0,0,1,1
fa12,123,REVELLE,CLAS,Classic St,0,0,0,0,0,0,0,0,0,0,0,0,1,1,2,0,0,0,1,1,2
fa12,123,REVELLE,COGS,Cog Sci,1,8,9,0,0,0,0,6,6,5,5,10,6,6,12,0,0,0,12,25,37
fa12,123,REVELLE,COGS,CogSc/ClAs,0,1,1,0,0,0,0,2,2,0,2,2,1,4,5,0,0,0,1,9,10
fa12,123,REVELLE,COGS,CogSc/Comp,0,0,0,0,0,0,0,0,0,0,0,0,1,1,2,0,0,0,1,1,2
fa12,123,REVELLE,COGS,CogSc/HCI,0,0,0,0,0,0,1,0,1,0,1,1,5,1,6,0,0,0,6,2,8
fa12,123,REVELLE,COGS,CogSc/HCog,0,0,0,0,0,0,0,1,1,1,1,2,0,2,2,0,0,0,1,4,5
fa12,123,REVELLE,COGS,CogSc/Neur,2,5,7,0,0,0,1,3,4,4,12,16,6,22,28,0,0,0,13,42,55
fa12,123,REVELLE,COMM,Communic,1,0,1,0,0,0,2,4,6,6,6,12,10,10,20,0,0,0,19,20,39
fa12,123,REVELLE,CSE,Comp Sci,45,4,49,4,0,4,10,4,14,31,5,36,67,10,77,0,0,0,157,23,180
fa12,123,REVELLE,CSE,CompEngCSE,13,2,15,3,0,3,7,1,8,5,0,5,7,2,9,0,0,0,35,5,40
fa12,123,REVELLE,CSE,CompScBinf,2,2,4,0,0,0,1,0,1,3,1,4,4,4,8,0,0,0,10,7,17
fa12,123,REVELLE,ECE,CompEngECE,4,1,5,0,0,0,2,1,3,2,0,2,5,0,5,0,0,0,13,2,15
fa12,123,REVELLE,ECE,Electr Eng,27,4,31,2,0,2,20,3,23,8,1,9,42,7,49,0,0,0,99,15,114
fa12,123,REVELLE,ECE,EleEng&Soc,0,0,0,0,0,0,1,0,1,1,0,1,0,0,0,0,0,0,2,0,2
fa12,123,REVELLE,ECE,Engin Phys,0,0,0,0,0,0,0,0,0,4,0,4,0,0,0,0,0,0,4,0,4
fa12,123,REVELLE,ECE,Pr-EngPhys,2,1,3,0,0,0,2,0,2,0,0,0,0,0,0,0,0,0,4,1,5
fa12,123,REVELLE,ECON,Ec-Mth&Ecn,2,3,5,0,0,0,4,2,6,4,2,6,8,2,10,0,0,0,18,9,27
fa12,123,REVELLE,ECON,Econ-MgtSc,5,6,11,2,0,2,5,5,10,13,7,20,38,13,51,0,0,0,63,31,94
fa12,123,REVELLE,ECON,Economics,14,10,24,1,3,4,10,7,17,34,13,47,45,31,76,0,0,0,104,64,168
fa12,123,REVELLE,ESYS,EnvSys(EB),0,4,4,0,0,0,1,3,4,4,7,11,4,17,21,0,0,0,9,31,40
fa12,123,REVELLE,ESYS,EnvSys(EC),0,0,0,0,0,0,0,0,0,0,0,0,2,2,4,0,0,0,2,2,4
fa12,123,REVELLE,ESYS,EnvSys(EP),0,0,0,1,0,1,0,0,0,0,0,0,0,1,1,0,0,0,1,1,2
fa12,123,REVELLE,ESYS,EnvSys(ES),1,3,4,0,0,0,1,0,1,1,0,1,3,0,3,0,0,0,6,3,9
fa12,123,REVELLE,ETHN,Ethnic St,0,0,0,0,0,0,0,1,1,0,1,1,2,1,3,0,0,0,2,3,5
fa12,123,REVELLE,GMST,German Stu,0,0,0,0,0,0,0,0,0,1,0,1,0,0,0,0,0,0,1,0,1
fa12,123,REVELLE,HDP,Human Dev,0,0,0,0,0,0,0,0,0,0,1,1,0,9,9,0,0,0,0,10,10
fa12,123,REVELLE,HDP,Pr-HumnDev,0,1,1,0,0,0,3,3,6,0,8,8,0,2,2,0,0,0,3,14,17
fa12,123,REVELLE,HIST,History,1,1,2,0,0,0,0,0,0,1,1,2,7,5,12,0,0,0,9,7,16
fa12,123,REVELLE,INTL,Int-5yrEC,0,0,0,0,0,0,0,0,0,0,0,0,0,2,2,0,0,0,0,2,2
fa12,123,REVELLE,INTL,Int-5yrPS,0,0,0,0,0,0,0,0,0,0,0,0,0,1,1,0,0,0,0,1,1
fa12,123,REVELLE,INTL,IntSt-Anth,0,0,0,0,0,0,0,1,1,0,0,0,1,0,1,0,0,0,1,1,2
fa12,123,REVELLE,INTL,IntSt-Econ,0,0,0,0,0,0,0,2,2,1,4,5,3,2,5,0,0,0,4,8,12
fa12,123,REVELLE,INTL,IntSt-Hist,0,1,1,0,0,0,0,0,0,0,0,0,0,2,2,0,0,0,0,3,3
fa12,123,REVELLE,INTL,IntSt-Ling,0,0,0,0,0,0,0,2,2,0,1,1,0,1,1,0,0,0,0,4,4
fa12,123,REVELLE,INTL,IntSt-PolS,0,0,0,1,0,1,0,0,0,0,4,4,5,5,10,0,0,0,6,9,15
fa12,123,REVELLE,INTL,IntSt-Soc,0,1,1,0,0,0,0,1,1,0,2,2,0,3,3,0,0,0,0,7,7
fa12,123,REVELLE,JAPN,JapaneseSt,0,0,0,0,0,0,0,0,0,0,0,0,1,1,2,0,0,0,1,1,2
fa12,123,REVELLE,LING,Ling-CogLn,0,0,0,0,0,0,0,0,0,0,1,1,1,4,5,0,0,0,1,5,6
fa12,123,REVELLE,LING,Ling-LSoc,0,0,0,0,0,0,0,0,0,0,0,0,0,1,1,0,0,0,0,1,1
fa12,123,REVELLE,LING,Linguistcs,1,1,2,0,0,0,0,0,0,2,0,2,3,2,5,0,0,0,6,3,9
fa12,123,REVELLE,LIT,Lit/Compos,1,0,1,0,0,0,0,0,0,0,0,0,1,0,1,0,0,0,2,0,2
fa12,123,REVELLE,LIT,Lit/Engl,1,0,1,0,1,1,0,1,1,1,0,1,2,1,3,0,0,0,4,3,7
fa12,123,REVELLE,LIT,Lit/World,0,0,0,0,0,0,0,0,0,0,0,0,1,0,1,0,0,0,1,0,1
fa12,123,REVELLE,LIT,Lit/Writng,0,3,3,0,0,0,0,0,0,2,4,6,2,7,9,0,0,0,4,14,18
fa12,123,REVELLE,LIT,Pre-Lit/Wr,0,0,0,0,0,0,0,0,0,0,0,0,0,1,1,0,0,0,0,1,1
fa12,123,REVELLE,LIT,Spanish Lt,0,0,0,0,0,0,1,1,2,0,2,2,0,1,1,0,0,0,1,4,5
fa12,123,REVELLE,MAE,Aerosp Eng,16,3,19,0,0,0,3,3,6,8,1,9,18,5,23,0,0,0,45,12,57
fa12,123,REVELLE,MAE,Engin Sci,0,0,0,0,0,0,1,0,1,6,1,7,5,2,7,0,0,0,12,3,15
fa12,123,REVELLE,MAE,Envir Eng,6,2,8,0,2,2,4,5,9,5,2,7,14,3,17,0,0,0,29,14,43
fa12,123,REVELLE,MAE,Mech Engin,5,1,6,1,0,1,4,0,4,15,2,17,32,6,38,0,0,0,57,9,66
fa12,123,REVELLE,MATH,Appld Math,7,6,13,0,0,0,3,2,5,2,2,4,7,2,9,0,0,0,19,12,31
fa12,123,REVELLE,MATH,Math/SecEd,0,2,2,0,0,0,2,0,2,0,1,1,1,1,2,0,0,0,3,4,7
fa12,123,REVELLE,MATH,Mathematcs,6,4,10,2,0,2,1,3,4,1,3,4,5,6,11,0,0,0,15,16,31
fa12,123,REVELLE,MATH,Mth-CompSc,0,0,0,0,0,0,0,1,1,0,0,0,2,1,3,0,0,0,2,2,4
fa12,123,REVELLE,MATH,Mth-Mth&Ec,2,4,6,0,0,0,0,4,4,1,0,1,3,2,5,0,0,0,6,10,16
fa12,123,REVELLE,MATH,Mth-SciCom,0,0,0,0,0,0,0,0,0,0,0,0,0,1,1,0,0,0,0,1,1
fa12,123,REVELLE,MATH,Mth/ApldSc,2,0,2,0,0,0,1,0,1,1,0,1,0,0,0,0,0,0,4,0,4
fa12,123,REVELLE,MATH,Pr-Math CS,1,0,1,0,0,0,0,0,0,0,0,0,0,0,0,0,0,0,1,0,1
fa12,123,REVELLE,MATH,Prob&Stats,0,0,0,0,0,0,0,0,0,1,1,2,3,1,4,0,0,0,4,2,6
fa12,123,REVELLE,MUS,Mu-CompArt,0,0,0,0,0,0,0,0,0,2,0,2,4,0,4,0,0,0,6,0,6
fa12,123,REVELLE,MUS,Music,2,2,4,0,0,0,0,1,1,0,0,0,4,1,5,0,0,0,6,4,10
fa12,123,REVELLE,NENG,NanoEng,15,3,18,0,1,1,10,1,11,6,3,9,25,7,32,0,0,0,56,15,71
fa12,123,REVELLE,PHIL,Philosophy,0,1,1,0,0,0,2,0,2,2,2,4,4,1,5,0,0,0,8,4,12
fa12,123,REVELLE,PHYS,Biophysics,2,2,4,0,0,0,1,0,1,4,1,5,2,2,4,0,0,0,9,5,14
fa12,123,REVELLE,PHYS,Chem Phys,0,0,0,0,0,0,0,0,0,0,0,0,0,1,1,0,0,0,0,1,1
fa12,123,REVELLE,PHYS,GenPys/SEd,0,0,0,0,0,0,0,0,0,0,0,0,1,0,1,0,0,0,1,0,1
fa12,123,REVELLE,PHYS,Phy/ErthSc,0,1,1,0,0,0,0,0,0,0,0,0,1,0,1,0,0,0,1,1,2
fa12,123,REVELLE,PHYS,Phys/Astro,1,3,4,0,1,1,0,1,1,4,1,5,4,2,6,0,0,0,9,8,17
fa12,123,REVELLE,PHYS,Phys/Comp,1,0,1,0,0,0,0,0,0,0,0,0,0,0,0,0,0,0,1,0,1
fa12,123,REVELLE,PHYS,Phys/Mtrls,0,0,0,0,0,0,0,0,0,2,1,3,2,0,2,0,0,0,4,1,5
fa12,123,REVELLE,PHYS,Physics,4,1,5,0,1,1,3,1,4,2,1,3,8,2,10,0,0,0,17,6,23
fa12,123,REVELLE,POLI,Polit Sci,2,2,4,0,0,0,2,1,3,5,7,12,6,6,12,0,0,0,15,16,31
fa12,123,REVELLE,POLI,PolSc-Amer,0,0,0,0,0,0,1,0,1,1,1,2,4,2,6,0,0,0,6,3,9
fa12,123,REVELLE,POLI,PolSc-Comp,0,0,0,0,0,0,1,0,1,0,0,0,0,1,1,0,0,0,1,1,2
fa12,123,REVELLE,POLI,PolSc-Intl,0,1,1,0,1,1,0,1,1,3,3,6,3,4,7,0,0,0,6,10,16
fa12,123,REVELLE,POLI,PolSc-PLaw,2,1,3,0,0,0,0,2,2,2,3,5,1,0,1,0,0,0,5,6,11
fa12,123,REVELLE,POLI,PolSc-PPol,0,0,0,0,0,0,1,0,1,0,1,1,0,1,1,0,0,0,1,2,3
fa12,123,REVELLE,POLI,PolSc-Thry,0,0,0,0,0,0,0,1,1,0,0,0,1,1,2,0,0,0,1,2,3
fa12,123,REVELLE,PSYC,Psychology,9,13,22,2,2,4,10,29,39,15,35,50,36,63,99,0,0,0,72,142,214
fa12,123,REVELLE,RELI,Relig/Stu,0,0,0,0,0,0,0,0,0,0,1,1,0,0,0,0,0,0,0,1,1
fa12,123,REVELLE,RUSS,Russ&SovSt,0,0,0,0,0,0,0,0,0,1,0,1,0,0,0,0,0,0,1,0,1
fa12,123,REVELLE,SE,Engin Sci,3,0,3,0,0,0,1,0,1,0,0,0,0,0,0,0,0,0,4,0,4
fa12,123,REVELLE,SE,Struct Eng,17,5,22,0,0,0,16,1,17,15,4,19,24,8,32,0,0,0,72,18,90
fa12,123,REVELLE,SIO,Earth Sci,0,0,0,0,0,0,0,0,0,0,2,2,1,3,4,0,0,0,1,5,6
fa12,123,REVELLE,SIO,Marine Bio,0,4,4,0,0,0,0,1,1,0,2,2,1,1,2,0,0,0,1,8,9
fa12,123,REVELLE,SOC,SocEconSoc,0,0,0,0,0,0,0,0,0,0,0,0,0,2,2,0,0,0,0,2,2
fa12,123,REVELLE,SOC,Sociology,1,1,2,0,0,0,0,1,1,1,2,3,6,2,8,0,0,0,8,6,14
fa12,123,REVELLE,SOC,SocLawSoc,0,1,1,0,1,1,0,2,2,0,1,1,0,1,1,0,0,0,0,6,6
fa12,123,REVELLE,SOC,SocSciMed,0,0,0,0,0,0,0,1,1,0,3,3,0,4,4,0,0,0,0,8,8
fa12,123,REVELLE,SOC,SocSolneq,0,0,0,0,0,0,0,0,0,0,1,1,0,0,0,0,0,0,0,1,1
fa12,123,REVELLE,THEA,Dance,0,1,1,0,0,0,0,0,0,0,0,0,0,0,0,0,0,0,0,1,1
fa12,123,REVELLE,THEA,Theatre,0,2,2,0,0,0,0,0,0,2,0,2,0,3,3,0,0,0,2,5,7
fa12,123,REVELLE,TWS,ThirdWldSt,0,0,0,0,0,0,0,0,0,0,0,0,0,1,1,0,0,0,0,1,1
fa12,123,REVELLE,UNAF,Limited St,0,0,0,0,0,0,0,0,0,0,0,0,0,0,0,9,9,18,9,9,18
fa12,123,REVELLE,UNAF,Spec-Emply,0,0,0,0,0,0,0,0,0,0,0,0,0,0,0,1,5,6,1,5,6
fa12,123,REVELLE,UNAF,UndecHumAr,3,6,9,0,0,0,2,0,2,0,1,1,0,0,0,0,0,0,5,7,12
fa12,123,REVELLE,UNAF,Undeclared,35,54,89,2,1,3,11,12,23,4,5,9,0,0,0,0,0,0,52,72,124
fa12,123,REVELLE,UNAF,UndecPhysS,10,11,21,0,0,0,0,1,1,0,1,1,0,0,0,0,0,0,10,13,23
fa12,123,REVELLE,UNAF,UndecSocSc,8,5,13,0,0,0,0,2,2,0,0,0,0,0,0,0,0,0,8,7,15
fa12,123,REVELLE,USP,Urb Stu&Pl,1,2,3,0,0,0,0,0,0,1,1,2,3,0,3,0,0,0,5,3,8
fa12,123,REVELLE,VIS,Media,0,0,0,0,0,0,1,0,1,1,1,2,2,1,3,0,0,0,4,2,6
fa12,123,REVELLE,VIS,Studio VA,0,0,0,0,0,0,1,0,1,1,1,2,0,2,2,0,0,0,2,3,5
fa12,123,REVELLE,VIS,VA-CompArt,1,0,1,0,0,0,1,1,2,0,2,2,3,3,6,0,0,0,5,6,11
fa12,123,ROOSEVELT,ANTH,Anth-Arch,1,3,4,0,0,0,0,1,1,1,3,4,0,3,3,0,0,0,2,10,12
fa12,123,ROOSEVELT,ANTH,Anth-Biol,0,1,1,0,0,0,0,1,1,1,0,1,1,4,5,0,0,0,2,6,8
fa12,123,ROOSEVELT,ANTH,Anth-Soci,0,4,4,0,0,0,0,1,1,5,8,13,3,7,10,0,0,0,8,20,28
fa12,123,ROOSEVELT,BENG,Bioen:Binf,2,3,5,0,0,0,1,2,3,1,5,6,3,1,4,0,0,0,7,11,18
fa12,123,ROOSEVELT,BENG,Bioeng:PM,0,0,0,0,0,0,0,0,0,0,0,0,5,1,6,0,0,0,5,1,6
fa12,123,ROOSEVELT,BENG,BioengBiot,1,1,2,0,0,0,0,1,1,2,2,4,11,3,14,0,0,0,14,7,21
fa12,123,ROOSEVELT,BENG,Bioengin,1,3,4,0,0,0,2,2,4,3,3,6,4,4,8,0,0,0,10,12,22
fa12,123,ROOSEVELT,BIOL,Bioc/CellB,8,4,12,1,0,1,2,3,5,13,5,18,10,29,39,0,0,0,34,41,75
fa12,123,ROOSEVELT,BIOL,BiolBioinf,2,0,2,0,0,0,0,0,0,0,0,0,0,0,0,0,0,0,2,0,2
fa12,123,ROOSEVELT,BIOL,Ec/Beh/Evo,0,1,1,0,0,0,0,4,4,1,0,1,4,4,8,0,0,0,5,9,14
fa12,123,ROOSEVELT,BIOL,Genl Biol,4,13,17,1,2,3,2,4,6,7,11,18,30,34,64,0,0,0,44,64,108
fa12,123,ROOSEVELT,BIOL,Human Bio,7,21,28,1,1,2,6,15,21,17,26,43,34,49,83,0,0,0,65,112,177
fa12,123,ROOSEVELT,BIOL,Microbiol,2,2,4,0,0,0,0,2,2,1,3,4,2,1,3,0,0,0,5,8,13
fa12,123,ROOSEVELT,BIOL,Molec Biol,1,1,2,0,0,0,1,2,3,2,2,4,1,3,4,0,0,0,5,8,13
fa12,123,ROOSEVELT,BIOL,PhyslNeuro,5,8,13,0,0,0,3,12,15,1,7,8,13,13,26,0,0,0,22,40,62
fa12,123,ROOSEVELT,CENG,Chem Engin,5,2,7,0,0,0,2,1,3,8,4,12,16,2,18,0,0,0,31,9,40
fa12,123,ROOSEVELT,CGS,CritGendSt,0,0,0,0,0,0,0,0,0,0,0,0,0,1,1,0,0,0,0,1,1
fa12,123,ROOSEVELT,CHEM,Bioch/Chem,7,11,18,0,3,3,2,6,8,11,10,21,11,22,33,0,0,0,31,52,83
fa12,123,ROOSEVELT,CHEM,Chem Phys,0,0,0,0,0,0,0,1,1,0,0,0,0,0,0,0,0,0,0,1,1
fa12,123,ROOSEVELT,CHEM,Chemistry,5,8,13,0,0,0,5,3,8,4,1,5,5,3,8,0,0,0,19,15,34
fa12,123,ROOSEVELT,CHEM,Envir Chem,0,1,1,0,0,0,0,0,0,1,0,1,4,1,5,0,0,0,5,2,7
fa12,123,ROOSEVELT,CHEM,MolecSynth,0,1,1,0,0,0,0,0,0,1,0,1,0,3,3,0,0,0,1,4,5
fa12,123,ROOSEVELT,CHEM,Pharm Chem,9,11,20,0,0,0,5,4,9,6,7,13,12,13,25,0,0,0,32,35,67
fa12,123,ROOSEVELT,CHIN,Chinese St,0,0,0,0,0,0,0,0,0,0,2,2,1,2,3,0,0,0,1,4,5
fa12,123,ROOSEVELT,CLAS,Classic St,1,1,2,0,0,0,0,0,0,1,2,3,0,1,1,0,0,0,2,4,6
fa12,123,ROOSEVELT,COGS,Cog Sci,1,8,9,0,0,0,1,3,4,3,5,8,3,7,10,0,0,0,8,23,31
fa12,123,ROOSEVELT,COGS,CogSc/ClAs,0,1,1,0,0,0,0,1,1,0,0,0,0,4,4,0,0,0,0,6,6
fa12,123,ROOSEVELT,COGS,CogSc/Comp,0,0,0,0,0,0,0,1,1,0,0,0,1,2,3,0,0,0,1,3,4
fa12,123,ROOSEVELT,COGS,CogSc/HCI,0,0,0,1,0,1,1,1,2,2,3,5,2,2,4,0,0,0,6,6,12
fa12,123,ROOSEVELT,COGS,CogSc/HCog,0,0,0,0,1,1,1,2,3,1,0,1,1,1,2,0,0,0,3,4,7
fa12,123,ROOSEVELT,COGS,CogSc/Neur,0,4,4,0,1,1,3,3,6,2,8,10,9,19,28,0,0,0,14,35,49
fa12,123,ROOSEVELT,COMM,Communic,3,15,18,0,1,1,1,8,9,6,46,52,15,50,65,0,0,0,25,120,145
fa12,123,ROOSEVELT,CSE,Comp Sci,17,8,25,0,1,1,7,1,8,26,1,27,37,8,45,0,0,0,87,19,106
fa12,123,ROOSEVELT,CSE,CompEngCSE,13,1,14,0,0,0,4,1,5,5,0,5,6,1,7,0,0,0,28,3,31
fa12,123,ROOSEVELT,CSE,CompScBinf,1,1,2,0,0,0,1,0,1,0,0,0,0,1,1,0,0,0,2,2,4
fa12,123,ROOSEVELT,ECE,CompEngECE,4,0,4,0,0,0,2,1,3,0,0,0,2,0,2,0,0,0,8,1,9
fa12,123,ROOSEVELT,ECE,Electr Eng,18,4,22,2,0,2,7,0,7,16,4,20,21,8,29,0,0,0,64,16,80
fa12,123,ROOSEVELT,ECE,Engin Phys,1,0,1,0,0,0,1,0,1,0,0,0,1,0,1,0,0,0,3,0,3
fa12,123,ROOSEVELT,ECON,Ec-Mth&Ecn,5,2,7,0,0,0,0,3,3,6,2,8,11,2,13,0,0,0,22,9,31
fa12,123,ROOSEVELT,ECON,Econ-MgtSc,6,9,15,2,0,2,9,1,10,23,23,46,36,18,54,0,0,0,76,51,127
fa12,123,ROOSEVELT,ECON,Economics,28,19,47,1,1,2,15,8,23,53,39,92,61,40,101,0,0,0,158,107,265
fa12,123,ROOSEVELT,ESYS,EnvSys(EB),0,5,5,0,0,0,3,2,5,3,10,13,3,12,15,0,0,0,9,29,38
fa12,123,ROOSEVELT,ESYS,EnvSys(EC),0,0,0,0,0,0,0,0,0,0,3,3,1,3,4,0,0,0,1,6,7
fa12,123,ROOSEVELT,ESYS,EnvSys(EP),1,2,3,0,0,0,0,0,0,0,0,0,0,1,1,0,0,0,1,3,4
fa12,123,ROOSEVELT,ESYS,EnvSys(ES),0,1,1,0,0,0,0,1,1,1,3,4,1,3,4,0,0,0,2,8,10
fa12,123,ROOSEVELT,ETHN,Ethnic St,0,0,0,0,0,0,0,0,0,1,1,2,1,2,3,0,0,0,2,3,5
fa12,123,ROOSEVELT,GMST,German Stu,0,0,0,0,0,0,0,0,0,1,0,1,0,0,0,0,0,0,1,0,1
fa12,123,ROOSEVELT,HDP,Human Dev,0,0,0,0,0,0,0,0,0,0,4,4,4,18,22,0,0,0,4,22,26
fa12,123,ROOSEVELT,HDP,Pr-HumnDev,0,4,4,0,3,3,0,10,10,0,13,13,0,4,4,0,0,0,0,34,34
fa12,123,ROOSEVELT,HIST,History,3,7,10,1,1,2,2,4,6,15,11,26,11,16,27,0,0,0,32,39,71
fa12,123,ROOSEVELT,INTL,Int-5yrEC,0,0,0,0,0,0,0,0,0,0,0,0,0,1,1,0,0,0,0,1,1
fa12,123,ROOSEVELT,INTL,Int-5yrPS,0,0,0,0,0,0,0,0,0,0,0,0,1,1,2,0,0,0,1,1,2
fa12,123,ROOSEVELT,INTL,IntSt-Anth,0,2,2,0,0,0,0,1,1,0,4,4,0,4,4,0,0,0,0,11,11
fa12,123,ROOSEVELT,INTL,IntSt-Econ,5,5,10,0,0,0,3,11,14,11,15,26,6,13,19,0,0,0,25,44,69
fa12,123,ROOSEVELT,INTL,IntSt-Hist,1,0,1,0,0,0,0,1,1,0,3,3,4,9,13,0,0,0,5,13,18
fa12,123,ROOSEVELT,INTL,IntSt-Ling,0,6,6,0,0,0,1,0,1,1,2,3,1,3,4,0,0,0,3,11,14
fa12,123,ROOSEVELT,INTL,IntSt-Lit,0,0,0,0,0,0,0,0,0,0,1,1,0,1,1,0,0,0,0,2,2
fa12,123,ROOSEVELT,INTL,IntSt-PolS,8,10,18,0,0,0,1,9,10,7,20,27,13,32,45,0,0,0,29,71,100
fa12,123,ROOSEVELT,INTL,IntSt-Soc,1,5,6,0,1,1,0,2,2,4,5,9,1,8,9,0,0,0,6,21,27
fa12,123,ROOSEVELT,ITAL,Italian St,0,0,0,0,0,0,1,0,1,0,0,0,0,0,0,0,0,0,1,0,1
fa12,123,ROOSEVELT,JAPN,JapaneseSt,0,2,2,0,0,0,0,0,0,1,1,2,3,0,3,0,0,0,4,3,7
fa12,123,ROOSEVELT,LATI,LatinAm St,0,0,0,0,0,0,0,0,0,0,0,0,0,2,2,0,0,0,0,2,2
fa12,123,ROOSEVELT,LING,Lang Stu,0,0,0,0,0,0,0,0,0,0,2,2,1,1,2,0,0,0,1,3,4
fa12,123,ROOSEVELT,LING,Ling-CogLn,0,0,0,0,0,0,0,0,0,0,2,2,0,2,2,0,0,0,0,4,4
fa12,123,ROOSEVELT,LING,Ling-LSoc,0,1,1,0,0,0,1,0,1,1,1,2,1,4,5,0,0,0,3,6,9
fa12,123,ROOSEVELT,LING,Linguistcs,0,0,0,0,0,0,0,0,0,1,3,4,1,1,2,0,0,0,2,4,6
fa12,123,ROOSEVELT,LIT,Lit/CultSt,1,0,1,0,0,0,0,0,0,0,0,0,1,1,2,0,0,0,2,1,3
fa12,123,ROOSEVELT,LIT,Lit/Engl,2,3,5,0,0,0,0,0,0,0,5,5,3,7,10,0,0,0,5,15,20
fa12,123,ROOSEVELT,LIT,Lit/World,0,1,1,0,0,0,0,1,1,0,1,1,0,0,0,0,0,0,0,3,3
fa12,123,ROOSEVELT,LIT,Lit/Writng,1,5,6,0,0,0,1,5,6,3,8,11,5,13,18,0,0,0,10,31,41
fa12,123,ROOSEVELT,LIT,Pre-Lit/Wr,0,0,0,0,0,0,0,0,0,1,0,1,0,0,0,0,0,0,1,0,1
fa12,123,ROOSEVELT,LIT,Spanish Lt,0,0,0,0,0,0,0,0,0,0,1,1,2,1,3,0,0,0,2,2,4
fa12,123,ROOSEVELT,MAE,Aerosp Eng,4,0,4,0,0,0,1,0,1,3,0,3,13,3,16,0,0,0,21,3,24
fa12,123,ROOSEVELT,MAE,Engin Sci,0,0,0,0,0,0,0,0,0,1,0,1,3,0,3,0,0,0,4,0,4
fa12,123,ROOSEVELT,MAE,Envir Eng,1,7,8,0,0,0,5,1,6,4,1,5,7,3,10,0,0,0,17,12,29
fa12,123,ROOSEVELT,MAE,Mech Engin,1,1,2,1,0,1,4,1,5,2,0,2,33,4,37,0,0,0,41,6,47
fa12,123,ROOSEVELT,MATH,Appld Math,5,1,6,0,1,1,0,1,1,0,1,1,0,1,1,0,0,0,5,5,10
fa12,123,ROOSEVELT,MATH,Math/SecEd,0,1,1,0,1,1,0,1,1,0,0,0,0,2,2,0,0,0,0,5,5
fa12,123,ROOSEVELT,MATH,Mathematcs,2,0,2,0,0,0,2,1,3,5,1,6,2,2,4,0,0,0,11,4,15
fa12,123,ROOSEVELT,MATH,Mth-CompSc,0,0,0,0,0,0,0,1,1,0,0,0,2,1,3,0,0,0,2,2,4
fa12,123,ROOSEVELT,MATH,Mth-Mth&Ec,2,4,6,1,0,1,0,3,3,1,6,7,4,2,6,0,0,0,8,15,23
fa12,123,ROOSEVELT,MATH,Mth/ApldSc,2,1,3,0,0,0,1,0,1,0,0,0,0,0,0,0,0,0,3,1,4
fa12,123,ROOSEVELT,MATH,Prob&Stats,0,0,0,0,0,0,1,0,1,0,0,0,0,2,2,0,0,0,1,2,3
fa12,123,ROOSEVELT,MUS,Mu-CompArt,0,0,0,0,0,0,0,0,0,1,1,2,0,1,1,0,0,0,1,2,3
fa12,123,ROOSEVELT,MUS,Music,0,0,0,0,0,0,0,1,1,0,0,0,2,2,4,0,0,0,2,3,5
fa12,123,ROOSEVELT,MUS,Music Hum,0,0,0,0,0,0,0,0,0,0,1,1,0,0,0,0,0,0,0,1,1
fa12,123,ROOSEVELT,NENG,NanoEng,2,1,3,0,0,0,2,2,4,11,2,13,10,3,13,0,0,0,25,8,33
fa12,123,ROOSEVELT,PHIL,Philosophy,0,1,1,0,0,0,0,0,0,1,1,2,4,2,6,0,0,0,5,4,9
fa12,123,ROOSEVELT,PHYS,Biophysics,0,1,1,0,0,0,1,0,1,0,0,0,1,2,3,0,0,0,2,3,5
fa12,123,ROOSEVELT,PHYS,Phy/ErthSc,0,0,0,0,0,0,0,0,0,0,0,0,0,1,1,0,0,0,0,1,1
fa12,123,ROOSEVELT,PHYS,Phys/Astro,2,1,3,0,0,0,1,0,1,0,1,1,0,0,0,0,0,0,3,2,5
fa12,123,ROOSEVELT,PHYS,Phys/Comp,0,0,0,0,0,0,0,0,0,0,0,0,1,0,1,0,0,0,1,0,1
fa12,123,ROOSEVELT,PHYS,Phys/Mtrls,0,0,0,0,0,0,0,0,0,0,0,0,1,0,1,0,0,0,1,0,1
fa12,123,ROOSEVELT,PHYS,Physics,3,1,4,0,0,0,1,0,1,1,1,2,1,0,1,0,0,0,6,2,8
fa12,123,ROOSEVELT,POLI,Polit Sci,7,11,18,0,1,1,3,8,11,14,20,34,27,17,44,0,0,0,51,57,108
fa12,123,ROOSEVELT,POLI,PolSc-Amer,1,1,2,0,0,0,1,0,1,1,1,2,4,3,7,0,0,0,7,5,12
fa12,123,ROOSEVELT,POLI,PolSc-Intl,5,9,14,1,1,2,2,5,7,12,19,31,22,26,48,0,0,0,42,60,102
fa12,123,ROOSEVELT,POLI,PolSc-PLaw,2,8,10,0,0,0,4,5,9,5,7,12,7,8,15,0,0,0,18,28,46
fa12,123,ROOSEVELT,POLI,PolSc-PPol,4,2,6,0,0,0,0,0,0,1,1,2,1,1,2,0,0,0,6,4,10
fa12,123,ROOSEVELT,POLI,PolSc-Thry,0,0,0,1,0,1,0,0,0,2,0,2,1,0,1,0,0,0,4,0,4
fa12,123,ROOSEVELT,PSYC,Psychology,4,24,28,0,2,2,7,22,29,11,49,60,34,79,113,0,0,0,56,176,232
fa12,123,ROOSEVELT,RELI,Relig/Stu,0,0,0,0,0,0,0,0,0,0,1,1,0,3,3,0,0,0,0,4,4
fa12,123,ROOSEVELT,RUSS,Russ&SovSt,0,1,1,0,0,0,0,0,0,0,0,0,0,0,0,0,0,0,0,1,1
fa12,123,ROOSEVELT,SE,Engin Sci,1,2,3,0,0,0,1,0,1,0,0,0,1,0,1,0,0,0,3,2,5
fa12,123,ROOSEVELT,SE,Struct Eng,8,7,15,3,2,5,4,0,4,16,4,20,19,4,23,0,0,0,50,17,67
fa12,123,ROOSEVELT,SIO,Earth Sci,1,1,2,0,0,0,0,2,2,1,0,1,0,1,1,0,0,0,2,4,6
fa12,123,ROOSEVELT,SIO,ErSc-Geol,0,0,0,0,0,0,0,0,0,0,1,1,0,0,0,0,0,0,0,1,1
fa12,123,ROOSEVELT,SIO,Marine Bio,1,4,5,0,0,0,0,1,1,1,1,2,2,2,4,0,0,0,4,8,12
fa12,123,ROOSEVELT,SOC,SocAmSt,0,0,0,0,0,0,0,0,0,0,1,1,0,1,1,0,0,0,0,2,2
fa12,123,ROOSEVELT,SOC,SocCulCom,0,1,1,0,0,0,0,0,0,0,0,0,1,3,4,0,0,0,1,4,5
fa12,123,ROOSEVELT,SOC,SocEconSoc,1,0,1,0,0,0,0,0,0,0,2,2,1,1,2,0,0,0,2,3,5
fa12,123,ROOSEVELT,SOC,SocIntlStu,0,0,0,0,0,0,0,0,0,0,0,0,1,1,2,0,0,0,1,1,2
fa12,123,ROOSEVELT,SOC,Sociology,1,4,5,0,2,2,0,1,1,3,17,20,6,10,16,0,0,0,10,34,44
fa12,123,ROOSEVELT,SOC,SocLawSoc,0,0,0,0,0,0,0,0,0,1,3,4,1,3,4,0,0,0,2,6,8
fa12,123,ROOSEVELT,SOC,SocSciMed,0,0,0,0,0,0,0,1,1,0,1,1,1,2,3,0,0,0,1,4,5
fa12,123,ROOSEVELT,SOC,SocSolneq,0,0,0,0,0,0,0,0,0,0,0,0,0,3,3,0,0,0,0,3,3
fa12,123,ROOSEVELT,THEA,Dance,0,0,0,0,0,0,0,1,1,0,1,1,0,1,1,0,0,0,0,3,3
fa12,123,ROOSEVELT,THEA,Theatre,0,3,3,0,0,0,0,2,2,0,3,3,1,7,8,0,0,0,1,15,16
fa12,123,ROOSEVELT,TWS,ThirdWldSt,0,0,0,0,0,0,1,1,2,0,0,0,0,2,2,0,0,0,1,3,4
fa12,123,ROOSEVELT,UNAF,UndecHumAr,2,10,12,0,0,0,1,2,3,0,0,0,0,0,0,0,0,0,3,12,15
fa12,123,ROOSEVELT,UNAF,Undeclared,54,79,133,2,1,3,9,15,24,4,5,9,1,0,1,0,0,0,70,100,170
fa12,123,ROOSEVELT,UNAF,UndecPhysS,11,8,19,0,0,0,2,1,3,0,0,0,0,0,0,0,0,0,13,9,22
fa12,123,ROOSEVELT,UNAF,UndecSocSc,6,8,14,0,0,0,2,3,5,0,0,0,0,0,0,0,0,0,8,11,19
fa12,123,ROOSEVELT,USP,Urb Stu&Pl,1,0,1,0,0,0,0,4,4,3,6,9,6,13,19,0,0,0,10,23,33
fa12,123,ROOSEVELT,VIS,Art Hst/Cr,0,0,0,0,0,0,0,0,0,0,2,2,1,2,3,0,0,0,1,4,5
fa12,123,ROOSEVELT,VIS,Media,3,4,7,0,1,1,3,1,4,5,7,12,6,10,16,0,0,0,17,23,40
fa12,123,ROOSEVELT,VIS,Studio VA,0,2,2,0,0,0,2,1,3,0,1,1,1,4,5,0,0,0,3,8,11
fa12,123,ROOSEVELT,VIS,VA-CompArt,0,1,1,0,0,0,0,0,0,1,0,1,0,3,3,0,0,0,1,4,5
fa12,123,SIXTH,ANTH,Anth-Arch,1,0,1,0,0,0,0,0,0,0,0,0,1,2,3,0,0,0,2,2,4
fa12,123,SIXTH,ANTH,Anth-Biol,1,0,1,0,0,0,0,0,0,0,1,1,1,9,10,0,0,0,2,10,12
fa12,123,SIXTH,ANTH,Anth-Soci,0,1,1,0,0,0,0,1,1,1,3,4,0,6,6,0,0,0,1,11,12
fa12,123,SIXTH,BENG,Bioen:Binf,3,6,9,0,0,0,2,0,2,3,3,6,5,1,6,0,0,0,13,10,23
fa12,123,SIXTH,BENG,Bioeng:PM,0,0,0,0,0,0,0,0,0,0,0,0,5,1,6,0,0,0,5,1,6
fa12,123,SIXTH,BENG,BioengBiot,5,4,9,0,0,0,4,1,5,5,8,13,16,4,20,0,0,0,30,17,47
fa12,123,SIXTH,BENG,Bioengin,2,1,3,0,0,0,1,1,2,6,4,10,7,3,10,0,0,0,16,9,25
fa12,123,SIXTH,BIOL,Bioc/CellB,12,8,20,0,0,0,9,11,20,10,12,22,16,28,44,0,0,0,47,59,106
fa12,123,SIXTH,BIOL,BiolBioinf,0,1,1,0,0,0,0,0,0,1,0,1,0,0,0,0,0,0,1,1,2
fa12,123,SIXTH,BIOL,Ec/Beh/Evo,0,1,1,0,0,0,0,0,0,2,3,5,3,5,8,0,0,0,5,9,14
fa12,123,SIXTH,BIOL,Genl Biol,5,13,18,0,0,0,2,8,10,13,7,20,21,27,48,0,0,0,41,55,96
fa12,123,SIXTH,BIOL,Human Bio,14,23,37,0,1,1,8,12,20,19,16,35,31,28,59,0,0,0,72,80,152
fa12,123,SIXTH,BIOL,Microbiol,0,3,3,0,0,0,1,0,1,1,2,3,5,3,8,0,0,0,7,8,15
fa12,123,SIXTH,BIOL,Molec Biol,4,1,5,0,0,0,0,0,0,1,3,4,2,1,3,0,0,0,7,5,12
fa12,123,SIXTH,BIOL,PhyslNeuro,3,5,8,0,0,0,1,2,3,9,7,16,11,17,28,0,0,0,24,31,55
fa12,123,SIXTH,CENG,Chem Engin,18,5,23,0,0,0,3,2,5,9,3,12,17,5,22,0,0,0,47,15,62
fa12,123,SIXTH,CGS,CritGendSt,0,0,0,0,0,0,0,0,0,0,0,0,1,1,2,0,0,0,1,1,2
fa12,123,SIXTH,CHEM,Bioch/Chem,6,6,12,0,0,0,2,11,13,13,8,21,28,15,43,0,0,0,49,40,89
fa12,123,SIXTH,CHEM,Chem Phys,0,0,0,0,0,0,0,0,0,2,0,2,1,0,1,0,0,0,3,0,3
fa12,123,SIXTH,CHEM,Chemistry,3,8,11,0,0,0,3,3,6,3,5,8,7,3,10,0,0,0,16,19,35
fa12,123,SIXTH,CHEM,Envir Chem,0,0,0,0,0,0,0,1,1,0,1,1,0,1,1,0,0,0,0,3,3
fa12,123,SIXTH,CHEM,MolecSynth,0,0,0,0,0,0,0,1,1,0,0,0,1,2,3,0,0,0,1,3,4
fa12,123,SIXTH,CHEM,Pharm Chem,4,9,13,0,2,2,8,6,14,18,8,26,18,19,37,0,0,0,48,44,92
fa12,123,SIXTH,CHIN,Chinese St,1,0,1,0,0,0,0,0,0,1,0,1,0,1,1,0,0,0,2,1,3
fa12,123,SIXTH,COGS,Cog Sci,4,1,5,0,0,0,1,4,5,1,3,4,9,4,13,0,0,0,15,12,27
fa12,123,SIXTH,COGS,CogSc/ClAs,0,0,0,0,0,0,0,0,0,0,0,0,0,2,2,0,0,0,0,2,2
fa12,123,SIXTH,COGS,CogSc/Comp,0,0,0,0,0,0,0,1,1,0,0,0,4,1,5,0,0,0,4,2,6
fa12,123,SIXTH,COGS,CogSc/HCI,0,0,0,0,0,0,0,0,0,4,4,8,4,6,10,0,0,0,8,10,18
fa12,123,SIXTH,COGS,CogSc/HCog,0,0,0,0,0,0,1,0,1,0,0,0,0,1,1,0,0,0,1,1,2
fa12,123,SIXTH,COGS,CogSc/Neur,1,0,1,0,1,1,1,1,2,3,2,5,13,20,33,0,0,0,18,24,42
fa12,123,SIXTH,COMM,Communic,1,18,19,1,1,2,1,14,15,13,52,65,15,44,59,0,0,0,31,129,160
fa12,123,SIXTH,CSE,Comp Sci,59,15,74,2,0,2,28,3,31,46,14,60,89,20,109,0,0,0,224,52,276
fa12,123,SIXTH,CSE,CompEngCSE,35,5,40,0,1,1,9,4,13,14,1,15,18,0,18,0,0,0,76,11,87
fa12,123,SIXTH,CSE,CompScBinf,2,3,5,0,0,0,0,1,1,1,2,3,7,0,7,0,0,0,10,6,16
fa12,123,SIXTH,ECE,CompEngECE,6,0,6,0,0,0,4,0,4,1,0,1,4,0,4,0,0,0,15,0,15
fa12,123,SIXTH,ECE,Electr Eng,45,5,50,0,0,0,13,1,14,24,1,25,37,3,40,0,0,0,119,10,129
fa12,123,SIXTH,ECE,EleEng&Soc,0,0,0,0,0,0,0,1,1,0,0,0,0,0,0,0,0,0,0,1,1
fa12,123,SIXTH,ECE,Engin Phys,0,0,0,0,0,0,1,0,1,0,0,0,1,0,1,0,0,0,2,0,2
fa12,123,SIXTH,ECON,Ec-Mth&Ecn,2,2,4,0,0,0,1,1,2,4,1,5,5,2,7,0,0,0,12,6,18
fa12,123,SIXTH,ECON,Econ-MgtSc,4,3,7,1,0,1,5,5,10,32,20,52,23,35,58,0,0,0,65,63,128
fa12,123,SIXTH,ECON,Economics,23,15,38,1,0,1,10,6,16,50,32,82,56,26,82,0,0,0,140,79,219
fa12,123,SIXTH,ESYS,EnvSys(EB),0,2,2,0,0,0,0,4,4,5,10,15,5,14,19,0,0,0,10,30,40
fa12,123,SIXTH,ESYS,EnvSys(EC),0,0,0,0,0,0,1,0,1,0,0,0,3,0,3,0,0,0,4,0,4
fa12,123,SIXTH,ESYS,EnvSys(EP),1,3,4,0,0,0,0,0,0,1,4,5,1,4,5,0,0,0,3,11,14
fa12,123,SIXTH,ESYS,EnvSys(ES),1,1,2,0,0,0,1,2,3,1,2,3,1,0,1,0,0,0,4,5,9
fa12,123,SIXTH,ETHN,Ethnic St,0,0,0,0,0,0,1,0,1,1,2,3,2,3,5,0,0,0,4,5,9
fa12,123,SIXTH,GMST,German Stu,0,0,0,0,0,0,0,0,0,0,1,1,0,0,0,0,0,0,0,1,1
fa12,123,SIXTH,HDP,Human Dev,0,0,0,0,0,0,0,0,0,0,7,7,3,14,17,0,0,0,3,21,24
fa12,123,SIXTH,HDP,Pr-HumnDev,0,3,3,1,2,3,4,8,12,0,11,11,0,3,3,0,0,0,5,27,32
fa12,123,SIXTH,HIST,History,1,0,1,0,0,0,3,0,3,4,3,7,8,8,16,0,0,0,16,11,27
fa12,123,SIXTH,INTL,IntSt-Anth,0,2,2,0,0,0,1,0,1,0,1,1,0,1,1,0,0,0,1,4,5
fa12,123,SIXTH,INTL,IntSt-Econ,4,3,7,0,0,0,0,3,3,5,5,10,6,10,16,0,0,0,15,21,36
fa12,123,SIXTH,INTL,IntSt-Hist,0,2,2,0,0,0,1,0,1,0,1,1,0,2,2,0,0,0,1,5,6
fa12,123,SIXTH,INTL,IntSt-Ling,0,0,0,0,0,0,0,0,0,0,2,2,1,3,4,0,0,0,1,5,6
fa12,123,SIXTH,INTL,IntSt-PolS,1,0,1,0,1,1,0,0,0,0,6,6,5,8,13,0,0,0,6,15,21
fa12,123,SIXTH,INTL,IntSt-Soc,0,3,3,0,0,0,0,1,1,1,1,2,0,5,5,0,0,0,1,10,11
fa12,123,SIXTH,JAPN,JapaneseSt,0,0,0,0,0,0,0,0,0,0,0,0,0,2,2,0,0,0,0,2,2
fa12,123,SIXTH,LATI,LatinAm St,0,0,0,0,0,0,0,0,0,1,0,1,0,0,0,0,0,0,1,0,1
fa12,123,SIXTH,LING,Lang Stu,0,0,0,0,0,0,0,0,0,1,1,2,1,1,2,0,0,0,2,2,4
fa12,123,SIXTH,LING,Ling-CogLn,0,2,2,0,0,0,0,1,1,1,2,3,1,0,1,0,0,0,2,5,7
fa12,123,SIXTH,LING,Ling-LSoc,0,0,0,0,0,0,0,0,0,0,2,2,0,1,1,0,0,0,0,3,3
fa12,123,SIXTH,LING,Linguistcs,0,3,3,0,0,0,0,0,0,0,1,1,1,2,3,0,0,0,1,6,7
fa12,123,SIXTH,LIT,French Lit,0,0,0,0,0,0,0,0,0,0,0,0,0,1,1,0,0,0,0,1,1
fa12,123,SIXTH,LIT,Lit/Engl,0,1,1,0,1,1,1,0,1,0,2,2,1,0,1,0,0,0,2,4,6
fa12,123,SIXTH,LIT,Lit/World,0,0,0,0,0,0,0,0,0,0,1,1,0,1,1,0,0,0,0,2,2
fa12,123,SIXTH,LIT,Lit/Writng,2,3,5,0,0,0,0,2,2,3,2,5,1,12,13,0,0,0,6,19,25
fa12,123,SIXTH,LIT,Spanish Lt,0,0,0,0,0,0,0,0,0,0,0,0,0,1,1,0,0,0,0,1,1
fa12,123,SIXTH,MAE,Aerosp Eng,5,1,6,0,0,0,4,2,6,8,0,8,26,6,32,0,0,0,43,9,52
fa12,123,SIXTH,MAE,Engin Sci,0,0,0,0,0,0,1,0,1,4,0,4,4,0,4,0,0,0,9,0,9
fa12,123,SIXTH,MAE,Envir Eng,7,4,11,1,1,2,2,2,4,8,7,15,8,8,16,0,0,0,26,22,48
fa12,123,SIXTH,MAE,Mech Engin,3,3,6,0,0,0,10,3,13,16,3,19,48,7,55,0,0,0,77,16,93
fa12,123,SIXTH,MATH,Appld Math,5,5,10,1,0,1,2,3,5,1,2,3,3,1,4,0,0,0,12,11,23
fa12,123,SIXTH,MATH,Math/SecEd,1,0,1,0,0,0,0,0,0,0,1,1,0,1,1,0,0,0,1,2,3
fa12,123,SIXTH,MATH,Mathematcs,3,3,6,0,0,0,1,1,2,1,1,2,6,3,9,0,0,0,11,8,19
fa12,123,SIXTH,MATH,Mth-CompSc,0,0,0,0,0,0,0,1,1,2,0,2,2,0,2,0,0,0,4,1,5
fa12,123,SIXTH,MATH,Mth-Mth&Ec,5,2,7,1,0,1,0,1,1,3,2,5,3,3,6,0,0,0,12,8,20
fa12,123,SIXTH,MATH,Mth-SciCom,0,1,1,0,0,0,0,0,0,0,0,0,0,1,1,0,0,0,0,2,2
fa12,123,SIXTH,MATH,Mth/ApldSc,2,1,3,0,0,0,0,0,0,1,0,1,0,0,0,0,0,0,3,1,4
fa12,123,SIXTH,MATH,Pr-Math CS,1,0,1,0,0,0,0,0,0,2,0,2,0,0,0,0,0,0,3,0,3
fa12,123,SIXTH,MATH,Prob&Stats,2,1,3,0,0,0,1,0,1,1,0,1,2,2,4,0,0,0,6,3,9
fa12,123,SIXTH,MUS,Mu-CompArt,1,0,1,0,0,0,0,0,0,9,0,9,13,3,16,0,0,0,23,3,26
fa12,123,SIXTH,MUS,Music,2,0,2,0,1,1,1,0,1,2,3,5,6,4,10,0,0,0,11,8,19
fa12,123,SIXTH,MUS,Music Hum,0,0,0,0,0,0,0,0,0,0,0,0,0,1,1,0,0,0,0,1,1
fa12,123,SIXTH,NENG,NanoEng,6,1,7,0,0,0,8,1,9,7,0,7,13,2,15,0,0,0,34,4,38
fa12,123,SIXTH,PHIL,Philosophy,1,0,1,0,0,0,1,0,1,1,0,1,4,1,5,0,0,0,7,1,8
fa12,123,SIXTH,PHYS,Biophysics,0,0,0,0,0,0,0,0,0,1,0,1,5,0,5,0,0,0,6,0,6
fa12,123,SIXTH,PHYS,Phy/ErthSc,0,0,0,0,0,0,0,0,0,2,0,2,0,0,0,0,0,0,2,0,2
fa12,123,SIXTH,PHYS,Phys/Astro,0,1,1,0,0,0,0,0,0,0,1,1,1,0,1,0,0,0,1,2,3
fa12,123,SIXTH,PHYS,Phys/Comp,1,0,1,0,0,0,0,0,0,0,0,0,0,0,0,0,0,0,1,0,1
fa12,123,SIXTH,PHYS,Phys/Mtrls,1,0,1,0,0,0,0,0,0,0,0,0,1,0,1,0,0,0,2,0,2
fa12,123,SIXTH,PHYS,Physics,5,1,6,0,0,0,1,0,1,2,0,2,7,0,7,0,0,0,15,1,16
fa12,123,SIXTH,POLI,Polit Sci,2,4,6,0,0,0,1,1,2,9,6,15,11,11,22,0,0,0,23,22,45
fa12,123,SIXTH,POLI,PolSc-Amer,0,0,0,1,0,1,0,0,0,0,1,1,3,1,4,0,0,0,4,2,6
fa12,123,SIXTH,POLI,PolSc-Comp,0,0,0,0,0,0,0,0,0,0,0,0,0,1,1,0,0,0,0,1,1
fa12,123,SIXTH,POLI,PolSc-Intl,1,2,3,0,0,0,1,4,5,5,3,8,4,9,13,0,0,0,11,18,29
fa12,123,SIXTH,POLI,PolSc-PLaw,0,0,0,0,0,0,3,0,3,4,0,4,5,4,9,0,0,0,12,4,16
fa12,123,SIXTH,POLI,PolSc-PPol,0,0,0,0,0,0,1,0,1,0,1,1,1,1,2,0,0,0,2,2,4
fa12,123,SIXTH,POLI,PolSc-Thry,0,0,0,0,0,0,0,1,1,0,0,0,0,2,2,0,0,0,0,3,3
fa12,123,SIXTH,PSYC,Psychology,10,20,30,3,0,3,6,16,22,20,45,65,33,50,83,0,0,0,72,131,203
fa12,123,SIXTH,RELI,Relig/Stu,0,0,0,0,0,0,0,0,0,0,0,0,0,1,1,0,0,0,0,1,1
fa12,123,SIXTH,SE,Engin Sci,1,0,1,0,0,0,0,0,0,0,1,1,0,0,0,0,0,0,1,1,2
fa12,123,SIXTH,SE,Struct Eng,19,7,26,0,0,0,9,4,13,16,3,19,40,12,52,0,0,0,84,26,110
fa12,123,SIXTH,SIO,Earth Sci,0,2,2,0,0,0,1,0,1,1,0,1,2,2,4,0,0,0,4,4,8
fa12,123,SIXTH,SIO,ErSc-Geoph,0,0,0,0,0,0,0,0,0,0,0,0,0,1,1,0,0,0,0,1,1
fa12,123,SIXTH,SIO,Marine Bio,2,1,3,0,0,0,0,0,0,0,0,0,0,0,0,0,0,0,2,1,3
fa12,123,SIXTH,SOC,SocCulCom,0,0,0,0,0,0,0,0,0,0,0,0,1,5,6,0,0,0,1,5,6
fa12,123,SIXTH,SOC,SocEconSoc,0,0,0,0,0,0,0,0,0,1,0,1,0,0,0,0,0,0,1,0,1
fa12,123,SIXTH,SOC,SocIntlStu,0,0,0,0,0,0,0,1,1,0,1,1,0,2,2,0,0,0,0,4,4
fa12,123,SIXTH,SOC,Sociology,1,3,4,0,1,1,0,0,0,3,8,11,8,14,22,0,0,0,12,26,38
fa12,123,SIXTH,SOC,SocLawSoc,0,0,0,0,0,0,0,0,0,0,1,1,0,3,3,0,0,0,0,4,4
fa12,123,SIXTH,SOC,SocSciMed,0,0,0,0,0,0,1,0,1,0,0,0,2,3,5,0,0,0,3,3,6
fa12,123,SIXTH,SOC,SocSolneq,0,0,0,0,0,0,0,1,1,0,1,1,0,0,0,0,0,0,0,2,2
fa12,123,SIXTH,THEA,Dance,0,0,0,0,0,0,0,0,0,1,0,1,0,0,0,0,0,0,1,0,1
fa12,123,SIXTH,THEA,Theatre,0,1,1,1,0,1,2,2,4,1,5,6,1,7,8,0,0,0,5,15,20
fa12,123,SIXTH,TWS,ThirdWldSt,0,0,0,0,0,0,0,1,1,0,0,0,0,1,1,0,0,0,0,2,2
fa12,123,SIXTH,UNAF,UndecHumAr,4,5,9,0,0,0,0,1,1,0,0,0,0,0,0,0,0,0,4,6,10
fa12,123,SIXTH,UNAF,Undeclared,60,49,109,3,3,6,8,10,18,5,3,8,0,0,0,0,0,0,76,65,141
fa12,123,SIXTH,UNAF,UndecPhysS,12,4,16,0,0,0,1,2,3,0,0,0,0,0,0,0,0,0,13,6,19
fa12,123,SIXTH,UNAF,UndecSocSc,3,10,13,0,0,0,0,1,1,0,0,0,0,0,0,0,0,0,3,11,14
fa12,123,SIXTH,USP,Urb Stu&Pl,1,3,4,1,0,1,0,2,2,1,7,8,7,6,13,0,0,0,10,18,28
fa12,123,SIXTH,VIS,Art Hst/Cr,0,0,0,0,0,0,0,1,1,0,5,5,1,4,5,0,0,0,1,10,11
fa12,123,SIXTH,VIS,Media,4,9,13,0,0,0,2,8,10,12,10,22,17,19,36,0,0,0,35,46,81
fa12,123,SIXTH,VIS,Studio VA,0,4,4,1,1,2,2,3,5,1,11,12,3,6,9,0,0,0,7,25,32
fa12,123,SIXTH,VIS,VA-CompArt,0,5,5,0,0,0,2,4,6,7,4,11,5,8,13,0,0,0,14,21,35
fa12,123,WARREN,ANTH,Anth-Arch,0,1,1,0,0,0,0,0,0,0,1,1,1,0,1,0,0,0,1,2,3
fa12,123,WARREN,ANTH,Anth-Biol,0,0,0,0,0,0,0,0,0,0,2,2,1,4,5,0,0,0,1,6,7
fa12,123,WARREN,ANTH,Anth-Soci,0,0,0,0,0,0,0,0,0,0,1,1,1,8,9,0,0,0,1,9,10
fa12,123,WARREN,BENG,Bioen:Binf,6,2,8,0,0,0,0,4,4,1,2,3,2,3,5,0,0,0,9,11,20
fa12,123,WARREN,BENG,Bioeng:PM,0,0,0,0,0,0,0,0,0,0,2,2,11,5,16,0,0,0,11,7,18
fa12,123,WARREN,BENG,BioengBiot,10,8,18,0,0,0,4,3,7,12,9,21,30,19,49,0,0,0,56,39,95
fa12,123,WARREN,BENG,Bioengin,6,10,16,0,0,0,7,1,8,11,6,17,21,9,30,0,0,0,45,26,71
fa12,123,WARREN,BIOL,Bioc/CellB,9,16,25,0,1,1,3,5,8,12,9,21,39,29,68,0,0,0,63,60,123
fa12,123,WARREN,BIOL,BiolBioinf,1,0,1,0,0,0,0,0,0,0,1,1,0,0,0,0,0,0,1,1,2
fa12,123,WARREN,BIOL,Ec/Beh/Evo,1,1,2,0,0,0,1,0,1,2,3,5,2,3,5,0,0,0,6,7,13
fa12,123,WARREN,BIOL,Genl Biol,7,21,28,0,0,0,3,3,6,11,12,23,30,36,66,0,0,0,51,72,123
fa12,123,WARREN,BIOL,Human Bio,10,22,32,0,2,2,7,14,21,18,21,39,37,44,81,0,0,0,72,103,175
fa12,123,WARREN,BIOL,Microbiol,0,5,5,1,0,1,0,0,0,2,2,4,5,7,12,0,0,0,8,14,22
fa12,123,WARREN,BIOL,Molec Biol,1,4,5,0,0,0,1,0,1,4,2,6,8,5,13,0,0,0,14,11,25
fa12,123,WARREN,BIOL,PhyslNeuro,13,9,22,0,2,2,3,6,9,6,10,16,26,13,39,0,0,0,48,40,88
fa12,123,WARREN,CENG,Chem Engin,17,11,28,0,0,0,10,9,19,23,12,35,43,14,57,0,0,0,93,46,139
fa12,123,WARREN,CGS,CritGendSt,0,0,0,1,0,1,0,0,0,0,0,0,0,0,0,0,0,0,1,0,1
fa12,123,WARREN,CHEM,Bioch/Chem,11,6,17,0,0,0,3,7,10,14,14,28,30,21,51,0,0,0,58,48,106
fa12,123,WARREN,CHEM,Bioinform,0,0,0,0,1,1,0,0,0,1,0,1,0,0,0,0,0,0,1,1,2
fa12,123,WARREN,CHEM,Chem Phys,1,0,1,0,0,0,0,0,0,0,1,1,0,1,1,0,0,0,1,2,3
fa12,123,WARREN,CHEM,Chemistry,4,3,7,0,0,0,1,3,4,4,5,9,3,11,14,0,0,0,12,22,34
fa12,123,WARREN,CHEM,Envir Chem,0,0,0,0,0,0,0,0,0,0,1,1,0,0,0,0,0,0,0,1,1
fa12,123,WARREN,CHEM,MolecSynth,0,0,0,0,0,0,0,0,0,2,0,2,0,1,1,0,0,0,2,1,3
fa12,123,WARREN,CHEM,Pharm Chem,2,6,8,0,0,0,4,6,10,15,14,29,21,22,43,0,0,0,42,48,90
fa12,123,WARREN,CHIN,Chinese St,0,0,0,0,0,0,0,0,0,0,0,0,1,1,2,0,0,0,1,1,2
fa12,123,WARREN,COGS,Cog Sci,2,1,3,0,1,1,1,4,5,6,2,8,5,5,10,0,0,0,14,13,27
fa12,123,WARREN,COGS,CogSc/ClAs,0,1,1,0,0,0,0,1,1,1,0,1,1,2,3,0,0,0,2,4,6
fa12,123,WARREN,COGS,CogSc/Comp,0,0,0,0,0,0,0,1,1,0,0,0,2,0,2,0,0,0,2,1,3
fa12,123,WARREN,COGS,CogSc/HCI,0,0,0,0,1,1,1,1,2,3,1,4,6,5,11,0,0,0,10,8,18
fa12,123,WARREN,COGS,CogSc/HCog,0,0,0,0,0,0,0,0,0,0,0,0,2,3,5,0,0,0,2,3,5
fa12,123,WARREN,COGS,CogSc/Neur,0,2,2,0,0,0,0,6,6,6,10,16,8,15,23,0,0,0,14,33,47
fa12,123,WARREN,COMM,Communic,2,6,8,2,2,4,4,9,13,6,21,27,13,20,33,0,0,0,27,58,85
fa12,123,WARREN,CSE,Comp Sci,71,21,92,3,0,3,26,4,30,73,16,89,123,24,147,0,0,0,296,65,361
fa12,123,WARREN,CSE,CompEngCSE,23,6,29,4,0,4,8,4,12,20,4,24,32,4,36,0,0,0,87,18,105
fa12,123,WARREN,CSE,CompScBinf,3,0,3,0,0,0,0,0,0,5,2,7,2,4,6,0,0,0,10,6,16
fa12,123,WARREN,ECE,CompEngECE,9,1,10,0,1,1,5,1,6,8,0,8,4,0,4,0,0,0,26,3,29
fa12,123,WARREN,ECE,Electr Eng,38,4,42,3,0,3,15,4,19,49,7,56,69,12,81,0,0,0,174,27,201
fa12,123,WARREN,ECE,Pr-EngPhys,0,0,0,0,0,0,0,0,0,0,0,0,1,0,1,0,0,0,1,0,1
fa12,123,WARREN,ECON,Ec-Mth&Ecn,7,1,8,1,0,1,0,3,3,4,2,6,7,0,7,0,0,0,19,6,25
fa12,123,WARREN,ECON,Econ-MgtSc,8,6,14,1,1,2,8,5,13,16,16,32,33,20,53,0,0,0,66,48,114
fa12,123,WARREN,ECON,Economics,13,11,24,2,2,4,4,4,8,39,31,70,77,36,113,0,0,0,135,84,219
fa12,123,WARREN,ESYS,EnvSys(EB),0,1,1,0,0,0,0,1,1,3,5,8,2,12,14,0,0,0,5,19,24
fa12,123,WARREN,ESYS,EnvSys(EC),0,0,0,0,0,0,0,0,0,0,0,0,1,1,2,0,0,0,1,1,2
fa12,123,WARREN,ESYS,EnvSys(EP),0,0,0,0,0,0,0,0,0,1,0,1,1,1,2,0,0,0,2,1,3
fa12,123,WARREN,ESYS,EnvSys(ES),0,0,0,0,0,0,0,1,1,1,0,1,2,0,2,0,0,0,3,1,4
fa12,123,WARREN,ETHN,Ethnic St,0,0,0,0,0,0,1,0,1,0,0,0,0,4,4,0,0,0,1,4,5
fa12,123,WARREN,HDP,Human Dev,0,0,0,0,0,0,0,1,1,0,4,4,0,14,14,0,0,0,0,19,19
fa12,123,WARREN,HDP,Pr-HumnDev,0,0,0,2,0,2,0,7,7,5,4,9,1,3,4,0,0,0,8,14,22
fa12,123,WARREN,HIST,History,0,1,1,0,1,1,1,1,2,8,2,10,9,3,12,0,0,0,18,8,26
fa12,123,WARREN,INTD,Wa Ind St,0,0,0,0,0,0,0,0,0,0,0,0,0,1,1,0,0,0,0,1,1
fa12,123,WARREN,INTL,IntSt-Econ,0,1,1,0,0,0,0,2,2,0,6,6,5,5,10,0,0,0,5,14,19
fa12,123,WARREN,INTL,IntSt-Hist,0,0,0,0,0,0,0,0,0,1,1,2,1,1,2,0,0,0,2,2,4
fa12,123,WARREN,INTL,IntSt-Ling,0,0,0,0,0,0,0,1,1,0,1,1,1,0,1,0,0,0,1,2,3
fa12,123,WARREN,INTL,IntSt-PolS,2,0,2,0,0,0,1,0,1,2,1,3,2,4,6,0,0,0,7,5,12
fa12,123,WARREN,INTL,IntSt-Soc,0,0,0,0,0,0,0,0,0,0,0,0,0,4,4,0,0,0,0,4,4
fa12,123,WARREN,ITAL,Italian St,0,0,0,0,0,0,0,0,0,0,0,0,1,0,1,0,0,0,1,0,1
fa12,123,WARREN,JAPN,JapaneseSt,0,0,0,0,0,0,0,0,0,0,0,0,2,0,2,0,0,0,2,0,2
fa12,123,WARREN,LING,Lang Stu,0,0,0,0,0,0,0,0,0,1,0,1,0,1,1,0,0,0,1,1,2
fa12,123,WARREN,LING,Ling-LSoc,0,0,0,0,0,0,0,0,0,0,0,0,1,0,1,0,0,0,1,0,1
fa12,123,WARREN,LING,Linguistcs,0,0,0,0,0,0,0,0,0,1,0,1,0,4,4,0,0,0,1,4,5
fa12,123,WARREN,LIT,Lit/Engl,0,0,0,0,0,0,0,2,2,0,1,1,1,3,4,0,0,0,1,6,7
fa12,123,WARREN,LIT,Lit/World,0,0,0,0,0,0,0,0,0,0,0,0,0,1,1,0,0,0,0,1,1
fa12,123,WARREN,LIT,Lit/Writng,1,2,3,0,0,0,0,2,2,1,3,4,3,4,7,0,0,0,5,11,16
fa12,123,WARREN,LIT,Pre-Lit/Wr,0,0,0,0,0,0,0,0,0,0,0,0,0,1,1,0,0,0,0,1,1
fa12,123,WARREN,MAE,Aerosp Eng,20,8,28,0,1,1,4,6,10,12,0,12,34,6,40,0,0,0,70,21,91
fa12,123,WARREN,MAE,Engin Sci,0,0,0,0,0,0,4,1,5,3,1,4,8,0,8,0,0,0,15,2,17
fa12,123,WARREN,MAE,Envir Eng,9,2,11,0,1,1,3,2,5,8,4,12,14,15,29,0,0,0,34,24,58
fa12,123,WARREN,MAE,Mech Engin,24,4,28,1,1,2,13,3,16,21,10,31,71,6,77,0,0,0,130,24,154
fa12,123,WARREN,MATH,Appld Math,4,1,5,0,0,0,2,2,4,5,0,5,5,1,6,0,0,0,16,4,20
fa12,123,WARREN,MATH,Math/SecEd,0,2,2,0,0,0,0,0,0,0,2,2,1,2,3,0,0,0,1,6,7
fa12,123,WARREN,MATH,Mathematcs,1,1,2,0,1,1,0,2,2,3,4,7,6,1,7,0,0,0,10,9,19
fa12,123,WARREN,MATH,Mth-CompSc,0,0,0,0,0,0,0,0,0,1,2,3,5,1,6,0,0,0,6,3,9
fa12,123,WARREN,MATH,Mth-Mth&Ec,1,6,7,0,2,2,1,3,4,3,3,6,7,2,9,0,0,0,12,16,28
fa12,123,WARREN,MATH,Mth/ApldSc,1,0,1,0,0,0,0,0,0,0,1,1,0,1,1,0,0,0,1,2,3
fa12,123,WARREN,MATH,Prob&Stats,1,0,1,0,0,0,1,0,1,2,0,2,1,3,4,0,0,0,5,3,8
fa12,123,WARREN,MUS,Mu-CompArt,0,0,0,0,0,0,1,1,2,1,1,2,2,0,2,0,0,0,4,2,6
fa12,123,WARREN,MUS,Music,1,0,1,0,0,0,0,0,0,2,0,2,3,3,6,0,0,0,6,3,9
fa12,123,WARREN,MUS,Music Hum,0,0,0,0,0,0,0,0,0,0,0,0,1,0,1,0,0,0,1,0,1
fa12,123,WARREN,NENG,NanoEng,13,2,15,1,0,1,8,0,8,18,6,24,18,2,20,0,0,0,58,10,68
fa12,123,WARREN,PHIL,Philosophy,0,0,0,0,0,0,1,1,2,7,3,10,10,1,11,0,0,0,18,5,23
fa12,123,WARREN,PHYS,Biophysics,1,0,1,0,0,0,1,1,2,1,1,2,0,0,0,0,0,0,3,2,5
fa12,123,WARREN,PHYS,Phys/Astro,1,0,1,0,0,0,0,0,0,2,0,2,2,0,2,0,0,0,5,0,5
fa12,123,WARREN,PHYS,Phys/Comp,0,0,0,0,0,0,0,0,0,1,0,1,1,0,1,0,0,0,2,0,2
fa12,123,WARREN,PHYS,Physics,6,0,6,0,0,0,1,1,2,5,1,6,5,2,7,0,0,0,17,4,21
fa12,123,WARREN,POLI,Polit Sci,6,6,12,0,1,1,6,4,10,20,20,40,22,13,35,0,0,0,54,44,98
fa12,123,WARREN,POLI,PolSc-Amer,0,0,0,0,0,0,2,1,3,1,5,6,1,3,4,0,0,0,4,9,13
fa12,123,WARREN,POLI,PolSc-Comp,0,0,0,0,0,0,0,0,0,0,2,2,0,1,1,0,0,0,0,3,3
fa12,123,WARREN,POLI,PolSc-Intl,1,3,4,0,0,0,3,1,4,5,4,9,13,5,18,0,0,0,22,13,35
fa12,123,WARREN,POLI,PolSc-PLaw,1,4,5,0,0,0,3,5,8,3,3,6,4,10,14,0,0,0,11,22,33
fa12,123,WARREN,POLI,PolSc-PPol,2,0,2,0,0,0,0,0,0,3,5,8,1,1,2,0,0,0,6,6,12
fa12,123,WARREN,POLI,PolSc-Thry,0,0,0,0,0,0,0,0,0,3,1,4,2,0,2,0,0,0,5,1,6
fa12,123,WARREN,PSYC,Psychology,8,12,20,1,6,7,9,15,24,25,40,65,20,72,92,0,0,0,63,145,208
fa12,123,WARREN,RELI,Relig/Stu,0,0,0,0,0,0,0,0,0,1,1,2,1,1,2,0,0,0,2,2,4
fa12,123,WARREN,SE,Engin Sci,4,0,4,0,0,0,0,0,0,0,0,0,1,0,1,0,0,0,5,0,5
fa12,123,WARREN,SE,Struct Eng,22,9,31,1,1,2,18,6,24,44,14,58,55,15,70,0,0,0,140,45,185
fa12,123,WARREN,SIO,Earth Sci,1,0,1,0,0,0,0,1,1,1,2,3,5,3,8,0,0,0,7,6,13
fa12,123,WARREN,SIO,Marine Bio,0,0,0,0,0,0,0,0,0,2,0,2,0,1,1,0,0,0,2,1,3
fa12,123,WARREN,SOC,SocCulCom,0,0,0,0,0,0,0,1,1,0,0,0,2,0,2,0,0,0,2,1,3
fa12,123,WARREN,SOC,SocEconSoc,0,0,0,0,0,0,0,0,0,0,1,1,0,0,0,0,0,0,0,1,1
fa12,123,WARREN,SOC,SocIntlStu,0,0,0,0,0,0,0,0,0,0,0,0,0,2,2,0,0,0,0,2,2
fa12,123,WARREN,SOC,Sociology,1,1,2,0,0,0,2,5,7,6,5,11,4,8,12,0,0,0,13,19,32
fa12,123,WARREN,SOC,SocLawSoc,0,1,1,0,0,0,0,0,0,2,3,5,1,2,3,0,0,0,3,6,9
fa12,123,WARREN,SOC,SocSciMed,0,0,0,0,0,0,0,1,1,0,1,1,0,2,2,0,0,0,0,4,4
fa12,123,WARREN,SOC,SocSolneq,0,0,0,0,0,0,0,0,0,0,1,1,0,1,1,0,0,0,0,2,2
fa12,123,WARREN,THEA,Dance,0,0,0,0,0,0,0,0,0,0,0,0,0,1,1,0,0,0,0,1,1
fa12,123,WARREN,THEA,Theatre,0,0,0,0,0,0,0,2,2,1,1,2,3,3,6,0,0,0,4,6,10
fa12,123,WARREN,UNAF,IntcampVis,0,0,0,0,1,1,0,5,5,2,2,4,0,1,1,0,0,0,2,9,11
fa12,123,WARREN,UNAF,Limited St,0,0,0,0,0,0,0,0,0,0,0,0,0,0,0,1,1,2,1,1,2
fa12,123,WARREN,UNAF,UndecHumAr,1,0,1,0,0,0,0,0,0,0,0,0,0,0,0,0,0,0,1,0,1
fa12,123,WARREN,UNAF,Undeclared,39,33,72,2,5,7,9,6,15,2,5,7,0,0,0,0,0,0,52,49,101
fa12,123,WARREN,UNAF,UndecPhysS,3,4,7,0,0,0,1,3,4,0,0,0,0,0,0,0,0,0,4,7,11
fa12,123,WARREN,UNAF,UndecSocSc,4,3,7,0,0,0,0,0,0,0,0,0,0,0,0,0,0,0,4,3,7
fa12,123,WARREN,USP,Urb Stu&Pl,0,0,0,0,0,0,0,0,0,2,1,3,5,5,10,0,0,0,7,6,13
fa12,123,WARREN,VIS,Art Hst/Cr,0,0,0,0,0,0,1,0,1,0,0,0,1,1,2,0,0,0,2,1,3
fa12,123,WARREN,VIS,Media,1,0,1,0,0,0,0,0,0,3,2,5,4,6,10,0,0,0,8,8,16
fa12,123,WARREN,VIS,Studio VA,0,0,0,0,0,0,1,0,1,2,2,4,1,1,2,0,0,0,4,3,7
fa12,123,WARREN,VIS,VA-CompArt,0,1,1,0,0,0,0,0,0,1,0,1,2,0,2,0,0,0,3,1,4
sp15,152,MARSHALL,ANTH,Anth-Arch,0,0,0,0,0,0,0,0,0,1,0,1,0,0,0,0,0,0,1,0,1
sp15,152,MARSHALL,ANTH,Anth-Biol,0,0,0,0,0,0,0,0,0,0,0,0,0,1,1,0,0,0,0,1,1
sp15,152,MARSHALL,ANTH,Anth-Soci,0,0,0,0,0,0,0,1,1,2,2,4,1,5,6,0,0,0,3,8,11
sp15,152,MARSHALL,BENG,Bioen:Binf,0,0,0,0,0,0,2,2,4,4,4,8,4,6,10,0,0,0,10,12,22
sp15,152,MARSHALL,BENG,BioengBioS,0,0,0,0,0,0,1,1,2,7,0,7,0,0,0,0,0,0,8,1,9
sp15,152,MARSHALL,BENG,BioengBiot,0,0,0,0,0,0,1,1,2,0,4,4,8,3,11,0,0,0,9,8,17
sp15,152,MARSHALL,BENG,Bioengin,0,0,0,0,0,0,0,0,0,1,1,2,9,6,15,0,0,0,10,7,17
sp15,152,MARSHALL,BIOL,Bioc/CellB,0,0,0,0,1,1,14,23,37,22,25,47,35,73,108,0,0,0,71,122,193
sp15,152,MARSHALL,BIOL,BiolBioinf,0,0,0,0,2,2,1,2,3,0,3,3,0,0,0,0,0,0,1,7,8
sp15,152,MARSHALL,BIOL,Ec/Beh/Evo,0,0,0,0,0,0,0,0,0,1,4,5,2,1,3,0,0,0,3,5,8
sp15,152,MARSHALL,BIOL,Genl Biol,0,0,0,2,7,9,11,19,30,9,23,32,23,53,76,0,0,0,45,102,147
sp15,152,MARSHALL,BIOL,Human Bio,0,0,0,3,14,17,17,34,51,22,55,77,49,65,114,0,0,0,91,168,259
sp15,152,MARSHALL,BIOL,Microbiol,0,0,0,0,0,0,2,3,5,4,7,11,7,6,13,0,0,0,13,16,29
sp15,152,MARSHALL,BIOL,Molec Biol,0,0,0,0,0,0,2,0,2,6,4,10,5,3,8,0,0,0,13,7,20
sp15,152,MARSHALL,BIOL,PhyslNeuro,0,0,0,2,2,4,9,10,19,16,30,46,26,35,61,0,0,0,53,77,130
sp15,152,MARSHALL,CENG,Chem Engin,0,0,0,0,0,0,2,1,3,19,5,24,30,25,55,0,0,0,51,31,82
sp15,152,MARSHALL,CHEM,Bioch/Chem,0,0,0,0,0,0,3,3,6,2,3,5,7,16,23,0,0,0,12,22,34
sp15,152,MARSHALL,CHEM,Bioinform,0,0,0,0,0,0,1,0,1,2,1,3,1,0,1,0,0,0,4,1,5
sp15,152,MARSHALL,CHEM,Chem Educ,0,0,0,0,0,0,0,0,0,0,0,0,1,0,1,0,0,0,1,0,1
sp15,152,MARSHALL,CHEM,Chem Phys,0,0,0,0,0,0,1,1,2,0,0,0,0,1,1,0,0,0,1,2,3
sp15,152,MARSHALL,CHEM,Chemistry,0,0,0,1,3,4,9,6,15,3,4,7,7,7,14,0,0,0,20,20,40
sp15,152,MARSHALL,CHEM,Envir Chem,0,0,0,0,0,0,0,0,0,0,0,0,0,2,2,0,0,0,0,2,2
sp15,152,MARSHALL,CHEM,MolecSynth,0,0,0,0,0,0,0,0,0,0,0,0,1,2,3,0,0,0,1,2,3
sp15,152,MARSHALL,CHEM,Pharm Chem,0,0,0,2,0,2,1,5,6,5,6,11,6,8,14,0,0,0,14,19,33
sp15,152,MARSHALL,CLAS,Classic St,0,0,0,0,0,0,0,0,0,0,0,0,0,1,1,0,0,0,0,1,1
sp15,152,MARSHALL,COGS,Cog Sci,0,0,0,0,2,2,1,3,4,1,7,8,4,7,11,0,0,0,6,19,25
sp15,152,MARSHALL,COGS,CogSc/ClAs,0,0,0,0,1,1,0,1,1,0,1,1,0,1,1,0,0,0,0,4,4
sp15,152,MARSHALL,COGS,CogSc/Comp,0,0,0,0,0,0,2,0,2,0,1,1,1,0,1,0,0,0,3,1,4
sp15,152,MARSHALL,COGS,CogSc/HCI,0,0,0,1,1,2,0,2,2,1,5,6,5,10,15,0,0,0,7,18,25
sp15,152,MARSHALL,COGS,CogSc/HCog,0,0,0,0,1,1,0,1,1,1,0,1,0,2,2,0,0,0,1,4,5
sp15,152,MARSHALL,COGS,CogSc/Neur,0,0,0,0,0,0,0,3,3,0,3,3,4,11,15,0,0,0,4,17,21
sp15,152,MARSHALL,COMM,Communic,0,0,0,0,2,2,1,15,16,19,51,70,17,46,63,0,0,0,37,114,151
sp15,152,MARSHALL,CSE,Comp Sci,0,0,0,0,1,1,6,6,12,46,13,59,125,25,150,0,0,0,177,45,222
sp15,152,MARSHALL,CSE,CompEngCSE,0,0,0,0,0,0,2,0,2,8,1,9,20,2,22,0,0,0,30,3,33
sp15,152,MARSHALL,CSE,CompScBinf,0,0,0,0,0,0,0,0,0,3,2,5,3,2,5,0,0,0,6,4,10
sp15,152,MARSHALL,ECE,CompEngECE,0,0,0,0,0,0,11,1,12,15,3,18,9,1,10,0,0,0,35,5,40
sp15,152,MARSHALL,ECE,Electr Eng,0,0,0,0,0,0,9,3,12,30,7,37,58,12,70,0,0,0,97,22,119
sp15,152,MARSHALL,ECE,Pr-EngPhys,0,0,0,0,0,0,1,1,2,0,0,0,0,0,0,0,0,0,1,1,2
sp15,152,MARSHALL,ECON,Ec-Mth&Ecn,0,0,0,3,7,10,8,7,15,7,10,17,10,8,18,0,0,0,28,32,60
sp15,152,MARSHALL,ECON,Econ-MgtSc,0,0,0,3,7,10,3,13,16,23,37,60,43,48,91,0,0,0,72,105,177
sp15,152,MARSHALL,ECON,Economics,0,0,0,3,5,8,14,17,31,80,51,131,89,68,157,0,0,0,186,141,327
sp15,152,MARSHALL,ESYS,EnvSys(EB),0,0,0,0,0,0,0,1,1,2,2,4,3,6,9,0,0,0,5,9,14
sp15,152,MARSHALL,ESYS,EnvSys(EC),0,0,0,0,0,0,0,0,0,0,1,1,1,2,3,0,0,0,1,3,4
sp15,152,MARSHALL,ESYS,EnvSys(EP),0,0,0,0,0,0,0,0,0,0,1,1,1,3,4,0,0,0,1,4,5
sp15,152,MARSHALL,ESYS,EnvSys(ES),0,0,0,0,1,1,0,1,1,1,1,2,0,0,0,0,0,0,1,3,4
sp15,152,MARSHALL,ETHN,Ethnic St,0,0,0,0,1,1,0,1,1,1,2,3,1,2,3,0,0,0,2,6,8
sp15,152,MARSHALL,FPMU,Public Hlt,0,0,0,1,3,4,1,14,15,6,25,31,8,36,44,0,0,0,16,78,94
sp15,152,MARSHALL,GLBH,Global Hlt,0,0,0,0,0,0,0,1,1,0,0,0,1,1,2,0,0,0,1,2,3
sp15,152,MARSHALL,HDP,Human Dev,0,0,0,0,0,0,0,0,0,1,6,7,1,26,27,0,0,0,2,32,34
sp15,152,MARSHALL,HDP,Pr-HumnDev,0,0,0,0,1,1,0,8,8,1,12,13,1,1,2,0,0,0,2,22,24
sp15,152,MARSHALL,HIST,History,0,0,0,0,0,0,0,2,2,4,4,8,7,6,13,0,0,0,11,12,23
sp15,152,MARSHALL,INTD,Mar Ind St,0,0,0,0,0,0,0,0,0,0,0,0,1,0,1,0,0,0,1,0,1
sp15,152,MARSHALL,INTL,Int-5yrPS,0,0,0,0,0,0,0,0,0,0,0,0,0,2,2,0,0,0,0,2,2
sp15,152,MARSHALL,INTL,IntSt-Anth,0,0,0,0,0,0,0,0,0,0,1,1,0,1,1,0,0,0,0,2,2
sp15,152,MARSHALL,INTL,IntSt-Econ,0,0,0,0,0,0,5,1,6,2,5,7,5,12,17,0,0,0,12,18,30
sp15,152,MARSHALL,INTL,IntSt-Hist,0,0,0,0,0,0,0,1,1,0,0,0,0,2,2,0,0,0,0,3,3
sp15,152,MARSHALL,INTL,IntSt-Ling,0,0,0,0,0,0,0,0,0,0,0,0,0,1,1,0,0,0,0,1,1
sp15,152,MARSHALL,INTL,IntSt-PolS,0,0,0,1,1,2,0,6,6,3,4,7,3,14,17,0,0,0,7,25,32
sp15,152,MARSHALL,INTL,IntSt-Soc,0,0,0,0,0,0,1,0,1,0,2,2,1,2,3,0,0,0,2,4,6
sp15,152,MARSHALL,JAPN,JapaneseSt,0,0,0,0,0,0,0,1,1,0,0,0,0,0,0,0,0,0,0,1,1
sp15,152,MARSHALL,LATI,LatinAm St,0,0,0,0,0,0,0,0,0,0,0,0,0,1,1,0,0,0,0,1,1
sp15,152,MARSHALL,LING,Lang Stu,0,0,0,0,0,0,0,0,0,0,0,0,1,0,1,0,0,0,1,0,1
sp15,152,MARSHALL,LING,Ling-CogLn,0,0,0,0,0,0,1,0,1,0,1,1,0,4,4,0,0,0,1,5,6
sp15,152,MARSHALL,LING,Ling-LSoc,0,0,0,0,0,0,0,1,1,0,0,0,0,3,3,0,0,0,0,4,4
sp15,152,MARSHALL,LING,Linguistcs,0,0,0,0,0,0,0,0,0,0,0,0,1,0,1,0,0,0,1,0,1
sp15,152,MARSHALL,LIT,Lit/Compos,0,0,0,0,0,0,0,0,0,0,0,0,0,1,1,0,0,0,0,1,1
sp15,152,MARSHALL,LIT,Lit/CultSt,0,0,0,0,0,0,1,0,1,0,0,0,0,0,0,0,0,0,1,0,1
sp15,152,MARSHALL,LIT,Lit/Engl,0,0,0,0,1,1,0,1,1,1,0,1,2,3,5,0,0,0,3,5,8
sp15,152,MARSHALL,LIT,Lit/World,0,0,0,0,0,0,0,0,0,0,0,0,1,3,4,0,0,0,1,3,4
sp15,152,MARSHALL,LIT,Lit/Writng,0,0,0,1,0,1,0,0,0,3,3,6,3,2,5,0,0,0,7,5,12
sp15,152,MARSHALL,MAE,Aerosp Eng,0,0,0,0,0,0,2,1,3,4,0,4,13,2,15,0,0,0,19,3,22
sp15,152,MARSHALL,MAE,Engin Sci,0,0,0,0,0,0,0,0,0,0,0,0,1,0,1,0,0,0,1,0,1
sp15,152,MARSHALL,MAE,Envir Eng,0,0,0,0,0,0,5,2,7,5,4,9,9,3,12,0,0,0,19,9,28
sp15,152,MARSHALL,MAE,Mech Engin,0,0,0,1,0,1,6,1,7,2,0,2,17,4,21,0,0,0,26,5,31
sp15,152,MARSHALL,MATH,Appld Math,0,0,0,0,4,4,8,7,15,6,10,16,10,5,15,0,0,0,24,26,50
sp15,152,MARSHALL,MATH,Math/SecEd,0,0,0,0,0,0,0,0,0,1,2,3,1,0,1,0,0,0,2,2,4
sp15,152,MARSHALL,MATH,Mathematcs,0,0,0,1,2,3,0,1,1,4,4,8,1,3,4,0,0,0,6,10,16
sp15,152,MARSHALL,MATH,Mth-CompSc,0,0,0,4,0,4,19,2,21,5,2,7,2,3,5,0,0,0,30,7,37
sp15,152,MARSHALL,MATH,Mth-Mth&Ec,0,0,0,2,2,4,5,4,9,6,5,11,2,7,9,0,0,0,15,18,33
sp15,152,MARSHALL,MATH,Mth/ApldSc,0,0,0,0,0,0,1,1,2,1,1,2,1,0,1,0,0,0,3,2,5
sp15,152,MARSHALL,MATH,Prob&Stats,0,0,0,0,2,2,2,6,8,2,3,5,3,2,5,0,0,0,7,13,20
sp15,152,MARSHALL,MUS,Mu-CompArt,0,0,0,0,0,0,1,0,1,0,0,0,1,1,2,0,0,0,2,1,3
sp15,152,MARSHALL,MUS,Music,0,0,0,0,1,1,0,0,0,2,0,2,1,0,1,0,0,0,3,1,4
sp15,152,MARSHALL,MUS,Music Hum,0,0,0,0,0,0,0,0,0,0,0,0,0,1,1,0,0,0,0,1,1
sp15,152,MARSHALL,NENG,NanoEng,0,0,0,0,0,0,3,2,5,11,1,12,20,5,25,0,0,0,34,8,42
sp15,152,MARSHALL,PHIL,Philosophy,0,0,0,0,0,0,0,0,0,1,1,2,3,0,3,0,0,0,4,1,5
sp15,152,MARSHALL,PHIL,Biophysics,0,0,0,0,0,0,1,0,1,1,0,1,2,0,2,0,0,0,4,0,4
sp15,152,MARSHALL,PHIL,GenPys/SEd,0,0,0,0,0,0,0,0,0,0,0,0,1,1,2,0,0,0,1,1,2
sp15,152,MARSHALL,PHIL,Phy/ErthSc,0,0,0,0,0,0,0,0,0,0,0,0,1,0,1,0,0,0,1,0,1
sp15,152,MARSHALL,PHIL,Phys/Astro,0,0,0,1,0,1,0,0,0,1,0,1,1,0,1,0,0,0,3,0,3
sp15,152,MARSHALL,PHIL,Phys/Comp,0,0,0,0,0,0,1,0,1,1,0,1,0,0,0,0,0,0,2,0,2
sp15,152,MARSHALL,PHIL,Phys/Mtrls,0,0,0,1,0,1,1,1,2,0,0,0,0,0,0,0,0,0,2,1,3
sp15,152,MARSHALL,PHIL,Physics,0,0,0,1,2,3,6,0,6,4,2,6,2,2,4,0,0,0,13,6,19
sp15,152,MARSHALL,POLI,Polit Sci,0,0,0,1,0,1,6,5,11,7,5,12,17,19,36,0,0,0,31,29,60
sp15,152,MARSHALL,POLI,PolSc-Amer,0,0,0,0,0,0,0,0,0,1,3,4,5,2,7,0,0,0,6,5,11
sp15,152,MARSHALL,POLI,PolSc-Comp,0,0,0,0,0,0,0,0,0,0,2,2,1,1,2,0,0,0,1,3,4
sp15,152,MARSHALL,POLI,PolSc-Intl,0,0,0,0,1,1,1,4,5,5,3,8,9,8,17,0,0,0,15,16,31
sp15,152,MARSHALL,POLI,PolSc-PLaw,0,0,0,0,1,1,3,3,6,2,5,7,7,8,15,0,0,0,12,17,29
sp15,152,MARSHALL,POLI,PolSc-PPol,0,0,0,0,0,0,0,1,1,0,3,3,3,1,4,0,0,0,3,5,8
sp15,152,MARSHALL,POLI,PolSc-Thry,0,0,0,0,0,0,1,0,1,1,2,3,2,0,2,0,0,0,4,2,6
sp15,152,MARSHALL,PSYC,Psychology,0,0,0,3,8,11,7,20,27,20,38,58,36,96,132,0,0,0,66,162,228
sp15,152,MARSHALL,RELI,Relig/Stu,0,0,0,0,0,0,0,0,0,1,0,1,0,0,0,0,0,0,1,0,1
sp15,152,MARSHALL,SE,Struct Eng,0,0,0,1,0,1,5,3,8,16,3,19,38,12,50,0,0,0,60,18,78
sp15,152,MARSHALL,SIO,Earth Sci,0,0,0,0,0,0,0,1,1,1,1,2,0,1,1,0,0,0,1,3,4
sp15,152,MARSHALL,SIO,Marine Bio,0,0,0,0,1,1,0,2,2,1,5,6,0,5,5,0,0,0,1,13,14
sp15,152,MARSHALL,SOC,SocAmSt,0,0,0,0,0,0,0,0,0,0,0,0,1,1,2,0,0,0,1,1,2
sp15,152,MARSHALL,SOC,SocCulCom,0,0,0,0,0,0,0,0,0,1,0,1,1,4,5,0,0,0,2,4,6
sp15,152,MARSHALL,SOC,SocEconSoc,0,0,0,0,0,0,0,1,1,0,0,0,0,0,0,0,0,0,0,1,1
sp15,152,MARSHALL,SOC,SocIntlStu,0,0,0,0,0,0,0,0,0,0,0,0,1,2,3,0,0,0,1,2,3
sp15,152,MARSHALL,SOC,Sociology,0,0,0,0,1,1,1,2,3,1,4,5,7,6,13,0,0,0,9,13,22
sp15,152,MARSHALL,SOC,SocLawSoc,0,0,0,0,1,1,0,1,1,0,3,3,2,2,4,0,0,0,2,7,9
sp15,152,MARSHALL,SOC,SocSciMed,0,0,0,0,0,0,0,1,1,0,1,1,0,1,1,0,0,0,0,3,3
sp15,152,MARSHALL,SOC,SocSolneq,0,0,0,0,1,1,0,0,0,0,2,2,0,6,6,0,0,0,0,9,9
sp15,152,MARSHALL,THEA,Dance,0,0,0,0,0,0,0,1,1,0,0,0,0,1,1,0,0,0,0,2,2
sp15,152,MARSHALL,THEA,Theatre,0,0,0,0,0,0,0,2,2,1,2,3,0,2,2,0,0,0,1,6,7
sp15,152,MARSHALL,UNAF,UndecHumAr,0,0,0,0,0,0,0,1,1,0,0,0,0,0,0,0,0,0,0,1,1
sp15,152,MARSHALL,UNAF,Undeclared,0,0,0,12,10,22,18,14,32,1,1,2,0,0,0,0,0,0,31,25,56
sp15,152,MARSHALL,UNAF,UndecPhysS,0,0,0,2,0,2,0,2,2,0,0,0,0,0,0,0,0,0,2,2,4
sp15,152,MARSHALL,UNAF,UndecSocSc,0,0,0,1,0,1,2,4,6,0,0,0,0,0,0,0,0,0,3,4,7
sp15,152,MARSHALL,USP,Urb Stu&Pl,0,0,0,0,1,1,0,0,0,2,6,8,4,5,9,0,0,0,6,12,18
sp15,152,MARSHALL,VIS,Art Hst/Cr,0,0,0,0,0,0,0,0,0,0,1,1,0,3,3,0,0,0,0,4,4
sp15,152,MARSHALL,VIS,Media,0,0,0,0,0,0,1,2,3,1,5,6,7,8,15,0,0,0,9,15,24
sp15,152,MARSHALL,VIS,Studio VA,0,0,0,0,0,0,0,0,0,1,2,3,0,2,2,0,0,0,1,4,5
sp15,152,MARSHALL,VIS,VA-CompArt,0,0,0,1,0,1,0,1,1,2,6,8,1,5,6,0,0,0,4,12,16
sp15,152,MUIR,ANTH,Anth-Arch,0,0,0,1,0,1,1,0,1,0,1,1,1,5,6,0,0,0,3,6,9
sp15,152,MUIR,ANTH,Anth-Biol,0,0,0,0,0,0,0,0,0,1,0,1,0,13,13,0,0,0,1,13,14
sp15,152,MUIR,ANTH,Anth-Soci,0,0,0,0,0,0,1,0,1,0,3,3,1,3,4,0,0,0,2,6,8
sp15,152,MUIR,BENG,Bioen:Binf,0,0,0,0,0,0,1,1,2,3,4,7,8,3,11,0,0,0,12,8,20
sp15,152,MUIR,BENG,BioengBioS,0,0,0,0,1,1,3,1,4,2,1,3,2,1,3,0,0,0,7,4,11
sp15,152,MUIR,BENG,BioengBiot,0,0,0,0,0,0,4,3,7,7,7,14,9,6,15,0,0,0,20,16,36
sp15,152,MUIR,BENG,Bioengin,0,0,0,1,0,1,4,4,8,5,4,9,15,7,22,0,0,0,25,15,40
sp15,152,MUIR,BIOL,Bioc/CellB,0,0,0,1,7,8,16,38,54,24,40,64,42,53,95,0,0,0,83,138,221
sp15,152,MUIR,BIOL,BiolBioinf,0,0,0,1,0,1,1,1,2,1,0,1,0,0,0,0,0,0,3,1,4
sp15,152,MUIR,BIOL,Ec/Beh/Evo,0,0,0,1,0,1,0,6,6,1,7,8,5,12,17,0,0,0,7,25,32
sp15,152,MUIR,BIOL,Genl Biol,0,0,0,1,5,6,13,24,37,20,24,44,38,46,84,0,0,0,72,99,171
sp15,152,MUIR,BIOL,Human Bio,0,0,0,4,15,19,31,52,83,32,62,94,29,69,98,0,0,0,96,198,294
sp15,152,MUIR,BIOL,Microbiol,0,0,0,0,1,1,0,2,2,2,6,8,4,5,9,0,0,0,6,14,20
sp15,152,MUIR,BIOL,Molec Biol,0,0,0,1,1,2,9,4,13,3,4,7,9,11,20,0,0,0,22,20,42
sp15,152,MUIR,BIOL,PhyslNeuro,0,0,0,4,3,7,19,27,46,24,30,54,25,33,58,0,0,0,72,93,165
sp15,152,MUIR,CENG,Chem Engin,0,0,0,0,1,1,13,4,17,20,14,34,28,18,46,0,0,0,61,37,98
sp15,152,MUIR,CGS,CritGendSt,0,0,0,0,0,0,2,2,4,1,2,3,0,6,6,0,0,0,3,10,13
sp15,152,MUIR,CHEM,Bioch/Chem,0,0,0,0,0,0,8,6,14,8,8,16,10,15,25,0,0,0,26,29,55
sp15,152,MUIR,CHEM,Bioinform,0,0,0,0,0,0,0,0,0,0,0,0,1,0,1,0,0,0,1,0,1
sp15,152,MUIR,CHEM,Chem Educ,0,0,0,0,0,0,0,0,0,0,1,1,0,0,0,0,0,0,0,1,1
sp15,152,MUIR,CHEM,Chemistry,0,0,0,2,3,5,6,5,11,3,4,7,3,4,7,0,0,0,14,16,30
sp15,152,MUIR,CHEM,Envir Chem,0,0,0,1,0,1,1,1,2,0,0,0,1,2,3,0,0,0,3,3,6
sp15,152,MUIR,CHEM,MolecSynth,0,0,0,0,0,0,1,0,1,0,0,0,1,1,2,0,0,0,2,1,3
sp15,152,MUIR,CHEM,Pharm Chem,0,0,0,0,1,1,3,4,7,3,11,14,9,17,26,0,0,0,15,33,48
sp15,152,MUIR,COGS,Cog Sci,0,0,0,1,3,4,1,7,8,4,6,10,7,11,18,0,0,0,13,27,40
sp15,152,MUIR,COGS,CogSc/ClAs,0,0,0,0,0,0,0,2,2,0,1,1,1,1,2,0,0,0,1,4,5
sp15,152,MUIR,COGS,CogSc/Comp,0,0,0,0,0,0,2,2,4,1,0,1,2,0,2,0,0,0,5,2,7
sp15,152,MUIR,COGS,CogSc/HCI,0,0,0,1,1,2,3,1,4,5,4,9,4,9,13,0,0,0,13,15,28
sp15,152,MUIR,COGS,CogSc/HCog,0,0,0,0,0,0,0,1,1,1,0,1,1,3,4,0,0,0,2,4,6
sp15,152,MUIR,COGS,CogSc/Neur,0,0,0,0,1,1,4,7,11,1,6,7,8,18,26,0,0,0,13,32,45
sp15,152,MUIR,COMM,Communic,0,0,0,0,3,3,4,20,24,4,34,38,16,36,52,0,0,0,24,93,117
sp15,152,MUIR,CSE,Comp Sci,0,0,0,2,2,4,15,7,22,54,16,70,115,28,143,0,0,0,186,53,239
sp15,152,MUIR,CSE,CompEngCSE,0,0,0,1,0,1,5,1,6,8,0,8,18,1,19,0,0,0,32,2,34
sp15,152,MUIR,CSE,CompScBinf,0,0,0,0,0,0,2,1,3,0,2,2,5,1,6,0,0,0,7,4,11
sp15,152,MUIR,ECE,CompEngECE,0,0,0,0,0,0,4,1,5,12,1,13,8,1,9,0,0,0,24,3,27
sp15,152,MUIR,ECE,Electr Eng,0,0,0,0,1,1,17,1,18,28,2,30,37,7,44,0,0,0,82,11,93
sp15,152,MUIR,ECE,Pr-EngPhys,0,0,0,0,0,0,3,0,3,0,0,0,0,0,0,0,0,0,3,0,3
sp15,152,MUIR,ECON,Ec-Mth&Ecn,0,0,0,3,1,4,5,10,15,5,4,9,8,3,11,0,0,0,21,18,39
sp15,152,MUIR,ECON,Econ-MgtSc,0,0,0,3,4,7,15,9,24,25,13,38,29,29,58,0,0,0,72,55,127
sp15,152,MUIR,ECON,Economics,0,0,0,4,5,9,19,13,32,44,30,74,48,41,89,0,0,0,115,89,204
sp15,152,MUIR,ESYS,EnvSys(EB),0,0,0,1,0,1,0,4,4,1,2,3,8,8,16,0,0,0,10,14,24
sp15,152,MUIR,ESYS,EnvSys(EC),0,0,0,0,0,0,0,0,0,0,1,1,1,3,4,0,0,0,1,4,5
sp15,152,MUIR,ESYS,EnvSys(EP),0,0,0,0,0,0,1,1,2,2,0,2,1,1,2,0,0,0,4,2,6
sp15,152,MUIR,ESYS,EnvSys(ES),0,0,0,0,0,0,1,3,4,0,0,0,3,0,3,0,0,0,4,3,7
sp15,152,MUIR,ESYS,Ethnic St,0,0,0,0,0,0,1,2,3,0,3,3,2,2,4,0,0,0,3,7,10
sp15,152,MUIR,FPMU,Public Hlt,0,0,0,1,6,7,5,15,20,8,24,32,7,28,35,0,0,0,21,73,94
sp15,152,MUIR,GLBH,Global Hlt,0,0,0,0,1,1,0,1,1,1,4,5,0,2,2,0,0,0,1,8,9
sp15,152,MUIR,HDP,Human Dev,0,0,0,0,0,0,0,1,1,1,7,8,1,23,24,0,0,0,2,31,33
sp15,152,MUIR,HDP,Pr-HumnDev,0,0,0,0,1,1,0,6,6,1,12,13,0,2,2,0,0,0,1,21,22
sp15,152,MUIR,HIST,History,0,0,0,0,0,0,2,1,3,2,3,5,9,4,13,0,0,0,13,8,21
sp15,152,MUIR,INTL,IntSt-Anth,0,0,0,0,0,0,0,0,0,0,1,1,1,0,1,0,0,0,1,1,2
sp15,152,MUIR,INTL,IntSt-Econ,0,0,0,0,2,2,0,2,2,1,9,10,2,9,11,0,0,0,3,22,25
sp15,152,MUIR,INTL,IntSt-Ling,0,0,0,0,0,0,0,1,1,0,0,0,0,0,0,0,0,0,0,1,1
sp15,152,MUIR,INTL,IntSt-PolS,0,0,0,0,0,0,0,2,2,2,2,4,7,8,15,0,0,0,9,12,21
sp15,152,MUIR,INTL,IntSt-Soc,0,0,0,0,0,0,0,2,2,0,0,0,1,8,9,0,0,0,1,10,11
sp15,152,MUIR,ITAL,Italian St,0,0,0,0,0,0,0,0,0,0,1,1,0,0,0,0,0,0,0,1,1
sp15,152,MUIR,JAPN,JapaneseSt,0,0,0,0,0,0,0,0,0,0,1,1,0,2,2,0,0,0,0,3,3
sp15,152,MUIR,LING,Lang Stu,0,0,0,0,0,0,0,1,1,0,0,0,2,0,2,0,0,0,2,1,3
sp15,152,MUIR,LING,Ling-CogLn,0,0,0,0,1,1,1,0,1,2,1,3,2,3,5,0,0,0,5,5,10
sp15,152,MUIR,LING,Ling-LSoc,0,0,0,0,0,0,0,1,1,0,0,0,0,0,0,0,0,0,0,1,1
sp15,152,MUIR,LING,Linguistcs,0,0,0,0,0,0,1,1,2,1,0,1,1,5,6,0,0,0,3,6,9
sp15,152,MUIR,LIT,Lit/Compos,0,0,0,0,1,1,0,0,0,0,0,0,0,0,0,0,0,0,0,1,1
sp15,152,MUIR,LIT,Lit/Engl,0,0,0,0,1,1,0,5,5,0,4,4,0,5,5,0,0,0,0,15,15
sp15,152,MUIR,LIT,Lit/World,0,0,0,0,0,0,0,0,0,1,1,2,1,1,2,0,0,0,2,2,4
sp15,152,MUIR,LIT,Lit/Writng,0,0,0,0,0,0,0,5,5,3,6,9,4,13,17,0,0,0,7,24,31
sp15,152,MUIR,LIT,Spanish Lt,0,0,0,1,0,1,0,2,2,0,0,0,0,5,5,0,0,0,1,7,8
sp15,152,MUIR,MAE,Aerosp Eng,0,0,0,1,0,1,6,1,7,3,1,4,14,3,17,0,0,0,24,5,29
sp15,152,MUIR,MAE,Engin Sci,0,0,0,0,0,0,0,0,0,0,0,0,1,0,1,0,0,0,1,0,1
sp15,152,MUIR,MAE,Envir Eng,0,0,0,2,1,3,10,4,14,4,5,9,13,9,22,0,0,0,29,19,48
sp15,152,MUIR,MAE,Mech Engin,0,0,0,2,0,2,7,1,8,9,4,13,23,6,29,0,0,0,41,11,52
sp15,152,MUIR,MATH,Appld Math,0,0,0,5,3,8,4,8,12,6,6,12,10,4,14,0,0,0,25,21,46
sp15,152,MUIR,MATH,Math/SecEd,0,0,0,0,0,0,0,2,2,0,0,0,1,4,5,0,0,0,1,6,7
sp15,152,MUIR,MATH,Mathematcs,0,0,0,1,0,1,6,7,13,4,1,5,10,4,14,0,0,0,21,12,33
sp15,152,MUIR,MATH,Mth-CompSc,0,0,0,4,3,7,11,5,16,3,2,5,3,1,4,0,0,0,21,11,32
sp15,152,MUIR,MATH,Mth-Mth&Ec,0,0,0,0,3,3,2,0,2,5,1,6,6,3,9,0,0,0,13,7,20
sp15,152,MUIR,MATH,Mth/ApldSc,0,0,0,0,0,0,1,1,2,1,1,2,0,0,0,0,0,0,2,2,4
sp15,152,MUIR,MATH,Prob&Stats,0,0,0,0,1,1,2,3,5,3,1,4,6,2,8,0,0,0,11,7,18
sp15,152,MUIR,MUS,Mu-CompArt,0,0,0,1,1,2,0,1,1,4,0,4,5,3,8,0,0,0,10,5,15
sp15,152,MUIR,MUS,Music,0,0,0,0,0,0,1,0,1,4,1,5,4,3,7,0,0,0,9,4,13
sp15,152,MUIR,MUS,Music Hum,0,0,0,0,0,0,0,0,0,0,0,0,1,0,1,0,0,0,1,0,1
sp15,152,MUIR,NENG,NanoEng,0,0,0,1,0,1,5,0,5,9,3,12,15,4,19,0,0,0,30,7,37
sp15,152,MUIR,PHIL,Philosophy,0,0,0,1,0,1,1,0,1,0,0,0,2,0,2,0,0,0,4,0,4
sp15,152,MUIR,PHYS,Biophysics,0,0,0,0,0,0,1,0,1,0,0,0,2,1,3,0,0,0,3,1,4
sp15,152,MUIR,PHYS,Phy/ErthSc,0,0,0,0,0,0,0,0,0,1,0,1,0,0,0,0,0,0,1,0,1
sp15,152,MUIR,PHYS,Phys/Astro,0,0,0,0,0,0,6,3,9,1,0,1,0,0,0,0,0,0,7,3,10
sp15,152,MUIR,PHYS,Phys/Comp,0,0,0,0,0,0,0,0,0,1,0,1,2,0,2,0,0,0,3,0,3
sp15,152,MUIR,PHYS,Phys/Mtrls,0,0,0,0,0,0,1,0,1,0,0,0,1,0,1,0,0,0,2,0,2
sp15,152,MUIR,PHYS,Physics,0,0,0,2,1,3,4,3,7,4,1,5,7,0,7,0,0,0,17,5,22
sp15,152,MUIR,PHYS,Polit Sci,0,0,0,0,1,1,3,4,7,2,8,10,15,10,25,0,0,0,20,23,43
sp15,152,MUIR,PHYS,PolSc-Amer,0,0,0,0,0,0,0,0,0,1,1,2,2,2,4,0,0,0,3,3,6
sp15,152,MUIR,PHYS,PolSc-Comp,0,0,0,0,0,0,0,0,0,1,1,2,1,0,1,0,0,0,2,1,3
sp15,152,MUIR,PHYS,PolSc-Intl,0,0,0,0,0,0,2,1,3,4,2,6,13,3,16,0,0,0,19,6,25
sp15,152,MUIR,PHYS,PolSc-PLaw,0,0,0,0,0,0,1,0,1,5,7,12,7,4,11,0,0,0,13,11,24
sp15,152,MUIR,PHYS,PolSc-PPol,0,0,0,0,0,0,1,0,1,2,2,4,0,2,2,0,0,0,3,4,7
sp15,152,MUIR,PHYS,PolSc-Thry,0,0,0,0,0,0,0,1,1,0,0,0,0,1,1,0,0,0,0,2,2
sp15,152,MUIR,PSYC,Psychology,0,0,0,1,9,10,8,28,36,16,57,73,30,108,138,0,0,0,55,202,257
sp15,152,MUIR,RELI,Relig/Stu,0,0,0,1,0,1,0,0,0,0,0,0,0,0,0,0,0,0,1,0,1
sp15,152,MUIR,SE,Struct Eng,0,0,0,1,1,2,6,3,9,15,8,23,27,19,46,0,0,0,49,31,80
sp15,152,MUIR,SIO,Earth Sci,0,0,0,1,1,2,2,0,2,2,2,4,3,3,6,0,0,0,8,6,14
sp15,152,MUIR,SIO,Marine Bio,0,0,0,2,4,6,5,11,16,3,5,8,4,12,16,0,0,0,14,32,46
sp15,152,MUIR,SOC,SocCulCom,0,0,0,0,0,0,0,1,1,0,0,0,0,4,4,0,0,0,0,5,5
sp15,152,MUIR,SOC,SocEconSoc,0,0,0,0,0,0,0,0,0,0,1,1,0,0,0,0,0,0,0,1,1
sp15,152,MUIR,SOC,SocIntlStu,0,0,0,0,0,0,0,0,0,0,1,1,0,0,0,0,0,0,0,1,1
sp15,152,MUIR,SOC,Sociology,0,0,0,0,1,1,0,3,3,2,4,6,4,15,19,0,0,0,6,23,29
sp15,152,MUIR,SOC,SocLawSoc,0,0,0,0,5,5,0,2,2,1,2,3,1,6,7,0,0,0,2,15,17
sp15,152,MUIR,SOC,SocSciMed,0,0,0,0,0,0,0,1,1,0,1,1,0,0,0,0,0,0,0,2,2
sp15,152,MUIR,SOC,SocSolneq,0,0,0,0,0,0,0,3,3,1,1,2,2,9,11,0,0,0,3,13,16
sp15,152,MUIR,THEA,Dance,0,0,0,0,0,0,0,0,0,0,0,0,0,1,1,0,0,0,0,1,1
sp15,152,MUIR,THEA,Theatre,0,0,0,0,2,2,1,2,3,2,5,7,2,9,11,0,0,0,5,18,23
sp15,152,MUIR,UNAF,UndecHumAr,0,0,0,0,1,1,0,2,2,0,0,0,0,0,0,0,0,0,0,3,3
sp15,152,MUIR,UNAF,Undeclared,0,0,0,16,9,25,25,14,39,0,1,1,0,0,0,0,0,0,41,24,65
sp15,152,MUIR,UNAF,UndecPhysS,0,0,0,0,1,1,1,9,10,0,0,0,0,0,0,0,0,0,1,10,11
sp15,152,MUIR,UNAF,UndecSocSc,0,0,0,2,1,3,1,3,4,0,0,0,0,0,0,0,0,0,3,4,7
sp15,152,MUIR,USP,Urb Stu&Pl,0,0,0,0,0,0,1,2,3,1,2,3,2,11,13,0,0,0,4,15,19
sp15,152,MUIR,VIS,Art Hst/Cr,0,0,0,0,0,0,0,1,1,0,0,0,1,2,3,0,0,0,1,3,4
sp15,152,MUIR,VIS,Media,0,0,0,2,0,2,0,1,1,3,4,7,8,6,14,0,0,0,13,11,24
sp15,152,MUIR,VIS,Studio VA,0,0,0,0,0,0,0,1,1,0,3,3,0,6,6,0,0,0,0,10,10
sp15,152,MUIR,VIS,VA-CompArt,0,0,0,1,0,1,0,3,3,0,0,0,2,3,5,0,0,0,3,6,9
sp15,152,REVELLE,ANTH,Anth-Arch,0,0,0,0,0,0,0,0,0,2,1,3,0,1,1,0,0,0,2,2,4
sp15,152,REVELLE,ANTH,Anth-Biol,0,0,0,0,1,1,0,1,1,0,1,1,0,4,4,0,0,0,0,7,7
sp15,152,REVELLE,ANTH,Anth-Soci,0,0,0,0,0,0,0,0,0,0,1,1,0,1,1,0,0,0,0,2,2
sp15,152,REVELLE,BENG,Bioen:Binf,0,0,0,0,0,0,2,1,3,6,4,10,9,4,13,0,0,0,17,9,26
sp15,152,REVELLE,BENG,BioengBioS,0,0,0,1,0,1,2,1,3,3,3,6,3,1,4,0,0,0,9,5,14
sp15,152,REVELLE,BENG,BioengBiot,0,0,0,1,0,1,2,4,6,4,1,5,28,8,36,0,0,0,35,13,48
sp15,152,REVELLE,BENG,Bioengin,0,0,0,0,0,0,1,0,1,10,1,11,21,14,35,0,0,0,32,15,47
sp15,152,REVELLE,BIOL,Bioc/CellB,0,0,0,9,6,15,27,32,59,39,60,99,64,78,142,0,0,0,139,176,315
sp15,152,REVELLE,BIOL,BiolBioinf,0,0,0,0,0,0,2,5,7,1,0,1,1,1,2,0,0,0,4,6,10
sp15,152,REVELLE,BIOL,Ec/Beh/Evo,0,0,0,0,0,0,2,0,2,2,4,6,2,5,7,0,0,0,6,9,15
sp15,152,REVELLE,BIOL,Genl Biol,0,0,0,3,6,9,14,28,42,18,29,47,35,63,98,0,0,0,70,126,196
sp15,152,REVELLE,BIOL,Human Bio,0,0,0,3,8,11,25,64,89,43,72,115,65,90,155,0,0,0,136,234,370
sp15,152,REVELLE,BIOL,Microbiol,0,0,0,1,1,2,3,1,4,5,9,14,9,10,19,0,0,0,18,21,39
sp15,152,REVELLE,BIOL,Molec Biol,0,0,0,1,0,1,9,7,16,9,8,17,13,9,22,0,0,0,32,24,56
sp15,152,REVELLE,BIOL,PhyslNeuro,0,0,0,3,1,4,20,27,47,26,42,68,50,41,91,0,0,0,99,111,210
sp15,152,REVELLE,CENG,Chem Engin,0,0,0,0,0,0,17,8,25,33,14,47,80,28,108,0,0,0,130,50,180
sp15,152,REVELLE,CGS,CritGendSt,0,0,0,0,0,0,0,0,0,0,0,0,1,1,2,0,0,0,1,1,2
sp15,152,REVELLE,CHEM,Bioch/Chem,0,0,0,2,1,3,2,8,10,8,5,13,22,9,31,0,0,0,34,23,57
sp15,152,REVELLE,CHEM,Bioinform,0,0,0,0,0,0,0,1,1,2,0,2,0,1,1,0,0,0,2,2,4
sp15,152,REVELLE,CHEM,Chem Phys,0,0,0,0,0,0,0,1,1,0,0,0,2,1,3,0,0,0,2,2,4
sp15,152,REVELLE,CHEM,Chemistry,0,0,0,0,1,1,11,6,17,8,3,11,13,7,20,0,0,0,32,17,49
sp15,152,REVELLE,CHEM,Envir Chem,0,0,0,0,0,0,1,0,1,3,1,4,1,2,3,0,0,0,5,3,8
sp15,152,REVELLE,CHEM,MolecSynth,0,0,0,0,0,0,0,0,0,0,0,0,1,0,1,0,0,0,1,0,1
sp15,152,REVELLE,CHEM,Pharm Chem,0,0,0,0,1,1,8,14,22,13,8,21,18,18,36,0,0,0,39,41,80
sp15,152,REVELLE,CLAS,Classic St,0,0,0,0,0,0,0,1,1,0,0,0,0,0,0,0,0,0,0,1,1
sp15,152,REVELLE,COGS,Cog Sci,0,0,0,0,1,1,0,6,6,3,4,7,4,8,12,0,0,0,7,19,26
sp15,152,REVELLE,COGS,CogSc/ClAs,0,0,0,0,0,0,0,0,0,0,2,2,0,5,5,0,0,0,0,7,7
sp15,152,REVELLE,COGS,CogSc/Comp,0,0,0,2,0,2,0,1,1,2,0,2,2,1,3,0,0,0,6,2,8
sp15,152,REVELLE,COGS,CogSc/HCI,0,0,0,0,0,0,5,0,5,2,4,6,4,11,15,0,0,0,11,15,26
sp15,152,REVELLE,COGS,CogSc/HCog,0,0,0,0,0,0,1,1,2,2,2,4,0,2,2,0,0,0,3,5,8
sp15,152,REVELLE,COGS,CogSc/Neur,0,0,0,1,0,1,0,2,2,3,5,8,6,12,18,0,0,0,10,19,29
sp15,152,REVELLE,COMM,Communic,0,0,0,1,0,1,2,2,4,6,9,15,8,11,19,0,0,0,17,22,39
sp15,152,REVELLE,CSE,Comp Sci,0,0,0,0,0,0,18,1,19,46,11,57,134,24,158,0,0,0,198,36,234
sp15,152,REVELLE,CSE,CompEngCSE,0,0,0,0,0,0,5,0,5,6,0,6,16,2,18,0,0,0,27,2,29
sp15,152,REVELLE,CSE,CompScBinf,0,0,0,0,0,0,0,1,1,6,2,8,5,2,7,0,0,0,11,5,16
sp15,152,REVELLE,ECE,CompEngECE,0,0,0,0,0,0,9,1,10,11,3,14,13,1,14,0,0,0,33,5,38
sp15,152,REVELLE,ECE,Electr Eng,0,0,0,1,0,1,16,6,22,32,7,39,76,6,82,0,0,0,125,19,144
sp15,152,REVELLE,ECE,EleEng&Soc,0,0,0,0,0,0,0,0,0,1,0,1,0,0,0,0,0,0,1,0,1
sp15,152,REVELLE,ECE,Engin Phys,0,0,0,0,0,0,0,0,0,3,0,3,6,0,6,0,0,0,9,0,9
sp15,152,REVELLE,ECE,Pr-EngPhys,0,0,0,0,0,0,1,0,1,2,1,3,0,0,0,0,0,0,3,1,4
sp15,152,REVELLE,ECON,Ec-Mth&Ecn,0,0,0,2,2,4,11,6,17,4,1,5,10,2,12,0,0,0,27,11,38
sp15,152,REVELLE,ECON,Econ-MgtSc,0,0,0,2,1,3,6,7,13,19,13,32,34,16,50,0,0,0,61,37,98
sp15,152,REVELLE,ECON,Economics,0,0,0,4,2,6,10,9,19,39,28,67,56,21,77,0,0,0,109,60,169
sp15,152,REVELLE,ECON,EnvSys(EB),0,0,0,0,0,0,0,2,2,0,2,2,4,2,6,0,0,0,4,6,10
sp15,152,REVELLE,ECON,EnvSys(EC),0,0,0,0,0,0,0,0,0,0,0,0,2,1,3,0,0,0,2,1,3
sp15,152,REVELLE,ECON,EnvSys(ES),0,0,0,1,0,1,0,1,1,0,0,0,3,0,3,0,0,0,4,1,5
sp15,152,REVELLE,ETHN,Ethnic St,0,0,0,0,0,0,0,0,0,0,0,0,1,4,5,0,0,0,1,4,5
sp15,152,REVELLE,FPMU,Public Hlt,0,0,0,0,1,1,2,12,14,5,15,20,5,31,36,0,0,0,12,59,71
sp15,152,REVELLE,GLBH,Global Hlt,0,0,0,0,0,0,0,1,1,1,0,1,0,1,1,0,0,0,1,2,3
sp15,152,REVELLE,HDP,Human Dev,0,0,0,0,0,0,0,0,0,0,3,3,2,8,10,0,0,0,2,11,13
sp15,152,REVELLE,HDP,Pr-HumnDev,0,0,0,0,3,3,0,2,2,0,4,4,0,0,0,0,0,0,0,9,9
sp15,152,REVELLE,HIST,History,0,0,0,0,0,0,1,1,2,3,1,4,2,3,5,0,0,0,6,5,11
sp15,152,REVELLE,INTL,IntSt-Econ,0,0,0,0,0,0,0,1,1,3,0,3,5,5,10,0,0,0,8,6,14
sp15,152,REVELLE,INTL,IntSt-Hist,0,0,0,0,0,0,0,0,0,0,0,0,1,1,2,0,0,0,1,1,2
sp15,152,REVELLE,INTL,IntSt-Ling,0,0,0,0,0,0,0,0,0,0,0,0,0,1,1,0,0,0,0,1,1
sp15,152,REVELLE,INTL,IntSt-Lit,0,0,0,0,0,0,0,0,0,0,0,0,0,1,1,0,0,0,0,1,1
sp15,152,REVELLE,INTL,IntSt-PolS,0,0,0,0,0,0,0,0,0,0,2,2,1,4,5,0,0,0,1,6,7
sp15,152,REVELLE,INTL,IntSt-Soc,0,0,0,1,0,1,0,0,0,0,0,0,0,1,1,0,0,0,1,1,2
sp15,152,REVELLE,JAPN,JapaneseSt,0,0,0,0,0,0,1,0,1,0,0,0,0,0,0,0,0,0,1,0,1
sp15,152,REVELLE,LING,Lang Stu,0,0,0,0,1,1,0,0,0,1,0,1,0,1,1,0,0,0,1,2,3
sp15,152,REVELLE,LING,Ling-CogLn,0,0,0,0,0,0,0,1,1,0,0,0,0,0,0,0,0,0,0,1,1
sp15,152,REVELLE,LING,Linguistcs,0,0,0,0,0,0,0,0,0,1,0,1,2,2,4,0,0,0,3,2,5
sp15,152,REVELLE,LIT,Lit/CultSt,0,0,0,0,0,0,0,1,1,0,0,0,0,1,1,0,0,0,0,2,2
sp15,152,REVELLE,LIT,Lit/Engl,0,0,0,0,0,0,0,0,0,1,0,1,2,2,4,0,0,0,3,2,5
sp15,152,REVELLE,LIT,Lit/World,0,0,0,0,0,0,0,0,0,0,1,1,1,2,3,0,0,0,1,3,4
sp15,152,REVELLE,LIT,Lit/Writng,0,0,0,0,0,0,1,2,3,0,0,0,1,6,7,0,0,0,2,8,10
sp15,152,REVELLE,LIT,Spanish Lt,0,0,0,0,0,0,0,0,0,0,0,0,1,1,2,0,0,0,1,1,2
sp15,152,REVELLE,MAE,Aerosp Eng,0,0,0,1,0,1,7,0,7,12,2,14,24,4,28,0,0,0,44,6,50
sp15,152,REVELLE,MAE,Engin Sci,0,0,0,0,0,0,0,0,0,0,0,0,2,0,2,0,0,0,2,0,2
sp15,152,REVELLE,MAE,Envir Eng,0,0,0,2,0,2,3,3,6,7,7,14,9,6,15,0,0,0,21,16,37
sp15,152,REVELLE,MAE,Mech Engin,0,0,0,3,0,3,8,3,11,11,4,15,41,7,48,0,0,0,63,14,77
sp15,152,REVELLE,MATH,Appld Math,0,0,0,6,2,8,12,1,13,13,4,17,15,14,29,0,0,0,46,21,67
sp15,152,REVELLE,MATH,Math/SecEd,0,0,0,1,0,1,1,0,1,0,1,1,1,1,2,0,0,0,3,2,5
sp15,152,REVELLE,MATH,Mathematcs,0,0,0,5,1,6,7,3,10,5,3,8,8,2,10,0,0,0,25,9,34
sp15,152,REVELLE,MATH,Mth-CompSc,0,0,0,3,5,8,17,2,19,10,2,12,3,3,6,0,0,0,33,12,45
sp15,152,REVELLE,MATH,Mth-Mth&Ec,0,0,0,0,0,0,1,3,4,0,5,5,4,8,12,0,0,0,5,16,21
sp15,152,REVELLE,MATH,Mth-SciCom,0,0,0,0,0,0,0,1,1,1,0,1,1,0,1,0,0,0,2,1,3
sp15,152,REVELLE,MATH,Mth/ApldSc,0,0,0,0,1,1,1,0,1,2,0,2,2,0,2,0,0,0,5,1,6
sp15,152,REVELLE,MATH,Prob&Stats,0,0,0,0,1,1,1,2,3,1,6,7,5,5,10,0,0,0,7,14,21
sp15,152,REVELLE,MUS,Mu-CompArt,0,0,0,0,0,0,0,0,0,2,0,2,1,1,2,0,0,0,3,1,4
sp15,152,REVELLE,MUS,Music,0,0,0,0,0,0,1,0,1,1,0,1,1,2,3,0,0,0,3,2,5
sp15,152,REVELLE,NENG,NanoEng,0,0,0,0,1,1,5,2,7,11,4,15,35,8,43,0,0,0,51,15,66
sp15,152,REVELLE,PHIL,Philosophy,0,0,0,0,0,0,0,0,0,1,1,2,2,0,2,0,0,0,3,1,4
sp15,152,REVELLE,PHYS,Biophysics,0,0,0,0,0,0,1,2,3,2,0,2,4,1,5,0,0,0,7,3,10
sp15,152,REVELLE,PHYS,Gen Physcs,0,0,0,1,0,1,0,0,0,0,0,0,0,1,1,0,0,0,1,1,2
sp15,152,REVELLE,PHYS,Phy/ErthSc,0,0,0,0,0,0,0,0,0,0,0,0,1,0,1,0,0,0,1,0,1
sp15,152,REVELLE,PHYS,Phys/Astro,0,0,0,0,1,1,6,1,7,7,0,7,6,5,11,0,0,0,19,7,26
sp15,152,REVELLE,PHYS,Phys/Comp,0,0,0,0,0,0,1,0,1,0,0,0,4,0,4,0,0,0,5,0,5
sp15,152,REVELLE,PHYS,Phys/Mtrls,0,0,0,0,0,0,1,2,3,1,0,1,0,0,0,0,0,0,2,2,4
sp15,152,REVELLE,PHYS,Physics,0,0,0,4,0,4,11,2,13,6,0,6,15,5,20,0,0,0,36,7,43
sp15,152,REVELLE,POLI,Polit Sci,0,0,0,1,0,1,0,1,1,3,4,7,4,1,5,0,0,0,8,6,14
sp15,152,REVELLE,POLI,PolSc-Amer,0,0,0,1,0,1,0,0,0,0,0,0,2,0,2,0,0,0,3,0,3
sp15,152,REVELLE,POLI,PolSc-Comp,0,0,0,0,0,0,1,0,1,0,0,0,0,1,1,0,0,0,1,1,2
sp15,152,REVELLE,POLI,PolSc-Intl,0,0,0,1,0,1,2,2,4,4,1,5,4,3,7,0,0,0,11,6,17
sp15,152,REVELLE,POLI,PolSc-PLaw,0,0,0,0,0,0,2,0,2,1,2,3,0,6,6,0,0,0,3,8,11
sp15,152,REVELLE,POLI,PolSc-PPol,0,0,0,0,0,0,0,0,0,0,0,0,2,0,2,0,0,0,2,0,2
sp15,152,REVELLE,POLI,PolSc-Thry,0,0,0,0,0,0,0,0,0,0,0,0,1,1,2,0,0,0,1,1,2
sp15,152,REVELLE,PSYC,Psychology,0,0,0,1,5,6,4,13,17,13,20,33,26,66,92,0,0,0,44,104,148
sp15,152,REVELLE,RELI,Relig/Stu,0,0,0,0,0,0,0,0,0,0,0,0,0,1,1,0,0,0,0,1,1
sp15,152,REVELLE,SE,Struct Eng,0,0,0,1,0,1,8,3,11,24,5,29,46,13,59,0,0,0,79,21,100
sp15,152,REVELLE,SIO,Earth Sci,0,0,0,0,1,1,1,1,2,0,2,2,5,1,6,0,0,0,6,5,11
sp15,152,REVELLE,SIO,Marine Bio,0,0,0,1,2,3,5,7,12,1,8,9,1,11,12,0,0,0,8,28,36
sp15,152,REVELLE,SOC,SocEconSoc,0,0,0,0,0,0,0,0,0,0,0,0,0,1,1,0,0,0,0,1,1
sp15,152,REVELLE,SOC,SocIntlStu,0,0,0,0,0,0,0,0,0,0,0,0,1,0,1,0,0,0,1,0,1
sp15,152,REVELLE,SOC,Sociology,0,0,0,0,0,0,0,1,1,0,3,3,3,3,6,0,0,0,3,7,10
sp15,152,REVELLE,SOC,SocLawSoc,0,0,0,0,0,0,0,1,1,0,1,1,0,1,1,0,0,0,0,3,3
sp15,152,REVELLE,SOC,SocSciMed,0,0,0,0,0,0,0,0,0,0,0,0,0,2,2,0,0,0,0,2,2
sp15,152,REVELLE,SOC,SocSolneq,0,0,0,0,0,0,0,0,0,0,0,0,0,1,1,0,0,0,0,1,1
sp15,152,REVELLE,THEA,Dance,0,0,0,0,0,0,0,0,0,0,0,0,1,0,1,0,0,0,1,0,1
sp15,152,REVELLE,THEA,Theatre,0,0,0,1,1,2,0,1,1,0,3,3,0,3,3,0,0,0,1,8,9
sp15,152,REVELLE,THEA,Limited St,0,0,0,0,0,0,0,0,0,0,0,0,0,0,0,3,1,4,3,1,4
sp15,152,REVELLE,THEA,Spec-Emply,0,0,0,0,0,0,0,0,0,0,0,0,0,0,0,2,2,4,2,2,4
sp15,152,REVELLE,THEA,UndecHumAr,0,0,0,1,1,2,0,0,0,0,0,0,0,0,0,0,0,0,1,1,2
sp15,152,REVELLE,THEA,Undeclared,0,0,0,23,5,28,38,13,51,3,0,3,0,0,0,0,0,0,64,18,82
sp15,152,REVELLE,THEA,UndecPhysS,0,0,0,4,1,5,4,0,4,0,1,1,0,0,0,0,0,0,8,2,10
sp15,152,REVELLE,THEA,UndecSocSc,0,0,0,0,3,3,0,0,0,0,0,0,0,0,0,0,0,0,0,3,3
sp15,152,REVELLE,USP,Urb Stu&Pl,0,0,0,0,0,0,0,0,0,1,1,2,0,1,1,0,0,0,1,2,3
sp15,152,REVELLE,VIS,Art Hst/Cr,0,0,0,0,0,0,0,0,0,0,0,0,0,1,1,0,0,0,0,1,1
sp15,152,REVELLE,VIS,Media,0,0,0,0,0,0,1,1,2,0,2,2,1,3,4,0,0,0,2,6,8
sp15,152,REVELLE,VIS,Studio VA,0,0,0,0,1,1,0,0,0,0,1,1,1,0,1,0,0,0,1,2,3
sp15,152,REVELLE,VIS,VA-CompArt,0,0,0,0,0,0,1,3,4,2,6,8,3,1,4,0,0,0,6,10,16
sp15,152,ROOSEVELT,ANTH,Anth-Arch,0,0,0,0,1,1,0,0,0,1,1,2,3,7,10,0,0,0,4,9,13
sp15,152,ROOSEVELT,ANTH,Anth-Biol,0,0,0,0,1,1,0,1,1,0,4,4,1,6,7,0,0,0,1,12,13
sp15,152,ROOSEVELT,ANTH,Anth-Soci,0,0,0,0,0,0,0,0,0,1,6,7,3,4,7,0,0,0,4,10,14
sp15,152,ROOSEVELT,BENG,Bioen:Binf,0,0,0,0,0,0,1,0,1,3,4,7,5,4,9,0,0,0,9,8,17
sp15,152,ROOSEVELT,BENG,BioengBioS,0,0,0,0,0,0,0,1,1,4,4,8,1,0,1,0,0,0,5,5,10
sp15,152,ROOSEVELT,BENG,BioengBiot,0,0,0,0,0,0,0,2,2,2,0,2,3,3,6,0,0,0,5,5,10
sp15,152,ROOSEVELT,BENG,Bioengin,0,0,0,0,0,0,0,0,0,0,0,0,7,2,9,0,0,0,7,2,9
sp15,152,ROOSEVELT,BIOL,Bioc/CellB,0,0,0,4,5,9,18,28,46,13,22,35,37,42,79,0,0,0,72,97,169
sp15,152,ROOSEVELT,BIOL,BiolBioinf,0,0,0,0,4,4,1,1,2,1,0,1,1,2,3,0,0,0,3,7,10
sp15,152,ROOSEVELT,BIOL,Ec/Beh/Evo,0,0,0,1,1,2,1,0,1,1,5,6,10,4,14,0,0,0,13,10,23
sp15,152,ROOSEVELT,BIOL,Genl Biol,0,0,0,5,8,13,5,16,21,13,26,39,25,40,65,0,0,0,48,90,138
sp15,152,ROOSEVELT,BIOL,Human Bio,0,0,0,6,11,17,23,63,86,27,40,67,31,59,90,0,0,0,87,173,260
sp15,152,ROOSEVELT,BIOL,Microbiol,0,0,0,0,0,0,2,2,4,3,2,5,3,10,13,0,0,0,8,14,22
sp15,152,ROOSEVELT,BIOL,Molec Biol,0,0,0,1,0,1,0,4,4,0,3,3,2,7,9,0,0,0,3,14,17
sp15,152,ROOSEVELT,BIOL,PhyslNeuro,0,0,0,8,3,11,10,26,36,16,33,49,19,26,45,0,0,0,53,88,141
sp15,152,ROOSEVELT,CENG,Chem Engin,0,0,0,0,0,0,5,2,7,8,5,13,24,11,35,0,0,0,37,18,55
sp15,152,ROOSEVELT,CGS,CritGendSt,0,0,0,0,0,0,0,0,0,1,0,1,0,1,1,0,0,0,1,1,2
sp15,152,ROOSEVELT,CHEM,Bioch/Chem,0,0,0,2,3,5,8,3,11,3,6,9,11,6,17,0,0,0,24,18,42
sp15,152,ROOSEVELT,CHEM,Bioinform,0,0,0,0,1,1,1,0,1,0,0,0,0,0,0,0,0,0,1,1,2
sp15,152,ROOSEVELT,CHEM,Chem Phys,0,0,0,0,0,0,0,1,1,0,0,0,0,0,0,0,0,0,0,1,1
sp15,152,ROOSEVELT,CHEM,Chemistry,0,0,0,2,0,2,2,2,4,0,3,3,3,3,6,0,0,0,7,8,15
sp15,152,ROOSEVELT,CHEM,Envir Chem,0,0,0,0,2,2,0,0,0,0,0,0,1,1,2,0,0,0,1,3,4
sp15,152,ROOSEVELT,CHEM,Pharm Chem,0,0,0,1,2,3,4,11,15,3,5,8,11,13,24,0,0,0,19,31,50
sp15,152,ROOSEVELT,CHIN,Chinese St,0,0,0,0,0,0,0,1,1,0,1,1,0,0,0,0,0,0,0,2,2
sp15,152,ROOSEVELT,CLAS,Classic St,0,0,0,0,0,0,0,0,0,0,0,0,1,2,3,0,0,0,1,2,3
sp15,152,ROOSEVELT,COGS,Cog Sci,0,0,0,1,0,1,5,5,10,2,4,6,2,6,8,0,0,0,10,15,25
sp15,152,ROOSEVELT,COGS,CogSc/ClAs,0,0,0,0,1,1,0,1,1,0,1,1,0,3,3,0,0,0,0,6,6
sp15,152,ROOSEVELT,COGS,CogSc/Comp,0,0,0,1,0,1,0,1,1,0,0,0,0,1,1,0,0,0,1,2,3
sp15,152,ROOSEVELT,COGS,CogSc/HCI,0,0,0,0,0,0,3,4,7,1,1,2,4,8,12,0,0,0,8,13,21
sp15,152,ROOSEVELT,COGS,CogSc/HCog,0,0,0,0,0,0,0,2,2,0,1,1,0,1,1,0,0,0,0,4,4
sp15,152,ROOSEVELT,COGS,CogSc/Neur,0,0,0,0,0,0,1,3,4,2,4,6,5,6,11,0,0,0,8,13,21
sp15,152,ROOSEVELT,COMM,Communic,0,0,0,2,7,9,4,10,14,10,47,57,18,43,61,0,0,0,34,107,141
sp15,152,ROOSEVELT,CSE,Comp Sci,0,0,0,1,0,1,9,1,10,21,4,25,72,18,90,0,0,0,103,23,126
sp15,152,ROOSEVELT,CSE,CompEngCSE,0,0,0,2,0,2,2,2,4,5,2,7,13,2,15,0,0,0,22,6,28
sp15,152,ROOSEVELT,CSE,CompScBinf,0,0,0,0,0,0,0,0,0,4,0,4,4,3,7,0,0,0,8,3,11
sp15,152,ROOSEVELT,ECE,CompEngECE,0,0,0,0,1,1,5,1,6,11,3,14,8,0,8,0,0,0,24,5,29
sp15,152,ROOSEVELT,ECE,Electr Eng,0,0,0,2,0,2,9,1,10,20,7,27,48,9,57,0,0,0,79,17,96
sp15,152,ROOSEVELT,ECE,EleEng&Soc,0,0,0,0,0,0,1,0,1,0,0,0,0,0,0,0,0,0,1,0,1
sp15,152,ROOSEVELT,ECE,Engin Phys,0,0,0,0,0,0,0,0,0,1,0,1,1,0,1,0,0,0,2,0,2
sp15,152,ROOSEVELT,ECE,Pr-EngPhys,0,0,0,0,1,1,1,0,1,1,0,1,0,0,0,0,0,0,2,1,3
sp15,152,ROOSEVELT,ECON,Ec-Mth&Ecn,0,0,0,3,6,9,8,11,19,12,4,16,7,8,15,0,0,0,30,29,59
sp15,152,ROOSEVELT,ECON,Econ-MgtSc,0,0,0,5,9,14,21,13,34,22,17,39,37,27,64,0,0,0,85,66,151
sp15,152,ROOSEVELT,ECON,Economics,0,0,0,25,11,36,25,18,43,66,34,100,52,53,105,0,0,0,168,116,284
sp15,152,ROOSEVELT,ECON,EnvSys(EB),0,0,0,0,0,0,3,3,6,0,4,4,2,4,6,0,0,0,5,11,16
sp15,152,ROOSEVELT,ECON,EnvSys(EC),0,0,0,0,0,0,0,0,0,0,0,0,0,1,1,0,0,0,0,1,1
sp15,152,ROOSEVELT,ECON,EnvSys(EP),0,0,0,0,1,1,3,1,4,1,1,2,1,1,2,0,0,0,5,4,9
sp15,152,ROOSEVELT,ECON,EnvSys(ES),0,0,0,0,0,0,0,2,2,1,1,2,2,3,5,0,0,0,3,6,9
sp15,152,ROOSEVELT,ETHN,Ethnic St,0,0,0,0,1,1,1,0,1,0,1,1,1,1,2,0,0,0,2,3,5
sp15,152,ROOSEVELT,FPMU,Public Hlt,0,0,0,1,4,5,2,11,13,6,21,27,3,25,28,0,0,0,12,61,73
sp15,152,ROOSEVELT,GLBH,Global Hlt,0,0,0,0,0,0,0,5,5,2,5,7,1,3,4,0,0,0,3,13,16
sp15,152,ROOSEVELT,GMST,German Stu,0,0,0,0,0,0,0,0,0,0,0,0,1,0,1,0,0,0,1,0,1
sp15,152,ROOSEVELT,HDP,Human Dev,0,0,0,0,0,0,0,2,2,0,5,5,1,23,24,0,0,0,1,30,31
sp15,152,ROOSEVELT,HDP,Pr-HumnDev,0,0,0,0,4,4,0,7,7,1,8,9,1,1,2,0,0,0,2,20,22
sp15,152,ROOSEVELT,HIST,History,0,0,0,0,0,0,5,7,12,8,12,20,16,17,33,0,0,0,29,36,65
sp15,152,ROOSEVELT,INTL,Int-5yrEC,0,0,0,0,0,0,0,0,0,0,0,0,2,1,3,0,0,0,2,1,3
sp15,152,ROOSEVELT,INTL,IntSt-Anth,0,0,0,0,0,0,0,1,1,0,0,0,0,3,3,0,0,0,0,4,4
sp15,152,ROOSEVELT,INTL,IntSt-Econ,0,0,0,0,3,3,5,9,14,4,7,11,9,17,26,0,0,0,18,36,54
sp15,152,ROOSEVELT,INTL,IntSt-Hist,0,0,0,0,0,0,0,1,1,0,3,3,1,4,5,0,0,0,1,8,9
sp15,152,ROOSEVELT,INTL,IntSt-Ling,0,0,0,0,0,0,0,1,1,0,1,1,2,4,6,0,0,0,2,6,8
sp15,152,ROOSEVELT,INTL,IntSt-Lit,0,0,0,0,0,0,0,0,0,0,1,1,1,0,1,0,0,0,1,1,2
sp15,152,ROOSEVELT,INTL,IntSt-PolS,0,0,0,1,1,2,6,12,18,7,13,20,22,34,56,0,0,0,36,60,96
sp15,152,ROOSEVELT,INTL,IntSt-Soc,0,0,0,0,1,1,1,4,5,4,8,12,2,12,14,0,0,0,7,25,32
sp15,152,ROOSEVELT,JAPN,JapaneseSt,0,0,0,0,0,0,1,0,1,0,1,1,1,2,3,0,0,0,2,3,5
sp15,152,ROOSEVELT,JAPN,LatinAm St,0,0,0,0,0,0,0,0,0,0,1,1,1,0,1,0,0,0,1,1,2
sp15,152,ROOSEVELT,LING,Lang Stu,0,0,0,0,0,0,0,2,2,0,2,2,1,1,2,0,0,0,1,5,6
sp15,152,ROOSEVELT,LING,Ling-CogLn,0,0,0,0,0,0,0,3,3,1,2,3,0,4,4,0,0,0,1,9,10
sp15,152,ROOSEVELT,LING,Ling-LSoc,0,0,0,0,1,1,1,0,1,0,2,2,1,2,3,0,0,0,2,5,7
sp15,152,ROOSEVELT,LING,Linguistcs,0,0,0,0,0,0,0,0,0,1,3,4,1,6,7,0,0,0,2,9,11
sp15,152,ROOSEVELT,LIT,French Lit,0,0,0,0,0,0,0,1,1,0,1,1,0,0,0,0,0,0,0,2,2
sp15,152,ROOSEVELT,LIT,Lit/Compos,0,0,0,0,0,0,1,0,1,0,1,1,0,0,0,0,0,0,1,1,2
sp15,152,ROOSEVELT,LIT,Lit/CultSt,0,0,0,0,0,0,0,0,0,0,1,1,0,2,2,0,0,0,0,3,3
sp15,152,ROOSEVELT,LIT,Lit/Engl,0,0,0,0,1,1,1,3,4,3,3,6,0,6,6,0,0,0,4,13,17
sp15,152,ROOSEVELT,LIT,Lit/World,0,0,0,0,0,0,0,0,0,0,0,0,0,3,3,0,0,0,0,3,3
sp15,152,ROOSEVELT,LIT,Lit/Writng,0,0,0,0,0,0,0,2,2,1,2,3,1,17,18,0,0,0,2,21,23
sp15,152,ROOSEVELT,LIT,Spanish Lt,0,0,0,0,1,1,0,0,0,0,2,2,0,0,0,0,0,0,0,3,3
sp15,152,ROOSEVELT,MAE,Aerosp Eng,0,0,0,0,0,0,2,1,3,0,1,1,7,0,7,0,0,0,9,2,11
sp15,152,ROOSEVELT,MAE,Engin Sci,0,0,0,0,0,0,0,0,0,0,0,0,2,0,2,0,0,0,2,0,2
sp15,152,ROOSEVELT,MAE,Envir Eng,0,0,0,1,0,1,6,2,8,4,4,8,5,7,12,0,0,0,16,13,29
sp15,152,ROOSEVELT,MAE,Mech Engin,0,0,0,2,0,2,0,1,1,2,1,3,7,2,9,0,0,0,11,4,15
sp15,152,ROOSEVELT,MATH,Appld Math,0,0,0,5,6,11,8,9,17,5,9,14,4,5,9,0,0,0,22,29,51
sp15,152,ROOSEVELT,MATH,Math/SecEd,0,0,0,0,0,0,0,0,0,0,3,3,1,2,3,0,0,0,1,5,6
sp15,152,ROOSEVELT,MATH,Mathematcs,0,0,0,2,2,4,5,0,5,1,1,2,2,1,3,0,0,0,10,4,14
sp15,152,ROOSEVELT,MATH,Mth-CompSc,0,0,0,8,3,11,20,3,23,8,0,8,4,3,7,0,0,0,40,9,49
sp15,152,ROOSEVELT,MATH,Mth-Mth&Ec,0,0,0,0,4,4,3,7,10,6,5,11,5,3,8,0,0,0,14,19,33
sp15,152,ROOSEVELT,MATH,Mth/ApldSc,0,0,0,0,2,2,1,1,2,1,0,1,1,0,1,0,0,0,3,3,6
sp15,152,ROOSEVELT,MATH,Prob&Stats,0,0,0,3,3,6,5,3,8,1,3,4,1,1,2,0,0,0,10,10,20
sp15,152,ROOSEVELT,MUS,Mu-CompArt,0,0,0,0,0,0,1,0,1,2,0,2,0,1,1,0,0,0,3,1,4
sp15,152,ROOSEVELT,MUS,Music,0,0,0,0,0,0,0,1,1,0,0,0,1,0,1,0,0,0,1,1,2
sp15,152,ROOSEVELT,NENG,NanoEng,0,0,0,0,0,0,0,1,1,6,2,8,20,9,29,0,0,0,26,12,38
sp15,152,ROOSEVELT,PHIL,Philosophy,0,0,0,0,1,1,0,1,1,0,1,1,4,2,6,0,0,0,4,5,9
sp15,152,ROOSEVELT,PHYS,Biophysics,0,0,0,0,0,0,0,0,0,1,1,2,1,0,1,0,0,0,2,1,3
sp15,152,ROOSEVELT,PHYS,Phys/Astro,0,0,0,0,0,0,5,2,7,1,1,2,0,0,0,0,0,0,6,3,9
sp15,152,ROOSEVELT,PHYS,Phys/Comp,0,0,0,0,0,0,0,0,0,0,0,0,1,0,1,0,0,0,1,0,1
sp15,152,ROOSEVELT,PHYS,Phys/Mtrls,0,0,0,0,0,0,0,0,0,0,0,0,1,0,1,0,0,0,1,0,1
sp15,152,ROOSEVELT,PHYS,Physics,0,0,0,2,0,2,9,1,10,1,1,2,2,1,3,0,0,0,14,3,17
sp15,152,ROOSEVELT,POLI,Polit Sci,0,0,0,2,3,5,2,14,16,9,13,22,17,27,44,0,0,0,30,57,87
sp15,152,ROOSEVELT,POLI,PolSc-Amer,0,0,0,1,1,2,0,0,0,1,5,6,5,3,8,0,0,0,7,9,16
sp15,152,ROOSEVELT,POLI,PolSc-Comp,0,0,0,0,0,0,1,1,2,0,1,1,1,3,4,0,0,0,2,5,7
sp15,152,ROOSEVELT,POLI,PolSc-Intl,0,0,0,1,1,2,9,6,15,11,18,29,26,17,43,0,0,0,47,42,89
sp15,152,ROOSEVELT,POLI,PolSc-PLaw,0,0,0,1,0,1,0,3,3,5,8,13,4,9,13,0,0,0,10,20,30
sp15,152,ROOSEVELT,POLI,PolSc-PPol,0,0,0,0,0,0,0,0,0,3,1,4,2,4,6,0,0,0,5,5,10
sp15,152,ROOSEVELT,POLI,PolSc-Thry,0,0,0,0,1,1,1,0,1,0,1,1,0,1,1,0,0,0,1,3,4
sp15,152,ROOSEVELT,PSYC,Psychology,0,0,0,1,11,12,6,30,36,12,41,53,20,73,93,0,0,0,39,155,194
sp15,152,ROOSEVELT,SE,Engin Sci,0,0,0,0,0,0,2,1,3,0,0,0,0,0,0,0,0,0,2,1,3
sp15,152,ROOSEVELT,SE,Struct Eng,0,0,0,3,0,3,8,3,11,9,3,12,31,8,39,0,0,0,51,14,65
sp15,152,ROOSEVELT,SIO,Earth Sci,0,0,0,0,0,0,1,0,1,2,1,3,2,5,7,0,0,0,5,6,11
sp15,152,ROOSEVELT,SIO,Marine Bio,0,0,0,1,2,3,1,6,7,2,6,8,4,8,12,0,0,0,8,22,30
sp15,152,ROOSEVELT,SOC,SocCulCom,0,0,0,0,0,0,0,0,0,0,2,2,0,1,1,0,0,0,0,3,3
sp15,152,ROOSEVELT,SOC,SocEconSoc,0,0,0,0,0,0,0,0,0,0,0,0,1,1,2,0,0,0,1,1,2
sp15,152,ROOSEVELT,SOC,SocIntlStu,0,0,0,0,0,0,0,0,0,0,2,2,0,0,0,0,0,0,0,2,2
sp15,152,ROOSEVELT,SOC,Sociology,0,0,0,0,0,0,2,3,5,3,3,6,3,15,18,0,0,0,8,21,29
sp15,152,ROOSEVELT,SOC,SocLawSoc,0,0,0,0,1,1,0,1,1,0,2,2,4,1,5,0,0,0,4,5,9
sp15,152,ROOSEVELT,SOC,SocSciMed,0,0,0,0,0,0,0,0,0,0,3,3,0,1,1,0,0,0,0,4,4
sp15,152,ROOSEVELT,SOC,SocSolneq,0,0,0,0,0,0,0,0,0,0,1,1,0,3,3,0,0,0,0,4,4
sp15,152,ROOSEVELT,THEA,Dance,0,0,0,0,0,0,0,1,1,0,0,0,1,0,1,0,0,0,1,1,2
sp15,152,ROOSEVELT,THEA,Theatre,0,0,0,0,0,0,1,2,3,2,1,3,2,5,7,0,0,0,5,8,13
sp15,152,ROOSEVELT,TWS,ThirdWldSt,0,0,0,0,0,0,0,0,0,0,0,0,0,2,2,0,0,0,0,2,2
sp15,152,ROOSEVELT,UNAF,UndecHumAr,0,0,0,0,2,2,1,4,5,0,0,0,0,0,0,0,0,0,1,6,7
sp15,152,ROOSEVELT,UNAF,Undeclared,0,0,0,22,17,39,33,14,47,0,0,0,0,0,0,0,0,0,55,31,86
sp15,152,ROOSEVELT,UNAF,UndecPhysS,0,0,0,3,4,7,2,2,4,0,1,1,0,0,0,0,0,0,5,7,12
sp15,152,ROOSEVELT,UNAF,UndecSocSc,0,0,0,3,2,5,3,6,9,0,0,0,0,0,0,0,0,0,6,8,14
sp15,152,ROOSEVELT,USP,Urb Stu&Pl,0,0,0,0,0,0,1,0,1,2,2,4,1,2,3,0,0,0,4,4,8
sp15,152,ROOSEVELT,VIS,Art Hst/Cr,0,0,0,0,0,0,0,0,0,0,1,1,0,4,4,0,0,0,0,5,5
sp15,152,ROOSEVELT,VIS,Media,0,0,0,0,2,2,2,1,3,1,2,3,5,3,8,0,0,0,8,8,16
sp15,152,ROOSEVELT,VIS,Studio VA,0,0,0,0,0,0,1,3,4,0,1,1,1,6,7,0,0,0,2,10,12
sp15,152,ROOSEVELT,VIS,VA-CompArt,0,0,0,1,1,2,0,2,2,0,1,1,2,4,6,0,0,0,3,8,11
sp15,152,SIXTH,ANTH,Anth-Arch,0,0,0,0,0,0,0,0,0,0,1,1,0,2,2,0,0,0,0,3,3
sp15,152,SIXTH,ANTH,Anth-Biol,0,0,0,0,0,0,0,0,0,0,0,0,0,3,3,0,0,0,0,3,3
sp15,152,SIXTH,ANTH,Anth-Soci,0,0,0,0,0,0,0,0,0,1,1,2,0,4,4,0,0,0,1,5,6
sp15,152,SIXTH,BENG,Bioen:Binf,0,0,0,0,0,0,0,2,2,3,5,8,5,6,11,0,0,0,8,13,21
sp15,152,SIXTH,BENG,BioengBioS,0,0,0,0,0,0,1,1,2,3,3,6,1,2,3,0,0,0,5,6,11
sp15,152,SIXTH,BENG,BioengBiot,0,0,0,0,0,0,2,2,4,3,1,4,11,9,20,0,0,0,16,12,28
sp15,152,SIXTH,BENG,Bioengin,0,0,0,0,0,0,1,0,1,3,0,3,9,7,16,0,0,0,13,7,20
sp15,152,SIXTH,BIOL,Bioc/CellB,0,0,0,3,4,7,23,27,50,28,21,49,38,48,86,0,0,0,92,100,192
sp15,152,SIXTH,BIOL,BiolBioinf,0,0,0,2,0,2,3,1,4,2,2,4,1,0,1,0,0,0,8,3,11
sp15,152,SIXTH,BIOL,Ec/Beh/Evo,0,0,0,0,0,0,1,1,2,1,3,4,2,8,10,0,0,0,4,12,16
sp15,152,SIXTH,BIOL,Genl Biol,0,0,0,3,0,3,12,18,30,7,17,24,24,35,59,0,0,0,46,70,116
sp15,152,SIXTH,BIOL,Human Bio,0,0,0,0,12,12,32,34,66,26,32,58,48,42,90,0,0,0,106,120,226
sp15,152,SIXTH,BIOL,Microbiol,0,0,0,0,1,1,2,5,7,4,5,9,2,5,7,0,0,0,8,16,24
sp15,152,SIXTH,BIOL,Molec Biol,0,0,0,0,0,0,4,5,9,3,4,7,5,4,9,0,0,0,12,13,25
sp15,152,SIXTH,BIOL,PhyslNeuro,0,0,0,3,1,4,11,21,32,17,24,41,25,17,42,0,0,0,56,63,119
sp15,152,SIXTH,CENG,Chem Engin,0,0,0,0,0,0,5,3,8,23,12,35,27,13,40,0,0,0,55,28,83
sp15,152,SIXTH,CGS,CritGendSt,0,0,0,0,0,0,0,0,0,0,0,0,1,1,2,0,0,0,1,1,2
sp15,152,SIXTH,CHEM,Bioch/Chem,0,0,0,1,1,2,3,5,8,1,1,2,15,5,20,0,0,0,20,12,32
sp15,152,SIXTH,CHEM,Bioinform,0,0,0,0,0,0,2,1,3,1,0,1,0,0,0,0,0,0,3,1,4
sp15,152,SIXTH,CHEM,Chemistry,0,0,0,1,2,3,4,7,11,5,4,9,3,6,9,0,0,0,13,19,32
sp15,152,SIXTH,CHEM,Envir Chem,0,0,0,0,0,0,0,0,0,1,1,2,0,2,2,0,0,0,1,3,4
sp15,152,SIXTH,CHEM,MolecSynth,0,0,0,0,0,0,0,0,0,0,0,0,1,0,1,0,0,0,1,0,1
sp15,152,SIXTH,CHEM,Pharm Chem,0,0,0,0,4,4,5,12,17,3,12,15,12,13,25,0,0,0,20,41,61
sp15,152,SIXTH,CHIN,Chinese St,0,0,0,0,0,0,0,1,1,0,0,0,0,0,0,0,0,0,0,1,1
sp15,152,SIXTH,COGS,Cog Sci,0,0,0,2,3,5,1,5,6,3,3,6,3,2,5,0,0,0,9,13,22
sp15,152,SIXTH,COGS,CogSc/ClAs,0,0,0,0,0,0,0,0,0,1,0,1,0,1,1,0,0,0,1,1,2
sp15,152,SIXTH,COGS,CogSc/Comp,0,0,0,2,0,2,7,2,9,1,0,1,0,2,2,0,0,0,10,4,14
sp15,152,SIXTH,COGS,CogSc/HCI,0,0,0,1,1,2,7,4,11,6,8,14,10,5,15,0,0,0,24,18,42
sp15,152,SIXTH,COGS,CogSc/HCog,0,0,0,0,1,1,1,1,2,0,0,0,3,2,5,0,0,0,4,4,8
sp15,152,SIXTH,COGS,CogSc/Neur,0,0,0,0,0,0,3,3,6,1,2,3,12,8,20,0,0,0,16,13,29
sp15,152,SIXTH,COMM,Communic,0,0,0,4,4,8,7,11,18,16,39,55,20,47,67,0,0,0,47,101,148
sp15,152,SIXTH,CSE,Comp Sci,0,0,0,1,1,2,29,9,38,84,15,99,171,44,215,0,0,0,285,69,354
sp15,152,SIXTH,CSE,CompEngCSE,0,0,0,0,0,0,3,0,3,13,1,14,35,3,38,0,0,0,51,4,55
sp15,152,SIXTH,CSE,CompScBinf,0,0,0,0,0,0,3,0,3,5,3,8,2,3,5,0,0,0,10,6,16
sp15,152,SIXTH,ECE,CompEngECE,0,0,0,1,0,1,11,0,11,26,5,31,10,0,10,0,0,0,48,5,53
sp15,152,SIXTH,ECE,Electr Eng,0,0,0,2,0,2,23,4,27,57,4,61,86,11,97,0,0,0,168,19,187
sp15,152,SIXTH,ECE,EleEng&Soc,0,0,0,0,0,0,0,0,0,0,0,0,1,0,1,0,0,0,1,0,1
sp15,152,SIXTH,ECE,Engin Phys,0,0,0,0,0,0,0,0,0,0,0,0,1,0,1,0,0,0,1,0,1
sp15,152,SIXTH,ECE,Pr-EngPhys,0,0,0,0,0,0,3,1,4,0,0,0,0,0,0,0,0,0,3,1,4
sp15,152,SIXTH,ECON,Ec-Mth&Ecn,0,0,0,4,6,10,4,2,6,8,7,15,8,3,11,0,0,0,24,18,42
sp15,152,SIXTH,ECON,Econ-MgtSc,0,0,0,4,0,4,17,5,22,40,17,57,36,20,56,0,0,0,97,42,139
sp15,152,SIXTH,ECON,Economics,0,0,0,7,4,11,26,13,39,46,22,68,44,34,78,0,0,0,123,73,196
sp15,152,SIXTH,ESYS,EnvSys(EB),0,0,0,0,0,0,0,2,2,1,0,1,1,7,8,0,0,0,2,9,11
sp15,152,SIXTH,ESYS,EnvSys(EC),0,0,0,0,0,0,1,1,2,0,0,0,1,0,1,0,0,0,2,1,3
sp15,152,SIXTH,ESYS,EnvSys(EP),0,0,0,0,0,0,2,1,3,1,0,1,0,3,3,0,0,0,3,4,7
sp15,152,SIXTH,ESYS,EnvSys(ES),0,0,0,0,0,0,2,1,3,1,2,3,2,5,7,0,0,0,5,8,13
sp15,152,SIXTH,ETHN,Ethnic St,0,0,0,0,0,0,0,0,0,0,0,0,2,1,3,0,0,0,2,1,3
sp15,152,SIXTH,FPMU,Public Hlt,0,0,0,0,0,0,2,14,16,5,13,18,4,19,23,0,0,0,11,46,57
sp15,152,SIXTH,GLBH,Global Hlt,0,0,0,0,1,1,0,1,1,0,1,1,0,0,0,0,0,0,0,3,3
sp15,152,SIXTH,HDP,Human Dev,0,0,0,0,0,0,0,2,2,2,8,10,4,18,22,0,0,0,6,28,34
sp15,152,SIXTH,HDP,Pr-HumnDev,0,0,0,0,1,1,0,5,5,1,2,3,0,1,1,0,0,0,1,9,10
sp15,152,SIXTH,HIST,History,0,0,0,1,0,1,1,1,2,1,1,2,5,3,8,0,0,0,8,5,13
sp15,152,SIXTH,INTL,IntSt-Anth,0,0,0,0,0,0,0,0,0,0,1,1,0,1,1,0,0,0,0,2,2
sp15,152,SIXTH,INTL,IntSt-Econ,0,0,0,1,0,1,1,7,8,6,1,7,3,9,12,0,0,0,11,17,28
sp15,152,SIXTH,INTL,IntSt-Hist,0,0,0,0,0,0,0,0,0,0,0,0,1,1,2,0,0,0,1,1,2
sp15,152,SIXTH,INTL,IntSt-Ling,0,0,0,0,1,1,0,0,0,0,0,0,0,1,1,0,0,0,0,2,2
sp15,152,SIXTH,INTL,IntSt-Lit,0,0,0,0,0,0,0,1,1,0,0,0,0,1,1,0,0,0,0,2,2
sp15,152,SIXTH,INTL,IntSt-PolS,0,0,0,0,0,0,2,1,3,0,3,3,2,5,7,0,0,0,4,9,13
sp15,152,SIXTH,INTL,IntSt-Soc,0,0,0,0,0,0,0,0,0,1,3,4,0,0,0,0,0,0,1,3,4
sp15,152,SIXTH,JUDA,Judaic Stu,0,0,0,0,0,0,0,0,0,0,0,0,0,1,1,0,0,0,0,1,1
sp15,152,SIXTH,LING,Lang Stu,0,0,0,0,0,0,0,0,0,1,0,1,0,2,2,0,0,0,1,2,3
sp15,152,SIXTH,LING,Ling-CogLn,0,0,0,0,0,0,0,0,0,0,1,1,1,1,2,0,0,0,1,2,3
sp15,152,SIXTH,LING,Ling-LSoc,0,0,0,0,0,0,0,0,0,0,1,1,1,2,3,0,0,0,1,3,4
sp15,152,SIXTH,LING,Linguistcs,0,0,0,0,0,0,0,0,0,1,3,4,1,3,4,0,0,0,2,6,8
sp15,152,SIXTH,LING,Ital Lit,0,0,0,0,0,0,0,0,0,0,0,0,0,1,1,0,0,0,0,1,1
sp15,152,SIXTH,LING,Lit/CultSt,0,0,0,0,0,0,0,0,0,0,0,0,0,1,1,0,0,0,0,1,1
sp15,152,SIXTH,LING,Lit/Engl,0,0,0,0,0,0,0,1,1,0,0,0,1,5,6,0,0,0,1,6,7
sp15,152,SIXTH,LING,Lit/Writng,0,0,0,0,2,2,0,3,3,3,5,8,3,5,8,0,0,0,6,15,21
sp15,152,SIXTH,MAE,Aerosp Eng,0,0,0,0,0,0,3,2,5,5,2,7,18,4,22,0,0,0,26,8,34
sp15,152,SIXTH,MAE,Engin Sci,0,0,0,0,0,0,0,0,0,0,0,0,3,0,3,0,0,0,3,0,3
sp15,152,SIXTH,MAE,Envir Eng,0,0,0,1,0,1,6,1,7,9,4,13,11,10,21,0,0,0,27,15,42
sp15,152,SIXTH,MAE,Mech Engin,0,0,0,0,1,1,7,0,7,10,2,12,29,9,38,0,0,0,46,12,58
sp15,152,SIXTH,MATH,Appld Math,0,0,0,4,2,6,4,10,14,6,9,15,9,7,16,0,0,0,23,28,51
sp15,152,SIXTH,MATH,Math/SecEd,0,0,0,0,0,0,0,0,0,1,1,2,0,1,1,0,0,0,1,2,3
sp15,152,SIXTH,MATH,Mathematcs,0,0,0,2,2,4,2,3,5,3,0,3,9,2,11,0,0,0,16,7,23
sp15,152,SIXTH,MATH,Mth-CompSc,0,0,0,8,2,10,35,15,50,14,1,15,4,4,8,0,0,0,61,22,83
sp15,152,SIXTH,MATH,Mth-Mth&Ec,0,0,0,0,0,0,5,1,6,3,3,6,4,5,9,0,0,0,12,9,21
sp15,152,SIXTH,MATH,Mth/ApldSc,0,0,0,0,0,0,1,0,1,0,0,0,1,0,1,0,0,0,2,0,2
sp15,152,SIXTH,MATH,Prob&Stats,0,0,0,2,1,3,6,3,9,3,2,5,2,2,4,0,0,0,13,8,21
sp15,152,SIXTH,MUS,Mu-CompArt,0,0,0,0,0,0,3,1,4,1,3,4,17,1,18,0,0,0,21,5,26
sp15,152,SIXTH,MUS,Music,0,0,0,0,0,0,2,0,2,1,0,1,2,2,4,0,0,0,5,2,7
sp15,152,SIXTH,MUS,Music Hum,0,0,0,0,0,0,0,0,0,1,0,1,0,0,0,0,0,0,1,0,1
sp15,152,SIXTH,NENG,NanoEng,0,0,0,2,0,2,10,0,10,11,3,14,27,5,32,0,0,0,50,8,58
sp15,152,SIXTH,PHIL,Philosophy,0,0,0,1,0,1,2,0,2,1,2,3,2,0,2,0,0,0,6,2,8
sp15,152,SIXTH,PHYS,Biophysics,0,0,0,0,1,1,1,0,1,2,1,3,0,0,0,0,0,0,3,2,5
sp15,152,SIXTH,PHYS,Gen Physcs,0,0,0,1,0,1,0,0,0,1,0,1,0,0,0,0,0,0,2,0,2
sp15,152,SIXTH,PHYS,Phys/Astro,0,0,0,0,1,1,0,0,0,2,1,3,3,2,5,0,0,0,5,4,9
sp15,152,SIXTH,PHYS,Phys/Comp,0,0,0,0,0,0,1,0,1,1,0,1,2,0,2,0,0,0,4,0,4
sp15,152,SIXTH,PHYS,Phys/Mtrls,0,0,0,1,1,2,1,1,2,1,0,1,1,0,1,0,0,0,4,2,6
sp15,152,SIXTH,PHYS,Physics,0,0,0,3,1,4,10,1,11,10,0,10,5,1,6,0,0,0,28,3,31
sp15,152,SIXTH,POLI,Polit Sci,0,0,0,1,1,2,4,3,7,5,8,13,8,6,14,0,0,0,18,18,36
sp15,152,SIXTH,POLI,PolSc-Amer,0,0,0,0,0,0,0,2,2,1,1,2,1,0,1,0,0,0,2,3,5
sp15,152,SIXTH,POLI,PolSc-Comp,0,0,0,0,0,0,0,0,0,0,0,0,0,1,1,0,0,0,0,1,1
sp15,152,SIXTH,POLI,PolSc-Intl,0,0,0,0,0,0,1,0,1,2,3,5,4,7,11,0,0,0,7,10,17
sp15,152,SIXTH,POLI,PolSc-PLaw,0,0,0,0,0,0,0,3,3,1,4,5,3,5,8,0,0,0,4,12,16
sp15,152,SIXTH,POLI,PolSc-PPol,0,0,0,0,0,0,0,1,1,2,0,2,1,1,2,0,0,0,3,2,5
sp15,152,SIXTH,POLI,PolSc-Thry,0,0,0,0,0,0,0,0,0,0,1,1,1,0,1,0,0,0,1,1,2
sp15,152,SIXTH,PSYC,Psychology,0,0,0,1,4,5,1,19,20,12,33,45,26,73,99,0,0,0,40,129,169
sp15,152,SIXTH,RELI,Relig/Stu,0,0,0,0,0,0,0,0,0,0,0,0,2,0,2,0,0,0,2,0,2
sp15,152,SIXTH,SE,Engin Sci,0,0,0,0,0,0,1,0,1,0,0,0,0,0,0,0,0,0,1,0,1
sp15,152,SIXTH,SE,Struct Eng,0,0,0,2,0,2,14,5,19,33,12,45,51,17,68,0,0,0,100,34,134
sp15,152,SIXTH,SIO,Earth Sci,0,0,0,0,0,0,0,1,1,0,1,1,1,1,2,0,0,0,1,3,4
sp15,152,SIXTH,SIO,Marine Bio,0,0,0,0,0,0,4,7,11,0,5,5,3,7,10,0,0,0,7,19,26
sp15,152,SIXTH,SOC,SocCulCom,0,0,0,0,0,0,0,0,0,1,3,4,0,1,1,0,0,0,1,4,5
sp15,152,SIXTH,SOC,SocEconSoc,0,0,0,0,0,0,0,0,0,2,0,2,1,0,1,0,0,0,3,0,3
sp15,152,SIXTH,SOC,SocIntlStu,0,0,0,0,0,0,0,0,0,0,0,0,0,2,2,0,0,0,0,2,2
sp15,152,SIXTH,SOC,Sociology,0,0,0,0,1,1,3,1,4,1,6,7,2,8,10,0,0,0,6,16,22
sp15,152,SIXTH,SOC,SocLawSoc,0,0,0,0,0,0,1,0,1,0,0,0,1,4,5,0,0,0,2,4,6
sp15,152,SIXTH,SOC,SocSciMed,0,0,0,0,0,0,0,0,0,0,0,0,0,1,1,0,0,0,0,1,1
sp15,152,SIXTH,SOC,SocSolneq,0,0,0,0,0,0,0,0,0,0,0,0,0,3,3,0,0,0,0,3,3
sp15,152,SIXTH,SOC,Dance,0,0,0,0,0,0,0,0,0,0,0,0,0,2,2,0,0,0,0,2,2
sp15,152,SIXTH,SOC,Theatre,0,0,0,1,2,3,0,3,3,0,4,4,9,8,17,0,0,0,10,17,27
sp15,152,SIXTH,UNAF,UndecHumAr,0,0,0,0,1,1,2,2,4,0,0,0,0,0,0,0,0,0,2,3,5
sp15,152,SIXTH,UNAF,Undeclared,0,0,0,29,10,39,53,20,73,4,0,4,0,0,0,0,0,0,86,30,116
sp15,152,SIXTH,UNAF,UndecPhysS,0,0,0,0,3,3,3,2,5,1,0,1,0,0,0,0,0,0,4,5,9
sp15,152,SIXTH,UNAF,UndecSocSc,0,0,0,1,0,1,2,2,4,0,0,0,0,0,0,0,0,0,3,2,5
sp15,152,SIXTH,USP,Urb Stu&Pl,0,0,0,0,0,0,0,3,3,2,3,5,7,13,20,0,0,0,9,19,28
sp15,152,SIXTH,VIS,Art Hst/Cr,0,0,0,0,0,0,0,2,2,0,3,3,0,4,4,0,0,0,0,9,9
sp15,152,SIXTH,VIS,Media,0,0,0,5,3,8,7,6,13,18,14,32,12,19,31,0,0,0,42,42,84
sp15,152,SIXTH,VIS,Studio VA,0,0,0,0,0,0,1,4,5,2,3,5,2,15,17,0,0,0,5,22,27
sp15,152,SIXTH,VIS,VA-CompArt,0,0,0,2,2,4,6,7,13,4,12,16,6,8,14,0,0,0,18,29,47
sp15,152,WARREN,ANTH,Anth-Arch,0,0,0,0,0,0,0,0,0,0,2,2,1,1,2,0,0,0,1,3,4
sp15,152,WARREN,ANTH,Anth-Biol,0,0,0,0,0,0,0,0,0,1,0,1,0,2,2,0,0,0,1,2,3
sp15,152,WARREN,ANTH,Anth-Soci,0,0,0,0,0,0,0,0,0,1,1,2,0,2,2,0,0,0,1,3,4
sp15,152,WARREN,BENG,Bioen:Binf,0,0,0,0,0,0,5,1,6,5,8,13,8,10,18,0,0,0,18,19,37
sp15,152,WARREN,BENG,BioengBioS,0,0,0,0,0,0,3,1,4,4,1,5,1,0,1,0,0,0,8,2,10
sp15,152,WARREN,BENG,BioengBiot,0,0,0,0,0,0,9,5,14,7,9,16,28,26,54,0,0,0,44,40,84
sp15,152,WARREN,BENG,Bioengin,0,0,0,0,0,0,7,2,9,8,5,13,24,17,41,0,0,0,39,24,63
sp15,152,WARREN,BIOL,Bioc/CellB,0,0,0,1,7,8,15,18,33,19,24,43,40,46,86,0,0,0,75,95,170
sp15,152,WARREN,BIOL,BiolBioinf,0,0,0,0,0,0,0,1,1,2,0,2,0,1,1,0,0,0,2,2,4
sp15,152,WARREN,BIOL,Ec/Beh/Evo,0,0,0,0,0,0,0,0,0,1,2,3,4,8,12,0,0,0,5,10,15
sp15,152,WARREN,BIOL,Genl Biol,0,0,0,1,2,3,3,5,8,5,14,19,29,48,77,0,0,0,38,69,107
sp15,152,WARREN,BIOL,Human Bio,0,0,0,2,8,10,9,13,22,22,35,57,43,52,95,0,0,0,76,108,184
sp15,152,WARREN,BIOL,Microbiol,0,0,0,0,1,1,4,0,4,1,3,4,3,6,9,0,0,0,8,10,18
sp15,152,WARREN,BIOL,Molec Biol,0,0,0,0,0,0,3,1,4,2,0,2,12,6,18,0,0,0,17,7,24
sp15,152,WARREN,BIOL,PhyslNeuro,0,0,0,0,3,3,6,8,14,10,16,26,32,17,49,0,0,0,48,44,92
sp15,152,WARREN,CENG,Chem Engin,0,0,0,0,0,0,9,7,16,33,12,45,73,41,114,0,0,0,115,60,175
sp15,152,WARREN,CGS,CritGendSt,0,0,0,0,0,0,0,0,0,0,0,0,1,0,1,0,0,0,1,0,1
sp15,152,WARREN,CHEM,Bioch/Chem,0,0,0,1,1,2,2,4,6,6,6,12,6,15,21,0,0,0,15,26,41
sp15,152,WARREN,CHEM,Bioinform,0,0,0,0,0,0,0,0,0,0,0,0,0,1,1,0,0,0,0,1,1
sp15,152,WARREN,CHEM,Chemistry,0,0,0,0,1,1,3,1,4,0,5,5,3,9,12,0,0,0,6,16,22
sp15,152,WARREN,CHEM,Envir Chem,0,0,0,0,0,0,0,0,0,1,0,1,2,1,3,0,0,0,3,1,4
sp15,152,WARREN,CHEM,Pharm Chem,0,0,0,0,0,0,1,5,6,1,4,5,8,18,26,0,0,0,10,27,37
sp15,152,WARREN,CHIN,Chinese St,0,0,0,0,0,0,0,0,0,0,1,1,0,2,2,0,0,0,0,3,3
sp15,152,WARREN,COGS,Cog Sci,0,0,0,0,0,0,1,2,3,2,2,4,4,8,12,0,0,0,7,12,19
sp15,152,WARREN,COGS,CogSc/ClAs,0,0,0,0,0,0,0,0,0,2,2,4,0,1,1,0,0,0,2,3,5
sp15,152,WARREN,COGS,CogSc/Comp,0,0,0,0,0,0,2,1,3,0,1,1,0,0,0,0,0,0,2,2,4
sp15,152,WARREN,COGS,CogSc/HCI,0,0,0,0,0,0,4,2,6,3,4,7,7,6,13,0,0,0,14,12,26
sp15,152,WARREN,COGS,CogSc/HCog,0,0,0,0,0,0,0,0,0,1,1,2,0,2,2,0,0,0,1,3,4
sp15,152,WARREN,COGS,CogSc/Neur,0,0,0,0,1,1,1,2,3,0,3,3,4,14,18,0,0,0,5,20,25
sp15,152,WARREN,COMM,Communic,0,0,0,0,4,4,2,11,13,6,12,18,15,29,44,0,0,0,23,56,79
sp15,152,WARREN,CSE,Comp Sci,0,0,0,4,2,6,57,13,70,121,23,144,235,49,284,0,0,0,417,87,504
sp15,152,WARREN,CSE,CompEngCSE,0,0,0,1,1,2,21,3,24,19,2,21,64,8,72,0,0,0,105,14,119
sp15,152,WARREN,CSE,CompScBinf,0,0,0,1,0,1,1,1,2,4,2,6,5,3,8,0,0,0,11,6,17
sp15,152,WARREN,ECE,CompEngECE,0,0,0,0,0,0,26,1,27,25,6,31,23,0,23,0,0,0,74,7,81
sp15,152,WARREN,ECE,Electr Eng,0,0,0,6,0,6,27,7,34,56,16,72,122,18,140,0,0,0,211,41,252
sp15,152,WARREN,ECE,Engin Phys,0,0,0,0,0,0,0,0,0,1,0,1,1,0,1,0,0,0,2,0,2
sp15,152,WARREN,ECE,Pr-EngPhys,0,0,0,0,0,0,3,0,3,0,0,0,1,0,1,0,0,0,4,0,4
sp15,152,WARREN,ECON,Ec-Mth&Ecn,0,0,0,0,0,0,5,4,9,9,3,12,7,0,7,0,0,0,21,7,28
sp15,152,WARREN,ECON,Econ-MgtSc,0,0,0,2,1,3,8,3,11,23,15,38,46,27,73,0,0,0,79,46,125
sp15,152,WARREN,ECON,Economics,0,0,0,3,3,6,11,4,15,49,21,70,70,45,115,0,0,0,133,73,206
sp15,152,WARREN,ESYS,EnvSys(EB),0,0,0,0,0,0,0,0,0,0,0,0,1,4,5,0,0,0,1,4,5
sp15,152,WARREN,ESYS,EnvSys(ES),0,0,0,0,0,0,0,0,0,0,1,1,0,1,1,0,0,0,0,2,2
sp15,152,WARREN,ESYS,Ethnic St,0,0,0,0,1,1,0,0,0,0,0,0,1,3,4,0,0,0,1,4,5
sp15,152,WARREN,FPMU,Public Hlt,0,0,0,0,1,1,2,2,4,2,5,7,2,11,13,0,0,0,6,19,25
sp15,152,WARREN,GLBH,Global Hlt,0,0,0,0,0,0,0,0,0,0,0,0,0,4,4,0,0,0,0,4,4
sp15,152,WARREN,HDP,Human Dev,0,0,0,0,0,0,0,0,0,0,3,3,1,16,17,0,0,0,1,19,20
sp15,152,WARREN,HDP,Pr-HumnDev,0,0,0,0,2,2,0,0,0,0,4,4,1,0,1,0,0,0,1,6,7
sp15,152,WARREN,HIST,History,0,0,0,0,1,1,0,0,0,2,0,2,7,3,10,0,0,0,9,4,13
sp15,152,WARREN,INTL,IntSt-Anth,0,0,0,0,0,0,0,0,0,1,0,1,0,0,0,0,0,0,1,0,1
sp15,152,WARREN,INTL,IntSt-Econ,0,0,0,0,1,1,0,1,1,3,2,5,0,3,3,0,0,0,3,7,10
sp15,152,WARREN,INTL,IntSt-Hist,0,0,0,0,0,0,0,0,0,0,0,0,1,0,1,0,0,0,1,0,1
sp15,152,WARREN,INTL,IntSt-Ling,0,0,0,0,0,0,0,1,1,0,0,0,0,1,1,0,0,0,0,2,2
sp15,152,WARREN,INTL,IntSt-PolS,0,0,0,0,0,0,0,1,1,0,3,3,3,2,5,0,0,0,3,6,9
sp15,152,WARREN,INTL,IntSt-Soc,0,0,0,0,0,0,0,0,0,0,2,2,0,1,1,0,0,0,0,3,3
sp15,152,WARREN,JAPN,JapaneseSt,0,0,0,0,0,0,0,0,0,0,0,0,1,0,1,0,0,0,1,0,1
sp15,152,WARREN,JUDA,Judaic Stu,0,0,0,0,0,0,0,0,0,0,0,0,1,0,1,0,0,0,1,0,1
sp15,152,WARREN,LATI,LatinAm St,0,0,0,0,0,0,0,0,0,1,0,1,0,0,0,0,0,0,1,0,1
sp15,152,WARREN,LING,Lang Stu,0,0,0,0,0,0,0,1,1,0,1,1,0,0,0,0,0,0,0,2,2
sp15,152,WARREN,LING,Ling-CogLn,0,0,0,0,0,0,1,1,2,0,0,0,0,1,1,0,0,0,1,2,3
sp15,152,WARREN,LING,Ling-LSoc,0,0,0,0,0,0,0,0,0,0,0,0,0,1,1,0,0,0,0,1,1
sp15,152,WARREN,LING,Linguistcs,0,0,0,0,0,0,1,1,2,0,1,1,3,2,5,0,0,0,4,4,8
sp15,152,WARREN,LING,Lit/Engl,0,0,0,0,0,0,1,0,1,0,0,0,0,3,3,0,0,0,1,3,4
sp15,152,WARREN,LING,Lit/World,0,0,0,0,0,0,0,0,0,0,0,0,0,1,1,0,0,0,0,1,1
sp15,152,WARREN,LING,Lit/Writng,0,0,0,0,1,1,1,1,2,0,2,2,5,9,14,0,0,0,6,13,19
sp15,152,WARREN,LING,Spanish Lt,0,0,0,0,0,0,0,0,0,0,1,1,1,1,2,0,0,0,1,2,3
sp15,152,WARREN,MAE,Aerosp Eng,0,0,0,1,0,1,13,4,17,18,3,21,35,9,44,0,0,0,67,16,83
sp15,152,WARREN,MAE,Engin Sci,0,0,0,0,0,0,0,0,0,0,0,0,4,0,4,0,0,0,4,0,4
sp15,152,WARREN,MAE,Envir Eng,0,0,0,1,1,2,5,9,14,10,5,15,17,10,27,0,0,0,33,25,58
sp15,152,WARREN,MAE,Mech Engin,0,0,0,2,1,3,18,4,22,33,9,42,70,17,87,0,0,0,123,31,154
sp15,152,WARREN,MATH,Appld Math,0,0,0,5,1,6,5,3,8,7,2,9,9,14,23,0,0,0,26,20,46
sp15,152,WARREN,MATH,Math/SecEd,0,0,0,0,0,0,0,0,0,1,2,3,0,3,3,0,0,0,1,5,6
sp15,152,WARREN,MATH,Mathematcs,0,0,0,0,3,3,1,1,2,6,2,8,7,7,14,0,0,0,14,13,27
sp15,152,WARREN,MATH,Mth-CompSc,0,0,0,5,4,9,16,6,22,10,1,11,4,1,5,0,0,0,35,12,47
sp15,152,WARREN,MATH,Mth-Mth&Ec,0,0,0,1,1,2,1,8,9,7,7,14,7,10,17,0,0,0,16,26,42
sp15,152,WARREN,MATH,Mth-SciCom,0,0,0,1,0,1,0,0,0,0,0,0,0,0,0,0,0,0,1,0,1
sp15,152,WARREN,MATH,Mth/ApldSc,0,0,0,0,1,1,1,0,1,1,1,2,1,3,4,0,0,0,3,5,8
sp15,152,WARREN,MATH,Prob&Stats,0,0,0,1,1,2,3,2,5,3,4,7,2,3,5,0,0,0,9,10,19
sp15,152,WARREN,MUS,Mu-CompArt,0,0,0,1,0,1,0,0,0,0,0,0,7,0,7,0,0,0,8,0,8
sp15,152,WARREN,MUS,Music,0,0,0,0,0,0,1,0,1,0,0,0,2,1,3,0,0,0,3,1,4
sp15,152,WARREN,NENG,NanoEng,0,0,0,0,0,0,3,0,3,19,6,25,37,7,44,0,0,0,59,13,72
sp15,152,WARREN,PHIL,Philosophy,0,0,0,0,0,0,0,1,1,1,2,3,5,2,7,0,0,0,6,5,11
sp15,152,WARREN,PHYS,Biophysics,0,0,0,0,1,1,2,0,2,1,1,2,2,2,4,0,0,0,5,4,9
sp15,152,WARREN,PHYS,Gen Physcs,0,0,0,0,0,0,0,0,0,0,0,0,1,0,1,0,0,0,1,0,1
sp15,152,WARREN,PHYS,Phys/Astro,0,0,0,0,1,1,2,2,4,0,1,1,2,2,4,0,0,0,4,6,10
sp15,152,WARREN,PHYS,Phys/Comp,0,0,0,1,0,1,1,0,1,0,0,0,1,0,1,0,0,0,3,0,3
sp15,152,WARREN,PHYS,Phys/Mtrls,0,0,0,0,0,0,2,0,2,1,0,1,0,0,0,0,0,0,3,0,3
sp15,152,WARREN,PHYS,Physics,0,0,0,2,0,2,5,2,7,3,0,3,8,1,9,0,0,0,18,3,21
sp15,152,WARREN,POLI,Polit Sci,0,0,0,1,0,1,5,3,8,8,10,18,28,16,44,0,0,0,42,29,71
sp15,152,WARREN,POLI,PolSc-Amer,0,0,0,0,0,0,1,0,1,1,1,2,4,2,6,0,0,0,6,3,9
sp15,152,WARREN,POLI,PolSc-Comp,0,0,0,0,0,0,2,0,2,0,0,0,0,1,1,0,0,0,2,1,3
sp15,152,WARREN,POLI,PolSc-Intl,0,0,0,0,1,1,3,1,4,4,3,7,9,4,13,0,0,0,16,9,25
sp15,152,WARREN,POLI,PolSc-PLaw,0,0,0,1,3,4,0,3,3,4,3,7,3,5,8,0,0,0,8,14,22
sp15,152,WARREN,POLI,PolSc-PPol,0,0,0,0,0,0,1,0,1,1,1,2,4,0,4,0,0,0,6,1,7
sp15,152,WARREN,POLI,PolSc-Thry,0,0,0,0,0,0,0,0,0,0,0,0,1,1,2,0,0,0,1,1,2
sp15,152,WARREN,PSYC,Psychology,0,0,0,1,3,4,4,8,12,8,22,30,28,57,85,0,0,0,41,90,131
sp15,152,WARREN,RELI,Relig/Stu,0,0,0,0,0,0,0,0,0,0,0,0,2,0,2,0,0,0,2,0,2
sp15,152,WARREN,RUSS,RusEE&EStd,0,0,0,0,0,0,0,0,0,0,0,0,0,1,1,0,0,0,0,1,1
sp15,152,WARREN,SE,Engin Sci,0,0,0,0,0,0,1,0,1,2,0,2,0,0,0,0,0,0,3,0,3
sp15,152,WARREN,SE,Struct Eng,0,0,0,1,2,3,13,5,18,38,15,53,80,26,106,0,0,0,132,48,180
sp15,152,WARREN,SIO,Earth Sci,0,0,0,0,0,0,0,2,2,0,1,1,1,1,2,0,0,0,1,4,5
sp15,152,WARREN,SIO,Marine Bio,0,0,0,0,1,1,0,2,2,0,1,1,2,4,6,0,0,0,2,8,10
sp15,152,WARREN,SOC,SocAmSt,0,0,0,0,0,0,0,0,0,0,0,0,0,1,1,0,0,0,0,1,1
sp15,152,WARREN,SOC,SocEconSoc,0,0,0,0,0,0,0,0,0,1,0,1,1,1,2,0,0,0,2,1,3
sp15,152,WARREN,SOC,SocIntlStu,0,0,0,0,0,0,0,0,0,0,0,0,1,0,1,0,0,0,1,0,1
sp15,152,WARREN,SOC,Sociology,0,0,0,1,0,1,0,0,0,1,5,6,2,4,6,0,0,0,4,9,13
sp15,152,WARREN,SOC,SocLawSoc,0,0,0,0,1,1,0,0,0,2,0,2,3,4,7,0,0,0,5,5,10
sp15,152,WARREN,SOC,SocSolneq,0,0,0,0,0,0,0,0,0,0,1,1,0,2,2,0,0,0,0,3,3
sp15,152,WARREN,SOC,Dance,0,0,0,0,1,1,0,0,0,0,0,0,0,1,1,0,0,0,0,2,2
sp15,152,WARREN,SOC,Theatre,0,0,0,1,0,1,0,0,0,1,1,2,1,1,2,0,0,0,3,2,5
sp15,152,WARREN,UNAF,IntcampVis,0,0,0,0,0,0,2,2,4,0,1,1,1,1,2,0,0,0,3,4,7
sp15,152,WARREN,UNAF,Undeclared,0,0,0,18,5,23,37,12,49,3,0,3,0,0,0,0,0,0,58,17,75
sp15,152,WARREN,UNAF,UndecPhysS,0,0,0,2,1,3,2,0,2,1,0,1,0,0,0,0,0,0,5,1,6
sp15,152,WARREN,UNAF,UndecSocSc,0,0,0,0,1,1,0,0,0,0,0,0,0,0,0,0,0,0,0,1,1
sp15,152,WARREN,USP,Urb Stu&Pl,0,0,0,0,0,0,1,0,1,2,2,4,2,1,3,0,0,0,5,3,8
sp15,152,WARREN,VIS,Media,0,0,0,1,0,1,0,0,0,2,2,4,6,4,10,0,0,0,9,6,15
sp15,152,WARREN,VIS,Studio VA,0,0,0,0,0,0,0,2,2,0,3,3,0,0,0,0,0,0,0,5,5
sp15,152,WARREN,VIS,VA-CompArt,0,0,0,0,0,0,0,0,0,0,2,2,1,1,2,0,0,0,1,3,4
sp16,162,MARSHALL,ANTH,Anth-Arch,0,0,0,0,0,0,0,0,0,0,0,0,1,0,1,0,0,0,1,0,1
sp16,162,MARSHALL,ANTH,Anth-Biol,0,0,0,0,0,0,1,0,1,0,1,1,0,0,0,0,0,0,1,1,2
sp16,162,MARSHALL,ANTH,Anth-Soci,0,0,0,0,0,0,0,1,1,1,3,4,2,3,5,0,0,0,3,7,10
sp16,162,MARSHALL,BENG,Bioen:Binf,0,0,0,0,0,0,1,2,3,0,1,1,5,6,11,0,0,0,6,9,15
sp16,162,MARSHALL,BENG,BioengBioS,0,0,0,0,0,0,2,1,3,2,1,3,6,0,6,0,0,0,10,2,12
sp16,162,MARSHALL,BENG,BioengBiot,0,0,0,0,0,0,1,2,3,0,3,3,6,7,13,0,0,0,7,12,19
sp16,162,MARSHALL,BENG,Bioengin,0,0,0,0,0,0,2,1,3,0,1,1,6,4,10,0,0,0,8,6,14
sp16,162,MARSHALL,BIOL,Bioc/CellB,0,0,0,5,5,10,14,18,32,23,24,47,48,66,114,0,0,0,90,113,203
sp16,162,MARSHALL,BIOL,BiolBioinf,0,0,0,0,1,1,1,2,3,3,2,5,2,2,4,0,0,0,6,7,13
sp16,162,MARSHALL,BIOL,Ec/Beh/Evo,0,0,0,0,0,0,0,4,4,0,1,1,2,3,5,0,0,0,2,8,10
sp16,162,MARSHALL,BIOL,Genl Biol,0,0,0,3,2,5,10,25,35,16,18,34,27,65,92,0,0,0,56,110,166
sp16,162,MARSHALL,BIOL,Human Bio,0,0,0,1,8,9,19,59,78,30,43,73,43,85,128,0,0,0,93,195,288
sp16,162,MARSHALL,BIOL,Microbiol,0,0,0,0,0,0,1,4,5,3,8,11,9,12,21,0,0,0,13,24,37
sp16,162,MARSHALL,BIOL,Molec Biol,0,0,0,0,0,0,3,5,8,3,3,6,9,6,15,0,0,0,15,14,29
sp16,162,MARSHALL,BIOL,PhyslNeuro,0,0,0,3,2,5,16,21,37,17,25,42,23,43,66,0,0,0,59,91,150
sp16,162,MARSHALL,CENG,Chem Engin,0,0,0,0,0,0,1,3,4,4,3,7,39,22,61,0,0,0,44,28,72
sp16,162,MARSHALL,CGS,CritGendSt,0,0,0,0,0,0,0,1,1,0,0,0,0,0,0,0,0,0,0,1,1
sp16,162,MARSHALL,CHEM,Bioch/Chem,0,0,0,0,1,1,7,11,18,7,2,9,3,14,17,0,0,0,17,28,45
sp16,162,MARSHALL,CHEM,Bioinform,0,0,0,0,0,0,1,0,1,1,0,1,1,0,1,0,0,0,3,0,3
sp16,162,MARSHALL,CHEM,Chem Educ,0,0,0,0,0,0,0,0,0,0,0,0,1,0,1,0,0,0,1,0,1
sp16,162,MARSHALL,CHEM,Chem Phys,0,0,0,0,0,0,0,0,0,0,0,0,0,1,1,0,0,0,0,1,1
sp16,162,MARSHALL,CHEM,Chemistry,0,0,0,3,3,6,5,1,6,4,5,9,3,7,10,0,0,0,15,16,31
sp16,162,MARSHALL,CHEM,Envir Chem,0,0,0,0,0,0,0,0,0,3,1,4,0,2,2,0,0,0,3,3,6
sp16,162,MARSHALL,CHEM,MolecSynth,0,0,0,0,0,0,0,0,0,1,0,1,1,3,4,0,0,0,2,3,5
sp16,162,MARSHALL,CHEM,Pharm Chem,0,0,0,2,1,3,4,7,11,3,2,5,10,9,19,0,0,0,19,19,38
sp16,162,MARSHALL,CLAS,Classic St,0,0,0,0,0,0,0,0,0,0,0,0,0,1,1,0,0,0,0,1,1
sp16,162,MARSHALL,COGS,Cog Sci,0,0,0,0,0,0,3,5,8,3,5,8,2,10,12,0,0,0,8,20,28
sp16,162,MARSHALL,COGS,CogBehNeur,0,0,0,0,0,0,0,2,2,1,1,2,0,2,2,0,0,0,1,5,6
sp16,162,MARSHALL,COGS,CogSc/ClAs,0,0,0,0,0,0,0,1,1,0,1,1,0,4,4,0,0,0,0,6,6
sp16,162,MARSHALL,COGS,CogSc/Comp,0,0,0,0,1,1,3,1,4,2,1,3,0,0,0,0,0,0,5,3,8
sp16,162,MARSHALL,COGS,CogSc/HCI,0,0,0,0,0,0,2,2,4,3,7,10,7,10,17,0,0,0,12,19,31
sp16,162,MARSHALL,COGS,CogSc/HCog,0,0,0,0,0,0,0,2,2,1,2,3,2,4,6,0,0,0,3,8,11
sp16,162,MARSHALL,COGS,CogSc/Neur,0,0,0,0,0,0,2,1,3,0,2,2,3,4,7,0,0,0,5,7,12
sp16,162,MARSHALL,COMM,Communic,0,0,0,1,6,7,3,7,10,21,35,56,22,66,88,0,0,0,47,114,161
sp16,162,MARSHALL,CSE,Comp Sci,0,0,0,1,0,1,14,1,15,23,8,31,135,29,164,0,0,0,173,38,211
sp16,162,MARSHALL,CSE,CompEngCSE,0,0,0,0,0,0,0,0,0,6,1,7,17,2,19,0,0,0,23,3,26
sp16,162,MARSHALL,CSE,CompScBinf,0,0,0,0,0,0,0,0,0,1,1,2,5,3,8,0,0,0,6,4,10
sp16,162,MARSHALL,ECE,CompEngECE,0,0,0,0,0,0,3,1,4,8,1,9,22,3,25,0,0,0,33,5,38
sp16,162,MARSHALL,ECE,Electr Eng,0,0,0,2,0,2,4,0,4,12,4,16,74,13,87,0,0,0,92,17,109
sp16,162,MARSHALL,ECE,Engin Phys,0,0,0,0,0,0,0,0,0,0,0,0,1,0,1,0,0,0,1,0,1
sp16,162,MARSHALL,ECON,Ec-Mth&Ecn,0,0,0,1,4,5,11,7,18,16,6,22,15,7,22,0,0,0,43,24,67
sp16,162,MARSHALL,ECON,Econ-MgtSc,0,0,0,0,2,2,9,10,19,24,25,49,40,48,88,0,0,0,73,85,158
sp16,162,MARSHALL,ECON,Economics,0,0,0,3,1,4,6,7,13,62,54,116,91,76,167,0,0,0,162,138,300
sp16,162,MARSHALL,ECON,EnvSys(EB),0,0,0,0,0,0,0,1,1,0,3,3,3,3,6,0,0,0,3,7,10
sp16,162,MARSHALL,ECON,EnvSys(EC),0,0,0,1,0,1,0,1,1,0,1,1,1,2,3,0,0,0,2,4,6
sp16,162,MARSHALL,ECON,EnvSys(EP),0,0,0,0,1,1,0,1,1,1,0,1,1,3,4,0,0,0,2,5,7
sp16,162,MARSHALL,ECON,EnvSys(ES),0,0,0,0,0,0,1,1,2,1,1,2,1,0,1,0,0,0,3,2,5
sp16,162,MARSHALL,ETHN,Ethnic St,0,0,0,0,3,3,0,2,2,1,2,3,0,4,4,0,0,0,1,11,12
sp16,162,MARSHALL,FPMU,Public Hlt,0,0,0,1,1,2,1,10,11,2,24,26,13,46,59,0,0,0,17,81,98
sp16,162,MARSHALL,GLBH,Global Hlt,0,0,0,0,0,0,0,1,1,5,4,9,2,4,6,0,0,0,7,9,16
sp16,162,MARSHALL,HDP,Human Dev,0,0,0,0,0,0,0,1,1,0,5,5,2,23,25,0,0,0,2,29,31
sp16,162,MARSHALL,HDP,Pr-HumnDev,0,0,0,0,1,1,0,3,3,0,2,2,1,4,5,0,0,0,1,10,11
sp16,162,MARSHALL,HIST,History,0,0,0,1,0,1,0,0,0,2,4,6,7,4,11,0,0,0,10,8,18
sp16,162,MARSHALL,INTD,Mar Ind St,0,0,0,0,0,0,0,0,0,0,0,0,1,0,1,0,0,0,1,0,1
sp16,162,MARSHALL,INTL,InSt-InBus,0,0,0,1,5,6,3,14,17,11,23,34,4,8,12,0,0,0,19,50,69
sp16,162,MARSHALL,INTL,Int-5yrEC,0,0,0,0,0,0,0,0,0,0,0,0,1,0,1,0,0,0,1,0,1
sp16,162,MARSHALL,INTL,Int-5yrPS,0,0,0,0,0,0,0,0,0,0,0,0,0,1,1,0,0,0,0,1,1
sp16,162,MARSHALL,INTL,IntSt-Anth,0,0,0,0,0,0,0,0,0,0,0,0,0,1,1,0,0,0,0,1,1
sp16,162,MARSHALL,INTL,IntSt-Econ,0,0,0,1,1,2,0,3,3,5,2,7,6,4,10,0,0,0,12,10,22
sp16,162,MARSHALL,INTL,IntSt-Hist,0,0,0,0,0,0,0,1,1,0,0,0,0,1,1,0,0,0,0,2,2
sp16,162,MARSHALL,INTL,IntSt-Lit,0,0,0,0,0,0,0,1,1,0,0,0,0,0,0,0,0,0,0,1,1
sp16,162,MARSHALL,INTL,IntSt-PolS,0,0,0,0,0,0,0,1,1,0,6,6,3,7,10,0,0,0,3,14,17
sp16,162,MARSHALL,INTL,IntSt-Soc,0,0,0,0,0,0,0,0,0,0,0,0,0,2,2,0,0,0,0,2,2
sp16,162,MARSHALL,JAPN,JapaneseSt,0,0,0,0,0,0,0,0,0,1,1,2,0,0,0,0,0,0,1,1,2
sp16,162,MARSHALL,JAPN,Lang Stu,0,0,0,0,0,0,1,0,1,0,0,0,1,0,1,0,0,0,2,0,2
sp16,162,MARSHALL,JAPN,Ling-CogLn,0,0,0,0,0,0,0,1,1,0,0,0,0,2,2,0,0,0,0,3,3
sp16,162,MARSHALL,JAPN,Ling-LSoc,0,0,0,0,0,0,0,0,0,0,1,1,1,1,2,0,0,0,1,2,3
sp16,162,MARSHALL,JAPN,Linguistcs,0,0,0,0,0,0,0,0,0,0,1,1,1,1,2,0,0,0,1,2,3
sp16,162,MARSHALL,LIT,Lit/CultSt,0,0,0,0,0,0,0,0,0,1,0,1,0,0,0,0,0,0,1,0,1
sp16,162,MARSHALL,LIT,Lit/Engl,0,0,0,0,0,0,0,4,4,0,5,5,2,1,3,0,0,0,2,10,12
sp16,162,MARSHALL,LIT,Lit/World,0,0,0,0,0,0,0,1,1,0,0,0,0,2,2,0,0,0,0,3,3
sp16,162,MARSHALL,LIT,Lit/Writng,0,0,0,0,0,0,1,1,2,0,4,4,5,6,11,0,0,0,6,11,17
sp16,162,MARSHALL,MAE,Aerosp Eng,0,0,0,0,0,0,5,0,5,1,2,3,11,0,11,0,0,0,17,2,19
sp16,162,MARSHALL,MAE,Envir Eng,0,0,0,0,0,0,0,1,1,5,2,7,12,5,17,0,0,0,17,8,25
sp16,162,MARSHALL,MAE,Mech Engin,0,0,0,1,0,1,5,0,5,8,1,9,11,2,13,0,0,0,25,3,28
sp16,162,MARSHALL,MATH,Appld Math,0,0,0,3,2,5,15,11,26,8,8,16,14,12,26,0,0,0,40,33,73
sp16,162,MARSHALL,MATH,Math/SecEd,0,0,0,1,0,1,0,0,0,0,1,1,0,2,2,0,0,0,1,3,4
sp16,162,MARSHALL,MATH,Mathematcs,0,0,0,3,0,3,2,6,8,7,2,9,5,4,9,0,0,0,17,12,29
sp16,162,MARSHALL,MATH,Mth-CompSc,0,0,0,9,2,11,30,9,39,29,7,36,13,9,22,0,0,0,81,27,108
sp16,162,MARSHALL,MATH,Mth-Mth&Ec,0,0,0,2,1,3,4,7,11,11,8,19,6,8,14,0,0,0,23,24,47
sp16,162,MARSHALL,MATH,Mth-SciCom,0,0,0,0,0,0,1,0,1,0,0,0,0,0,0,0,0,0,1,0,1
sp16,162,MARSHALL,MATH,Mth/ApldSc,0,0,0,0,0,0,1,0,1,3,1,4,3,1,4,0,0,0,7,2,9
sp16,162,MARSHALL,MATH,Prob&Stats,0,0,0,0,0,0,6,4,10,6,11,17,2,4,6,0,0,0,14,19,33
sp16,162,MARSHALL,MUS,Mu-CompArt,0,0,0,0,0,0,1,1,2,1,0,1,0,1,1,0,0,0,2,2,4
sp16,162,MARSHALL,MUS,Music,0,0,0,0,0,0,0,0,0,0,0,0,2,0,2,0,0,0,2,0,2
sp16,162,MARSHALL,MUS,Music Hum,0,0,0,0,0,0,0,0,0,0,0,0,0,1,1,0,0,0,0,1,1
sp16,162,MARSHALL,NENG,NanoEng,0,0,0,0,0,0,3,0,3,5,3,8,22,6,28,0,0,0,30,9,39
sp16,162,MARSHALL,NENG,Philosophy,0,0,0,0,0,0,0,0,0,0,0,0,2,1,3,0,0,0,2,1,3
sp16,162,MARSHALL,PHYS,Biophysics,0,0,0,0,0,0,1,0,1,1,0,1,2,0,2,0,0,0,4,0,4
sp16,162,MARSHALL,PHYS,Gen Physcs,0,0,0,1,0,1,0,0,0,0,0,0,0,0,0,0,0,0,1,0,1
sp16,162,MARSHALL,PHYS,Phy/ErthSc,0,0,0,0,0,0,0,0,0,0,2,2,0,0,0,0,0,0,0,2,2
sp16,162,MARSHALL,PHYS,Phys/Astro,0,0,0,1,0,1,2,0,2,3,2,5,1,0,1,0,0,0,7,2,9
sp16,162,MARSHALL,PHYS,Phys/Comp,0,0,0,0,0,0,0,0,0,1,0,1,0,1,1,0,0,0,1,1,2
sp16,162,MARSHALL,PHYS,Phys/Mtrls,0,0,0,0,1,1,0,0,0,0,1,1,0,0,0,0,0,0,0,2,2
sp16,162,MARSHALL,PHYS,Physics,0,0,0,2,0,2,9,1,10,7,1,8,7,0,7,0,0,0,25,2,27
sp16,162,MARSHALL,POLI,Polit Sci,0,0,0,0,2,2,6,2,8,9,15,24,8,11,19,0,0,0,23,30,53
sp16,162,MARSHALL,POLI,PolSc-Amer,0,0,0,0,0,0,1,2,3,2,0,2,2,2,4,0,0,0,5,4,9
sp16,162,MARSHALL,POLI,PolSc-Comp,0,0,0,0,0,0,0,0,0,1,0,1,2,3,5,0,0,0,3,3,6
sp16,162,MARSHALL,POLI,PolSc-Intl,0,0,0,2,1,3,4,1,5,6,5,11,9,7,16,0,0,0,21,14,35
sp16,162,MARSHALL,POLI,PolSc-PLaw,0,0,0,1,0,1,1,4,5,4,6,10,5,8,13,0,0,0,11,18,29
sp16,162,MARSHALL,POLI,PolSc-PPol,0,0,0,0,0,0,0,2,2,1,3,4,0,2,2,0,0,0,1,7,8
sp16,162,MARSHALL,POLI,PolSc-Thry,0,0,0,0,0,0,0,0,0,2,0,2,1,2,3,0,0,0,3,2,5
sp16,162,MARSHALL,PSYC,CogBehNeur,0,0,0,0,0,0,0,1,1,0,2,2,0,1,1,0,0,0,0,4,4
sp16,162,MARSHALL,PSYC,Psyc/ClPsy,0,0,0,0,1,1,4,6,10,2,7,9,9,11,20,0,0,0,15,25,40
sp16,162,MARSHALL,PSYC,Psyc/CogPs,0,0,0,0,0,0,2,2,4,1,4,5,1,1,2,0,0,0,4,7,11
sp16,162,MARSHALL,PSYC,Psyc/DelPs,0,0,0,0,0,0,1,1,2,0,2,2,2,3,5,0,0,0,3,6,9
sp16,162,MARSHALL,PSYC,Psyc/HumHl,0,0,0,0,1,1,0,2,2,2,1,3,3,8,11,0,0,0,5,12,17
sp16,162,MARSHALL,PSYC,Psyc/SenPr,0,0,0,0,0,0,0,0,0,0,0,0,0,1,1,0,0,0,0,1,1
sp16,162,MARSHALL,PSYC,Psyc/SocPs,0,0,0,0,1,1,0,3,3,5,5,10,2,8,10,0,0,0,7,17,24
sp16,162,MARSHALL,PSYC,Psychology,0,0,0,1,2,3,2,12,14,11,24,35,12,40,52,0,0,0,26,78,104
sp16,162,MARSHALL,RELI,Relig/Stu,0,0,0,0,0,0,1,0,1,1,0,1,2,0,2,0,0,0,4,0,4
sp16,162,MARSHALL,RELI,Engin Sci,0,0,0,0,0,0,1,0,1,0,1,1,0,0,0,0,0,0,1,1,2
sp16,162,MARSHALL,RELI,Struct Eng,0,0,0,1,0,1,2,0,2,4,4,8,43,9,52,0,0,0,50,13,63
sp16,162,MARSHALL,SIO,Earth Sci,0,0,0,0,0,0,0,0,0,0,3,3,3,2,5,0,0,0,3,5,8
sp16,162,MARSHALL,SIO,Marine Bio,0,0,0,1,1,2,1,2,3,0,3,3,2,6,8,0,0,0,4,12,16
sp16,162,MARSHALL,SOC,SocAmSt,0,0,0,0,0,0,0,0,0,0,0,0,0,1,1,0,0,0,0,1,1
sp16,162,MARSHALL,SOC,SocCulCom,0,0,0,1,1,2,0,1,1,0,1,1,1,3,4,0,0,0,2,6,8
sp16,162,MARSHALL,SOC,SocEconSoc,0,0,0,0,0,0,0,0,0,0,3,3,1,0,1,0,0,0,1,3,4
sp16,162,MARSHALL,SOC,Sociology,0,0,0,1,1,2,1,4,5,0,5,5,2,6,8,0,0,0,4,16,20
sp16,162,MARSHALL,SOC,SocLawSoc,0,0,0,0,0,0,0,1,1,1,3,4,4,3,7,0,0,0,5,7,12
sp16,162,MARSHALL,SOC,SocSciMed,0,0,0,0,0,0,0,0,0,0,2,2,0,1,1,0,0,0,0,3,3
sp16,162,MARSHALL,SOC,SocSolneq,0,0,0,0,1,1,0,0,0,0,4,4,1,2,3,0,0,0,1,7,8
sp16,162,MARSHALL,THEA,Dance,0,0,0,0,0,0,0,1,1,0,0,0,0,0,0,0,0,0,0,1,1
sp16,162,MARSHALL,THEA,Theatre,0,0,0,0,0,0,0,0,0,0,3,3,2,2,4,0,0,0,2,5,7
sp16,162,MARSHALL,UNAF,Undeclared,0,0,0,10,4,14,28,14,42,1,2,3,0,0,0,0,0,0,39,20,59
sp16,162,MARSHALL,UNAF,UndecPhysS,0,0,0,3,0,3,1,2,3,0,0,0,0,0,0,0,0,0,4,2,6
sp16,162,MARSHALL,UNAF,UndecSocSc,0,0,0,0,2,2,2,1,3,1,0,1,0,0,0,0,0,0,3,3,6
sp16,162,MARSHALL,USP,Urb Stu&Pl,0,0,0,0,0,0,1,1,2,0,0,0,4,7,11,0,0,0,5,8,13
sp16,162,MARSHALL,VIS,Art Hst/Cr,0,0,0,0,0,0,0,1,1,0,0,0,0,2,2,0,0,0,0,3,3
sp16,162,MARSHALL,VIS,Media,0,0,0,0,2,2,0,1,1,1,3,4,4,7,11,0,0,0,5,13,18
sp16,162,MARSHALL,VIS,Studio VA,0,0,0,0,2,2,1,0,1,0,4,4,1,5,6,0,0,0,2,11,13
sp16,162,MARSHALL,VIS,VA-CompArt,0,0,0,0,0,0,1,0,1,0,1,1,3,8,11,0,0,0,4,9,13
sp16,162,MUIR,ANTH,Anth-Arch,0,0,0,0,1,1,0,1,1,1,0,1,0,3,3,0,0,0,1,5,6
sp16,162,MUIR,ANTH,Anth-Biol,0,0,0,0,1,1,0,1,1,2,0,2,1,2,3,0,0,0,3,4,7
sp16,162,MUIR,ANTH,Anth-Soci,0,0,0,0,2,2,0,0,0,3,1,4,0,5,5,0,0,0,3,8,11
sp16,162,MUIR,BENG,Bioen:Binf,0,0,0,0,0,0,0,1,1,2,2,4,13,6,19,0,0,0,15,9,24
sp16,162,MUIR,BENG,BioengBioS,0,0,0,0,0,0,1,1,2,2,1,3,6,3,9,0,0,0,9,5,14
sp16,162,MUIR,BENG,BioengBiot,0,0,0,0,1,1,3,0,3,6,8,14,9,10,19,0,0,0,18,19,37
sp16,162,MUIR,BENG,Bioengin,0,0,0,0,0,0,1,4,5,4,4,8,17,9,26,0,0,0,22,17,39
sp16,162,MUIR,BIOL,Bioc/CellB,0,0,0,4,2,6,21,36,57,28,41,69,54,69,123,0,0,0,107,148,255
sp16,162,MUIR,BIOL,BiolBioinf,0,0,0,0,0,0,2,2,4,6,3,9,1,2,3,0,0,0,9,7,16
sp16,162,MUIR,BIOL,Ec/Beh/Evo,0,0,0,0,1,1,0,3,3,0,12,12,7,16,23,0,0,0,7,32,39
sp16,162,MUIR,BIOL,Genl Biol,0,0,0,3,5,8,6,15,21,19,34,53,32,57,89,0,0,0,60,111,171
sp16,162,MUIR,BIOL,Human Bio,0,0,0,3,11,14,13,44,57,35,63,98,48,94,142,0,0,0,99,212,311
sp16,162,MUIR,BIOL,Microbiol,0,0,0,0,1,1,3,2,5,6,6,12,6,9,15,0,0,0,15,18,33
sp16,162,MUIR,BIOL,Molec Biol,0,0,0,0,1,1,5,6,11,6,3,9,11,11,22,0,0,0,22,21,43
sp16,162,MUIR,BIOL,PhyslNeuro,0,0,0,1,4,5,16,21,37,20,34,54,41,54,95,0,0,0,78,113,191
sp16,162,MUIR,CENG,Chem Engin,0,0,0,0,0,0,1,4,5,14,3,17,30,26,56,0,0,0,45,33,78
sp16,162,MUIR,CGS,CritGendSt,0,0,0,0,0,0,0,0,0,1,3,4,2,6,8,0,0,0,3,9,12
sp16,162,MUIR,CHEM,Bioch/Chem,0,0,0,1,0,1,7,5,12,13,12,25,13,10,23,0,0,0,34,27,61
sp16,162,MUIR,CHEM,Chem Phys,0,0,0,0,0,0,1,0,1,0,0,0,0,0,0,0,0,0,1,0,1
sp16,162,MUIR,CHEM,Chemistry,0,0,0,0,0,0,4,5,9,2,6,8,3,6,9,0,0,0,9,17,26
sp16,162,MUIR,CHEM,Envir Chem,0,0,0,0,0,0,1,1,2,1,1,2,1,1,2,0,0,0,3,3,6
sp16,162,MUIR,CHEM,MolecSynth,0,0,0,0,0,0,1,0,1,1,0,1,1,0,1,0,0,0,3,0,3
sp16,162,MUIR,CHEM,Pharm Chem,0,0,0,1,1,2,2,8,10,2,6,8,12,15,27,0,0,0,17,30,47
sp16,162,MUIR,CHIN,Chinese St,0,0,0,0,0,0,0,0,0,0,0,0,0,1,1,0,0,0,0,1,1
sp16,162,MUIR,COGS,Cog Sci,0,0,0,0,0,0,2,6,8,3,11,14,6,7,13,0,0,0,11,24,35
sp16,162,MUIR,COGS,CogBehNeur,0,0,0,0,2,2,1,5,6,2,1,3,1,1,2,0,0,0,4,9,13
sp16,162,MUIR,COGS,CogSc/ClAs,0,0,0,0,0,0,1,0,1,0,3,3,1,2,3,0,0,0,2,5,7
sp16,162,MUIR,COGS,CogSc/Comp,0,0,0,0,0,0,5,1,6,1,0,1,1,3,4,0,0,0,7,4,11
sp16,162,MUIR,COGS,CogSc/HCI,0,0,0,0,0,0,4,3,7,4,8,12,7,13,20,0,0,0,15,24,39
sp16,162,MUIR,COGS,CogSc/HCog,0,0,0,0,2,2,0,1,1,1,2,3,2,3,5,0,0,0,3,8,11
sp16,162,MUIR,COGS,CogSc/Neur,0,0,0,1,0,1,2,3,5,4,8,12,3,14,17,0,0,0,10,25,35
sp16,162,MUIR,COMM,Communic,0,0,0,3,0,3,7,11,18,17,40,57,6,37,43,0,0,0,33,88,121
sp16,162,MUIR,CSE,Comp Sci,0,0,0,1,0,1,22,6,28,36,6,42,129,39,168,0,0,0,188,51,239
sp16,162,MUIR,CSE,CompEngCSE,0,0,0,0,0,0,9,3,12,7,1,8,22,2,24,0,0,0,38,6,44
sp16,162,MUIR,CSE,CompScBinf,0,0,0,0,0,0,0,0,0,2,0,2,2,3,5,0,0,0,4,3,7
sp16,162,MUIR,ECE,CompEngECE,0,0,0,0,0,0,3,2,5,7,1,8,14,2,16,0,0,0,24,5,29
sp16,162,MUIR,ECE,Electr Eng,0,0,0,2,0,2,9,4,13,22,2,24,49,6,55,0,0,0,82,12,94
sp16,162,MUIR,ECE,Engin Phys,0,0,0,0,0,0,0,0,0,1,0,1,0,0,0,0,0,0,1,0,1
sp16,162,MUIR,ECE,Pr-EngPhys,0,0,0,1,0,1,1,0,1,1,0,1,0,0,0,0,0,0,3,0,3
sp16,162,MUIR,ECON,Ec-Mth&Ecn,0,0,0,1,1,2,1,6,7,8,11,19,6,5,11,0,0,0,16,23,39
sp16,162,MUIR,ECON,Econ-MgtSc,0,0,0,1,0,1,8,4,12,16,19,35,40,17,57,0,0,0,65,40,105
sp16,162,MUIR,ECON,Economics,0,0,0,1,1,2,8,8,16,44,33,77,60,41,101,0,0,0,113,83,196
sp16,162,MUIR,ESYS,EnvSys(EB),0,0,0,0,0,0,1,2,3,3,5,8,5,5,10,0,0,0,9,12,21
sp16,162,MUIR,ESYS,EnvSys(EC),0,0,0,0,0,0,0,1,1,0,0,0,0,3,3,0,0,0,0,4,4
sp16,162,MUIR,ESYS,EnvSys(EP),0,0,0,0,0,0,0,3,3,1,2,3,1,0,1,0,0,0,2,5,7
sp16,162,MUIR,ESYS,EnvSys(ES),0,0,0,1,0,1,1,2,3,1,3,4,1,0,1,0,0,0,4,5,9
sp16,162,MUIR,ETHN,Ethnic St,0,0,0,0,0,0,0,1,1,0,3,3,1,5,6,0,0,0,1,9,10
sp16,162,MUIR,FPMU,Public Hlt,0,0,0,0,0,0,3,7,10,7,30,37,13,36,49,0,0,0,23,73,96
sp16,162,MUIR,GLBH,Global Hlt,0,0,0,0,1,1,2,3,5,1,6,7,2,7,9,0,0,0,5,17,22
sp16,162,MUIR,HDP,Human Dev,0,0,0,0,0,0,0,0,0,0,6,6,3,24,27,0,0,0,3,30,33
sp16,162,MUIR,HDP,Pr-HumnDev,0,0,0,0,2,2,0,9,9,0,2,2,0,0,0,0,0,0,0,13,13
sp16,162,MUIR,HIST,History,0,0,0,0,0,0,0,3,3,5,3,8,6,5,11,0,0,0,11,11,22
sp16,162,MUIR,INTL,InSt-InBus,0,0,0,2,1,3,2,8,10,7,7,14,4,9,13,0,0,0,15,25,40
sp16,162,MUIR,INTL,IntSt-Anth,0,0,0,0,0,0,0,0,0,0,0,0,0,1,1,0,0,0,0,1,1
sp16,162,MUIR,INTL,IntSt-Econ,0,0,0,1,0,1,2,3,5,0,1,1,3,8,11,0,0,0,6,12,18
sp16,162,MUIR,INTL,IntSt-Hist,0,0,0,0,0,0,0,0,0,0,0,0,1,0,1,0,0,0,1,0,1
sp16,162,MUIR,INTL,IntSt-Lit,0,0,0,0,0,0,0,0,0,0,0,0,0,1,1,0,0,0,0,1,1
sp16,162,MUIR,INTL,IntSt-PolS,0,0,0,0,1,1,0,1,1,0,3,3,2,7,9,0,0,0,2,12,14
sp16,162,MUIR,INTL,IntSt-Soc,0,0,0,0,0,0,0,0,0,0,2,2,0,1,1,0,0,0,0,3,3
sp16,162,MUIR,ITAL,Italian St,0,0,0,0,0,0,0,0,0,0,0,0,0,1,1,0,0,0,0,1,1
sp16,162,MUIR,JAPN,JapaneseSt,0,0,0,0,0,0,0,0,0,1,1,2,0,3,3,0,0,0,1,4,5
sp16,162,MUIR,LING,Lang Stu,0,0,0,0,0,0,0,2,2,0,2,2,2,0,2,0,0,0,2,4,6
sp16,162,MUIR,LING,Ling-CogLn,0,0,0,0,0,0,0,2,2,1,1,2,1,1,2,0,0,0,2,4,6
sp16,162,MUIR,LING,Ling-LSoc,0,0,0,0,0,0,0,0,0,1,0,1,0,0,0,0,0,0,1,0,1
sp16,162,MUIR,LING,Linguistcs,0,0,0,0,0,0,0,1,1,1,2,3,1,3,4,0,0,0,2,6,8
sp16,162,MUIR,LIT,Lit/Compos,0,0,0,0,0,0,0,0,0,0,1,1,0,0,0,0,0,0,0,1,1
sp16,162,MUIR,LIT,Lit/Engl,0,0,0,0,1,1,1,0,1,1,5,6,0,5,5,0,0,0,2,11,13
sp16,162,MUIR,LIT,Lit/World,0,0,0,0,0,0,0,1,1,0,0,0,3,1,4,0,0,0,3,2,5
sp16,162,MUIR,LIT,Lit/Writng,0,0,0,0,0,0,1,2,3,1,5,6,8,14,22,0,0,0,10,21,31
sp16,162,MUIR,LIT,Spanish Lt,0,0,0,0,0,0,1,2,3,0,3,3,0,0,0,0,0,0,1,5,6
sp16,162,MUIR,MAE,Aerosp Eng,0,0,0,0,1,1,4,1,5,7,1,8,12,1,13,0,0,0,23,4,27
sp16,162,MUIR,MAE,Envir Eng,0,0,0,0,0,0,5,6,11,8,4,12,14,9,23,0,0,0,27,19,46
sp16,162,MUIR,MAE,Mech Engin,0,0,0,1,0,1,11,4,15,14,4,18,27,8,35,0,0,0,53,16,69
sp16,162,MUIR,MATH,Appld Math,0,0,0,3,1,4,13,9,22,9,7,16,9,9,18,0,0,0,34,26,60
sp16,162,MUIR,MATH,Math/SecEd,0,0,0,1,0,1,0,1,1,0,2,2,0,1,1,0,0,0,1,4,5
sp16,162,MUIR,MATH,Mathematcs,0,0,0,2,0,2,3,3,6,6,3,9,7,3,10,0,0,0,18,9,27
sp16,162,MUIR,MATH,Mth-CompSc,0,0,0,10,3,13,31,10,41,25,16,41,12,1,13,0,0,0,78,30,108
sp16,162,MUIR,MATH,Mth-Mth&Ec,0,0,0,0,0,0,4,5,9,5,8,13,7,1,8,0,0,0,16,14,30
sp16,162,MUIR,MATH,Mth/ApldSc,0,0,0,0,1,1,2,0,2,1,0,1,0,1,1,0,0,0,3,2,5
sp16,162,MUIR,MATH,Prob&Stats,0,0,0,0,1,1,5,3,8,5,4,9,6,2,8,0,0,0,16,10,26
sp16,162,MUIR,MUS,Mu-CompArt,0,0,0,1,0,1,0,0,0,1,2,3,6,2,8,0,0,0,8,4,12
sp16,162,MUIR,MUS,Music,0,0,0,0,1,1,1,1,2,1,0,1,6,4,10,0,0,0,8,6,14
sp16,162,MUIR,MUS,Music Hum,0,0,0,0,0,0,0,0,0,0,0,0,1,0,1,0,0,0,1,0,1
sp16,162,MUIR,NENG,NanoEng,0,0,0,1,1,2,1,0,1,8,0,8,15,5,20,0,0,0,25,6,31
sp16,162,MUIR,PHIL,Philosophy,0,0,0,1,2,3,2,0,2,0,0,0,1,1,2,0,0,0,4,3,7
sp16,162,MUIR,PHYS,Biophysics,0,0,0,0,0,0,1,1,2,1,0,1,0,2,2,0,0,0,2,3,5
sp16,162,MUIR,PHYS,Gen Physcs,0,0,0,0,0,0,0,0,0,0,0,0,2,0,2,0,0,0,2,0,2
sp16,162,MUIR,PHYS,Phy/ErthSc,0,0,0,0,0,0,0,0,0,0,0,0,1,0,1,0,0,0,1,0,1
sp16,162,MUIR,PHYS,Phys/Astro,0,0,0,2,0,2,3,0,3,4,2,6,2,0,2,0,0,0,11,2,13
sp16,162,MUIR,PHYS,Phys/Comp,0,0,0,0,0,0,1,0,1,1,0,1,2,0,2,0,0,0,4,0,4
sp16,162,MUIR,PHYS,Phys/Mtrls,0,0,0,0,1,1,0,1,1,1,1,2,2,0,2,0,0,0,3,3,6
sp16,162,MUIR,PHYS,Physics,0,0,0,0,0,0,5,3,8,4,3,7,4,1,5,0,0,0,13,7,20
sp16,162,MUIR,POLI,Polit Sci,0,0,0,0,0,0,3,3,6,8,6,14,9,11,20,0,0,0,20,20,40
sp16,162,MUIR,POLI,PolSc-Amer,0,0,0,0,0,0,2,0,2,3,1,4,1,2,3,0,0,0,6,3,9
sp16,162,MUIR,POLI,PolSc-Comp,0,0,0,0,0,0,0,1,1,0,0,0,1,1,2,0,0,0,1,2,3
sp16,162,MUIR,POLI,PolSc-Intl,0,0,0,0,1,1,3,3,6,2,7,9,6,4,10,0,0,0,11,15,26
sp16,162,MUIR,POLI,PolSc-PLaw,0,0,0,0,1,1,1,3,4,1,1,2,9,6,15,0,0,0,11,11,22
sp16,162,MUIR,POLI,PolSc-PPol,0,0,0,0,1,1,1,0,1,1,0,1,3,4,7,0,0,0,5,5,10
sp16,162,MUIR,POLI,PolSc-Thry,0,0,0,0,0,0,0,1,1,1,1,2,0,0,0,0,0,0,1,2,3
sp16,162,MUIR,PSYC,CogBehNeur,0,0,0,0,0,0,1,2,3,1,3,4,0,2,2,0,0,0,2,7,9
sp16,162,MUIR,PSYC,Psyc/ClPsy,0,0,0,2,2,4,4,3,7,2,13,15,4,22,26,0,0,0,12,40,52
sp16,162,MUIR,PSYC,Psyc/CogPs,0,0,0,0,0,0,1,0,1,0,2,2,1,2,3,0,0,0,2,4,6
sp16,162,MUIR,PSYC,Psyc/DelPs,0,0,0,0,0,0,0,0,0,0,2,2,0,7,7,0,0,0,0,9,9
sp16,162,MUIR,PSYC,Psyc/HumHl,0,0,0,0,0,0,0,4,4,0,3,3,1,2,3,0,0,0,1,9,10
sp16,162,MUIR,PSYC,Psyc/SenPr,0,0,0,0,0,0,0,0,0,0,1,1,0,0,0,0,0,0,0,1,1
sp16,162,MUIR,PSYC,Psyc/SocPs,0,0,0,1,0,1,1,4,5,2,7,9,1,7,8,0,0,0,5,18,23
sp16,162,MUIR,PSYC,Psychology,0,0,0,0,2,2,4,10,14,14,21,35,13,49,62,0,0,0,31,82,113
sp16,162,MUIR,RELI,Relig/Stu,0,0,0,1,0,1,0,0,0,0,1,1,0,0,0,0,0,0,1,1,2
sp16,162,MUIR,SE,Engin Sci,0,0,0,0,0,0,1,0,1,0,0,0,0,0,0,0,0,0,1,0,1
sp16,162,MUIR,SE,Struct Eng,0,0,0,1,0,1,3,2,5,7,3,10,23,20,43,0,0,0,34,25,59
sp16,162,MUIR,SIO,Earth Sci,0,0,0,0,0,0,3,1,4,2,0,2,5,5,10,0,0,0,10,6,16
sp16,162,MUIR,SIO,Marine Bio,0,0,0,0,4,4,3,8,11,7,12,19,4,11,15,0,0,0,14,35,49
sp16,162,MUIR,SOC,SocAmSt,0,0,0,0,0,0,0,0,0,0,0,0,0,1,1,0,0,0,0,1,1
sp16,162,MUIR,SOC,SocCulCom,0,0,0,0,0,0,0,3,3,1,2,3,0,0,0,0,0,0,1,5,6
sp16,162,MUIR,SOC,SocEconSoc,0,0,0,1,0,1,0,0,0,1,2,3,0,1,1,0,0,0,2,3,5
sp16,162,MUIR,SOC,SocIntlStu,0,0,0,0,0,0,0,0,0,0,0,0,0,1,1,0,0,0,0,1,1
sp16,162,MUIR,SOC,Sociology,0,0,0,0,1,1,0,3,3,1,10,11,3,7,10,0,0,0,4,21,25
sp16,162,MUIR,SOC,SocLawSoc,0,0,0,0,0,0,0,4,4,2,5,7,0,6,6,0,0,0,2,15,17
sp16,162,MUIR,SOC,SocSciMed,0,0,0,0,0,0,0,1,1,1,1,2,0,1,1,0,0,0,1,3,4
sp16,162,MUIR,SOC,SocSolneq,0,0,0,0,1,1,0,1,1,1,2,3,2,6,8,0,0,0,3,10,13
sp16,162,MUIR,THEA,Dance,0,0,0,0,0,0,0,0,0,0,0,0,0,1,1,0,0,0,0,1,1
sp16,162,MUIR,THEA,Theatre,0,0,0,1,3,4,2,3,5,4,5,9,2,9,11,0,0,0,9,20,29
sp16,162,MUIR,UNAF,UndecHumAr,0,0,0,0,0,0,1,0,1,0,0,0,0,0,0,0,0,0,1,0,1
sp16,162,MUIR,UNAF,Undeclared,0,0,0,13,10,23,35,14,49,2,2,4,0,0,0,0,0,0,50,26,76
sp16,162,MUIR,UNAF,UndecPhysS,0,0,0,2,2,4,2,2,4,1,0,1,0,0,0,0,0,0,5,4,9
sp16,162,MUIR,UNAF,UndecSocSc,0,0,0,0,0,0,2,4,6,1,1,2,0,0,0,0,0,0,3,5,8
sp16,162,MUIR,USP,Urb Stu&Pl,0,0,0,0,1,1,2,2,4,2,5,7,2,6,8,0,0,0,6,14,20
sp16,162,MUIR,VIS,Art Hst/Cr,0,0,0,0,0,0,0,1,1,0,2,2,0,2,2,0,0,0,0,5,5
sp16,162,MUIR,VIS,Media,0,0,0,1,1,2,2,1,3,2,3,5,5,4,9,0,0,0,10,9,19
sp16,162,MUIR,VIS,Spec Desgn,0,0,0,0,0,0,0,0,0,0,1,1,0,0,0,0,0,0,0,1,1
sp16,162,MUIR,VIS,Studio VA,0,0,0,0,1,1,0,1,1,1,3,4,0,7,7,0,0,0,1,12,13
sp16,162,MUIR,VIS,VA-CompArt,0,0,0,0,0,0,1,3,4,1,1,2,2,3,5,0,0,0,4,7,11
sp16,162,REVELLE,ANTH,Anth-Arch,0,0,0,0,0,0,0,1,1,0,0,0,1,1,2,0,0,0,1,2,3
sp16,162,REVELLE,ANTH,Anth-Biol,0,0,0,0,0,0,0,2,2,1,1,2,0,3,3,0,0,0,1,6,7
sp16,162,REVELLE,ANTH,Anth-Soci,0,0,0,0,0,0,0,0,0,0,0,0,1,3,4,0,0,0,1,3,4
sp16,162,REVELLE,BENG,Bioen:Binf,0,0,0,0,1,1,0,0,0,2,3,5,9,7,16,0,0,0,11,11,22
sp16,162,REVELLE,BENG,BioengBioS,0,0,0,0,1,1,1,3,4,5,1,6,6,4,10,0,0,0,12,9,21
sp16,162,REVELLE,BENG,BioengBiot,0,0,0,0,2,2,4,5,9,3,5,8,28,10,38,0,0,0,35,22,57
sp16,162,REVELLE,BENG,Bioengin,0,0,0,2,0,2,3,6,9,4,5,9,25,9,34,0,0,0,34,20,54
sp16,162,REVELLE,BIOL,Bioc/CellB,0,0,0,5,3,8,31,35,66,39,45,84,92,112,204,0,0,0,167,195,362
sp16,162,REVELLE,BIOL,BiolBioinf,0,0,0,2,0,2,2,2,4,4,2,6,3,3,6,0,0,0,11,7,18
sp16,162,REVELLE,BIOL,Ec/Beh/Evo,0,0,0,0,0,0,3,4,7,4,5,9,3,8,11,0,0,0,10,17,27
sp16,162,REVELLE,BIOL,Genl Biol,0,0,0,1,2,3,11,22,33,16,34,50,39,69,108,0,0,0,67,127,194
sp16,162,REVELLE,BIOL,Human Bio,0,0,0,8,12,20,23,43,66,39,70,109,73,115,188,0,0,0,143,240,383
sp16,162,REVELLE,BIOL,Microbiol,0,0,0,0,1,1,2,5,7,7,2,9,8,10,18,0,0,0,17,18,35
sp16,162,REVELLE,BIOL,Molec Biol,0,0,0,0,1,1,7,10,17,10,13,23,23,17,40,0,0,0,40,41,81
sp16,162,REVELLE,BIOL,PhyslNeuro,0,0,0,3,5,8,27,36,63,30,26,56,65,66,131,0,0,0,125,133,258
sp16,162,REVELLE,CENG,Chem Engin,0,0,0,0,1,1,11,4,15,19,8,27,94,36,130,0,0,0,124,49,173
sp16,162,REVELLE,CHEM,Bioch/Chem,0,0,0,0,1,1,8,8,16,10,9,19,17,9,26,0,0,0,35,27,62
sp16,162,REVELLE,CHEM,Bioinform,0,0,0,0,0,0,0,0,0,0,1,1,1,1,2,0,0,0,1,2,3
sp16,162,REVELLE,CHEM,Chem Phys,0,0,0,0,0,0,0,0,0,1,1,2,1,1,2,0,0,0,2,2,4
sp16,162,REVELLE,CHEM,Chemistry,0,0,0,1,0,1,9,9,18,16,11,27,16,9,25,0,0,0,42,29,71
sp16,162,REVELLE,CHEM,Envir Chem,0,0,0,0,0,0,1,1,2,1,1,2,5,2,7,0,0,0,7,4,11
sp16,162,REVELLE,CHEM,MolecSynth,0,0,0,0,0,0,0,1,1,6,0,6,4,2,6,0,0,0,10,3,13
sp16,162,REVELLE,CHEM,Pharm Chem,0,0,0,1,3,4,5,5,10,10,13,23,22,12,34,0,0,0,38,33,71
sp16,162,REVELLE,CHIN,Chinese St,0,0,0,0,0,0,1,0,1,0,0,0,0,0,0,0,0,0,1,0,1
sp16,162,REVELLE,COGS,Cog Sci,0,0,0,0,0,0,1,2,3,4,4,8,6,13,19,0,0,0,11,19,30
sp16,162,REVELLE,COGS,CogBehNeur,0,0,0,0,0,0,0,0,0,0,1,1,0,1,1,0,0,0,0,2,2
sp16,162,REVELLE,COGS,CogSc/ClAs,0,0,0,0,0,0,0,0,0,0,0,0,0,5,5,0,0,0,0,5,5
sp16,162,REVELLE,COGS,CogSc/Comp,0,0,0,1,0,1,2,2,4,1,2,3,2,2,4,0,0,0,6,6,12
sp16,162,REVELLE,COGS,CogSc/HCI,0,0,0,1,1,2,1,1,2,5,5,10,8,9,17,0,0,0,15,16,31
sp16,162,REVELLE,COGS,CogSc/HCog,0,0,0,0,0,0,1,0,1,1,0,1,2,3,5,0,0,0,4,3,7
sp16,162,REVELLE,COGS,CogSc/Neur,0,0,0,0,1,1,1,1,2,0,2,2,6,14,20,0,0,0,7,18,25
sp16,162,REVELLE,COMM,Communic,0,0,0,0,1,1,0,4,4,3,4,7,12,11,23,0,0,0,15,20,35
sp16,162,REVELLE,CSE,Comp Sci,0,0,0,1,0,1,17,7,24,38,4,42,149,29,178,0,0,0,205,40,245
sp16,162,REVELLE,CSE,CompEngCSE,0,0,0,1,0,1,7,1,8,7,1,8,18,1,19,0,0,0,33,3,36
sp16,162,REVELLE,CSE,CompScBinf,0,0,0,0,0,0,2,0,2,1,1,2,9,2,11,0,0,0,12,3,15
sp16,162,REVELLE,ECE,CompEngECE,0,0,0,1,0,1,7,3,10,12,0,12,25,4,29,0,0,0,45,7,52
sp16,162,REVELLE,ECE,Electr Eng,0,0,0,0,0,0,14,3,17,20,3,23,87,15,102,0,0,0,121,21,142
sp16,162,REVELLE,ECE,EleEng&Soc,0,0,0,0,0,0,0,0,0,0,0,0,1,0,1,0,0,0,1,0,1
sp16,162,REVELLE,ECE,Engin Phys,0,0,0,0,0,0,0,0,0,0,0,0,5,0,5,0,0,0,5,0,5
sp16,162,REVELLE,ECE,Pr-EngPhys,0,0,0,0,0,0,0,0,0,1,0,1,0,0,0,0,0,0,1,0,1
sp16,162,REVELLE,ECON,Ec-Mth&Ecn,0,0,0,0,0,0,7,0,7,6,3,9,10,3,13,0,0,0,23,6,29
sp16,162,REVELLE,ECON,Econ-MgtSc,0,0,0,0,1,1,7,3,10,11,15,26,36,24,60,0,0,0,54,43,97
sp16,162,REVELLE,ECON,Economics,0,0,0,3,0,3,5,2,7,29,22,51,67,28,95,0,0,0,104,52,156
sp16,162,REVELLE,ESYS,EnvSys(EB),0,0,0,0,0,0,0,4,4,0,0,0,1,7,8,0,0,0,1,11,12
sp16,162,REVELLE,ESYS,EnvSys(EC),0,0,0,0,0,0,1,0,1,2,1,3,1,0,1,0,0,0,4,1,5
sp16,162,REVELLE,ESYS,EnvSys(EP),0,0,0,0,0,0,0,0,0,1,0,1,0,0,0,0,0,0,1,0,1
sp16,162,REVELLE,ESYS,EnvSys(ES),0,0,0,0,1,1,0,1,1,0,0,0,3,1,4,0,0,0,3,3,6
sp16,162,REVELLE,ETHN,Ethnic St,0,0,0,0,0,0,0,1,1,0,0,0,1,2,3,0,0,0,1,3,4
sp16,162,REVELLE,FPMU,Public Hlt,0,0,0,1,0,1,0,3,3,2,12,14,9,41,50,0,0,0,12,56,68
sp16,162,REVELLE,GLBH,Global Hlt,0,0,0,0,0,0,0,1,1,1,3,4,1,3,4,0,0,0,2,7,9
sp16,162,REVELLE,HDP,Human Dev,0,0,0,0,0,0,0,0,0,0,2,2,0,10,10,0,0,0,0,12,12
sp16,162,REVELLE,HDP,Pr-HumnDev,0,0,0,0,0,0,0,0,0,1,3,4,0,1,1,0,0,0,1,4,5
sp16,162,REVELLE,HIST,History,0,0,0,0,0,0,1,1,2,1,1,2,5,3,8,0,0,0,7,5,12
sp16,162,REVELLE,INTL,InSt-InBus,0,0,0,1,4,5,1,1,2,6,5,11,3,5,8,0,0,0,11,15,26
sp16,162,REVELLE,INTL,Int-5yrEC,0,0,0,0,0,0,0,0,0,0,0,0,1,1,2,0,0,0,1,1,2
sp16,162,REVELLE,INTL,IntSt-Econ,0,0,0,1,0,1,2,2,4,1,2,3,5,3,8,0,0,0,9,7,16
sp16,162,REVELLE,INTL,IntSt-Hist,0,0,0,0,0,0,0,0,0,0,0,0,1,1,2,0,0,0,1,1,2
sp16,162,REVELLE,INTL,IntSt-PolS,0,0,0,0,0,0,0,1,1,1,0,1,0,3,3,0,0,0,1,4,5
sp16,162,REVELLE,INTL,IntSt-Soc,0,0,0,0,0,0,0,1,1,0,0,0,0,0,0,0,0,0,0,1,1
sp16,162,REVELLE,LING,Lang Stu,0,0,0,0,0,0,0,1,1,0,0,0,0,1,1,0,0,0,0,2,2
sp16,162,REVELLE,LING,Ling-CogLn,0,0,0,0,0,0,0,0,0,0,2,2,1,2,3,0,0,0,1,4,5
sp16,162,REVELLE,LING,Linguistcs,0,0,0,0,0,0,0,0,0,0,0,0,2,4,6,0,0,0,2,4,6
sp16,162,REVELLE,LIT,Lit/Compos,0,0,0,0,0,0,0,1,1,0,0,0,0,0,0,0,0,0,0,1,1
sp16,162,REVELLE,LIT,Lit/CultSt,0,0,0,0,0,0,0,0,0,0,0,0,0,1,1,0,0,0,0,1,1
sp16,162,REVELLE,LIT,Lit/Engl,0,0,0,0,0,0,0,2,2,0,2,2,2,2,4,0,0,0,2,6,8
sp16,162,REVELLE,LIT,Lit/World,0,0,0,0,0,0,0,0,0,0,2,2,1,1,2,0,0,0,1,3,4
sp16,162,REVELLE,LIT,Lit/Writng,0,0,0,0,0,0,0,4,4,1,2,3,0,5,5,0,0,0,1,11,12
sp16,162,REVELLE,LIT,Spanish Lt,0,0,0,0,0,0,1,0,1,0,0,0,0,1,1,0,0,0,1,1,2
sp16,162,REVELLE,MAE,Aerosp Eng,0,0,0,1,0,1,12,1,13,16,1,17,31,6,37,0,0,0,60,8,68
sp16,162,REVELLE,MAE,Engin Sci,0,0,0,0,0,0,0,0,0,0,0,0,1,0,1,0,0,0,1,0,1
sp16,162,REVELLE,MAE,Envir Eng,0,0,0,0,0,0,6,3,9,6,5,11,9,7,16,0,0,0,21,15,36
sp16,162,REVELLE,MAE,Mech Engin,0,0,0,2,1,3,16,1,17,9,4,13,42,9,51,0,0,0,69,15,84
sp16,162,REVELLE,MATH,Appld Math,0,0,0,2,0,2,10,6,16,14,4,18,17,10,27,0,0,0,43,20,63
sp16,162,REVELLE,MATH,Math/SecEd,0,0,0,0,1,1,1,0,1,1,4,5,3,1,4,0,0,0,5,6,11
sp16,162,REVELLE,MATH,Mathematcs,0,0,0,1,2,3,13,2,15,9,5,14,12,9,21,0,0,0,35,18,53
sp16,162,REVELLE,MATH,Mth-CompSc,0,0,0,7,5,12,42,14,56,42,10,52,18,6,24,0,0,0,109,35,144
sp16,162,REVELLE,MATH,Mth-Mth&Ec,0,0,0,5,1,6,5,2,7,3,4,7,4,7,11,0,0,0,17,14,31
sp16,162,REVELLE,MATH,Mth-SciCom,0,0,0,0,0,0,0,1,1,0,2,2,0,0,0,0,0,0,0,3,3
sp16,162,REVELLE,MATH,Mth/ApldSc,0,0,0,0,0,0,0,1,1,2,1,3,2,0,2,0,0,0,4,2,6
sp16,162,REVELLE,MATH,Prob&Stats,0,0,0,0,1,1,4,2,6,4,2,6,5,6,11,0,0,0,13,11,24
sp16,162,REVELLE,MUS,Mu-CompArt,0,0,0,0,0,0,2,0,2,1,0,1,4,1,5,0,0,0,7,1,8
sp16,162,REVELLE,MUS,Music,0,0,0,0,0,0,1,0,1,1,0,1,1,1,2,0,0,0,3,1,4
sp16,162,REVELLE,NENG,NanoEng,0,0,0,1,1,2,8,1,9,6,4,10,31,6,37,0,0,0,46,12,58
sp16,162,REVELLE,PHIL,Philosophy,0,0,0,0,0,0,2,0,2,0,1,1,1,1,2,0,0,0,3,2,5
sp16,162,REVELLE,PHYS,Biophysics,0,0,0,0,0,0,1,0,1,2,0,2,5,0,5,0,0,0,8,0,8
sp16,162,REVELLE,PHYS,Gen Physcs,0,0,0,0,0,0,1,0,1,1,0,1,0,0,0,0,0,0,2,0,2
sp16,162,REVELLE,PHYS,Phys/Astro,0,0,0,0,1,1,1,1,2,7,1,8,10,3,13,0,0,0,18,6,24
sp16,162,REVELLE,PHYS,Phys/Comp,0,0,0,1,0,1,2,1,3,2,0,2,4,0,4,0,0,0,9,1,10
sp16,162,REVELLE,PHYS,Phys/Mtrls,0,0,0,1,0,1,2,1,3,9,0,9,1,1,2,0,0,0,13,2,15
sp16,162,REVELLE,PHYS,Physics,0,0,0,1,0,1,4,2,6,11,4,15,15,5,20,0,0,0,31,11,42
sp16,162,REVELLE,PHYS,Polit Sci,0,0,0,0,1,1,1,2,3,2,3,5,5,4,9,0,0,0,8,10,18
sp16,162,REVELLE,PHYS,PolSc-Amer,0,0,0,0,0,0,1,0,1,1,0,1,1,1,2,0,0,0,3,1,4
sp16,162,REVELLE,PHYS,PolSc-Comp,0,0,0,0,0,0,0,0,0,0,0,0,0,2,2,0,0,0,0,2,2
sp16,162,REVELLE,PHYS,PolSc-Intl,0,0,0,0,1,1,2,2,4,1,2,3,5,5,10,0,0,0,8,10,18
sp16,162,REVELLE,PHYS,PolSc-PLaw,0,0,0,0,0,0,1,0,1,3,0,3,1,5,6,0,0,0,5,5,10
sp16,162,REVELLE,PHYS,PolSc-PPol,0,0,0,0,0,0,0,0,0,0,0,0,0,1,1,0,0,0,0,1,1
sp16,162,REVELLE,PSYC,CogBehNeur,0,0,0,0,0,0,0,3,3,0,1,1,1,3,4,0,0,0,1,7,8
sp16,162,REVELLE,PSYC,Psyc/ClPsy,0,0,0,1,3,4,0,1,1,0,7,7,4,10,14,0,0,0,5,21,26
sp16,162,REVELLE,PSYC,Psyc/CogPs,0,0,0,0,0,0,0,2,2,1,1,2,2,2,4,0,0,0,3,5,8
sp16,162,REVELLE,PSYC,Psyc/DelPs,0,0,0,0,0,0,0,0,0,0,0,0,0,3,3,0,0,0,0,3,3
sp16,162,REVELLE,PSYC,Psyc/HumHl,0,0,0,0,1,1,0,1,1,0,3,3,2,7,9,0,0,0,2,12,14
sp16,162,REVELLE,PSYC,Psyc/SocPs,0,0,0,1,3,4,2,0,2,0,2,2,2,2,4,0,0,0,5,7,12
sp16,162,REVELLE,PSYC,Psychology,0,0,0,1,1,2,2,5,7,11,12,23,16,20,36,0,0,0,30,38,68
sp16,162,REVELLE,RELI,Relig/Stu,0,0,0,0,1,1,0,0,0,0,0,0,0,1,1,0,0,0,0,2,2
sp16,162,REVELLE,SE,Engin Sci,0,0,0,0,0,0,1,0,1,0,0,0,1,0,1,0,0,0,2,0,2
sp16,162,REVELLE,SE,Struct Eng,0,0,0,4,2,6,7,7,14,9,2,11,49,17,66,0,0,0,69,28,97
sp16,162,REVELLE,SIO,Earth Sci,0,0,0,0,0,0,0,0,0,2,1,3,3,3,6,0,0,0,5,4,9
sp16,162,REVELLE,SIO,Marine Bio,0,0,0,1,0,1,4,11,15,2,10,12,0,12,12,0,0,0,7,33,40
sp16,162,REVELLE,SOC,SocCulCom,0,0,0,0,0,0,0,0,0,1,0,1,0,0,0,0,0,0,1,0,1
sp16,162,REVELLE,SOC,Sociology,0,0,0,0,0,0,1,2,3,0,0,0,2,3,5,0,0,0,3,5,8
sp16,162,REVELLE,SOC,SocLawSoc,0,0,0,0,0,0,0,0,0,1,1,2,1,0,1,0,0,0,2,1,3
sp16,162,REVELLE,SOC,SocSciMed,0,0,0,0,0,0,0,1,1,0,1,1,1,1,2,0,0,0,1,3,4
sp16,162,REVELLE,SOC,SocSolneq,0,0,0,0,0,0,0,1,1,0,0,0,0,2,2,0,0,0,0,3,3
sp16,162,REVELLE,SOC,Dance,0,0,0,0,0,0,0,0,0,0,0,0,1,0,1,0,0,0,1,0,1
sp16,162,REVELLE,SOC,Theatre,0,0,0,0,0,0,1,2,3,1,0,1,0,6,6,0,0,0,2,8,10
sp16,162,REVELLE,UNAF,Limited St,0,0,0,0,0,0,0,0,0,0,0,0,0,0,0,2,1,3,2,1,3
sp16,162,REVELLE,UNAF,Spec-Emply,0,0,0,0,0,0,0,0,0,0,0,0,0,0,0,2,3,5,2,3,5
sp16,162,REVELLE,UNAF,UndecHumAr,0,0,0,0,2,2,1,0,1,0,0,0,0,0,0,0,0,0,1,2,3
sp16,162,REVELLE,UNAF,Undeclared,0,0,0,15,8,23,39,14,53,4,3,7,1,0,1,0,0,0,59,25,84
sp16,162,REVELLE,UNAF,UndecPhysS,0,0,0,2,1,3,4,2,6,1,1,2,0,0,0,0,0,0,7,4,11
sp16,162,REVELLE,UNAF,UndecSocSc,0,0,0,0,1,1,0,2,2,0,0,0,0,0,0,0,0,0,0,3,3
sp16,162,REVELLE,USP,Urb Stu&Pl,0,0,0,0,0,0,1,1,2,0,2,2,1,2,3,0,0,0,2,5,7
sp16,162,REVELLE,VIS,Art Hst/Cr,0,0,0,0,0,0,0,0,0,0,0,0,0,1,1,0,0,0,0,1,1
sp16,162,REVELLE,VIS,Media,0,0,0,0,1,1,3,0,3,3,1,4,2,2,4,0,0,0,8,4,12
sp16,162,REVELLE,VIS,Studio VA,0,0,0,0,0,0,0,1,1,0,0,0,1,2,3,0,0,0,1,3,4
sp16,162,REVELLE,VIS,VA-CompArt,0,0,0,0,0,0,2,0,2,0,2,2,2,6,8,0,0,0,4,8,12
sp16,162,ROOSEVELT,ANTH,Anth-Arch,0,0,0,0,0,0,0,0,0,0,1,1,3,2,5,0,0,0,3,3,6
sp16,162,ROOSEVELT,ANTH,Anth-Biol,0,0,0,0,0,0,0,0,0,0,3,3,0,5,5,0,0,0,0,8,8
sp16,162,ROOSEVELT,ANTH,Anth-Soci,0,0,0,0,0,0,0,0,0,1,2,3,2,8,10,0,0,0,3,10,13
sp16,162,ROOSEVELT,BENG,Bioen:Binf,0,0,0,0,1,1,1,1,2,2,0,2,7,8,15,0,0,0,10,10,20
sp16,162,ROOSEVELT,BENG,BioengBioS,0,0,0,0,0,0,0,0,0,0,0,0,3,5,8,0,0,0,3,5,8
sp16,162,ROOSEVELT,BENG,BioengBiot,0,0,0,0,0,0,2,1,3,1,1,2,4,3,7,0,0,0,7,5,12
sp16,162,ROOSEVELT,BENG,Bioengin,0,0,0,0,0,0,0,0,0,2,1,3,5,2,7,0,0,0,7,3,10
sp16,162,ROOSEVELT,BIOL,Bioc/CellB,0,0,0,1,4,5,22,36,58,26,28,54,31,49,80,0,0,0,80,117,197
sp16,162,ROOSEVELT,BIOL,BiolBioinf,0,0,0,0,1,1,2,5,7,1,3,4,3,2,5,0,0,0,6,11,17
sp16,162,ROOSEVELT,BIOL,Ec/Beh/Evo,0,0,0,1,1,2,2,3,5,3,5,8,11,9,20,0,0,0,17,18,35
sp16,162,ROOSEVELT,BIOL,Genl Biol,0,0,0,5,6,11,13,27,40,13,16,29,23,46,69,0,0,0,54,95,149
sp16,162,ROOSEVELT,BIOL,Human Bio,0,0,0,5,14,19,18,38,56,21,57,78,39,69,108,0,0,0,83,178,261
sp16,162,ROOSEVELT,BIOL,Microbiol,0,0,0,0,0,0,4,3,7,6,0,6,6,6,12,0,0,0,16,9,25
sp16,162,ROOSEVELT,BIOL,Molec Biol,0,0,0,1,0,1,5,4,9,2,6,8,1,10,11,0,0,0,9,20,29
sp16,162,ROOSEVELT,BIOL,PhyslNeuro,0,0,0,1,3,4,16,21,37,12,23,35,25,45,70,0,0,0,54,92,146
sp16,162,ROOSEVELT,CENG,Chem Engin,0,0,0,0,0,0,1,0,1,3,2,5,29,12,41,0,0,0,33,14,47
sp16,162,ROOSEVELT,CGS,CritGendSt,0,0,0,0,0,0,0,1,1,0,1,1,1,0,1,0,0,0,1,2,3
sp16,162,ROOSEVELT,CHEM,Bioch/Chem,0,0,0,0,1,1,7,7,14,8,3,11,8,8,16,0,0,0,23,19,42
sp16,162,ROOSEVELT,CHEM,Bioinform,0,0,0,0,1,1,0,0,0,0,0,0,0,0,0,0,0,0,0,1,1
sp16,162,ROOSEVELT,CHEM,Chem Phys,0,0,0,0,0,0,0,0,0,0,0,0,0,1,1,0,0,0,0,1,1
sp16,162,ROOSEVELT,CHEM,Chemistry,0,0,0,2,2,4,6,8,14,8,3,11,1,3,4,0,0,0,17,16,33
sp16,162,ROOSEVELT,CHEM,Envir Chem,0,0,0,0,0,0,1,1,2,0,0,0,1,0,1,0,0,0,2,1,3
sp16,162,ROOSEVELT,CHEM,MolecSynth,0,0,0,0,0,0,1,0,1,0,0,0,2,0,2,0,0,0,3,0,3
sp16,162,ROOSEVELT,CHEM,Pharm Chem,0,0,0,0,1,1,1,5,6,6,8,14,9,9,18,0,0,0,16,23,39
sp16,162,ROOSEVELT,CHIN,Chinese St,0,0,0,0,0,0,0,1,1,2,1,3,0,0,0,0,0,0,2,2,4
sp16,162,ROOSEVELT,CLAS,Classic St,0,0,0,0,0,0,0,0,0,0,1,1,1,1,2,0,0,0,1,2,3
sp16,162,ROOSEVELT,COGS,Cog Sci,0,0,0,0,0,0,2,6,8,7,4,11,4,4,8,0,0,0,13,14,27
sp16,162,ROOSEVELT,COGS,CogBehNeur,0,0,0,0,0,0,0,1,1,0,3,3,2,0,2,0,0,0,2,4,6
sp16,162,ROOSEVELT,COGS,CogSc/ClAs,0,0,0,0,0,0,0,0,0,0,0,0,0,3,3,0,0,0,0,3,3
sp16,162,ROOSEVELT,COGS,CogSc/Comp,0,0,0,4,1,5,0,2,2,2,0,2,0,0,0,0,0,0,6,3,9
sp16,162,ROOSEVELT,COGS,CogSc/HCI,0,0,0,2,2,4,3,4,7,8,4,12,1,12,13,0,0,0,14,22,36
sp16,162,ROOSEVELT,COGS,CogSc/HCog,0,0,0,0,2,2,3,3,6,2,1,3,0,3,3,0,0,0,5,9,14
sp16,162,ROOSEVELT,COGS,CogSc/Neur,0,0,0,0,0,0,0,6,6,1,4,5,1,9,10,0,0,0,2,19,21
sp16,162,ROOSEVELT,COMM,Communic,0,0,0,2,6,8,3,15,18,14,32,46,9,49,58,0,0,0,28,102,130
sp16,162,ROOSEVELT,CSE,Comp Sci,0,0,0,0,0,0,5,2,7,28,3,31,73,21,94,0,0,0,106,26,132
sp16,162,ROOSEVELT,CSE,CompEngCSE,0,0,0,1,0,1,0,1,1,4,2,6,15,3,18,0,0,0,20,6,26
sp16,162,ROOSEVELT,CSE,CompScBinf,0,0,0,0,0,0,0,0,0,0,1,1,6,3,9,0,0,0,6,4,10
sp16,162,ROOSEVELT,ECE,CompEngECE,0,0,0,0,0,0,2,0,2,4,3,7,19,3,22,0,0,0,25,6,31
sp16,162,ROOSEVELT,ECE,Electr Eng,0,0,0,1,0,1,8,0,8,14,2,16,49,11,60,0,0,0,72,13,85
sp16,162,ROOSEVELT,ECE,EleEng&Soc,0,0,0,0,0,0,0,0,0,0,0,0,1,0,1,0,0,0,1,0,1
sp16,162,ROOSEVELT,ECE,Pr-EngPhys,0,0,0,0,0,0,0,0,0,1,0,1,0,0,0,0,0,0,1,0,1
sp16,162,ROOSEVELT,ECON,Ec-Mth&Ecn,0,0,0,1,3,4,2,8,10,10,6,16,11,9,20,0,0,0,24,26,50
sp16,162,ROOSEVELT,ECON,Econ-MgtSc,0,0,0,0,0,0,17,8,25,22,19,41,38,25,63,0,0,0,77,52,129
sp16,162,ROOSEVELT,ECON,Economics,0,0,0,6,2,8,27,22,49,47,31,78,66,41,107,0,0,0,146,96,242
sp16,162,ROOSEVELT,ESYS,EnvSys(EB),0,0,0,0,0,0,0,5,5,2,0,2,0,8,8,0,0,0,2,13,15
sp16,162,ROOSEVELT,ESYS,EnvSys(EC),0,0,0,0,0,0,1,0,1,0,0,0,0,0,0,0,0,0,1,0,1
sp16,162,ROOSEVELT,ESYS,EnvSys(EP),0,0,0,0,2,2,1,0,1,4,3,7,1,3,4,0,0,0,6,8,14
sp16,162,ROOSEVELT,ESYS,EnvSys(ES),0,0,0,0,1,1,0,1,1,0,0,0,1,1,2,0,0,0,1,3,4
sp16,162,ROOSEVELT,ETHN,Ethnic St,0,0,0,0,0,0,0,1,1,1,0,1,2,4,6,0,0,0,3,5,8
sp16,162,ROOSEVELT,FPMU,Public Hlt,0,0,0,0,1,1,2,11,13,1,18,19,9,44,53,0,0,0,12,74,86
sp16,162,ROOSEVELT,GLBH,Global Hlt,0,0,0,0,3,3,2,6,8,1,12,13,2,10,12,0,0,0,5,31,36
sp16,162,ROOSEVELT,HDP,Human Dev,0,0,0,0,0,0,0,1,1,0,8,8,1,20,21,0,0,0,1,29,30
sp16,162,ROOSEVELT,HDP,Pr-HumnDev,0,0,0,0,1,1,2,5,7,0,8,8,0,2,2,0,0,0,2,16,18
sp16,162,ROOSEVELT,HIST,History,0,0,0,0,1,1,1,0,1,13,10,23,12,21,33,0,0,0,26,32,58
sp16,162,ROOSEVELT,INTL,InSt-InBus,0,0,0,4,6,10,14,19,33,17,20,37,14,17,31,0,0,0,49,62,111
sp16,162,ROOSEVELT,INTL,IntSt-Anth,0,0,0,0,0,0,0,1,1,0,4,4,0,1,1,0,0,0,0,6,6
sp16,162,ROOSEVELT,INTL,IntSt-Econ,0,0,0,1,1,2,0,4,4,4,7,11,8,13,21,0,0,0,13,25,38
sp16,162,ROOSEVELT,INTL,IntSt-Hist,0,0,0,0,1,1,1,0,1,2,1,3,0,4,4,0,0,0,3,6,9
sp16,162,ROOSEVELT,INTL,IntSt-Ling,0,0,0,0,0,0,1,1,2,0,2,2,1,1,2,0,0,0,2,4,6
sp16,162,ROOSEVELT,INTL,IntSt-Lit,0,0,0,0,0,0,0,0,0,0,1,1,0,1,1,0,0,0,0,2,2
sp16,162,ROOSEVELT,INTL,IntSt-PolS,0,0,0,0,0,0,2,4,6,5,19,24,15,29,44,0,0,0,22,52,74
sp16,162,ROOSEVELT,INTL,IntSt-Soc,0,0,0,0,1,1,1,1,2,2,3,5,4,15,19,0,0,0,7,20,27
sp16,162,ROOSEVELT,ITAL,Italian St,0,0,0,0,0,0,0,0,0,0,1,1,0,0,0,0,0,0,0,1,1
sp16,162,ROOSEVELT,ITAL,JapaneseSt,0,0,0,0,0,0,1,1,2,1,1,2,0,2,2,0,0,0,2,4,6
sp16,162,ROOSEVELT,LATI,LatinAm St,0,0,0,0,0,0,0,0,0,1,0,1,0,1,1,0,0,0,1,1,2
sp16,162,ROOSEVELT,LING,Lang Stu,0,0,0,0,0,0,0,0,0,0,3,3,0,3,3,0,0,0,0,6,6
sp16,162,ROOSEVELT,LING,Ling-CogLn,0,0,0,0,0,0,0,1,1,0,5,5,1,4,5,0,0,0,1,10,11
sp16,162,ROOSEVELT,LING,Ling-LSoc,0,0,0,0,0,0,1,2,3,0,4,4,0,3,3,0,0,0,1,9,10
sp16,162,ROOSEVELT,LING,Linguistcs,0,0,0,0,1,1,0,1,1,2,2,4,2,6,8,0,0,0,4,10,14
sp16,162,ROOSEVELT,LIT,French Lit,0,0,0,0,0,0,0,0,0,0,1,1,0,1,1,0,0,0,0,2,2
sp16,162,ROOSEVELT,LIT,Lit/CultSt,0,0,0,0,0,0,0,0,0,0,0,0,0,2,2,0,0,0,0,2,2
sp16,162,ROOSEVELT,LIT,Lit/Engl,0,0,0,0,0,0,1,1,2,0,6,6,2,6,8,0,0,0,3,13,16
sp16,162,ROOSEVELT,LIT,Lit/World,0,0,0,0,0,0,0,0,0,1,0,1,0,1,1,0,0,0,1,1,2
sp16,162,ROOSEVELT,LIT,Lit/Writng,0,0,0,1,0,1,1,3,4,4,3,7,2,10,12,0,0,0,8,16,24
sp16,162,ROOSEVELT,LIT,Russian Lt,0,0,0,1,0,1,0,0,0,0,0,0,0,0,0,0,0,0,1,0,1
sp16,162,ROOSEVELT,MAE,Aerosp Eng,0,0,0,0,0,0,4,2,6,5,1,6,5,2,7,0,0,0,14,5,19
sp16,162,ROOSEVELT,MAE,Envir Eng,0,0,0,0,1,1,3,2,5,5,3,8,8,10,18,0,0,0,16,16,32
sp16,162,ROOSEVELT,MAE,Mech Engin,0,0,0,0,0,0,5,0,5,5,1,6,4,1,5,0,0,0,14,2,16
sp16,162,ROOSEVELT,MATH,Appld Math,0,0,0,3,3,6,16,11,27,10,12,22,9,11,20,0,0,0,38,37,75
sp16,162,ROOSEVELT,MATH,Math/SecEd,0,0,0,0,0,0,0,0,0,0,0,0,0,3,3,0,0,0,0,3,3
sp16,162,ROOSEVELT,MATH,Mathematcs,0,0,0,5,2,7,3,2,5,6,2,8,0,2,2,0,0,0,14,8,22
sp16,162,ROOSEVELT,MATH,Mth-CompSc,0,0,0,13,6,19,33,16,49,35,9,44,23,4,27,0,0,0,104,35,139
sp16,162,ROOSEVELT,MATH,Mth-Mth&Ec,0,0,0,2,3,5,9,9,18,6,10,16,7,5,12,0,0,0,24,27,51
sp16,162,ROOSEVELT,MATH,Mth/ApldSc,0,0,0,2,1,3,1,4,5,2,1,3,1,0,1,0,0,0,6,6,12
sp16,162,ROOSEVELT,MATH,Prob&Stats,0,0,0,0,2,2,5,4,9,9,4,13,3,1,4,0,0,0,17,11,28
sp16,162,ROOSEVELT,MUS,Mu-CompArt,0,0,0,1,0,1,1,0,1,1,0,1,2,0,2,0,0,0,5,0,5
sp16,162,ROOSEVELT,MUS,Music,0,0,0,0,1,1,0,0,0,0,0,0,2,0,2,0,0,0,2,1,3
sp16,162,ROOSEVELT,NENG,NanoEng,0,0,0,0,0,0,4,0,4,2,2,4,16,7,23,0,0,0,22,9,31
sp16,162,ROOSEVELT,PHIL,Philosophy,0,0,0,0,0,0,0,1,1,3,1,4,3,5,8,0,0,0,6,7,13
sp16,162,ROOSEVELT,PHYS,Biophysics,0,0,0,0,0,0,2,0,2,1,0,1,1,1,2,0,0,0,4,1,5
sp16,162,ROOSEVELT,PHYS,Gen Physcs,0,0,0,1,0,1,1,0,1,1,0,1,0,0,0,0,0,0,3,0,3
sp16,162,ROOSEVELT,PHYS,Phys/Astro,0,0,0,1,1,2,1,1,2,2,4,6,2,0,2,0,0,0,6,6,12
sp16,162,ROOSEVELT,PHYS,Phys/Comp,0,0,0,0,0,0,0,0,0,0,2,2,0,0,0,0,0,0,0,2,2
sp16,162,ROOSEVELT,PHYS,Phys/Mtrls,0,0,0,0,0,0,3,0,3,2,0,2,0,0,0,0,0,0,5,0,5
sp16,162,ROOSEVELT,PHYS,Physics,0,0,0,3,0,3,11,1,12,8,0,8,5,2,7,0,0,0,27,3,30
sp16,162,ROOSEVELT,POLI,Polit Sci,0,0,0,1,2,3,4,6,10,10,18,28,14,22,36,0,0,0,29,48,77
sp16,162,ROOSEVELT,POLI,PolSc-Amer,0,0,0,0,1,1,3,2,5,2,3,5,4,7,11,0,0,0,9,13,22
sp16,162,ROOSEVELT,POLI,PolSc-Comp,0,0,0,2,0,2,0,1,1,2,0,2,3,2,5,0,0,0,7,3,10
sp16,162,ROOSEVELT,POLI,PolSc-Intl,0,0,0,0,2,2,3,6,9,18,12,30,22,24,46,0,0,0,43,44,87
sp16,162,ROOSEVELT,POLI,PolSc-PLaw,0,0,0,0,0,0,2,2,4,1,9,10,7,8,15,0,0,0,10,19,29
sp16,162,ROOSEVELT,POLI,PolSc-PPol,0,0,0,0,0,0,0,1,1,1,1,2,3,3,6,0,0,0,4,5,9
sp16,162,ROOSEVELT,POLI,PolSc-Thry,0,0,0,1,0,1,0,1,1,2,0,2,0,3,3,0,0,0,3,4,7
sp16,162,ROOSEVELT,PSYC,CogBehNeur,0,0,0,0,0,0,0,0,0,0,1,1,1,3,4,0,0,0,1,4,5
sp16,162,ROOSEVELT,PSYC,Psyc/ClPsy,0,0,0,1,4,5,1,3,4,2,8,10,6,9,15,0,0,0,10,24,34
sp16,162,ROOSEVELT,PSYC,Psyc/CogPs,0,0,0,0,0,0,1,0,1,1,2,3,0,3,3,0,0,0,2,5,7
sp16,162,ROOSEVELT,PSYC,Psyc/DelPs,0,0,0,0,2,2,1,5,6,0,3,3,0,3,3,0,0,0,1,13,14
sp16,162,ROOSEVELT,PSYC,Psyc/HumHl,0,0,0,0,0,0,1,3,4,0,5,5,3,8,11,0,0,0,4,16,20
sp16,162,ROOSEVELT,PSYC,Psyc/SocPs,0,0,0,0,1,1,0,3,3,1,6,7,4,6,10,0,0,0,5,16,21
sp16,162,ROOSEVELT,PSYC,Psychology,0,0,0,0,8,8,3,15,18,9,26,35,8,40,48,0,0,0,20,89,109
sp16,162,ROOSEVELT,PSYC,RusEE&EStd,0,0,0,0,0,0,0,0,0,1,0,1,0,0,0,0,0,0,1,0,1
sp16,162,ROOSEVELT,SE,Engin Sci,0,0,0,0,0,0,0,0,0,1,1,2,0,0,0,0,0,0,1,1,2
sp16,162,ROOSEVELT,SE,Struct Eng,0,0,0,0,0,0,7,2,9,5,6,11,25,8,33,0,0,0,37,16,53
sp16,162,ROOSEVELT,SIO,Earth Sci,0,0,0,0,0,0,0,1,1,2,0,2,3,5,8,0,0,0,5,6,11
sp16,162,ROOSEVELT,SIO,Marine Bio,0,0,0,1,0,1,1,6,7,4,4,8,5,9,14,0,0,0,11,19,30
sp16,162,ROOSEVELT,SOC,SocCulCom,0,0,0,0,0,0,0,2,2,0,3,3,0,0,0,0,0,0,0,5,5
sp16,162,ROOSEVELT,SOC,SocEconSoc,0,0,0,0,0,0,1,1,2,0,0,0,0,0,0,0,0,0,1,1,2
sp16,162,ROOSEVELT,SOC,SocIntlStu,0,0,0,0,0,0,0,0,0,0,0,0,0,2,2,0,0,0,0,2,2
sp16,162,ROOSEVELT,SOC,Sociology,0,0,0,0,1,1,1,4,5,4,4,8,2,7,9,0,0,0,7,16,23
sp16,162,ROOSEVELT,SOC,SocLawSoc,0,0,0,0,0,0,0,2,2,0,1,1,0,4,4,0,0,0,0,7,7
sp16,162,ROOSEVELT,SOC,SocSciMed,0,0,0,0,0,0,0,1,1,0,0,0,0,4,4,0,0,0,0,5,5
sp16,162,ROOSEVELT,SOC,SocSolneq,0,0,0,0,0,0,0,0,0,0,0,0,0,3,3,0,0,0,0,3,3
sp16,162,ROOSEVELT,THEA,Dance,0,0,0,0,0,0,0,0,0,0,0,0,1,1,2,0,0,0,1,1,2
sp16,162,ROOSEVELT,THEA,Theatre,0,0,0,1,0,1,2,4,6,0,2,2,4,5,9,0,0,0,7,11,18
sp16,162,ROOSEVELT,TWS,ThirdWldSt,0,0,0,0,0,0,0,0,0,0,0,0,0,1,1,0,0,0,0,1,1
sp16,162,ROOSEVELT,UNAF,UndecHumAr,0,0,0,0,0,0,1,4,5,0,0,0,0,0,0,0,0,0,1,4,5
sp16,162,ROOSEVELT,UNAF,Undeclared,0,0,0,15,1,16,29,25,54,3,1,4,0,0,0,0,0,0,47,27,74
sp16,162,ROOSEVELT,UNAF,UndecPhysS,0,0,0,1,0,1,4,2,6,1,0,1,0,0,0,0,0,0,6,2,8
sp16,162,ROOSEVELT,UNAF,UndecSocSc,0,0,0,1,4,5,3,5,8,0,0,0,0,0,0,0,0,0,4,9,13
sp16,162,ROOSEVELT,USP,Urb Stu&Pl,0,0,0,0,1,1,2,1,3,3,1,4,1,3,4,0,0,0,6,6,12
sp16,162,ROOSEVELT,VIS,Art Hst/Cr,0,0,0,0,0,0,0,0,0,0,1,1,0,2,2,0,0,0,0,3,3
sp16,162,ROOSEVELT,VIS,Media,0,0,0,1,1,2,3,4,7,5,2,7,4,5,9,0,0,0,13,12,25
sp16,162,ROOSEVELT,VIS,Spec Desgn,0,0,0,0,1,1,0,0,0,0,0,0,0,1,1,0,0,0,0,2,2
sp16,162,ROOSEVELT,VIS,Studio VA,0,0,0,0,0,0,0,0,0,1,5,6,0,6,6,0,0,0,1,11,12
sp16,162,ROOSEVELT,VIS,VA-CompArt,0,0,0,1,3,4,1,1,2,1,2,3,2,5,7,0,0,0,5,11,16
sp16,162,SIXTH,ANTH,Anth-Arch,0,0,0,0,0,0,1,0,1,0,0,0,0,3,3,0,0,0,1,3,4
sp16,162,SIXTH,ANTH,Anth-Biol,0,0,0,0,0,0,0,0,0,0,1,1,0,1,1,0,0,0,0,2,2
sp16,162,SIXTH,ANTH,Anth-Soci,0,0,0,0,0,0,0,0,0,0,1,1,0,2,2,0,0,0,0,3,3
sp16,162,SIXTH,BENG,Bioen:Binf,0,0,0,0,0,0,0,2,2,1,1,2,6,9,15,0,0,0,7,12,19
sp16,162,SIXTH,BENG,BioengBioS,0,0,0,0,1,1,0,3,3,3,2,5,5,5,10,0,0,0,8,11,19
sp16,162,SIXTH,BENG,BioengBiot,0,0,0,0,0,0,1,0,1,4,2,6,8,6,14,0,0,0,13,8,21
sp16,162,SIXTH,BENG,Bioengin,0,0,0,0,0,0,0,0,0,0,0,0,8,4,12,0,0,0,8,4,12
sp16,162,SIXTH,BIOL,Bioc/CellB,0,0,0,3,5,8,25,21,46,31,27,58,42,44,86,0,0,0,101,97,198
sp16,162,SIXTH,BIOL,BiolBioinf,0,0,0,0,0,0,5,4,9,3,3,6,3,3,6,0,0,0,11,10,21
sp16,162,SIXTH,BIOL,Ec/Beh/Evo,0,0,0,0,0,0,1,2,3,2,6,8,2,4,6,0,0,0,5,12,17
sp16,162,SIXTH,BIOL,Genl Biol,0,0,0,4,2,6,9,17,26,11,19,30,25,38,63,0,0,0,49,76,125
sp16,162,SIXTH,BIOL,Human Bio,0,0,0,3,6,9,11,33,44,28,46,74,53,55,108,0,0,0,95,140,235
sp16,162,SIXTH,BIOL,Microbiol,0,0,0,0,0,0,2,1,3,4,8,12,8,6,14,0,0,0,14,15,29
sp16,162,SIXTH,BIOL,Molec Biol,0,0,0,1,0,1,3,3,6,5,10,15,7,7,14,0,0,0,16,20,36
sp16,162,SIXTH,BIOL,PhyslNeuro,0,0,0,1,4,5,14,16,30,15,19,34,33,35,68,0,0,0,63,74,137
sp16,162,SIXTH,CENG,Chem Engin,0,0,0,0,0,0,1,0,1,7,3,10,44,21,65,0,0,0,52,24,76
sp16,162,SIXTH,CGS,CritGendSt,0,0,0,0,0,0,0,0,0,1,0,1,2,0,2,0,0,0,3,0,3
sp16,162,SIXTH,CHEM,Bioch/Chem,0,0,0,0,0,0,3,4,7,4,5,9,7,5,12,0,0,0,14,14,28
sp16,162,SIXTH,CHEM,Bioinform,0,0,0,0,0,0,2,2,4,2,0,2,1,0,1,0,0,0,5,2,7
sp16,162,SIXTH,CHEM,Chem Educ,0,0,0,0,0,0,0,0,0,0,0,0,0,1,1,0,0,0,0,1,1
sp16,162,SIXTH,CHEM,Chemistry,0,0,0,1,1,2,3,4,7,3,5,8,4,6,10,0,0,0,11,16,27
sp16,162,SIXTH,CHEM,Envir Chem,0,0,0,0,0,0,0,0,0,0,1,1,1,1,2,0,0,0,1,2,3
sp16,162,SIXTH,CHEM,MolecSynth,0,0,0,0,0,0,1,1,2,0,0,0,1,0,1,0,0,0,2,1,3
sp16,162,SIXTH,CHEM,Pharm Chem,0,0,0,2,1,3,4,5,9,3,8,11,9,16,25,0,0,0,18,30,48
sp16,162,SIXTH,CHIN,Chinese St,0,0,0,0,0,0,0,0,0,0,1,1,0,1,1,0,0,0,0,2,2
sp16,162,SIXTH,COGS,Cog Sci,0,0,0,0,0,0,3,5,8,5,5,10,6,5,11,0,0,0,14,15,29
sp16,162,SIXTH,COGS,CogBehNeur,0,0,0,0,0,0,0,1,1,1,0,1,1,0,1,0,0,0,2,1,3
sp16,162,SIXTH,COGS,CogSc/ClAs,0,0,0,0,0,0,0,2,2,0,0,0,1,1,2,0,0,0,1,3,4
sp16,162,SIXTH,COGS,CogSc/Comp,0,0,0,0,0,0,4,1,5,6,1,7,3,0,3,0,0,0,13,2,15
sp16,162,SIXTH,COGS,CogSc/HCI,0,0,0,3,0,3,4,6,10,14,5,19,13,10,23,0,0,0,34,21,55
sp16,162,SIXTH,COGS,CogSc/HCog,0,0,0,0,0,0,0,2,2,2,5,7,2,1,3,0,0,0,4,8,12
sp16,162,SIXTH,COGS,CogSc/Neur,0,0,0,0,1,1,1,2,3,2,2,4,5,9,14,0,0,0,8,14,22
sp16,162,SIXTH,COMM,Communic,0,0,0,1,4,5,5,14,19,17,44,61,21,61,82,0,0,0,44,123,167
sp16,162,SIXTH,CSE,Comp Sci,0,0,0,3,0,3,4,5,9,57,10,67,210,38,248,0,0,0,274,53,327
sp16,162,SIXTH,CSE,CompEngCSE,0,0,0,0,0,0,1,0,1,7,0,7,34,3,37,0,0,0,42,3,45
sp16,162,SIXTH,CSE,CompScBinf,0,0,0,0,0,0,0,0,0,2,0,2,5,5,10,0,0,0,7,5,12
sp16,162,SIXTH,ECE,CompEngECE,0,0,0,1,0,1,6,4,10,13,1,14,33,4,37,0,0,0,53,9,62
sp16,162,SIXTH,ECE,Electr Eng,0,0,0,1,0,1,12,2,14,22,6,28,116,16,132,0,0,0,151,24,175
sp16,162,SIXTH,ECE,EleEng&Soc,0,0,0,0,0,0,0,0,0,0,0,0,1,0,1,0,0,0,1,0,1
sp16,162,SIXTH,ECE,Engin Phys,0,0,0,0,0,0,0,0,0,1,0,1,0,0,0,0,0,0,1,0,1
sp16,162,SIXTH,ECE,Pr-EngPhys,0,0,0,0,0,0,0,1,1,1,0,1,0,0,0,0,0,0,1,1,2
sp16,162,SIXTH,ECON,Ec-Mth&Ecn,0,0,0,3,2,5,3,5,8,10,5,15,9,10,19,0,0,0,25,22,47
sp16,162,SIXTH,ECON,Econ-MgtSc,0,1,1,4,0,4,7,8,15,19,14,33,43,26,69,0,0,0,73,49,122
sp16,162,SIXTH,ECON,Economics,0,0,0,10,7,17,23,15,38,52,35,87,58,26,84,0,0,0,143,83,226
sp16,162,SIXTH,ECON,EnvSys(EB),0,0,0,1,0,1,1,0,1,1,2,3,1,3,4,0,0,0,4,5,9
sp16,162,SIXTH,ECON,EnvSys(EC),0,0,0,0,1,1,1,0,1,2,1,3,0,0,0,0,0,0,3,2,5
sp16,162,SIXTH,ECON,EnvSys(EP),0,0,0,0,0,0,0,0,0,0,1,1,2,0,2,0,0,0,2,1,3
sp16,162,SIXTH,ECON,EnvSys(ES),0,0,0,0,1,1,3,1,4,3,1,4,2,3,5,0,0,0,8,6,14
sp16,162,SIXTH,ETHN,Ethnic St,0,0,0,0,0,0,0,0,0,0,1,1,0,0,0,0,0,0,0,1,1
sp16,162,SIXTH,FPMU,Public Hlt,0,0,0,0,0,0,0,5,5,3,17,20,9,33,42,0,0,0,12,55,67
sp16,162,SIXTH,GLBH,Global Hlt,0,0,0,0,0,0,0,3,3,1,2,3,1,2,3,0,0,0,2,7,9
sp16,162,SIXTH,GMST,German Stu,0,0,0,0,1,1,0,0,0,0,0,0,0,0,0,0,0,0,0,1,1
sp16,162,SIXTH,HDP,Human Dev,0,0,0,0,0,0,0,2,2,0,5,5,3,14,17,0,0,0,3,21,24
sp16,162,SIXTH,HDP,Pr-HumnDev,0,0,0,0,1,1,0,4,4,0,4,4,0,0,0,0,0,0,0,9,9
sp16,162,SIXTH,HIST,History,0,0,0,1,0,1,2,1,3,2,2,4,2,2,4,0,0,0,7,5,12
sp16,162,SIXTH,INTL,InSt-InBus,0,0,0,8,5,13,7,8,15,17,17,34,8,8,16,0,0,0,40,38,78
sp16,162,SIXTH,INTL,Int-5yrEC,0,0,0,0,0,0,0,0,0,0,0,0,1,0,1,0,0,0,1,0,1
sp16,162,SIXTH,INTL,IntSt-Anth,0,0,0,0,0,0,0,1,1,0,1,1,2,2,4,0,0,0,2,4,6
sp16,162,SIXTH,INTL,IntSt-Econ,0,0,0,2,2,4,0,2,2,3,3,6,5,3,8,0,0,0,10,10,20
sp16,162,SIXTH,INTL,IntSt-Hist,0,0,0,0,1,1,0,0,0,0,0,0,0,0,0,0,0,0,0,1,1
sp16,162,SIXTH,INTL,IntSt-Ling,0,0,0,0,0,0,0,0,0,0,0,0,0,1,1,0,0,0,0,1,1
sp16,162,SIXTH,INTL,IntSt-Lit,0,0,0,0,0,0,0,1,1,0,0,0,0,1,1,0,0,0,0,2,2
sp16,162,SIXTH,INTL,IntSt-PolS,0,0,0,0,4,4,3,2,5,1,1,2,2,5,7,0,0,0,6,12,18
sp16,162,SIXTH,LING,Lang Stu,0,0,0,0,0,0,0,0,0,0,0,0,1,0,1,0,0,0,1,0,1
sp16,162,SIXTH,LING,Ling-CogLn,0,0,0,0,0,0,0,0,0,0,1,1,0,1,1,0,0,0,0,2,2
sp16,162,SIXTH,LING,Ling-LSoc,0,0,0,0,0,0,0,0,0,0,0,0,0,1,1,0,0,0,0,1,1
sp16,162,SIXTH,LING,Linguistcs,0,0,0,0,1,1,0,0,0,0,0,0,1,3,4,0,0,0,1,4,5
sp16,162,SIXTH,LIT,Lit/Engl,0,0,0,0,0,0,1,2,3,0,0,0,1,4,5,0,0,0,2,6,8
sp16,162,SIXTH,LIT,Lit/Writng,0,0,0,0,0,0,1,3,4,5,3,8,3,6,9,0,0,0,9,12,21
sp16,162,SIXTH,MAE,Aerosp Eng,0,0,0,2,0,2,9,3,12,8,1,9,21,6,27,0,0,0,40,10,50
sp16,162,SIXTH,MAE,Envir Eng,0,0,0,0,0,0,5,1,6,3,4,7,17,9,26,0,0,0,25,14,39
sp16,162,SIXTH,MAE,Mech Engin,0,0,0,1,0,1,4,1,5,8,4,12,25,8,33,0,0,0,38,13,51
sp16,162,SIXTH,MATH,Appld Math,0,0,0,6,6,12,12,17,29,11,12,23,10,13,23,0,0,0,39,48,87
sp16,162,SIXTH,MATH,Math/SecEd,0,0,0,0,0,0,1,1,2,1,0,1,0,1,1,0,0,0,2,2,4
sp16,162,SIXTH,MATH,Mathematcs,0,0,0,4,1,5,2,2,4,7,3,10,9,3,12,0,0,0,22,9,31
sp16,162,SIXTH,MATH,Mth-CompSc,0,0,0,17,5,22,68,30,98,66,24,90,21,8,29,0,0,0,172,67,239
sp16,162,SIXTH,MATH,Mth-Mth&Ec,0,0,0,4,1,5,5,6,11,8,5,13,6,3,9,0,0,0,23,15,38
sp16,162,SIXTH,MATH,Mth-SciCom,0,0,0,0,0,0,0,1,1,0,0,0,0,0,0,0,0,0,0,1,1
sp16,162,SIXTH,MATH,Mth/ApldSc,0,0,0,1,0,1,2,1,3,1,1,2,0,0,0,0,0,0,4,2,6
sp16,162,SIXTH,MATH,Prob&Stats,0,0,0,0,1,1,4,4,8,6,4,10,4,2,6,0,0,0,14,11,25
sp16,162,SIXTH,MUS,Mu-CompArt,0,0,0,4,0,4,3,1,4,5,3,8,10,3,13,0,0,0,22,7,29
sp16,162,SIXTH,MUS,Music,0,0,0,0,1,1,0,1,1,0,0,0,5,1,6,0,0,0,5,3,8
sp16,162,SIXTH,MUS,Music Hum,0,0,0,0,0,0,0,0,0,0,0,0,1,0,1,0,0,0,1,0,1
sp16,162,SIXTH,NENG,NanoEng,0,0,0,3,1,4,5,1,6,9,0,9,27,7,34,0,0,0,44,9,53
sp16,162,SIXTH,PHIL,Philosophy,0,0,0,0,0,0,2,0,2,2,0,2,4,2,6,0,0,0,8,2,10
sp16,162,SIXTH,PHYS,Biophysics,0,0,0,0,0,0,2,1,3,0,0,0,1,1,2,0,0,0,3,2,5
sp16,162,SIXTH,PHYS,Gen Physcs,0,0,0,0,0,0,1,0,1,0,0,0,2,0,2,0,0,0,3,0,3
sp16,162,SIXTH,PHYS,Phys/Astro,0,0,0,0,0,0,3,3,6,1,0,1,6,3,9,0,0,0,10,6,16
sp16,162,SIXTH,PHYS,Phys/Comp,0,0,0,0,0,0,1,0,1,2,1,3,1,0,1,0,0,0,4,1,5
sp16,162,SIXTH,PHYS,Phys/Mtrls,0,0,0,0,0,0,2,0,2,7,1,8,3,0,3,0,0,0,12,1,13
sp16,162,SIXTH,PHYS,Physics,0,0,0,3,2,5,9,1,10,11,0,11,13,1,14,0,0,0,36,4,40
sp16,162,SIXTH,POLI,Polit Sci,0,0,0,1,0,1,3,6,9,0,5,5,10,12,22,0,0,0,14,23,37
sp16,162,SIXTH,POLI,PolSc-Amer,0,0,0,0,0,0,0,1,1,0,0,0,0,1,1,0,0,0,0,2,2
sp16,162,SIXTH,POLI,PolSc-Comp,0,0,0,0,0,0,0,0,0,0,0,0,0,1,1,0,0,0,0,1,1
sp16,162,SIXTH,POLI,PolSc-Intl,0,0,0,0,1,1,2,1,3,5,3,8,3,4,7,0,0,0,10,9,19
sp16,162,SIXTH,POLI,PolSc-PLaw,0,0,0,0,1,1,1,1,2,1,2,3,1,6,7,0,0,0,3,10,13
sp16,162,SIXTH,POLI,PolSc-PPol,0,0,0,0,0,0,0,0,0,1,1,2,3,0,3,0,0,0,4,1,5
sp16,162,SIXTH,POLI,PolSc-Thry,0,0,0,0,0,0,0,0,0,0,0,0,0,1,1,0,0,0,0,1,1
sp16,162,SIXTH,PSYC,CogBehNeur,0,0,0,0,0,0,0,0,0,0,1,1,0,0,0,0,0,0,0,1,1
sp16,162,SIXTH,PSYC,Psyc/ClPsy,0,0,0,0,0,0,0,6,6,3,10,13,7,17,24,0,0,0,10,33,43
sp16,162,SIXTH,PSYC,Psyc/CogPs,0,0,0,0,0,0,0,0,0,0,1,1,1,1,2,0,0,0,1,2,3
sp16,162,SIXTH,PSYC,Psyc/DelPs,0,0,0,1,1,2,0,0,0,0,4,4,0,1,1,0,0,0,1,6,7
sp16,162,SIXTH,PSYC,Psyc/HumHl,0,0,0,0,1,1,0,2,2,1,3,4,1,2,3,0,0,0,2,8,10
sp16,162,SIXTH,PSYC,Psyc/SenPr,0,0,0,0,0,0,0,0,0,0,0,0,0,1,1,0,0,0,0,1,1
sp16,162,SIXTH,PSYC,Psyc/SocPs,0,0,0,1,2,3,0,3,3,0,2,2,2,3,5,0,0,0,3,10,13
sp16,162,SIXTH,PSYC,Psychology,0,0,0,3,6,9,3,8,11,4,11,15,13,31,44,0,0,0,23,56,79
sp16,162,SIXTH,RELI,Relig/Stu,0,0,0,0,0,0,0,0,0,0,0,0,1,0,1,0,0,0,1,0,1
sp16,162,SIXTH,SE,Engin Sci,0,0,0,0,0,0,1,1,2,0,0,0,0,0,0,0,0,0,1,1,2
sp16,162,SIXTH,SE,Struct Eng,0,0,0,1,0,1,9,4,13,22,6,28,56,21,77,0,0,0,88,31,119
sp16,162,SIXTH,SIO,Earth Sci,0,0,0,0,0,0,0,1,1,2,0,2,0,1,1,0,0,0,2,2,4
sp16,162,SIXTH,SIO,Marine Bio,0,0,0,1,1,2,2,2,4,4,4,8,2,7,9,0,0,0,9,14,23
sp16,162,SIXTH,SOC,SocCulCom,0,0,0,0,0,0,1,0,1,1,2,3,0,3,3,0,0,0,2,5,7
sp16,162,SIXTH,SOC,SocEconSoc,0,0,0,0,0,0,0,0,0,1,1,2,2,0,2,0,0,0,3,1,4
sp16,162,SIXTH,SOC,SocIntlStu,0,0,0,0,0,0,0,0,0,0,0,0,0,1,1,0,0,0,0,1,1
sp16,162,SIXTH,SOC,Sociology,0,0,0,1,0,1,1,3,4,3,4,7,2,7,9,0,0,0,7,14,21
sp16,162,SIXTH,SOC,SocLawSoc,0,0,0,0,0,0,0,0,0,4,2,6,0,2,2,0,0,0,4,4,8
sp16,162,SIXTH,SOC,SocSciMed,0,0,0,0,0,0,0,1,1,0,0,0,0,0,0,0,0,0,0,1,1
sp16,162,SIXTH,SOC,SocSolneq,0,0,0,0,0,0,0,0,0,0,1,1,0,3,3,0,0,0,0,4,4
sp16,162,SIXTH,THEA,Theatre,0,0,0,0,3,3,2,5,7,2,3,5,3,7,10,0,0,0,7,18,25
sp16,162,SIXTH,UNAF,UndecHumAr,0,0,0,0,1,1,2,2,4,0,0,0,0,0,0,0,0,0,2,3,5
sp16,162,SIXTH,UNAF,Undeclared,0,0,0,22,10,32,47,18,65,5,1,6,0,0,0,0,0,0,74,29,103
sp16,162,SIXTH,UNAF,UndecPhysS,0,0,0,1,0,1,1,3,4,0,1,1,0,0,0,0,0,0,2,4,6
sp16,162,SIXTH,UNAF,UndecSocSc,0,0,0,0,0,0,0,3,3,1,0,1,0,0,0,0,0,0,1,3,4
sp16,162,SIXTH,USP,Urb Stu&Pl,0,0,0,2,0,2,0,0,0,2,4,6,4,8,12,0,0,0,8,12,20
sp16,162,SIXTH,VIS,Art Hst/Cr,0,0,0,0,0,0,0,0,0,0,3,3,0,4,4,0,0,0,0,7,7
sp16,162,SIXTH,VIS,Media,0,0,0,0,10,10,9,11,20,10,15,25,22,16,38,0,0,0,41,52,93
sp16,162,SIXTH,VIS,Spec Desgn,0,0,0,0,0,0,2,4,6,3,1,4,0,0,0,0,0,0,5,5,10
sp16,162,SIXTH,VIS,Studio VA,0,0,0,1,1,2,0,4,4,4,9,13,3,7,10,0,0,0,8,21,29
sp16,162,SIXTH,VIS,VA-CompArt,0,0,0,3,0,3,4,7,11,5,10,15,9,16,25,0,0,0,21,33,54
sp16,162,WARREN,ANTH,Anth-Arch,0,0,0,0,1,1,0,0,0,0,0,0,0,1,1,0,0,0,0,2,2
sp16,162,WARREN,ANTH,Anth-Biol,0,0,0,0,0,0,0,1,1,0,1,1,1,0,1,0,0,0,1,2,3
sp16,162,WARREN,ANTH,Anth-Soci,0,0,0,0,0,0,0,0,0,0,0,0,1,2,3,0,0,0,1,2,3
sp16,162,WARREN,BENG,Bioen:Binf,0,0,0,0,1,1,3,1,4,4,1,5,10,13,23,0,0,0,17,16,33
sp16,162,WARREN,BENG,BioengBioS,0,0,0,0,0,0,1,2,3,2,3,5,6,2,8,0,0,0,9,7,16
sp16,162,WARREN,BENG,BioengBiot,0,0,0,1,0,1,4,2,6,10,4,14,24,29,53,0,0,0,39,35,74
sp16,162,WARREN,BENG,Bioengin,0,0,0,2,1,3,2,2,4,6,2,8,26,16,42,0,0,0,36,21,57
sp16,162,WARREN,BIOL,Bioc/CellB,0,0,0,3,4,7,14,16,30,21,21,42,42,55,97,0,0,0,80,96,176
sp16,162,WARREN,BIOL,BiolBioinf,0,0,0,3,0,3,3,2,5,3,1,4,2,1,3,0,0,0,11,4,15
sp16,162,WARREN,BIOL,Ec/Beh/Evo,0,0,0,0,0,0,1,2,3,0,1,1,3,6,9,0,0,0,4,9,13
sp16,162,WARREN,BIOL,Genl Biol,0,0,0,1,3,4,5,7,12,8,10,18,24,43,67,0,0,0,38,63,101
sp16,162,WARREN,BIOL,Human Bio,0,0,0,0,2,2,13,20,33,12,20,32,35,52,87,0,0,0,60,94,154
sp16,162,WARREN,BIOL,Microbiol,0,0,0,0,1,1,2,2,4,5,2,7,3,6,9,0,0,0,10,11,21
sp16,162,WARREN,BIOL,Molec Biol,0,0,0,0,0,0,2,6,8,4,2,6,9,5,14,0,0,0,15,13,28
sp16,162,WARREN,BIOL,PhyslNeuro,0,0,0,0,1,1,4,13,17,9,14,23,33,29,62,0,0,0,46,57,103
sp16,162,WARREN,CENG,Chem Engin,0,0,0,1,0,1,4,4,8,12,5,17,82,39,121,0,0,0,99,48,147
sp16,162,WARREN,CGS,CritGendSt,0,0,0,0,0,0,0,0,0,0,0,0,1,0,1,0,0,0,1,0,1
sp16,162,WARREN,CHEM,Bioch/Chem,0,0,0,0,1,1,5,7,12,4,4,8,10,10,20,0,0,0,19,22,41
sp16,162,WARREN,CHEM,Bioinform,0,0,0,0,0,0,0,0,0,0,0,0,0,1,1,0,0,0,0,1,1
sp16,162,WARREN,CHEM,Chem Phys,0,0,0,0,0,0,1,0,1,0,0,0,0,0,0,0,0,0,1,0,1
sp16,162,WARREN,CHEM,Chemistry,0,0,0,0,1,1,6,6,12,6,7,13,2,6,8,0,0,0,14,20,34
sp16,162,WARREN,CHEM,Envir Chem,0,0,0,0,0,0,0,0,0,0,0,0,2,0,2,0,0,0,2,0,2
sp16,162,WARREN,CHEM,MolecSynth,0,0,0,0,0,0,0,1,1,0,0,0,0,0,0,0,0,0,0,1,1
sp16,162,WARREN,CHEM,Pharm Chem,0,0,0,0,1,1,2,3,5,3,3,6,3,16,19,0,0,0,8,23,31
sp16,162,WARREN,CHIN,Chinese St,0,0,0,0,0,0,0,0,0,0,0,0,0,2,2,0,0,0,0,2,2
sp16,162,WARREN,COGS,Cog Sci,0,0,0,0,0,0,0,4,4,2,2,4,5,2,7,0,0,0,7,8,15
sp16,162,WARREN,COGS,CogBehNeur,0,0,0,0,0,0,0,0,0,1,0,1,0,1,1,0,0,0,1,1,2
sp16,162,WARREN,COGS,CogSc/ClAs,0,0,0,0,0,0,0,0,0,0,1,1,2,3,5,0,0,0,2,4,6
sp16,162,WARREN,COGS,CogSc/Comp,0,0,0,0,0,0,2,0,2,1,1,2,1,3,4,0,0,0,4,4,8
sp16,162,WARREN,COGS,CogSc/HCI,0,0,0,0,1,1,4,5,9,6,3,9,6,10,16,0,0,0,16,19,35
sp16,162,WARREN,COGS,CogSc/HCog,0,0,0,0,0,0,1,0,1,0,0,0,1,1,2,0,0,0,2,1,3
sp16,162,WARREN,COGS,CogSc/Neur,0,0,0,0,1,1,3,2,5,1,2,3,0,8,8,0,0,0,4,13,17
sp16,162,WARREN,COMM,Communic,0,0,0,1,3,4,0,4,4,4,20,24,8,18,26,0,0,0,13,45,58
sp16,162,WARREN,CSE,Comp Sci,0,0,0,4,0,4,43,19,62,93,20,113,296,64,360,0,0,0,436,103,539
sp16,162,WARREN,CSE,CompEngCSE,0,0,0,1,0,1,9,2,11,21,3,24,66,7,73,0,0,0,97,12,109
sp16,162,WARREN,CSE,CompScBinf,0,0,0,0,0,0,0,0,0,1,0,1,4,4,8,0,0,0,5,4,9
sp16,162,WARREN,ECE,CompEngECE,0,0,0,1,0,1,14,3,17,29,0,29,41,7,48,0,0,0,85,10,95
sp16,162,WARREN,ECE,Electr Eng,0,0,0,4,0,4,34,6,40,31,9,40,142,27,169,0,0,0,211,42,253
sp16,162,WARREN,ECE,Engin Phys,0,0,0,0,0,0,0,1,1,3,0,3,2,0,2,0,0,0,5,1,6
sp16,162,WARREN,ECE,Pr-EngPhys,0,0,0,0,0,0,1,1,2,1,1,2,0,0,0,0,0,0,2,2,4
sp16,162,WARREN,ECON,Ec-Mth&Ecn,0,0,0,0,2,2,7,5,12,7,4,11,6,1,7,0,0,0,20,12,32
sp16,162,WARREN,ECON,Econ-MgtSc,0,0,0,2,1,3,9,7,16,15,11,26,41,26,67,0,0,0,67,45,112
sp16,162,WARREN,ECON,Economics,0,0,0,5,1,6,8,6,14,39,17,56,68,34,102,0,0,0,120,58,178
sp16,162,WARREN,ECON,EnvSys(EB),0,0,0,0,0,0,0,2,2,0,1,1,0,2,2,0,0,0,0,5,5
sp16,162,WARREN,ECON,EnvSys(EP),0,0,0,0,0,0,0,2,2,0,0,0,0,0,0,0,0,0,0,2,2
sp16,162,WARREN,ECON,EnvSys(ES),0,0,0,0,0,0,0,0,0,1,0,1,0,1,1,0,0,0,1,1,2
sp16,162,WARREN,ETHN,Ethnic St,0,0,0,0,0,0,0,1,1,0,1,1,2,2,4,0,0,0,2,4,6
sp16,162,WARREN,FPMU,Public Hlt,0,0,0,0,0,0,1,0,1,5,9,14,5,12,17,0,0,0,11,21,32
sp16,162,WARREN,GLBH,Global Hlt,0,0,0,0,0,0,0,0,0,0,3,3,0,5,5,0,0,0,0,8,8
sp16,162,WARREN,HDP,Human Dev,0,0,0,0,0,0,0,0,0,0,4,4,2,10,12,0,0,0,2,14,16
sp16,162,WARREN,HDP,Pr-HumnDev,0,0,0,0,0,0,0,4,4,0,1,1,0,1,1,0,0,0,0,6,6
sp16,162,WARREN,HIST,History,0,0,0,0,0,0,2,2,4,0,2,2,6,0,6,0,0,0,8,4,12
sp16,162,WARREN,INTL,InSt-InBus,0,0,0,6,3,9,3,6,9,9,7,16,10,3,13,0,0,0,28,19,47
sp16,162,WARREN,INTL,Int-5yrEC,0,0,0,0,0,0,0,0,0,0,0,0,1,0,1,0,0,0,1,0,1
sp16,162,WARREN,INTL,Int-5yrPS,0,0,0,0,0,0,0,0,0,0,0,0,1,1,2,0,0,0,1,1,2
sp16,162,WARREN,INTL,IntSt-Anth,0,0,0,0,0,0,0,0,0,0,0,0,1,1,2,0,0,0,1,1,2
sp16,162,WARREN,INTL,IntSt-Econ,0,0,0,0,0,0,1,0,1,1,0,1,0,1,1,0,0,0,2,1,3
sp16,162,WARREN,INTL,IntSt-Ling,0,0,0,0,0,0,0,0,0,0,2,2,0,0,0,0,0,0,0,2,2
sp16,162,WARREN,INTL,IntSt-Lit,0,0,0,0,0,0,0,0,0,1,1,2,0,0,0,0,0,0,1,1,2
sp16,162,WARREN,INTL,IntSt-PolS,0,0,0,0,0,0,0,0,0,0,4,4,1,7,8,0,0,0,1,11,12
sp16,162,WARREN,INTL,IntSt-Soc,0,0,0,0,0,0,0,0,0,0,1,1,0,1,1,0,0,0,0,2,2
sp16,162,WARREN,LATI,LatinAm St,0,0,0,0,0,0,0,0,0,0,1,1,1,0,1,0,0,0,1,1,2
sp16,162,WARREN,LING,Ling-CogLn,0,0,0,0,0,0,0,1,1,0,0,0,0,1,1,0,0,0,0,2,2
sp16,162,WARREN,LING,Linguistcs,0,0,0,0,0,0,0,0,0,0,0,0,2,1,3,0,0,0,2,1,3
sp16,162,WARREN,LING,French Lit,0,0,0,0,0,0,0,0,0,0,0,0,1,0,1,0,0,0,1,0,1
sp16,162,WARREN,LING,Lit/Engl,0,0,0,0,0,0,0,0,0,1,1,2,0,1,1,0,0,0,1,2,3
sp16,162,WARREN,LING,Lit/World,0,0,0,0,0,0,0,0,0,1,0,1,0,1,1,0,0,0,1,1,2
sp16,162,WARREN,LING,Lit/Writng,0,0,0,0,0,0,1,1,2,1,0,1,2,9,11,0,0,0,4,10,14
sp16,162,WARREN,LING,Russian Lt,0,0,0,0,0,0,0,1,1,0,0,0,0,0,0,0,0,0,0,1,1
sp16,162,WARREN,LING,Spanish Lt,0,0,0,0,0,0,0,0,0,1,0,1,1,1,2,0,0,0,2,1,3
sp16,162,WARREN,MAE,Aerosp Eng,0,0,0,0,0,0,19,2,21,21,6,27,46,12,58,0,0,0,86,20,106
sp16,162,WARREN,MAE,Engin Sci,0,0,0,0,0,0,0,0,0,0,0,0,2,0,2,0,0,0,2,0,2
sp16,162,WARREN,MAE,Envir Eng,0,0,0,0,2,2,2,1,3,6,5,11,23,11,34,0,0,0,31,19,50
sp16,162,WARREN,MAE,Mech Engin,0,0,0,1,1,2,26,7,33,32,7,39,82,16,98,0,0,0,141,31,172
sp16,162,WARREN,MATH,Appld Math,0,0,0,4,5,9,7,12,19,7,7,14,10,7,17,0,0,0,28,31,59
sp16,162,WARREN,MATH,Math/SecEd,0,0,0,0,0,0,1,1,2,0,1,1,1,3,4,0,0,0,2,5,7
sp16,162,WARREN,MATH,Mathematcs,0,0,0,4,1,5,6,3,9,5,1,6,8,8,16,0,0,0,23,13,36
sp16,162,WARREN,MATH,Mth-CompSc,0,0,0,23,6,29,66,32,98,35,10,45,30,7,37,0,0,0,154,55,209
sp16,162,WARREN,MATH,Mth-Mth&Ec,0,0,0,4,6,10,6,3,9,5,8,13,6,9,15,0,0,0,21,26,47
sp16,162,WARREN,MATH,Mth-SciCom,0,0,0,0,0,0,1,0,1,1,0,1,0,0,0,0,0,0,2,0,2
sp16,162,WARREN,MATH,Mth/ApldSc,0,0,0,1,0,1,1,1,2,5,0,5,1,2,3,0,0,0,8,3,11
sp16,162,WARREN,MATH,Prob&Stats,0,0,0,1,1,2,2,5,7,6,8,14,4,6,10,0,0,0,13,20,33
sp16,162,WARREN,MUS,Mu-CompArt,0,0,0,1,0,1,2,1,3,0,0,0,3,0,3,0,0,0,6,1,7
sp16,162,WARREN,MUS,Music,0,0,0,0,0,0,1,0,1,2,0,2,1,0,1,0,0,0,4,0,4
sp16,162,WARREN,NENG,NanoEng,0,0,0,1,0,1,2,2,4,2,0,2,37,10,47,0,0,0,42,12,54
sp16,162,WARREN,PHIL,Philosophy,0,0,0,0,1,1,0,1,1,1,1,2,1,4,5,0,0,0,2,7,9
sp16,162,WARREN,PHYS,Biophysics,0,0,0,0,0,0,2,1,3,1,0,1,1,1,2,0,0,0,4,2,6
sp16,162,WARREN,PHYS,Gen Physcs,0,0,0,0,0,0,0,0,0,1,0,1,0,0,0,0,0,0,1,0,1
sp16,162,WARREN,PHYS,Phys/Astro,0,0,0,0,0,0,2,1,3,4,1,5,3,1,4,0,0,0,9,3,12
sp16,162,WARREN,PHYS,Phys/Comp,0,0,0,0,1,1,1,0,1,1,0,1,1,0,1,0,0,0,3,1,4
sp16,162,WARREN,PHYS,Phys/Mtrls,0,0,0,1,0,1,1,0,1,3,0,3,0,0,0,0,0,0,5,0,5
sp16,162,WARREN,PHYS,Physics,0,0,0,2,0,2,7,2,9,6,3,9,7,1,8,0,0,0,22,6,28
sp16,162,WARREN,POLI,Polit Sci,0,0,0,0,2,2,3,4,7,7,2,9,12,17,29,0,0,0,22,25,47
sp16,162,WARREN,POLI,PolSc-Amer,0,0,0,0,0,0,0,1,1,0,0,0,2,1,3,0,0,0,2,2,4
sp16,162,WARREN,POLI,PolSc-Comp,0,0,0,0,0,0,0,0,0,0,0,0,0,1,1,0,0,0,0,1,1
sp16,162,WARREN,POLI,PolSc-Intl,0,0,0,0,1,1,3,3,6,5,2,7,10,7,17,0,0,0,18,13,31
sp16,162,WARREN,POLI,PolSc-PLaw,0,0,0,0,0,0,2,5,7,3,4,7,3,4,7,0,0,0,8,13,21
sp16,162,WARREN,POLI,PolSc-PPol,0,0,0,0,0,0,0,0,0,1,0,1,2,0,2,0,0,0,3,0,3
sp16,162,WARREN,POLI,PolSc-Thry,0,0,0,0,0,0,0,0,0,1,0,1,0,1,1,0,0,0,1,1,2
sp16,162,WARREN,PSYC,CogBehNeur,0,0,0,0,0,0,0,0,0,0,0,0,0,1,1,0,0,0,0,1,1
sp16,162,WARREN,PSYC,Psyc/ClPsy,0,0,0,0,0,0,1,1,2,0,2,2,8,4,12,0,0,0,9,7,16
sp16,162,WARREN,PSYC,Psyc/CogPs,0,0,0,0,0,0,1,0,1,2,0,2,1,0,1,0,0,0,4,0,4
sp16,162,WARREN,PSYC,Psyc/DelPs,0,0,0,0,0,0,0,0,0,0,1,1,0,1,1,0,0,0,0,2,2
sp16,162,WARREN,PSYC,Psyc/HumHl,0,0,0,0,1,1,1,0,1,0,3,3,1,4,5,0,0,0,2,8,10
sp16,162,WARREN,PSYC,Psyc/SocPs,0,0,0,0,1,1,0,0,0,2,1,3,4,5,9,0,0,0,6,7,13
sp16,162,WARREN,PSYC,Psychology,0,0,0,1,0,1,0,3,3,6,16,22,11,31,42,0,0,0,18,50,68
sp16,162,WARREN,RELI,Relig/Stu,0,0,0,0,0,0,0,0,0,0,0,0,2,0,2,0,0,0,2,0,2
sp16,162,WARREN,RUSS,RusEE&EStd,0,0,0,0,0,0,0,0,0,0,0,0,0,1,1,0,0,0,0,1,1
sp16,162,WARREN,SE,Struct Eng,0,0,0,1,3,4,6,3,9,12,6,18,81,30,111,0,0,0,100,42,142
sp16,162,WARREN,SIO,Earth Sci,0,0,0,0,0,0,1,1,2,0,1,1,1,1,2,0,0,0,2,3,5
sp16,162,WARREN,SIO,Marine Bio,0,0,0,0,1,1,1,2,3,0,2,2,2,1,3,0,0,0,3,6,9
sp16,162,WARREN,SIO,SocEconSoc,0,0,0,0,0,0,0,0,0,0,0,0,1,1,2,0,0,0,1,1,2
sp16,162,WARREN,SIO,Sociology,0,0,0,0,0,0,1,2,3,0,2,2,1,6,7,0,0,0,2,10,12
sp16,162,WARREN,SIO,SocLawSoc,0,0,0,0,2,2,1,1,2,2,2,4,2,2,4,0,0,0,5,7,12
sp16,162,WARREN,SIO,SocSolneq,0,0,0,0,0,0,0,1,1,0,0,0,0,3,3,0,0,0,0,4,4
sp16,162,WARREN,THEA,Dance,0,0,0,0,0,0,0,1,1,0,0,0,0,1,1,0,0,0,0,2,2
sp16,162,WARREN,THEA,Theatre,0,0,0,0,2,2,1,0,1,0,0,0,2,4,6,0,0,0,3,6,9
sp16,162,WARREN,UNAF,IntcampVis,0,0,0,0,0,0,0,0,0,0,3,3,1,1,2,0,0,0,1,4,5
sp16,162,WARREN,UNAF,Undeclared,0,0,0,19,5,24,30,11,41,5,0,5,0,0,0,0,0,0,54,16,70
sp16,162,WARREN,UNAF,UndecPhysS,0,0,0,2,0,2,7,1,8,1,0,1,0,0,0,0,0,0,10,1,11
sp16,162,WARREN,UNAF,UndecSocSc,0,0,0,0,1,1,1,2,3,0,0,0,0,0,0,0,0,0,1,3,4
sp16,162,WARREN,USP,Urb Stu&Pl,0,0,0,0,0,0,1,0,1,3,0,3,4,2,6,0,0,0,8,2,10
sp16,162,WARREN,VIS,Media,0,0,0,0,0,0,3,0,3,2,0,2,5,2,7,0,0,0,10,2,12
sp16,162,WARREN,VIS,Spec Desgn,0,0,0,0,0,0,0,0,0,0,1,1,0,0,0,0,0,0,0,1,1
sp16,162,WARREN,VIS,Studio VA,0,0,0,0,0,0,0,0,0,0,2,2,0,3,3,0,0,0,0,5,5
sp16,162,WARREN,VIS,VA-CompArt,0,0,0,2,0,2,0,0,0,0,1,1,2,3,5,0,0,0,4,4,8
wi16,161,MARSHALL,ANTH,Anth-Arch,0,0,0,0,0,0,0,0,0,1,0,1,1,0,1,0,0,0,2,0,2
wi16,161,MARSHALL,ANTH,Anth-Biol,0,0,0,0,0,0,0,0,0,0,1,1,0,0,0,0,0,0,0,1,1
wi16,161,MARSHALL,ANTH,Anth-Soci,0,0,0,0,0,0,1,1,2,0,4,4,2,4,6,0,0,0,3,9,12
wi16,161,MARSHALL,BENG,Bioen:Binf,0,0,0,0,0,0,1,3,4,1,1,2,6,6,12,0,0,0,8,10,18
wi16,161,MARSHALL,BENG,BioengBioS,0,0,0,0,1,1,2,0,2,4,1,5,4,0,4,0,0,0,10,2,12
wi16,161,MARSHALL,BENG,BioengBiot,0,0,0,0,1,1,2,1,3,2,3,5,4,6,10,0,0,0,8,11,19
wi16,161,MARSHALL,BENG,Bioengin,0,0,0,0,0,0,1,1,2,0,1,1,6,4,10,0,0,0,7,6,13
wi16,161,MARSHALL,BIOL,Bioc/CellB,0,0,0,8,11,19,16,16,32,23,38,61,40,53,93,0,0,0,87,118,205
wi16,161,MARSHALL,BIOL,BiolBioinf,0,0,0,2,0,2,2,3,5,1,1,2,0,4,4,0,0,0,5,8,13
wi16,161,MARSHALL,BIOL,Ec/Beh/Evo,0,0,0,0,3,3,0,1,1,1,3,4,1,2,3,0,0,0,2,9,11
wi16,161,MARSHALL,BIOL,Genl Biol,0,0,0,6,6,12,11,20,31,14,28,42,27,53,80,0,0,0,58,107,165
wi16,161,MARSHALL,BIOL,Human Bio,0,0,0,7,27,34,20,53,73,34,44,78,41,80,121,0,0,0,102,204,306
wi16,161,MARSHALL,BIOL,Microbiol,0,0,0,0,0,0,2,6,8,3,7,10,8,10,18,0,0,0,13,23,36
wi16,161,MARSHALL,BIOL,Molec Biol,0,0,0,1,0,1,5,4,9,5,5,10,8,5,13,0,0,0,19,14,33
wi16,161,MARSHALL,BIOL,PhyslNeuro,0,0,0,6,7,13,14,16,30,18,32,50,21,37,58,0,0,0,59,92,151
wi16,161,MARSHALL,CENG,Chem Engin,0,0,0,0,0,0,2,4,6,7,2,9,35,22,57,0,0,0,44,28,72
wi16,161,MARSHALL,CGS,CritGendSt,0,0,0,0,1,1,0,0,0,0,0,0,0,0,0,0,0,0,0,1,1
wi16,161,MARSHALL,CHEM,Bioch/Chem,0,0,0,3,4,7,3,8,11,5,5,10,5,12,17,0,0,0,16,29,45
wi16,161,MARSHALL,CHEM,Bioinform,0,0,0,0,0,0,0,0,0,3,0,3,1,0,1,0,0,0,4,0,4
wi16,161,MARSHALL,CHEM,Chem Educ,0,0,0,0,0,0,0,0,0,0,0,0,1,0,1,0,0,0,1,0,1
wi16,161,MARSHALL,CHEM,Chem Phys,0,0,0,0,0,0,0,0,0,0,0,0,0,1,1,0,0,0,0,1,1
wi16,161,MARSHALL,CHEM,Chemistry,0,0,0,5,4,9,4,2,6,7,9,16,3,6,9,0,0,0,19,21,40
wi16,161,MARSHALL,CHEM,Envir Chem,0,0,0,0,0,0,0,0,0,3,1,4,0,1,1,0,0,0,3,2,5
wi16,161,MARSHALL,CHEM,MolecSynth,0,0,0,0,0,0,0,0,0,1,0,1,1,1,2,0,0,0,2,1,3
wi16,161,MARSHALL,CHEM,Pharm Chem,0,0,0,2,4,6,3,10,13,5,4,9,8,8,16,0,0,0,18,26,44
wi16,161,MARSHALL,CLAS,Classic St,0,0,0,0,0,0,0,0,0,0,0,0,0,1,1,0,0,0,0,1,1
wi16,161,MARSHALL,COGS,Cog Sci,0,0,0,0,2,2,6,5,11,4,4,8,0,7,7,0,0,0,10,18,28
wi16,161,MARSHALL,COGS,CogBehNeur,0,0,0,0,1,1,0,2,2,1,1,2,0,1,1,0,0,0,1,5,6
wi16,161,MARSHALL,COGS,CogSc/ClAs,0,0,0,0,0,0,0,1,1,0,1,1,0,2,2,0,0,0,0,4,4
wi16,161,MARSHALL,COGS,CogSc/Comp,0,0,0,0,1,1,2,1,3,0,0,0,0,1,1,0,0,0,2,3,5
wi16,161,MARSHALL,COGS,CogSc/HCI,0,0,0,0,0,0,2,3,5,2,9,11,7,10,17,0,0,0,11,22,33
wi16,161,MARSHALL,COGS,CogSc/HCog,0,0,0,0,0,0,1,1,2,1,1,2,1,3,4,0,0,0,3,5,8
wi16,161,MARSHALL,COGS,CogSc/Neur,0,0,0,1,1,2,1,2,3,1,1,2,2,5,7,0,0,0,5,9,14
wi16,161,MARSHALL,COMM,Communic,0,0,0,1,7,8,2,8,10,18,43,61,22,66,88,0,0,0,43,124,167
wi16,161,MARSHALL,CSE,Comp Sci,0,0,0,2,0,2,20,3,23,27,11,38,138,27,165,0,0,0,187,41,228
wi16,161,MARSHALL,CSE,CompEngCSE,0,0,0,0,0,0,2,0,2,5,1,6,17,2,19,0,0,0,24,3,27
wi16,161,MARSHALL,CSE,CompScBinf,0,0,0,0,0,0,0,0,0,1,2,3,5,2,7,0,0,0,6,4,10
wi16,161,MARSHALL,ECE,CompEngECE,0,0,0,0,0,0,5,2,7,12,1,13,20,3,23,0,0,0,37,6,43
wi16,161,MARSHALL,ECE,Electr Eng,0,0,0,2,0,2,5,1,6,14,3,17,71,12,83,0,0,0,92,16,108
wi16,161,MARSHALL,ECE,Engin Phys,0,0,0,0,0,0,0,0,0,1,0,1,0,0,0,0,0,0,1,0,1
wi16,161,MARSHALL,ECON,Ec-Mth&Ecn,0,0,0,6,7,13,9,7,16,17,6,23,15,8,23,0,0,0,47,28,75
wi16,161,MARSHALL,ECON,Econ-MgtSc,0,0,0,1,3,4,5,6,11,24,25,49,40,49,89,0,0,0,70,83,153
wi16,161,MARSHALL,ECON,Economics,0,0,0,4,9,13,7,10,17,69,64,133,99,71,170,0,0,0,179,154,333
wi16,161,MARSHALL,ECON,EnvSys(EB),0,0,0,1,0,1,0,2,2,0,2,2,3,3,6,0,0,0,4,7,11
wi16,161,MARSHALL,ECON,EnvSys(EC),0,0,0,0,0,0,1,1,2,0,0,0,1,4,5,0,0,0,2,5,7
wi16,161,MARSHALL,ECON,EnvSys(EP),0,0,0,0,1,1,0,1,1,0,0,0,1,3,4,0,0,0,1,5,6
wi16,161,MARSHALL,ECON,EnvSys(ES),0,0,0,0,0,0,0,2,2,1,1,2,1,0,1,0,0,0,2,3,5
wi16,161,MARSHALL,ETHN,Ethnic St,0,0,0,0,1,1,0,2,2,1,4,5,0,2,2,0,0,0,1,9,10
wi16,161,MARSHALL,FPMU,Public Hlt,0,0,0,1,5,6,1,10,11,4,26,30,11,44,55,0,0,0,17,85,102
wi16,161,MARSHALL,GLBH,Global Hlt,0,0,0,0,1,1,0,0,0,5,3,8,2,3,5,0,0,0,7,7,14
wi16,161,MARSHALL,HDP,Human Dev,0,0,0,0,0,0,0,2,2,0,5,5,2,21,23,0,0,0,2,28,30
wi16,161,MARSHALL,HDP,Pr-HumnDev,0,0,0,0,2,2,0,2,2,0,8,8,1,2,3,0,0,0,1,14,15
wi16,161,MARSHALL,HIST,History,0,0,0,1,1,2,0,1,1,2,3,5,7,4,11,0,0,0,10,9,19
wi16,161,MARSHALL,INTD,Mar Ind St,0,0,0,0,0,0,0,0,0,0,0,0,1,0,1,0,0,0,1,0,1
wi16,161,MARSHALL,INTL,InSt-InBus,0,0,0,1,7,8,2,11,13,11,19,30,2,3,5,0,0,0,16,40,56
wi16,161,MARSHALL,INTL,Int-5yrEC,0,0,0,0,0,0,0,0,0,0,0,0,1,0,1,0,0,0,1,0,1
wi16,161,MARSHALL,INTL,Int-5yrPS,0,0,0,0,0,0,0,0,0,0,0,0,0,1,1,0,0,0,0,1,1
wi16,161,MARSHALL,INTL,IntSt-Anth,0,0,0,0,0,0,0,0,0,0,0,0,0,1,1,0,0,0,0,1,1
wi16,161,MARSHALL,INTL,IntSt-Econ,0,0,0,0,2,2,1,2,3,6,2,8,4,6,10,0,0,0,11,12,23
wi16,161,MARSHALL,INTL,IntSt-Hist,0,0,0,0,0,0,0,1,1,0,1,1,0,0,0,0,0,0,0,2,2
wi16,161,MARSHALL,INTL,IntSt-PolS,0,0,0,0,1,1,0,3,3,0,7,7,3,6,9,0,0,0,3,17,20
wi16,161,MARSHALL,INTL,IntSt-Soc,0,0,0,0,0,0,0,0,0,0,0,0,0,1,1,0,0,0,0,1,1
wi16,161,MARSHALL,JAPN,JapaneseSt,0,0,0,0,0,0,0,0,0,1,1,2,0,0,0,0,0,0,1,1,2
wi16,161,MARSHALL,JAPN,LatinAm St,0,0,0,0,0,0,0,0,0,0,0,0,0,1,1,0,0,0,0,1,1
wi16,161,MARSHALL,LING,Lang Stu,0,0,0,0,0,0,1,0,1,1,0,1,0,0,0,0,0,0,2,0,2
wi16,161,MARSHALL,LING,Ling-CogLn,0,0,0,0,0,0,0,1,1,0,1,1,0,2,2,0,0,0,0,4,4
wi16,161,MARSHALL,LING,Ling-LSoc,0,0,0,0,0,0,0,0,0,1,1,2,0,1,1,0,0,0,1,2,3
wi16,161,MARSHALL,LING,Linguistcs,0,0,0,0,0,0,0,0,0,0,1,1,1,0,1,0,0,0,1,1,2
wi16,161,MARSHALL,LIT,Lit/CultSt,0,0,0,0,0,0,0,0,0,1,0,1,0,0,0,0,0,0,1,0,1
wi16,161,MARSHALL,LIT,Lit/Engl,0,0,0,0,1,1,0,5,5,0,5,5,2,1,3,0,0,0,2,12,14
wi16,161,MARSHALL,LIT,Lit/World,0,0,0,0,0,0,0,0,0,0,0,0,0,2,2,0,0,0,0,2,2
wi16,161,MARSHALL,LIT,Lit/Writng,0,0,0,0,1,1,1,0,1,2,5,7,3,5,8,0,0,0,6,11,17
wi16,161,MARSHALL,MAE,Aerosp Eng,0,0,0,1,0,1,5,0,5,3,2,5,9,0,9,0,0,0,18,2,20
wi16,161,MARSHALL,MAE,Engin Sci,0,0,0,0,0,0,0,0,0,0,0,0,1,0,1,0,0,0,1,0,1
wi16,161,MARSHALL,MAE,Envir Eng,0,0,0,0,0,0,2,2,4,5,2,7,10,5,15,0,0,0,17,9,26
wi16,161,MARSHALL,MAE,Mech Engin,0,0,0,4,0,4,3,0,3,10,1,11,13,2,15,0,0,0,30,3,33
wi16,161,MARSHALL,MATH,Appld Math,0,0,0,7,5,12,16,7,23,6,11,17,13,10,23,0,0,0,42,33,75
wi16,161,MARSHALL,MATH,Math/SecEd,0,0,0,1,0,1,0,0,0,1,0,1,0,2,2,0,0,0,2,2,4
wi16,161,MARSHALL,MATH,Mathematcs,0,0,0,3,6,9,5,3,8,7,3,10,4,3,7,0,0,0,19,15,34
wi16,161,MARSHALL,MATH,Mth-CompSc,0,0,0,6,3,9,26,6,32,24,5,29,7,8,15,0,0,0,63,22,85
wi16,161,MARSHALL,MATH,Mth-Mth&Ec,0,0,0,4,2,6,6,6,12,8,8,16,5,6,11,0,0,0,23,22,45
wi16,161,MARSHALL,MATH,Mth/ApldSc,0,0,0,0,0,0,1,0,1,2,1,3,2,1,3,0,0,0,5,2,7
wi16,161,MARSHALL,MATH,Prob&Stats,0,0,0,3,1,4,2,5,7,8,10,18,1,3,4,0,0,0,14,19,33
wi16,161,MARSHALL,MUS,Mu-CompArt,0,0,0,0,0,0,1,1,2,0,0,0,1,1,2,0,0,0,2,2,4
wi16,161,MARSHALL,MUS,Music,0,0,0,0,0,0,0,0,0,0,0,0,2,0,2,0,0,0,2,0,2
wi16,161,MARSHALL,MUS,Music Hum,0,0,0,0,0,0,0,0,0,0,0,0,0,1,1,0,0,0,0,1,1
wi16,161,MARSHALL,MUS,NanoEng,0,0,0,1,0,1,3,1,4,5,3,8,21,6,27,0,0,0,30,10,40
wi16,161,MARSHALL,PHIL,Philosophy,0,0,0,0,0,0,0,0,0,0,0,0,2,1,3,0,0,0,2,1,3
wi16,161,MARSHALL,PHYS,Biophysics,0,0,0,1,0,1,1,0,1,2,0,2,2,0,2,0,0,0,6,0,6
wi16,161,MARSHALL,PHYS,Gen Physcs,0,0,0,1,0,1,0,0,0,0,0,0,0,0,0,0,0,0,1,0,1
wi16,161,MARSHALL,PHYS,Phy/ErthSc,0,0,0,0,0,0,0,1,1,0,1,1,1,0,1,0,0,0,1,2,3
wi16,161,MARSHALL,PHYS,Phys/Astro,0,0,0,1,0,1,0,1,1,4,2,6,0,0,0,0,0,0,5,3,8
wi16,161,MARSHALL,PHYS,Phys/Comp,0,0,0,0,0,0,0,0,0,1,0,1,0,1,1,0,0,0,1,1,2
wi16,161,MARSHALL,PHYS,Phys/Mtrls,0,0,0,0,1,1,0,1,1,1,0,1,0,0,0,0,0,0,1,2,3
wi16,161,MARSHALL,PHYS,Physics,0,0,0,9,0,9,5,2,7,9,1,10,4,0,4,0,0,0,27,3,30
wi16,161,MARSHALL,POLI,Polit Sci,0,0,0,1,3,4,5,5,10,12,11,23,9,14,23,0,0,0,27,33,60
wi16,161,MARSHALL,POLI,PolSc-Amer,0,0,0,0,1,1,1,1,2,2,0,2,3,3,6,0,0,0,6,5,11
wi16,161,MARSHALL,POLI,PolSc-Comp,0,0,0,0,0,0,0,0,0,1,0,1,2,3,5,0,0,0,3,3,6
wi16,161,MARSHALL,POLI,PolSc-Intl,0,0,0,5,0,5,1,1,2,4,5,9,8,6,14,0,0,0,18,12,30
wi16,161,MARSHALL,POLI,PolSc-PLaw,0,0,0,1,1,2,3,4,7,2,5,7,4,9,13,0,0,0,10,19,29
wi16,161,MARSHALL,POLI,PolSc-PPol,0,0,0,0,1,1,0,1,1,2,3,5,0,2,2,0,0,0,2,7,9
wi16,161,MARSHALL,POLI,PolSc-Thry,0,0,0,0,0,0,0,0,0,1,0,1,1,1,2,0,0,0,2,1,3
wi16,161,MARSHALL,PSYC,CogBehNeur,0,0,0,0,0,0,0,0,0,0,1,1,0,0,0,0,0,0,0,1,1
wi16,161,MARSHALL,PSYC,Psyc/ClPsy,0,0,0,0,3,3,3,5,8,3,9,12,7,5,12,0,0,0,13,22,35
wi16,161,MARSHALL,PSYC,Psyc/CogPs,0,0,0,0,2,2,2,1,3,1,3,4,0,2,2,0,0,0,3,8,11
wi16,161,MARSHALL,PSYC,Psyc/DelPs,0,0,0,0,1,1,1,1,2,0,1,1,2,4,6,0,0,0,3,7,10
wi16,161,MARSHALL,PSYC,Psyc/HumHl,0,0,0,0,1,1,0,1,1,2,1,3,3,9,12,0,0,0,5,12,17
wi16,161,MARSHALL,PSYC,Psyc/SenPr,0,0,0,0,0,0,0,0,0,0,0,0,0,1,1,0,0,0,0,1,1
wi16,161,MARSHALL,PSYC,Psyc/SocPs,0,0,0,0,2,2,1,3,4,6,7,13,0,6,6,0,0,0,7,18,25
wi16,161,MARSHALL,PSYC,Psychology,0,0,0,2,5,7,5,14,19,12,26,38,13,43,56,0,0,0,32,88,120
wi16,161,MARSHALL,PSYC,Relig/Stu,0,0,0,1,0,1,0,0,0,2,0,2,1,0,1,0,0,0,4,0,4
wi16,161,MARSHALL,SE,Engin Sci,0,0,0,1,0,1,0,0,0,0,1,1,0,0,0,0,0,0,1,1,2
wi16,161,MARSHALL,SE,Struct Eng,0,0,0,1,0,1,2,1,3,10,5,15,35,7,42,0,0,0,48,13,61
wi16,161,MARSHALL,SIO,Earth Sci,0,0,0,0,0,0,1,0,1,1,3,4,1,2,3,0,0,0,3,5,8
wi16,161,MARSHALL,SIO,Marine Bio,0,0,0,1,1,2,1,2,3,0,3,3,2,7,9,0,0,0,4,13,17
wi16,161,MARSHALL,SOC,SocAmSt,0,0,0,0,0,0,0,0,0,0,0,0,0,1,1,0,0,0,0,1,1
wi16,161,MARSHALL,SOC,SocCulCom,0,0,0,1,1,2,0,0,0,0,1,1,2,4,6,0,0,0,3,6,9
wi16,161,MARSHALL,SOC,SocEconSoc,0,0,0,0,0,0,0,0,0,0,3,3,1,0,1,0,0,0,1,3,4
wi16,161,MARSHALL,SOC,Sociology,1,0,1,1,1,2,1,3,4,1,4,5,3,7,10,0,0,0,7,15,22
wi16,161,MARSHALL,SOC,SocLawSoc,0,0,0,0,0,0,0,1,1,3,5,8,2,1,3,0,0,0,5,7,12
wi16,161,MARSHALL,SOC,SocSciMed,0,0,0,0,0,0,1,1,2,0,1,1,0,1,1,0,0,0,1,3,4
wi16,161,MARSHALL,SOC,SocSolneq,0,0,0,0,1,1,0,0,0,0,3,3,1,3,4,0,0,0,1,7,8
wi16,161,MARSHALL,THEA,Theatre,0,0,0,0,0,0,0,3,3,1,1,2,1,2,3,0,0,0,2,6,8
wi16,161,MARSHALL,UNAF,Undeclared,0,0,0,28,21,49,35,15,50,2,2,4,0,0,0,0,0,0,65,38,103
wi16,161,MARSHALL,UNAF,UndecPhysS,0,0,0,4,1,5,1,3,4,0,0,0,0,0,0,0,0,0,5,4,9
wi16,161,MARSHALL,UNAF,UndecSocSc,0,0,0,1,5,6,3,1,4,0,0,0,0,0,0,0,0,0,4,6,10
wi16,161,MARSHALL,USP,Urb Stu&Pl,0,0,0,0,1,1,0,0,0,1,0,1,3,9,12,0,0,0,4,10,14
wi16,161,MARSHALL,VIS,Art Hst/Cr,0,0,0,0,1,1,0,0,0,0,0,0,0,2,2,0,0,0,0,3,3
wi16,161,MARSHALL,VIS,Media,0,0,0,0,1,1,0,2,2,1,2,3,4,8,12,0,0,0,5,13,18
wi16,161,MARSHALL,VIS,Studio VA,0,0,0,0,1,1,1,0,1,0,5,5,1,4,5,0,0,0,2,10,12
wi16,161,MARSHALL,VIS,VA-CompArt,0,0,0,0,0,0,1,0,1,0,4,4,3,6,9,0,0,0,4,10,14
wi16,161,MUIR,ANTH,Anth-Arch,0,0,0,0,1,1,0,1,1,1,1,2,0,2,2,0,0,0,1,5,6
wi16,161,MUIR,ANTH,Anth-Biol,0,0,0,0,0,0,0,0,0,2,1,3,1,6,7,0,0,0,3,7,10
wi16,161,MUIR,ANTH,Anth-Soci,0,0,0,0,1,1,0,0,0,3,4,7,0,3,3,0,0,0,3,8,11
wi16,161,MUIR,BENG,Bioen:Binf,0,0,0,0,0,0,2,1,3,2,3,5,11,5,16,0,0,0,15,9,24
wi16,161,MUIR,BENG,BioengBioS,0,0,0,0,0,0,1,1,2,4,2,6,5,2,7,0,0,0,10,5,15
wi16,161,MUIR,BENG,BioengBiot,0,0,0,0,1,1,4,2,6,4,8,12,8,7,15,0,0,0,16,18,34
wi16,161,MUIR,BENG,Bioengin,0,0,0,0,0,0,2,5,7,5,6,11,16,7,23,0,0,0,23,18,41
wi16,161,MUIR,BIOL,Bioc/CellB,0,0,0,8,8,16,28,42,70,35,43,78,42,67,109,0,0,0,113,160,273
wi16,161,MUIR,BIOL,BiolBioinf,0,0,0,1,1,2,2,3,5,5,3,8,2,0,2,0,0,0,10,7,17
wi16,161,MUIR,BIOL,Ec/Beh/Evo,0,0,0,0,2,2,0,6,6,1,9,10,6,15,21,0,0,0,7,32,39
wi16,161,MUIR,BIOL,Genl Biol,0,0,0,5,14,19,6,14,20,22,34,56,28,49,77,0,0,0,61,111,172
wi16,161,MUIR,BIOL,Human Bio,0,0,0,5,27,32,20,46,66,45,72,117,37,84,121,0,0,0,107,229,336
wi16,161,MUIR,BIOL,Microbiol,0,0,0,0,1,1,4,3,7,4,6,10,6,7,13,0,0,0,14,17,31
wi16,161,MUIR,BIOL,Molec Biol,0,0,0,1,3,4,5,7,12,8,5,13,10,8,18,0,0,0,24,23,47
wi16,161,MUIR,BIOL,PhyslNeuro,0,0,0,5,13,18,13,26,39,29,34,63,38,50,88,0,0,0,85,123,208
wi16,161,MUIR,CENG,Chem Engin,0,0,0,0,0,0,2,4,6,18,4,22,26,25,51,0,0,0,46,33,79
wi16,161,MUIR,CGS,CritGendSt,0,0,0,0,0,0,0,1,1,2,2,4,1,6,7,0,0,0,3,9,12
wi16,161,MUIR,CHEM,Bioch/Chem,0,0,0,3,1,4,7,6,13,14,9,23,11,10,21,0,0,0,35,26,61
wi16,161,MUIR,CHEM,Chem Phys,0,0,0,0,0,0,1,0,1,0,0,0,0,0,0,0,0,0,1,0,1
wi16,161,MUIR,CHEM,Chemistry,0,0,0,3,1,4,2,3,5,6,8,14,3,5,8,0,0,0,14,17,31
wi16,161,MUIR,CHEM,Envir Chem,0,0,0,0,0,0,1,0,1,1,0,1,1,1,2,0,0,0,3,1,4
wi16,161,MUIR,CHEM,MolecSynth,0,0,0,0,0,0,1,0,1,1,0,1,1,1,2,0,0,0,3,1,4
wi16,161,MUIR,CHEM,Pharm Chem,0,0,0,2,5,7,2,9,11,6,9,15,9,14,23,0,0,0,19,37,56
wi16,161,MUIR,CHIN,Chinese St,0,0,0,0,0,0,0,0,0,0,0,0,0,1,1,0,0,0,0,1,1
wi16,161,MUIR,COGS,Cog Sci,0,0,0,2,5,7,5,6,11,5,8,13,6,8,14,0,0,0,18,27,45
wi16,161,MUIR,COGS,CogBehNeur,0,0,0,0,0,0,1,1,2,0,0,0,1,1,2,0,0,0,2,2,4
wi16,161,MUIR,COGS,CogSc/ClAs,0,0,0,0,0,0,0,2,2,0,2,2,1,2,3,0,0,0,1,6,7
wi16,161,MUIR,COGS,CogSc/Comp,0,0,0,0,0,0,1,1,2,2,3,5,1,2,3,0,0,0,4,6,10
wi16,161,MUIR,COGS,CogSc/HCI,0,0,0,0,0,0,5,4,9,5,5,10,5,14,19,0,0,0,15,23,38
wi16,161,MUIR,COGS,CogSc/HCog,0,0,0,0,1,1,0,2,2,1,1,2,2,3,5,0,0,0,3,7,10
wi16,161,MUIR,COGS,CogSc/Neur,0,0,0,2,1,3,3,4,7,3,11,14,4,12,16,0,0,0,12,28,40
wi16,161,MUIR,COMM,Communic,0,0,0,4,2,6,7,11,18,13,41,54,8,39,47,0,0,0,32,93,125
wi16,161,MUIR,CSE,Comp Sci,0,0,0,5,2,7,32,6,38,41,13,54,132,33,165,0,0,0,210,54,264
wi16,161,MUIR,CSE,CompEngCSE,0,0,0,1,0,1,10,3,13,11,1,12,16,2,18,0,0,0,38,6,44
wi16,161,MUIR,CSE,CompScBinf,0,0,0,0,0,0,0,0,0,2,1,3,2,3,5,0,0,0,4,4,8
wi16,161,MUIR,ECE,CompEngECE,0,0,0,1,0,1,3,2,5,9,1,10,12,2,14,0,0,0,25,5,30
wi16,161,MUIR,ECE,Electr Eng,0,0,0,4,1,5,9,4,13,22,0,22,45,6,51,0,0,0,80,11,91
wi16,161,MUIR,ECE,Engin Phys,0,0,0,0,0,0,0,0,0,1,0,1,0,0,0,0,0,0,1,0,1
wi16,161,MUIR,ECE,Pr-EngPhys,0,0,0,1,0,1,1,0,1,1,0,1,0,0,0,0,0,0,3,0,3
wi16,161,MUIR,ECON,Ec-Mth&Ecn,0,0,0,1,4,5,3,5,8,8,14,22,6,3,9,0,0,0,18,26,44
wi16,161,MUIR,ECON,Econ-MgtSc,0,0,0,1,0,1,11,9,20,12,19,31,41,17,58,0,0,0,65,45,110
wi16,161,MUIR,ECON,Economics,0,0,0,4,3,7,8,13,21,53,35,88,52,43,95,0,0,0,117,94,211
wi16,161,MUIR,ESYS,EnvSys(EB),0,0,0,2,2,4,1,2,3,2,5,7,5,5,10,0,0,0,10,14,24
wi16,161,MUIR,ESYS,EnvSys(EC),0,0,0,0,0,0,0,0,0,0,0,0,0,3,3,0,0,0,0,3,3
wi16,161,MUIR,ESYS,EnvSys(EP),0,0,0,0,1,1,1,3,4,1,0,1,1,0,1,0,0,0,3,4,7
wi16,161,MUIR,ESYS,EnvSys(ES),0,0,0,1,2,3,0,2,2,1,2,3,1,0,1,0,0,0,3,6,9
wi16,161,MUIR,ETHN,Ethnic St,0,0,0,0,0,0,0,1,1,1,4,5,0,4,4,0,0,0,1,9,10
wi16,161,MUIR,FPMU,Public Hlt,0,0,0,0,1,1,4,11,15,8,28,36,13,33,46,0,0,0,25,73,98
wi16,161,MUIR,GLBH,Global Hlt,0,0,0,0,0,0,3,2,5,0,5,5,2,6,8,0,0,0,5,13,18
wi16,161,MUIR,HDP,Human Dev,0,0,0,0,0,0,0,0,0,0,9,9,3,16,19,0,0,0,3,25,28
wi16,161,MUIR,HDP,Pr-HumnDev,0,0,0,0,2,2,0,6,6,0,6,6,0,1,1,0,0,0,0,15,15
wi16,161,MUIR,HIST,History,0,0,0,0,0,0,0,4,4,4,2,6,7,6,13,0,0,0,11,12,23
wi16,161,MUIR,INTL,InSt-InBus,0,0,0,2,2,4,3,7,10,4,5,9,3,5,8,0,0,0,12,19,31
wi16,161,MUIR,INTL,IntSt-Anth,0,0,0,0,1,1,0,0,0,0,0,0,1,1,2,0,0,0,1,2,3
wi16,161,MUIR,INTL,IntSt-Econ,0,0,0,1,0,1,2,2,4,0,4,4,4,5,9,0,0,0,7,11,18
wi16,161,MUIR,INTL,IntSt-Lit,0,0,0,0,0,0,0,0,0,0,1,1,0,0,0,0,0,0,0,1,1
wi16,161,MUIR,INTL,IntSt-PolS,0,0,0,0,1,1,1,1,2,0,5,5,2,7,9,0,0,0,3,14,17
wi16,161,MUIR,INTL,IntSt-Soc,0,0,0,0,0,0,0,1,1,0,2,2,0,1,1,0,0,0,0,4,4
wi16,161,MUIR,ITAL,Italian St,0,0,0,0,0,0,0,0,0,0,0,0,0,1,1,0,0,0,0,1,1
wi16,161,MUIR,JAPN,JapaneseSt,0,0,0,0,0,0,0,0,0,1,2,3,0,2,2,0,0,0,1,4,5
wi16,161,MUIR,LING,Lang Stu,0,0,0,0,0,0,0,1,1,0,2,2,2,0,2,0,0,0,2,3,5
wi16,161,MUIR,LING,Ling-CogLn,0,0,0,0,1,1,0,1,1,1,1,2,2,1,3,0,0,0,3,4,7
wi16,161,MUIR,LING,Ling-LSoc,0,0,0,0,0,0,0,0,0,1,0,1,0,0,0,0,0,0,1,0,1
wi16,161,MUIR,LING,Linguistcs,0,0,0,1,1,2,0,0,0,1,3,4,1,2,3,0,0,0,3,6,9
wi16,161,MUIR,LING,Lit/Compos,0,0,0,0,0,0,0,1,1,0,0,0,0,0,0,0,0,0,0,1,1
wi16,161,MUIR,LING,Lit/CultSt,0,0,0,0,0,0,0,0,0,0,1,1,0,0,0,0,0,0,0,1,1
wi16,161,MUIR,LING,Lit/Engl,0,0,0,0,1,1,0,0,0,1,5,6,0,5,5,0,0,0,1,11,12
wi16,161,MUIR,LING,Lit/World,0,0,0,0,0,0,0,0,0,1,0,1,2,1,3,0,0,0,3,1,4
wi16,161,MUIR,LING,Lit/Writng,0,0,0,0,0,0,1,2,3,0,9,9,8,9,17,0,0,0,9,20,29
wi16,161,MUIR,LING,Spanish Lt,0,0,0,0,0,0,1,2,3,0,1,1,0,0,0,0,0,0,1,3,4
wi16,161,MUIR,MAE,Aerosp Eng,0,0,0,0,1,1,7,1,8,6,1,7,12,1,13,0,0,0,25,4,29
wi16,161,MUIR,MAE,Envir Eng,0,0,0,0,3,3,5,4,9,9,5,14,15,9,24,0,0,0,29,21,50
wi16,161,MUIR,MAE,Mech Engin,0,0,0,5,1,6,10,4,14,16,4,20,22,7,29,0,0,0,53,16,69
wi16,161,MUIR,MATH,Appld Math,0,0,0,7,4,11,9,5,14,12,10,22,9,6,15,0,0,0,37,25,62
wi16,161,MUIR,MATH,Math/SecEd,0,0,0,1,1,2,0,1,1,0,1,1,1,2,3,0,0,0,2,5,7
wi16,161,MUIR,MATH,Mathematcs,0,0,0,2,2,4,7,3,10,4,4,8,6,4,10,0,0,0,19,13,32
wi16,161,MUIR,MATH,Mth-CompSc,0,0,0,8,4,12,27,8,35,16,6,22,8,1,9,0,0,0,59,19,78
wi16,161,MUIR,MATH,Mth-Mth&Ec,0,0,0,0,3,3,5,8,13,5,3,8,6,1,7,0,0,0,16,15,31
wi16,161,MUIR,MATH,Mth/ApldSc,0,0,0,0,3,3,2,0,2,0,2,2,0,0,0,0,0,0,2,5,7
wi16,161,MUIR,MATH,Prob&Stats,0,0,0,3,2,5,3,3,6,4,3,7,6,1,7,0,0,0,16,9,25
wi16,161,MUIR,MUS,Mu-CompArt,0,0,0,1,0,1,1,0,1,2,3,5,5,3,8,0,0,0,9,6,15
wi16,161,MUIR,MUS,Music,0,0,0,0,1,1,1,1,2,1,0,1,5,4,9,0,0,0,7,6,13
wi16,161,MUIR,MUS,Music Hum,0,0,0,0,0,0,0,0,0,0,0,0,1,0,1,0,0,0,1,0,1
wi16,161,MUIR,NENG,NanoEng,0,0,0,1,1,2,4,0,4,8,0,8,12,5,17,0,0,0,25,6,31
wi16,161,MUIR,PHIL,Philosophy,0,0,0,2,0,2,2,1,3,0,0,0,1,1,2,0,0,0,5,2,7
wi16,161,MUIR,PHYS,Biophysics,0,0,0,0,1,1,1,0,1,1,1,2,0,1,1,0,0,0,2,3,5
wi16,161,MUIR,PHYS,Gen Physcs,0,0,0,0,0,0,0,0,0,1,0,1,0,0,0,0,0,0,1,0,1
wi16,161,MUIR,PHYS,Phy/ErthSc,0,0,0,0,0,0,0,0,0,0,0,0,1,0,1,0,0,0,1,0,1
wi16,161,MUIR,PHYS,Phys/Astro,0,0,0,4,0,4,1,2,3,5,2,7,1,0,1,0,0,0,11,4,15
wi16,161,MUIR,PHYS,Phys/Comp,0,0,0,1,0,1,0,0,0,2,0,2,1,0,1,0,0,0,4,0,4
wi16,161,MUIR,PHYS,Phys/Mtrls,0,0,0,0,1,1,0,0,0,1,1,2,2,0,2,0,0,0,3,2,5
wi16,161,MUIR,PHYS,Physics,0,0,0,3,2,5,2,2,4,6,1,7,5,1,6,0,0,0,16,6,22
wi16,161,MUIR,POLI,Polit Sci,0,0,0,0,2,2,4,2,6,10,8,18,8,10,18,0,0,0,22,22,44
wi16,161,MUIR,POLI,PolSc-Amer,0,0,0,2,0,2,0,0,0,3,0,3,1,2,3,0,0,0,6,2,8
wi16,161,MUIR,POLI,PolSc-Comp,0,0,0,0,0,0,0,1,1,0,0,0,1,1,2,0,0,0,1,2,3
wi16,161,MUIR,POLI,PolSc-Intl,0,0,0,0,1,1,4,3,7,1,6,7,6,3,9,0,0,0,11,13,24
wi16,161,MUIR,POLI,PolSc-PLaw,0,0,0,0,1,1,2,1,3,2,1,3,6,6,12,0,0,0,10,9,19
wi16,161,MUIR,POLI,PolSc-PPol,0,0,0,0,1,1,1,0,1,2,1,3,3,4,7,0,0,0,6,6,12
wi16,161,MUIR,POLI,PolSc-Thry,0,0,0,0,0,0,0,1,1,1,0,1,0,0,0,0,0,0,1,1,2
wi16,161,MUIR,PSYC,CogBehNeur,0,0,0,0,0,0,0,0,0,0,0,0,0,1,1,0,0,0,0,1,1
wi16,161,MUIR,PSYC,Psyc/ClPsy,0,0,0,2,4,6,4,5,9,4,11,15,2,19,21,0,0,0,12,39,51
wi16,161,MUIR,PSYC,Psyc/CogPs,0,0,0,1,0,1,1,0,1,0,1,1,0,1,1,0,0,0,2,2,4
wi16,161,MUIR,PSYC,Psyc/DelPs,0,0,0,0,1,1,0,0,0,0,2,2,0,5,5,0,0,0,0,8,8
wi16,161,MUIR,PSYC,Psyc/HumHl,0,0,0,0,0,0,0,5,5,0,3,3,1,3,4,0,0,0,1,11,12
wi16,161,MUIR,PSYC,Psyc/SenPr,0,0,0,0,0,0,0,0,0,0,0,0,0,2,2,0,0,0,0,2,2
wi16,161,MUIR,PSYC,Psyc/SocPs,0,0,0,2,1,3,1,7,8,2,4,6,0,5,5,0,0,0,5,17,22
wi16,161,MUIR,PSYC,Psychology,0,0,0,1,8,9,5,13,18,13,30,43,14,49,63,0,0,0,33,100,133
wi16,161,MUIR,RELI,Relig/Stu,0,0,0,0,0,0,0,0,0,0,1,1,1,0,1,0,0,0,1,1,2
wi16,161,MUIR,SE,Engin Sci,0,0,0,1,0,1,0,0,0,0,0,0,0,0,0,0,0,0,1,0,1
wi16,161,MUIR,SE,Struct Eng,0,0,0,2,0,2,4,4,8,8,6,14,24,17,41,0,0,0,38,27,65
wi16,161,MUIR,SIO,Earth Sci,0,0,0,1,0,1,2,2,4,3,0,3,5,5,10,0,0,0,11,7,18
wi16,161,MUIR,SIO,Marine Bio,0,0,0,0,6,6,5,12,17,5,12,17,3,8,11,0,0,0,13,38,51
wi16,161,MUIR,SIO,SocAmSt,0,0,0,0,0,0,0,0,0,0,0,0,0,1,1,0,0,0,0,1,1
wi16,161,MUIR,SIO,SocCulCom,0,0,0,0,1,1,0,1,1,1,3,4,0,0,0,0,0,0,1,5,6
wi16,161,MUIR,SIO,SocEconSoc,0,0,0,1,0,1,0,0,0,1,1,2,0,1,1,0,0,0,2,2,4
wi16,161,MUIR,SIO,SocIntlStu,0,0,0,0,0,0,0,0,0,0,1,1,0,1,1,0,0,0,0,2,2
wi16,161,MUIR,SIO,Sociology,0,0,0,0,2,2,0,3,3,2,9,11,3,9,12,0,0,0,5,23,28
wi16,161,MUIR,SIO,SocLawSoc,0,0,0,0,2,2,0,4,4,1,6,7,0,2,2,0,0,0,1,14,15
wi16,161,MUIR,SIO,SocSciMed,0,0,0,0,0,0,0,1,1,0,1,1,0,1,1,0,0,0,0,3,3
wi16,161,MUIR,SIO,SocSolneq,0,0,0,0,0,0,0,1,1,1,1,2,2,6,8,0,0,0,3,8,11
wi16,161,MUIR,THEA,Dance,0,0,0,0,0,0,0,0,0,0,0,0,0,1,1,0,0,0,0,1,1
wi16,161,MUIR,THEA,Theatre,0,0,0,1,2,3,1,4,5,5,6,11,2,7,9,0,0,0,9,19,28
wi16,161,MUIR,UNAF,UndecHumAr,0,0,0,0,0,0,1,1,2,0,0,0,0,0,0,0,0,0,1,1,2
wi16,161,MUIR,UNAF,Undeclared,0,0,0,36,17,53,32,22,54,3,0,3,0,0,0,0,0,0,71,39,110
wi16,161,MUIR,UNAF,UndecPhysS,0,0,0,2,3,5,4,2,6,0,0,0,0,0,0,0,0,0,6,5,11
wi16,161,MUIR,UNAF,UndecSocSc,0,0,0,1,2,3,3,6,9,0,1,1,0,0,0,0,0,0,4,9,13
wi16,161,MUIR,USP,Urb Stu&Pl,0,0,0,0,3,3,2,1,3,2,6,8,2,6,8,0,0,0,6,16,22
wi16,161,MUIR,VIS,Art Hst/Cr,0,0,0,0,0,0,0,0,0,0,2,2,0,2,2,0,0,0,0,4,4
wi16,161,MUIR,VIS,Media,0,0,0,1,0,1,2,1,3,3,2,5,4,4,8,0,0,0,10,7,17
wi16,161,MUIR,VIS,Spec Desgn,0,0,0,0,0,0,0,0,0,0,1,1,0,0,0,0,0,0,0,1,1
wi16,161,MUIR,VIS,Studio VA,0,0,0,0,1,1,0,1,1,1,3,4,0,7,7,0,0,0,1,12,13
wi16,161,MUIR,VIS,VA-CompArt,0,0,0,0,2,2,0,1,1,2,2,4,2,3,5,0,0,0,4,8,12
wi16,161,REVELLE,ANTH,Anth-Arch,0,0,0,0,1,1,0,1,1,2,0,2,1,1,2,0,0,0,3,3,6
wi16,161,REVELLE,ANTH,Anth-Biol,0,0,0,0,0,0,0,1,1,0,1,1,0,4,4,0,0,0,0,6,6
wi16,161,REVELLE,ANTH,Anth-Soci,0,0,0,0,0,0,0,0,0,1,0,1,0,3,3,0,0,0,1,3,4
wi16,161,REVELLE,BENG,Bioen:Binf,0,0,0,0,1,1,0,2,2,2,2,4,7,6,13,0,0,0,9,11,20
wi16,161,REVELLE,BENG,BioengBioS,0,0,0,1,2,3,3,2,5,3,3,6,7,3,10,0,0,0,14,10,24
wi16,161,REVELLE,BENG,BioengBiot,0,0,0,2,4,6,5,3,8,7,9,16,25,4,29,0,0,0,39,20,59
wi16,161,REVELLE,BENG,Bioengin,0,0,0,1,1,2,3,9,12,5,2,7,25,9,34,0,0,0,34,21,55
wi16,161,REVELLE,BIOL,Bioc/CellB,0,0,0,16,11,27,25,39,64,42,55,97,78,91,169,0,0,0,161,196,357
wi16,161,REVELLE,BIOL,BiolBioinf,0,0,0,2,0,2,3,2,5,3,2,5,3,3,6,0,0,0,11,7,18
wi16,161,REVELLE,BIOL,Ec/Beh/Evo,0,0,0,0,2,2,3,3,6,4,7,11,2,7,9,0,0,0,9,19,28
wi16,161,REVELLE,BIOL,Genl Biol,0,0,0,4,7,11,15,24,39,20,37,57,36,57,93,0,0,0,75,125,200
wi16,161,REVELLE,BIOL,Human Bio,0,0,0,10,23,33,26,43,69,44,79,123,67,102,169,0,0,0,147,247,394
wi16,161,REVELLE,BIOL,Microbiol,0,0,0,1,2,3,3,3,6,6,5,11,9,9,18,0,0,0,19,19,38
wi16,161,REVELLE,BIOL,Molec Biol,0,0,0,1,5,6,9,10,19,13,12,25,17,16,33,0,0,0,40,43,83
wi16,161,REVELLE,BIOL,PhyslNeuro,0,0,0,8,17,25,26,28,54,42,29,71,51,65,116,0,0,0,127,139,266
wi16,161,REVELLE,CENG,Chem Engin,0,0,0,1,1,2,15,6,21,24,10,34,88,31,119,0,0,0,128,48,176
wi16,161,REVELLE,CHEM,Bioch/Chem,0,0,0,1,3,4,10,6,16,4,9,13,17,11,28,0,0,0,32,29,61
wi16,161,REVELLE,CHEM,Bioinform,0,0,0,0,0,0,0,0,0,0,1,1,1,1,2,0,0,0,1,2,3
wi16,161,REVELLE,CHEM,Chem Phys,0,0,0,0,0,0,0,0,0,1,2,3,1,0,1,0,0,0,2,2,4
wi16,161,REVELLE,CHEM,Chemistry,0,0,0,6,2,8,10,9,19,16,13,29,14,8,22,0,0,0,46,32,78
wi16,161,REVELLE,CHEM,Envir Chem,0,0,0,1,0,1,0,1,1,3,1,4,5,1,6,0,0,0,9,3,12
wi16,161,REVELLE,CHEM,MolecSynth,0,0,0,0,0,0,1,0,1,4,2,6,2,0,2,0,0,0,7,2,9
wi16,161,REVELLE,CHEM,Pharm Chem,0,0,0,2,7,9,5,6,11,16,10,26,20,16,36,0,0,0,43,39,82
wi16,161,REVELLE,CHIN,Chinese St,0,0,0,1,0,1,0,0,0,0,0,0,0,0,0,0,0,0,1,0,1
wi16,161,REVELLE,COGS,Cog Sci,0,0,0,0,3,3,1,1,2,5,3,8,4,9,13,0,0,0,10,16,26
wi16,161,REVELLE,COGS,CogBehNeur,0,0,0,0,0,0,0,0,0,0,0,0,0,1,1,0,0,0,0,1,1
wi16,161,REVELLE,COGS,CogSc/ClAs,0,0,0,0,0,0,0,0,0,0,2,2,0,3,3,0,0,0,0,5,5
wi16,161,REVELLE,COGS,CogSc/Comp,0,0,0,0,0,0,2,1,3,1,3,4,2,2,4,0,0,0,5,6,11
wi16,161,REVELLE,COGS,CogSc/HCI,0,0,0,1,0,1,2,3,5,6,1,7,5,10,15,0,0,0,14,14,28
wi16,161,REVELLE,COGS,CogSc/HCog,0,0,0,0,1,1,1,0,1,2,0,2,0,3,3,0,0,0,3,4,7
wi16,161,REVELLE,COGS,CogSc/Neur,0,0,0,0,2,2,1,3,4,0,5,5,7,13,20,0,0,0,8,23,31
wi16,161,REVELLE,COMM,Communic,0,0,0,0,2,2,2,2,4,6,8,14,8,11,19,0,0,0,16,23,39
wi16,161,REVELLE,CSE,Comp Sci,0,0,0,3,2,5,24,7,31,43,5,48,143,28,171,0,0,0,213,42,255
wi16,161,REVELLE,CSE,CompEngCSE,0,0,0,3,0,3,5,1,6,11,2,13,15,2,17,0,0,0,34,5,39
wi16,161,REVELLE,CSE,CompScBinf,0,0,0,0,0,0,3,0,3,0,1,1,10,2,12,0,0,0,13,3,16
wi16,161,REVELLE,ECE,CompEngECE,0,0,0,2,1,3,12,2,14,9,2,11,18,2,20,0,0,0,41,7,48
wi16,161,REVELLE,ECE,Electr Eng,0,0,0,6,2,8,10,2,12,24,8,32,77,9,86,0,0,0,117,21,138
wi16,161,REVELLE,ECE,EleEng&Soc,0,0,0,0,0,0,0,0,0,0,0,0,1,0,1,0,0,0,1,0,1
wi16,161,REVELLE,ECE,Engin Phys,0,0,0,0,0,0,0,0,0,1,0,1,5,0,5,0,0,0,6,0,6
wi16,161,REVELLE,ECE,Pr-EngPhys,0,0,0,0,0,0,0,0,0,1,0,1,0,0,0,0,0,0,1,0,1
wi16,161,REVELLE,ECON,Ec-Mth&Ecn,0,0,0,1,0,1,8,3,11,6,2,8,8,3,11,0,0,0,23,8,31
wi16,161,REVELLE,ECON,Econ-MgtSc,0,0,0,3,1,4,8,7,15,17,10,27,35,21,56,0,0,0,63,39,102
wi16,161,REVELLE,ECON,Economics,0,0,0,3,2,5,8,7,15,40,24,64,65,26,91,0,0,0,116,59,175
wi16,161,REVELLE,ESYS,EnvSys(EB),0,0,0,0,0,0,0,3,3,0,3,3,1,4,5,0,0,0,1,10,11
wi16,161,REVELLE,ESYS,EnvSys(EC),0,0,0,0,0,0,2,1,3,1,0,1,1,0,1,0,0,0,4,1,5
wi16,161,REVELLE,ESYS,EnvSys(EP),0,0,0,0,0,0,0,1,1,0,0,0,0,0,0,0,0,0,0,1,1
wi16,161,REVELLE,ESYS,EnvSys(ES),0,0,0,0,2,2,0,1,1,0,0,0,3,1,4,0,0,0,3,4,7
wi16,161,REVELLE,ETHN,Ethnic St,0,0,0,0,0,0,0,0,0,0,0,0,1,2,3,0,0,0,1,2,3
wi16,161,REVELLE,FPMU,Public Hlt,0,0,0,1,1,2,0,9,9,2,17,19,8,33,41,0,0,0,11,60,71
wi16,161,REVELLE,GLBH,Global Hlt,0,0,0,0,0,0,0,0,0,1,3,4,1,3,4,0,0,0,2,6,8
wi16,161,REVELLE,HDP,Human Dev,0,0,0,0,0,0,0,0,0,0,1,1,1,10,11,0,0,0,1,11,12
wi16,161,REVELLE,HDP,Pr-HumnDev,0,0,0,0,0,0,0,4,4,0,3,3,0,0,0,0,0,0,0,7,7
wi16,161,REVELLE,HIST,History,0,0,0,1,1,2,0,1,1,2,1,3,4,2,6,0,0,0,7,5,12
wi16,161,REVELLE,INTL,InSt-InBus,0,0,0,0,1,1,0,0,0,6,4,10,1,3,4,0,0,0,7,8,15
wi16,161,REVELLE,INTL,Int-5yrEC,0,0,0,0,0,0,0,0,0,0,0,0,1,1,2,0,0,0,1,1,2
wi16,161,REVELLE,INTL,IntSt-Econ,0,0,0,3,0,3,0,1,1,2,1,3,3,4,7,0,0,0,8,6,14
wi16,161,REVELLE,INTL,IntSt-Hist,0,0,0,0,0,0,0,0,0,0,0,0,1,1,2,0,0,0,1,1,2
wi16,161,REVELLE,INTL,IntSt-Ling,0,0,0,0,0,0,0,1,1,0,0,0,0,0,0,0,0,0,0,1,1
wi16,161,REVELLE,INTL,IntSt-Lit,0,0,0,0,0,0,0,0,0,0,0,0,0,1,1,0,0,0,0,1,1
wi16,161,REVELLE,INTL,IntSt-PolS,0,0,0,0,1,1,0,0,0,0,1,1,1,3,4,0,0,0,1,5,6
wi16,161,REVELLE,INTL,IntSt-Soc,0,0,0,0,1,1,0,0,0,0,0,0,0,0,0,0,0,0,0,1,1
wi16,161,REVELLE,LING,Lang Stu,0,0,0,0,0,0,0,1,1,0,1,1,0,1,1,0,0,0,0,3,3
wi16,161,REVELLE,LING,Ling-CogLn,0,0,0,0,0,0,0,0,0,0,1,1,0,1,1,0,0,0,0,2,2
wi16,161,REVELLE,LING,Ling-LSoc,0,0,0,0,0,0,0,0,0,0,0,0,1,0,1,0,0,0,1,0,1
wi16,161,REVELLE,LING,Linguistcs,0,0,0,0,1,1,0,0,0,0,1,1,2,3,5,0,0,0,2,5,7
wi16,161,REVELLE,LIT,Lit/Compos,0,0,0,0,0,0,0,2,2,0,0,0,0,0,0,0,0,0,0,2,2
wi16,161,REVELLE,LIT,Lit/CultSt,0,0,0,0,0,0,0,0,0,0,0,0,0,1,1,0,0,0,0,1,1
wi16,161,REVELLE,LIT,Lit/Engl,0,0,0,0,1,1,0,2,2,1,2,3,2,1,3,0,0,0,3,6,9
wi16,161,REVELLE,LIT,Lit/World,0,0,0,0,0,0,0,0,0,0,2,2,1,1,2,0,0,0,1,3,4
wi16,161,REVELLE,LIT,Lit/Writng,0,0,0,0,0,0,0,4,4,1,3,4,0,4,4,0,0,0,1,11,12
wi16,161,REVELLE,LIT,Spanish Lt,0,0,0,0,0,0,1,0,1,0,0,0,0,1,1,0,0,0,1,1,2
wi16,161,REVELLE,MAE,Aerosp Eng,0,0,0,5,1,6,13,0,13,13,1,14,29,7,36,0,0,0,60,9,69
wi16,161,REVELLE,MAE,Engin Sci,0,0,0,0,0,0,0,0,0,0,0,0,1,0,1,0,0,0,1,0,1
wi16,161,REVELLE,MAE,Envir Eng,0,0,0,0,0,0,9,3,12,5,5,10,7,8,15,0,0,0,21,16,37
wi16,161,REVELLE,MAE,Mech Engin,0,0,0,4,2,6,17,1,18,16,4,20,35,8,43,0,0,0,72,15,87
wi16,161,REVELLE,MATH,Appld Math,0,0,0,3,3,6,12,4,16,13,6,19,19,6,25,0,0,0,47,19,66
wi16,161,REVELLE,MATH,Math/SecEd,0,0,0,0,1,1,1,0,1,3,3,6,1,1,2,0,0,0,5,5,10
wi16,161,REVELLE,MATH,Mathematcs,0,0,0,2,2,4,14,3,17,6,4,10,12,7,19,0,0,0,34,16,50
wi16,161,REVELLE,MATH,Mth-CompSc,0,0,0,16,7,23,24,11,35,40,8,48,10,5,15,0,0,0,90,31,121
wi16,161,REVELLE,MATH,Mth-Mth&Ec,0,0,0,3,1,4,4,2,6,5,5,10,2,9,11,0,0,0,14,17,31
wi16,161,REVELLE,MATH,Mth-SciCom,0,0,0,0,0,0,1,1,2,0,2,2,0,0,0,0,0,0,1,3,4
wi16,161,REVELLE,MATH,Mth/ApldSc,0,0,0,1,0,1,2,2,4,2,1,3,2,0,2,0,0,0,7,3,10
wi16,161,REVELLE,MATH,Prob&Stats,0,0,0,0,2,2,3,2,5,3,1,4,5,7,12,0,0,0,11,12,23
wi16,161,REVELLE,MUS,Mu-CompArt,0,0,0,1,0,1,1,0,1,2,0,2,3,2,5,0,0,0,7,2,9
wi16,161,REVELLE,MUS,Music,0,0,0,0,0,0,0,0,0,2,0,2,0,1,1,0,0,0,2,1,3
wi16,161,REVELLE,NENG,NanoEng,0,0,0,4,1,5,8,2,10,6,3,9,33,6,39,0,0,0,51,12,63
wi16,161,REVELLE,PHIL,Philosophy,0,0,0,2,0,2,1,0,1,0,1,1,1,2,3,0,0,0,4,3,7
wi16,161,REVELLE,PHYS,Biophysics,0,0,0,2,0,2,1,1,2,2,0,2,4,0,4,0,0,0,9,1,10
wi16,161,REVELLE,PHYS,Gen Physcs,0,0,0,0,0,0,1,0,1,1,0,1,0,0,0,0,0,0,2,0,2
wi16,161,REVELLE,PHYS,Phys/Astro,0,0,0,0,1,1,2,3,5,12,2,14,7,2,9,0,0,0,21,8,29
wi16,161,REVELLE,PHYS,Phys/Comp,0,0,0,1,0,1,2,1,3,2,0,2,4,0,4,0,0,0,9,1,10
wi16,161,REVELLE,PHYS,Phys/Mtrls,0,0,0,3,0,3,0,0,0,7,1,8,0,0,0,0,0,0,10,1,11
wi16,161,REVELLE,PHYS,Physics,0,0,0,4,2,6,9,2,11,12,4,16,15,4,19,0,0,0,40,12,52
wi16,161,REVELLE,POLI,Polit Sci,0,0,0,0,3,3,2,0,2,2,3,5,7,3,10,0,0,0,11,9,20
wi16,161,REVELLE,POLI,PolSc-Amer,0,0,0,1,0,1,1,0,1,0,0,0,2,1,3,0,0,0,4,1,5
wi16,161,REVELLE,POLI,PolSc-Comp,0,0,0,0,0,0,0,0,0,0,1,1,0,1,1,0,0,0,0,2,2
wi16,161,REVELLE,POLI,PolSc-Intl,0,0,0,1,0,1,1,2,3,4,2,6,3,5,8,0,0,0,9,9,18
wi16,161,REVELLE,POLI,PolSc-PLaw,0,0,0,0,0,0,1,0,1,3,0,3,0,5,5,0,0,0,4,5,9
wi16,161,REVELLE,POLI,PolSc-PPol,0,0,0,0,0,0,0,0,0,0,0,0,0,1,1,0,0,0,0,1,1
wi16,161,REVELLE,POLI,PolSc-Thry,0,0,0,0,0,0,0,0,0,0,0,0,0,1,1,0,0,0,0,1,1
wi16,161,REVELLE,PSYC,CogBehNeur,0,0,0,0,0,0,0,0,0,1,0,1,2,3,5,0,0,0,3,3,6
wi16,161,REVELLE,PSYC,Psyc/ClPsy,0,0,0,1,2,3,0,4,4,1,4,5,3,9,12,0,0,0,5,19,24
wi16,161,REVELLE,PSYC,Psyc/CogPs,0,0,0,0,1,1,0,1,1,1,1,2,2,2,4,0,0,0,3,5,8
wi16,161,REVELLE,PSYC,Psyc/DelPs,0,0,0,0,0,0,0,0,0,0,1,1,0,4,4,0,0,0,0,5,5
wi16,161,REVELLE,PSYC,Psyc/HumHl,0,0,0,0,1,1,0,2,2,0,2,2,2,5,7,0,0,0,2,10,12
wi16,161,REVELLE,PSYC,Psyc/SocPs,0,0,0,2,0,2,1,0,1,0,4,4,2,1,3,0,0,0,5,5,10
wi16,161,REVELLE,PSYC,Psychology,0,0,0,3,6,9,2,8,10,10,12,22,14,21,35,0,0,0,29,47,76
wi16,161,REVELLE,RELI,Relig/Stu,0,0,0,0,0,0,0,0,0,0,0,0,0,1,1,0,0,0,0,1,1
wi16,161,REVELLE,SE,Engin Sci,0,0,0,0,0,0,1,0,1,0,0,0,1,0,1,0,0,0,2,0,2
wi16,161,REVELLE,SE,Struct Eng,0,0,0,6,7,13,10,4,14,10,2,12,46,17,63,0,0,0,72,30,102
wi16,161,REVELLE,SIO,Earth Sci,0,0,0,0,0,0,0,0,0,2,2,4,5,2,7,0,0,0,7,4,11
wi16,161,REVELLE,SIO,Marine Bio,0,0,0,3,4,7,1,8,9,3,11,14,0,12,12,0,0,0,7,35,42
wi16,161,REVELLE,SOC,SocCulCom,0,0,0,1,0,1,0,0,0,1,0,1,0,0,0,0,0,0,2,0,2
wi16,161,REVELLE,SOC,Sociology,0,0,0,0,1,1,1,1,2,1,1,2,3,4,7,0,0,0,5,7,12
wi16,161,REVELLE,SOC,SocLawSoc,0,0,0,0,0,0,0,0,0,1,1,2,0,0,0,0,0,0,1,1,2
wi16,161,REVELLE,SOC,SocSciMed,0,0,0,0,0,0,0,0,0,0,0,0,1,1,2,0,0,0,1,1,2
wi16,161,REVELLE,SOC,SocSolneq,0,0,0,0,0,0,0,0,0,0,0,0,0,4,4,0,0,0,0,4,4
wi16,161,REVELLE,THEA,Dance,0,0,0,0,0,0,0,0,0,0,0,0,1,0,1,0,0,0,1,0,1
wi16,161,REVELLE,THEA,Theatre,0,0,0,0,0,0,1,2,3,1,1,2,0,5,5,0,0,0,2,8,10
wi16,161,REVELLE,UNAF,Limited St,0,0,0,0,0,0,0,0,0,0,0,0,0,0,0,2,1,3,2,1,3
wi16,161,REVELLE,UNAF,Spec-Emply,0,0,0,0,0,0,0,0,0,0,0,0,0,0,0,3,2,5,3,2,5
wi16,161,REVELLE,UNAF,UndecHumAr,0,0,0,0,1,1,1,1,2,0,0,0,0,0,0,0,0,0,1,2,3
wi16,161,REVELLE,UNAF,Undeclared,0,0,0,40,20,60,43,22,65,2,0,2,0,0,0,0,0,0,85,42,127
wi16,161,REVELLE,UNAF,UndecPhysS,0,0,0,7,3,10,4,2,6,0,0,0,0,0,0,0,0,0,11,5,16
wi16,161,REVELLE,UNAF,UndecSocSc,0,0,0,0,1,1,0,4,4,0,0,0,0,0,0,0,0,0,0,5,5
wi16,161,REVELLE,USP,Urb Stu&Pl,0,0,0,0,0,0,1,0,1,0,2,2,1,2,3,0,0,0,2,4,6
wi16,161,REVELLE,VIS,Art Hst/Cr,0,0,0,0,0,0,0,0,0,0,0,0,0,1,1,0,0,0,0,1,1
wi16,161,REVELLE,VIS,Media,0,0,0,1,1,2,3,1,4,4,1,5,1,3,4,0,0,0,9,6,15
wi16,161,REVELLE,VIS,Studio VA,0,0,0,0,0,0,0,1,1,0,0,0,1,2,3,0,0,0,1,3,4
wi16,161,REVELLE,VIS,VA-CompArt,0,0,0,0,0,0,1,1,2,0,1,1,2,6,8,0,0,0,3,8,11
wi16,161,ROOSEVELT,ANTH,Anth-Arch,0,0,0,0,0,0,0,1,1,1,0,1,4,3,7,0,0,0,5,4,9
wi16,161,ROOSEVELT,ANTH,Anth-Biol,0,0,0,0,0,0,0,0,0,1,4,5,1,4,5,0,0,0,2,8,10
wi16,161,ROOSEVELT,ANTH,Anth-Soci,0,0,0,0,0,0,0,0,0,3,4,7,1,6,7,0,0,0,4,10,14
wi16,161,ROOSEVELT,BENG,Bioen:Binf,0,0,0,1,1,2,2,2,4,1,2,3,7,6,13,0,0,0,11,11,22
wi16,161,ROOSEVELT,BENG,BioengBioS,0,0,0,0,0,0,0,0,0,0,3,3,3,3,6,0,0,0,3,6,9
wi16,161,ROOSEVELT,BENG,BioengBiot,0,0,0,1,0,1,1,1,2,0,2,2,4,2,6,0,0,0,6,5,11
wi16,161,ROOSEVELT,BENG,Bioengin,0,0,0,0,0,0,0,0,0,2,0,2,5,2,7,0,0,0,7,2,9
wi16,161,ROOSEVELT,BIOL,Bioc/CellB,0,0,0,4,18,22,22,25,47,25,30,55,38,37,75,0,0,0,89,110,199
wi16,161,ROOSEVELT,BIOL,BiolBioinf,0,0,0,1,2,3,0,8,8,1,1,2,2,2,4,0,0,0,4,13,17
wi16,161,ROOSEVELT,BIOL,Ec/Beh/Evo,0,0,0,1,2,3,1,5,6,5,6,11,8,5,13,0,0,0,15,18,33
wi16,161,ROOSEVELT,BIOL,Genl Biol,0,0,0,9,19,28,9,22,31,12,20,32,20,44,64,0,0,0,50,105,155
wi16,161,ROOSEVELT,BIOL,Human Bio,0,0,0,10,21,31,19,47,66,29,58,87,30,59,89,0,0,0,88,185,273
wi16,161,ROOSEVELT,BIOL,Microbiol,0,0,0,3,2,5,2,2,4,9,0,9,5,7,12,0,0,0,19,11,30
wi16,161,ROOSEVELT,BIOL,Molec Biol,0,0,0,1,0,1,8,7,15,0,6,6,1,8,9,0,0,0,10,21,31
wi16,161,ROOSEVELT,BIOL,PhyslNeuro,0,0,0,3,9,12,22,24,46,12,29,41,23,41,64,0,0,0,60,103,163
wi16,161,ROOSEVELT,CENG,Chem Engin,0,0,0,0,0,0,2,1,3,6,3,9,28,10,38,0,0,0,36,14,50
wi16,161,ROOSEVELT,CGS,CritGendSt,0,0,0,0,1,1,0,0,0,0,1,1,1,0,1,0,0,0,1,2,3
wi16,161,ROOSEVELT,CHEM,Bioch/Chem,0,0,0,4,4,8,5,5,10,8,5,13,9,8,17,0,0,0,26,22,48
wi16,161,ROOSEVELT,CHEM,Bioinform,0,0,0,0,1,1,0,0,0,0,0,0,1,0,1,0,0,0,1,1,2
wi16,161,ROOSEVELT,CHEM,Chem Phys,0,0,0,0,1,1,0,0,0,0,1,1,0,0,0,0,0,0,0,2,2
wi16,161,ROOSEVELT,CHEM,Chemistry,0,1,1,3,6,9,8,6,14,4,4,8,1,3,4,0,0,0,16,20,36
wi16,161,ROOSEVELT,CHEM,Envir Chem,0,0,0,0,0,0,0,1,1,0,0,0,0,0,0,0,0,0,0,1,1
wi16,161,ROOSEVELT,CHEM,Pharm Chem,0,0,0,0,2,2,3,6,9,6,7,13,8,8,16,0,0,0,17,23,40
wi16,161,ROOSEVELT,CHIN,Chinese St,0,0,0,0,0,0,0,1,1,2,1,3,0,0,0,0,0,0,2,2,4
wi16,161,ROOSEVELT,CLAS,Classic St,0,0,0,0,0,0,0,0,0,0,1,1,1,1,2,0,0,0,1,2,3
wi16,161,ROOSEVELT,COGS,Cog Sci,0,0,0,0,3,3,4,5,9,8,7,15,3,4,7,0,0,0,15,19,34
wi16,161,ROOSEVELT,COGS,CogBehNeur,0,0,0,0,0,0,0,3,3,2,0,2,0,0,0,0,0,0,2,3,5
wi16,161,ROOSEVELT,COGS,CogSc/ClAs,0,0,0,0,1,1,1,0,1,0,0,0,0,3,3,0,0,0,1,4,5
wi16,161,ROOSEVELT,COGS,CogSc/Comp,0,0,0,1,1,2,1,2,3,1,0,1,0,0,0,0,0,0,3,3,6
wi16,161,ROOSEVELT,COGS,CogSc/HCI,0,0,0,1,1,2,3,3,6,4,3,7,2,11,13,0,0,0,10,18,28
wi16,161,ROOSEVELT,COGS,CogSc/HCog,0,0,0,1,1,2,1,1,2,2,2,4,0,1,1,0,0,0,4,5,9
wi16,161,ROOSEVELT,COGS,CogSc/Neur,0,0,0,0,3,3,1,3,4,0,6,6,2,7,9,0,0,0,3,19,22
wi16,161,ROOSEVELT,COMM,Communic,0,0,0,4,13,17,2,13,15,10,33,43,14,49,63,0,0,0,30,108,138
wi16,161,ROOSEVELT,CSE,Comp Sci,0,0,0,1,0,1,11,2,13,26,4,30,75,21,96,0,0,0,113,27,140
wi16,161,ROOSEVELT,CSE,CompEngCSE,0,0,0,1,0,1,2,1,3,4,2,6,13,3,16,0,0,0,20,6,26
wi16,161,ROOSEVELT,CSE,CompScBinf,0,0,0,0,0,0,0,1,1,0,0,0,6,3,9,0,0,0,6,4,10
wi16,161,ROOSEVELT,ECE,CompEngECE,0,0,0,0,0,0,3,1,4,5,2,7,16,3,19,0,0,0,24,6,30
wi16,161,ROOSEVELT,ECE,Electr Eng,0,0,0,4,0,4,8,0,8,18,4,22,46,10,56,0,0,0,76,14,90
wi16,161,ROOSEVELT,ECE,Engin Phys,0,0,0,0,0,0,0,0,0,0,0,0,2,0,2,0,0,0,2,0,2
wi16,161,ROOSEVELT,ECE,Pr-EngPhys,0,0,0,0,0,0,0,0,0,1,0,1,0,0,0,0,0,0,1,0,1
wi16,161,ROOSEVELT,ECON,Ec-Mth&Ecn,0,0,0,1,7,8,8,7,15,11,7,18,9,5,14,0,0,0,29,26,55
wi16,161,ROOSEVELT,ECON,Econ-MgtSc,0,0,0,4,3,7,14,12,26,16,19,35,42,23,65,0,0,0,76,57,133
wi16,161,ROOSEVELT,ECON,Economics,0,0,0,16,10,26,33,29,62,57,34,91,60,44,104,0,0,0,166,117,283
wi16,161,ROOSEVELT,ECON,EnvSys(EB),0,0,0,0,2,2,0,1,1,2,2,4,1,7,8,0,0,0,3,12,15
wi16,161,ROOSEVELT,ECON,EnvSys(EC),0,0,0,0,0,0,2,0,2,0,0,0,0,0,0,0,0,0,2,0,2
wi16,161,ROOSEVELT,ECON,EnvSys(EP),0,0,0,0,2,2,0,1,1,5,1,6,0,3,3,0,0,0,5,7,12
wi16,161,ROOSEVELT,ECON,EnvSys(ES),0,0,0,0,2,2,1,1,2,0,0,0,2,1,3,0,0,0,3,4,7
wi16,161,ROOSEVELT,ETHN,Ethnic St,0,0,0,0,0,0,0,1,1,0,1,1,1,3,4,0,0,0,1,5,6
wi16,161,ROOSEVELT,FPMU,Public Hlt,0,0,0,1,3,4,1,8,9,5,19,24,6,40,46,0,0,0,13,70,83
wi16,161,ROOSEVELT,GLBH,Global Hlt,0,0,0,0,2,2,3,8,11,1,11,12,1,6,7,0,0,0,5,27,32
wi16,161,ROOSEVELT,HDP,Human Dev,0,0,0,0,0,0,0,2,2,0,5,5,1,19,20,0,0,0,1,26,27
wi16,161,ROOSEVELT,HDP,Pr-HumnDev,0,0,0,0,1,1,3,9,12,0,9,9,0,1,1,0,0,0,3,20,23
wi16,161,ROOSEVELT,HIST,History,0,0,0,0,2,2,3,2,5,10,10,20,13,19,32,0,0,0,26,33,59
wi16,161,ROOSEVELT,INTL,InSt-InBus,0,0,0,6,10,16,10,15,25,12,19,31,10,9,19,0,0,0,38,53,91
wi16,161,ROOSEVELT,INTL,IntSt-Anth,0,0,0,0,0,0,0,2,2,0,4,4,0,2,2,0,0,0,0,8,8
wi16,161,ROOSEVELT,INTL,IntSt-Econ,0,0,0,1,3,4,2,5,7,5,10,15,7,11,18,0,0,0,15,29,44
wi16,161,ROOSEVELT,INTL,IntSt-Hist,0,0,0,1,1,2,0,0,0,1,2,3,0,3,3,0,0,0,2,6,8
wi16,161,ROOSEVELT,INTL,IntSt-Ling,0,0,0,1,0,1,1,1,2,0,2,2,1,3,4,0,0,0,3,6,9
wi16,161,ROOSEVELT,INTL,IntSt-Lit,0,0,0,0,0,0,0,0,0,1,1,2,1,1,2,0,0,0,2,2,4
wi16,161,ROOSEVELT,INTL,IntSt-PolS,0,0,0,0,2,2,4,10,14,5,13,18,14,26,40,0,0,0,23,51,74
wi16,161,ROOSEVELT,INTL,IntSt-Soc,0,0,0,0,1,1,1,1,2,2,3,5,4,15,19,0,0,0,7,20,27
wi16,161,ROOSEVELT,ITAL,Italian St,0,0,0,0,0,0,0,0,0,0,1,1,0,0,0,0,0,0,0,1,1
wi16,161,ROOSEVELT,JAPN,JapaneseSt,0,0,0,0,0,0,1,1,2,1,1,2,0,2,2,0,0,0,2,4,6
wi16,161,ROOSEVELT,JAPN,LatinAm St,0,0,0,0,0,0,0,0,0,1,1,2,0,0,0,0,0,0,1,1,2
wi16,161,ROOSEVELT,LING,Lang Stu,0,0,0,0,0,0,0,2,2,0,3,3,0,3,3,0,0,0,0,8,8
wi16,161,ROOSEVELT,LING,Ling-CogLn,0,0,0,0,0,0,0,2,2,0,4,4,1,4,5,0,0,0,1,10,11
wi16,161,ROOSEVELT,LING,Ling-LSoc,0,0,0,1,0,1,0,3,3,0,2,2,0,3,3,0,0,0,1,8,9
wi16,161,ROOSEVELT,LING,Linguistcs,0,0,0,1,1,2,0,1,1,3,1,4,1,5,6,0,0,0,5,8,13
wi16,161,ROOSEVELT,LIT,French Lit,0,0,0,0,0,0,0,0,0,0,1,1,0,1,1,0,0,0,0,2,2
wi16,161,ROOSEVELT,LIT,Lit/CultSt,0,0,0,0,0,0,0,0,0,0,0,0,0,2,2,0,0,0,0,2,2
wi16,161,ROOSEVELT,LIT,Lit/Engl,0,0,0,0,0,0,1,2,3,0,6,6,2,6,8,0,0,0,3,14,17
wi16,161,ROOSEVELT,LIT,Lit/World,0,0,0,0,0,0,0,0,0,1,0,1,0,1,1,0,0,0,1,1,2
wi16,161,ROOSEVELT,LIT,Lit/Writng,0,0,0,1,2,3,1,2,3,6,2,8,2,11,13,0,0,0,10,17,27
wi16,161,ROOSEVELT,LIT,Russian Lt,0,0,0,1,0,1,0,0,0,0,0,0,0,0,0,0,0,0,1,0,1
wi16,161,ROOSEVELT,LIT,Spanish Lt,0,0,0,0,0,0,0,0,0,0,0,0,0,1,1,0,0,0,0,1,1
wi16,161,ROOSEVELT,MAE,Aerosp Eng,0,0,0,1,1,2,4,1,5,4,3,7,5,0,5,0,0,0,14,5,19
wi16,161,ROOSEVELT,MAE,Envir Eng,0,0,0,1,1,2,6,3,9,3,3,6,7,10,17,0,0,0,17,17,34
wi16,161,ROOSEVELT,MAE,Mech Engin,0,0,0,0,0,0,7,1,8,2,1,3,3,1,4,0,0,0,12,3,15
wi16,161,ROOSEVELT,MATH,Appld Math,0,0,0,11,8,19,12,8,20,8,8,16,7,10,17,0,0,0,38,34,72
wi16,161,ROOSEVELT,MATH,Math/SecEd,0,0,0,0,0,0,0,1,1,1,1,2,0,2,2,0,0,0,1,4,5
wi16,161,ROOSEVELT,MATH,Mathematcs,0,0,0,6,3,9,3,1,4,3,2,5,1,2,3,0,0,0,13,8,21
wi16,161,ROOSEVELT,MATH,Mth-CompSc,0,0,0,12,5,17,24,10,34,38,7,45,12,2,14,0,0,0,86,24,110
wi16,161,ROOSEVELT,MATH,Mth-Mth&Ec,0,0,0,2,5,7,8,6,14,6,9,15,9,2,11,0,0,0,25,22,47
wi16,161,ROOSEVELT,MATH,Mth-SciCom,0,0,0,0,1,1,0,0,0,0,0,0,0,0,0,0,0,0,0,1,1
wi16,161,ROOSEVELT,MATH,Mth/ApldSc,0,0,0,0,2,2,1,3,4,2,0,2,1,0,1,0,0,0,4,5,9
wi16,161,ROOSEVELT,MATH,Prob&Stats,0,0,0,1,4,5,7,4,11,7,3,10,2,1,3,0,0,0,17,12,29
wi16,161,ROOSEVELT,MUS,Mu-CompArt,0,0,0,2,0,2,0,0,0,3,0,3,1,0,1,0,0,0,6,0,6
wi16,161,ROOSEVELT,MUS,Music,0,0,0,0,1,1,0,0,0,0,1,1,2,0,2,0,0,0,2,2,4
wi16,161,ROOSEVELT,NENG,NanoEng,0,0,0,3,0,3,2,0,2,4,3,7,15,6,21,0,0,0,24,9,33
wi16,161,ROOSEVELT,PHIL,Philosophy,0,0,0,0,0,0,2,1,3,1,2,3,3,4,7,0,0,0,6,7,13
wi16,161,ROOSEVELT,PHYS,Biophysics,0,0,0,0,0,0,2,0,2,1,0,1,1,1,2,0,0,0,4,1,5
wi16,161,ROOSEVELT,PHYS,Gen Physcs,0,0,0,1,0,1,1,0,1,1,0,1,0,0,0,0,0,0,3,0,3
wi16,161,ROOSEVELT,PHYS,Phys/Astro,0,0,0,1,1,2,3,3,6,3,1,4,0,0,0,0,0,0,7,5,12
wi16,161,ROOSEVELT,PHYS,Phys/Comp,0,0,0,0,0,0,0,1,1,0,0,0,1,0,1,0,0,0,1,1,2
wi16,161,ROOSEVELT,PHYS,Phys/Mtrls,0,0,0,1,0,1,1,0,1,0,0,0,0,0,0,0,0,0,2,0,2
wi16,161,ROOSEVELT,PHYS,Physics,0,0,0,6,0,6,10,2,12,7,0,7,5,2,7,0,0,0,28,4,32
wi16,161,ROOSEVELT,POLI,Polit Sci,0,0,0,2,3,5,5,7,12,12,21,33,14,19,33,0,0,0,33,50,83
wi16,161,ROOSEVELT,POLI,PolSc-Amer,0,0,0,0,2,2,2,1,3,3,2,5,2,7,9,0,0,0,7,12,19
wi16,161,ROOSEVELT,POLI,PolSc-Comp,0,0,0,1,0,1,0,1,1,2,0,2,3,2,5,0,0,0,6,3,9
wi16,161,ROOSEVELT,POLI,PolSc-Intl,0,0,0,2,4,6,6,7,13,19,17,36,19,18,37,0,0,0,46,46,92
wi16,161,ROOSEVELT,POLI,PolSc-PLaw,0,0,0,1,1,2,1,2,3,3,10,13,6,8,14,0,0,0,11,21,32
wi16,161,ROOSEVELT,POLI,PolSc-PPol,0,0,0,0,1,1,0,0,0,1,1,2,3,3,6,0,0,0,4,5,9
wi16,161,ROOSEVELT,POLI,PolSc-Thry,0,0,0,1,0,1,1,1,2,1,0,1,0,3,3,0,0,0,3,4,7
wi16,161,ROOSEVELT,PSYC,CogBehNeur,0,0,0,0,0,0,0,0,0,0,1,1,1,2,3,0,0,0,1,3,4
wi16,161,ROOSEVELT,PSYC,Psyc/ClPsy,0,0,0,2,3,5,1,3,4,2,6,8,5,9,14,0,0,0,10,21,31
wi16,161,ROOSEVELT,PSYC,Psyc/CogPs,0,0,0,0,0,0,0,0,0,2,3,5,0,2,2,0,0,0,2,5,7
wi16,161,ROOSEVELT,PSYC,Psyc/DelPs,0,0,0,0,1,1,0,5,5,0,3,3,0,2,2,0,0,0,0,11,11
wi16,161,ROOSEVELT,PSYC,Psyc/HumHl,0,0,0,0,0,0,0,1,1,2,6,8,1,6,7,0,0,0,3,13,16
wi16,161,ROOSEVELT,PSYC,Psyc/SocPs,0,0,0,0,2,2,0,3,3,0,4,4,2,4,6,0,0,0,2,13,15
wi16,161,ROOSEVELT,PSYC,Psychology,0,0,0,0,13,13,3,15,18,8,31,39,10,36,46,0,0,0,21,95,116
wi16,161,ROOSEVELT,PSYC,RusEE&EStd,0,0,0,0,0,0,0,0,0,1,0,1,0,0,0,0,0,0,1,0,1
wi16,161,ROOSEVELT,SE,Engin Sci,0,0,0,0,0,0,0,1,1,1,0,1,0,0,0,0,0,0,1,1,2
wi16,161,ROOSEVELT,SE,Struct Eng,0,0,0,3,1,4,6,4,10,7,3,10,22,8,30,0,0,0,38,16,54
wi16,161,ROOSEVELT,SIO,Earth Sci,0,0,0,0,0,0,0,1,1,2,0,2,2,6,8,0,0,0,4,7,11
wi16,161,ROOSEVELT,SIO,Marine Bio,0,0,0,2,1,3,3,6,9,4,6,10,3,7,10,0,0,0,12,20,32
wi16,161,ROOSEVELT,SOC,SocCulCom,0,0,0,0,0,0,0,2,2,0,3,3,0,0,0,0,0,0,0,5,5
wi16,161,ROOSEVELT,SOC,SocEconSoc,0,0,0,1,0,1,1,1,2,0,0,0,0,0,0,0,0,0,2,1,3
wi16,161,ROOSEVELT,SOC,SocIntlStu,0,0,0,0,0,0,0,0,0,0,1,1,0,2,2,0,0,0,0,3,3
wi16,161,ROOSEVELT,SOC,Sociology,0,0,0,1,2,3,0,3,3,3,4,7,2,7,9,0,0,0,6,16,22
wi16,161,ROOSEVELT,SOC,SocLawSoc,0,0,0,0,1,1,0,4,4,0,2,2,1,3,4,0,0,0,1,10,11
wi16,161,ROOSEVELT,SOC,SocSciMed,0,0,0,0,0,0,0,0,0,0,2,2,0,3,3,0,0,0,0,5,5
wi16,161,ROOSEVELT,SOC,SocSolneq,0,0,0,0,0,0,0,0,0,0,3,3,0,0,0,0,0,0,0,3,3
wi16,161,ROOSEVELT,THEA,Dance,0,0,0,0,0,0,0,0,0,0,0,0,1,1,2,0,0,0,1,1,2
wi16,161,ROOSEVELT,THEA,Theatre,0,0,0,0,1,1,2,4,6,1,2,3,2,6,8,0,0,0,5,13,18
wi16,161,ROOSEVELT,TWS,ThirdWldSt,0,0,0,0,0,0,0,0,0,0,0,0,0,1,1,0,0,0,0,1,1
wi16,161,ROOSEVELT,UNAF,UndecHumAr,0,0,0,0,2,2,1,5,6,0,0,0,0,0,0,0,0,0,1,7,8
wi16,161,ROOSEVELT,UNAF,Undeclared,0,0,0,34,18,52,43,24,67,1,3,4,0,0,0,0,0,0,78,45,123
wi16,161,ROOSEVELT,UNAF,UndecPhysS,0,0,0,6,7,13,7,2,9,0,0,0,0,0,0,0,0,0,13,9,22
wi16,161,ROOSEVELT,UNAF,UndecSocSc,0,0,0,1,9,10,5,4,9,0,0,0,0,0,0,0,0,0,6,13,19
wi16,161,ROOSEVELT,USP,Urb Stu&Pl,0,0,0,0,1,1,2,0,2,3,1,4,0,3,3,0,0,0,5,5,10
wi16,161,ROOSEVELT,VIS,Art Hst/Cr,0,0,0,0,0,0,0,0,0,0,1,1,0,2,2,0,0,0,0,3,3
wi16,161,ROOSEVELT,VIS,Media,0,0,0,2,2,4,2,2,4,4,3,7,3,5,8,0,0,0,11,12,23
wi16,161,ROOSEVELT,VIS,Spec Desgn,0,0,0,0,1,1,0,0,0,0,0,0,0,0,0,0,0,0,0,1,1
wi16,161,ROOSEVELT,VIS,Studio VA,0,0,0,0,0,0,1,1,2,0,4,4,0,6,6,0,0,0,1,11,12
wi16,161,ROOSEVELT,VIS,VA-CompArt,0,0,0,2,2,4,0,1,1,1,3,4,2,4,6,0,0,0,5,10,15
wi16,161,SIXTH,ANTH,Anth-Arch,0,0,0,0,0,0,0,0,0,0,0,0,0,2,2,0,0,0,0,2,2
wi16,161,SIXTH,ANTH,Anth-Biol,0,0,0,0,0,0,0,0,0,0,2,2,0,0,0,0,0,0,0,2,2
wi16,161,SIXTH,ANTH,Anth-Soci,0,0,0,0,0,0,0,2,2,0,0,0,0,1,1,0,0,0,0,3,3
wi16,161,SIXTH,BENG,Bioen:Binf,0,0,0,0,0,0,1,2,3,0,2,2,6,8,14,0,0,0,7,12,19
wi16,161,SIXTH,BENG,BioengBioS,0,0,0,0,1,1,1,3,4,3,2,5,4,5,9,0,0,0,8,11,19
wi16,161,SIXTH,BENG,BioengBiot,0,0,0,0,0,0,1,0,1,5,4,9,7,4,11,0,0,0,13,8,21
wi16,161,SIXTH,BENG,Bioengin,0,0,0,0,0,0,0,0,0,0,0,0,8,4,12,0,0,0,8,4,12
wi16,161,SIXTH,BIOL,Bioc/CellB,0,0,0,6,11,17,23,16,39,33,33,66,40,41,81,0,0,0,102,101,203
wi16,161,SIXTH,BIOL,BiolBioinf,0,0,0,0,1,1,5,4,9,2,3,5,3,2,5,0,0,0,10,10,20
wi16,161,SIXTH,BIOL,Ec/Beh/Evo,0,0,0,2,0,2,4,2,6,2,7,9,2,4,6,0,0,0,10,13,23
wi16,161,SIXTH,BIOL,Genl Biol,0,0,0,7,9,16,13,14,27,9,27,36,22,29,51,0,0,0,51,79,130
wi16,161,SIXTH,BIOL,Human Bio,0,0,0,6,17,23,12,42,54,31,42,73,50,51,101,0,0,0,99,152,251
wi16,161,SIXTH,BIOL,Microbiol,0,0,0,0,1,1,2,4,6,6,3,9,5,7,12,0,0,0,13,15,28
wi16,161,SIXTH,BIOL,Molec Biol,0,0,0,2,1,3,5,6,11,4,6,10,8,7,15,0,0,0,19,20,39
wi16,161,SIXTH,BIOL,PhyslNeuro,0,0,0,6,11,17,14,14,28,13,24,37,28,27,55,0,0,0,61,76,137
wi16,161,SIXTH,CENG,Chem Engin,0,0,0,0,0,0,1,0,1,12,5,17,40,19,59,0,0,0,53,24,77
wi16,161,SIXTH,CGS,CritGendSt,0,0,0,0,0,0,0,0,0,1,0,1,2,0,2,0,0,0,3,0,3
wi16,161,SIXTH,CHEM,Bioch/Chem,0,0,0,2,1,3,3,5,8,4,5,9,6,6,12,0,0,0,15,17,32
wi16,161,SIXTH,CHEM,Bioinform,0,0,0,0,3,3,2,0,2,1,1,2,1,0,1,0,0,0,4,4,8
wi16,161,SIXTH,CHEM,Chem Educ,0,0,0,0,0,0,0,0,0,0,0,0,0,1,1,0,0,0,0,1,1
wi16,161,SIXTH,CHEM,Chemistry,0,0,0,2,3,5,3,4,7,4,7,11,3,4,7,0,0,0,12,18,30
wi16,161,SIXTH,CHEM,Envir Chem,0,0,0,0,1,1,0,0,0,0,1,1,1,1,2,0,0,0,1,3,4
wi16,161,SIXTH,CHEM,MolecSynth,0,0,0,0,0,0,1,0,1,0,0,0,2,0,2,0,0,0,3,0,3
wi16,161,SIXTH,CHEM,Pharm Chem,0,0,0,3,2,5,2,7,9,5,12,17,9,13,22,0,0,0,19,34,53
wi16,161,SIXTH,CHIN,Chinese St,0,0,0,0,0,0,0,0,0,0,2,2,0,0,0,0,0,0,0,2,2
wi16,161,SIXTH,COGS,Cog Sci,0,0,0,1,4,5,3,7,10,6,2,8,3,3,6,0,0,0,13,16,29
wi16,161,SIXTH,COGS,CogSc/ClAs,0,0,0,0,1,1,0,1,1,0,1,1,2,1,3,0,0,0,2,4,6
wi16,161,SIXTH,COGS,CogSc/Comp,0,0,0,0,0,0,8,1,9,4,0,4,2,0,2,0,0,0,14,1,15
wi16,161,SIXTH,COGS,CogSc/HCI,0,0,0,2,0,2,8,5,13,10,6,16,11,9,20,0,0,0,31,20,51
wi16,161,SIXTH,COGS,CogSc/HCog,0,0,0,0,0,0,2,4,6,1,2,3,2,2,4,0,0,0,5,8,13
wi16,161,SIXTH,COGS,CogSc/Neur,0,0,0,0,2,2,3,1,4,2,3,5,6,7,13,0,0,0,11,13,24
wi16,161,SIXTH,COMM,Communic,0,0,0,1,9,10,7,12,19,17,45,62,20,53,73,0,0,0,45,119,164
wi16,161,SIXTH,CSE,Comp Sci,0,0,0,3,2,5,13,4,17,75,12,87,198,40,238,0,0,0,289,58,347
wi16,161,SIXTH,CSE,CompEngCSE,0,0,0,0,0,0,5,0,5,7,0,7,33,3,36,0,0,0,45,3,48
wi16,161,SIXTH,CSE,CompScBinf,0,0,0,0,0,0,0,0,0,2,0,2,5,6,11,0,0,0,7,6,13
wi16,161,SIXTH,ECE,CompEngECE,0,0,0,3,0,3,10,4,14,17,1,18,27,4,31,0,0,0,57,9,66
wi16,161,SIXTH,ECE,Electr Eng,0,0,0,4,0,4,15,4,19,30,5,35,109,14,123,0,0,0,158,23,181
wi16,161,SIXTH,ECE,EleEng&Soc,0,0,0,0,0,0,0,0,0,0,0,0,0,1,1,0,0,0,0,1,1
wi16,161,SIXTH,ECE,Engin Phys,0,0,0,0,0,0,0,0,0,0,1,1,0,0,0,0,0,0,0,1,1
wi16,161,SIXTH,ECE,Pr-EngPhys,0,0,0,0,0,0,1,1,2,1,0,1,0,0,0,0,0,0,2,1,3
wi16,161,SIXTH,ECON,Ec-Mth&Ecn,0,0,0,5,3,8,3,8,11,10,6,16,9,7,16,0,0,0,27,24,51
wi16,161,SIXTH,ECON,Econ-MgtSc,0,0,0,4,6,10,8,4,12,28,16,44,45,22,67,0,0,0,85,48,133
wi16,161,SIXTH,ECON,Economics,0,0,0,18,14,32,27,14,41,54,36,90,61,28,89,0,0,0,160,92,252
wi16,161,SIXTH,ECON,EnvSys(EB),0,0,0,0,0,0,1,0,1,1,1,2,1,3,4,0,0,0,3,4,7
wi16,161,SIXTH,ECON,EnvSys(EC),0,0,0,0,1,1,1,0,1,2,1,3,0,0,0,0,0,0,3,2,5
wi16,161,SIXTH,ECON,EnvSys(EP),0,0,0,0,0,0,0,0,0,1,1,2,1,0,1,0,0,0,2,1,3
wi16,161,SIXTH,ECON,EnvSys(ES),0,0,0,1,1,2,1,0,1,3,1,4,2,3,5,0,0,0,7,5,12
wi16,161,SIXTH,ETHN,Ethnic St,0,0,0,0,0,0,0,0,0,0,1,1,0,0,0,0,0,0,0,1,1
wi16,161,SIXTH,FPMU,Public Hlt,0,0,0,0,1,1,1,5,6,3,20,23,7,29,36,0,0,0,11,55,66
wi16,161,SIXTH,GLBH,Global Hlt,0,0,0,0,1,1,0,1,1,0,3,3,1,1,2,0,0,0,1,6,7
wi16,161,SIXTH,GMST,German Stu,0,0,0,0,1,1,0,0,0,0,0,0,0,0,0,0,0,0,0,1,1
wi16,161,SIXTH,HDP,Human Dev,0,0,0,0,0,0,0,2,2,0,3,3,3,14,17,0,0,0,3,19,22
wi16,161,SIXTH,HDP,Pr-HumnDev,0,0,0,0,1,1,0,5,5,0,4,4,0,1,1,0,0,0,0,11,11
wi16,161,SIXTH,HIST,History,0,0,0,1,0,1,2,2,4,3,2,5,2,1,3,0,0,0,8,5,13
wi16,161,SIXTH,INTL,InSt-InBus,0,0,0,8,3,11,6,6,12,12,18,30,8,5,13,0,0,0,34,32,66
wi16,161,SIXTH,INTL,Int-5yrEC,0,0,0,0,0,0,0,0,0,0,0,0,1,0,1,0,0,0,1,0,1
wi16,161,SIXTH,INTL,IntSt-Anth,0,0,0,0,0,0,0,0,0,0,1,1,1,2,3,0,0,0,1,3,4
wi16,161,SIXTH,INTL,IntSt-Econ,0,0,0,3,2,5,1,4,5,2,3,5,5,3,8,0,0,0,11,12,23
wi16,161,SIXTH,INTL,IntSt-Hist,0,0,0,0,1,1,0,0,0,0,0,0,0,0,0,0,0,0,0,1,1
wi16,161,SIXTH,INTL,IntSt-Ling,0,0,0,0,0,0,0,0,0,1,0,1,0,1,1,0,0,0,1,1,2
wi16,161,SIXTH,INTL,IntSt-Lit,0,0,0,0,1,1,0,1,1,0,0,0,0,1,1,0,0,0,0,3,3
wi16,161,SIXTH,INTL,IntSt-PolS,0,0,0,1,5,6,3,1,4,1,1,2,2,5,7,0,0,0,7,12,19
wi16,161,SIXTH,INTL,IntSt-Soc,0,0,0,0,0,0,0,0,0,0,0,0,0,1,1,0,0,0,0,1,1
wi16,161,SIXTH,JUDA,Judaic Stu,0,0,0,0,0,0,0,0,0,0,0,0,0,1,1,0,0,0,0,1,1
wi16,161,SIXTH,JUDA,Lang Stu,0,0,0,0,1,1,0,0,0,0,0,0,1,0,1,0,0,0,1,1,2
wi16,161,SIXTH,JUDA,Ling-CogLn,0,0,0,0,1,1,0,0,0,0,2,2,0,0,0,0,0,0,0,3,3
wi16,161,SIXTH,JUDA,Ling-LSoc,0,0,0,0,0,0,0,0,0,0,0,0,0,1,1,0,0,0,0,1,1
wi16,161,SIXTH,JUDA,Linguistcs,0,0,0,0,0,0,0,0,0,0,0,0,1,5,6,0,0,0,1,5,6
wi16,161,SIXTH,LIT,Lit/Engl,0,0,0,0,1,1,1,1,2,0,1,1,1,2,3,0,0,0,2,5,7
wi16,161,SIXTH,LIT,Lit/Writng,0,0,0,0,0,0,1,2,3,5,5,10,3,4,7,0,0,0,9,11,20
wi16,161,SIXTH,MAE,Aerosp Eng,0,0,0,5,2,7,7,1,8,12,2,14,17,5,22,0,0,0,41,10,51
wi16,161,SIXTH,MAE,Envir Eng,0,0,0,1,0,1,6,3,9,5,2,7,15,10,25,0,0,0,27,15,42
wi16,161,SIXTH,MAE,Mech Engin,0,0,0,1,1,2,5,2,7,11,4,15,26,8,34,0,0,0,43,15,58
wi16,161,SIXTH,MATH,Appld Math,0,0,0,14,13,27,7,9,16,7,9,16,10,8,18,0,0,0,38,39,77
wi16,161,SIXTH,MATH,Math/SecEd,0,0,0,1,0,1,1,1,2,0,0,0,0,1,1,0,0,0,2,2,4
wi16,161,SIXTH,MATH,Mathematcs,0,0,0,5,2,7,2,5,7,5,8,13,9,2,11,0,0,0,21,17,38
wi16,161,SIXTH,MATH,Mth-CompSc,0,0,0,26,11,37,45,18,63,49,16,65,15,7,22,0,0,0,135,52,187
wi16,161,SIXTH,MATH,Mth-Mth&Ec,0,0,0,5,3,8,5,5,10,7,3,10,4,6,10,0,0,0,21,17,38
wi16,161,SIXTH,MATH,Mth-SciCom,0,0,0,0,0,0,0,1,1,0,0,0,0,0,0,0,0,0,0,1,1
wi16,161,SIXTH,MATH,Mth/ApldSc,0,0,0,1,1,2,0,0,0,1,1,2,0,0,0,0,0,0,2,2,4
wi16,161,SIXTH,MATH,Prob&Stats,0,0,0,0,2,2,5,3,8,5,4,9,4,1,5,0,0,0,14,10,24
wi16,161,SIXTH,MUS,Mu-CompArt,0,0,0,5,1,6,3,0,3,3,3,6,10,3,13,0,0,0,21,7,28
wi16,161,SIXTH,MUS,Music,0,0,0,0,2,2,0,0,0,3,0,3,2,1,3,0,0,0,5,3,8
wi16,161,SIXTH,MUS,Music Hum,0,0,0,0,0,0,1,0,1,0,1,1,1,0,1,0,0,0,2,1,3
wi16,161,SIXTH,NENG,NanoEng,0,0,0,3,2,5,7,0,7,15,0,15,21,6,27,0,0,0,46,8,54
wi16,161,SIXTH,PHIL,Philosophy,0,0,0,0,0,0,2,0,2,4,0,4,3,2,5,0,0,0,9,2,11
wi16,161,SIXTH,PHIL,Biophysics,0,0,0,0,0,0,2,1,3,0,0,0,1,1,2,0,0,0,3,2,5
wi16,161,SIXTH,PHIL,Gen Physcs,0,0,0,0,0,0,2,0,2,1,0,1,1,0,1,0,0,0,4,0,4
wi16,161,SIXTH,PHIL,Phys/Astro,0,0,0,3,2,5,1,1,2,3,1,4,6,2,8,0,0,0,13,6,19
wi16,161,SIXTH,PHIL,Phys/Comp,0,0,0,1,0,1,0,1,1,1,1,2,1,0,1,0,0,0,3,2,5
wi16,161,SIXTH,PHIL,Phys/Mtrls,0,0,0,0,0,0,7,2,9,3,0,3,2,0,2,0,0,0,12,2,14
wi16,161,SIXTH,PHIL,Physics,0,0,0,9,4,13,9,1,10,11,1,12,12,1,13,0,0,0,41,7,48
wi16,161,SIXTH,POLI,Polit Sci,0,0,0,4,2,6,1,2,3,0,11,11,10,10,20,0,0,0,15,25,40
wi16,161,SIXTH,POLI,PolSc-Amer,0,0,0,0,0,0,0,1,1,0,0,0,0,1,1,0,0,0,0,2,2
wi16,161,SIXTH,POLI,PolSc-Intl,0,0,0,1,0,1,1,1,2,4,1,5,3,3,6,0,0,0,9,5,14
wi16,161,SIXTH,POLI,PolSc-PLaw,0,0,0,0,1,1,1,1,2,2,4,6,0,4,4,0,0,0,3,10,13
wi16,161,SIXTH,POLI,PolSc-PPol,0,0,0,0,0,0,0,0,0,2,1,3,4,0,4,0,0,0,6,1,7
wi16,161,SIXTH,POLI,PolSc-Thry,0,0,0,0,0,0,0,0,0,0,0,0,0,1,1,0,0,0,0,1,1
wi16,161,SIXTH,PSYC,CogBehNeur,0,0,0,0,0,0,0,0,0,0,1,1,0,0,0,0,0,0,0,1,1
wi16,161,SIXTH,PSYC,Psyc/ClPsy,0,0,0,0,2,2,0,6,6,5,7,12,6,16,22,0,0,0,11,31,42
wi16,161,SIXTH,PSYC,Psyc/CogPs,0,0,0,0,0,0,0,1,1,0,1,1,0,1,1,0,0,0,0,3,3
wi16,161,SIXTH,PSYC,Psyc/DelPs,0,0,0,0,1,1,0,0,0,0,4,4,0,2,2,0,0,0,0,7,7
wi16,161,SIXTH,PSYC,Psyc/HumHl,0,0,0,0,2,2,0,1,1,1,5,6,1,2,3,0,0,0,2,10,12
wi16,161,SIXTH,PSYC,Psyc/SenPr,0,0,0,0,0,0,0,0,0,0,0,0,0,1,1,0,0,0,0,1,1
wi16,161,SIXTH,PSYC,Psyc/SocPs,0,0,0,1,3,4,0,1,1,1,3,4,2,3,5,0,0,0,4,10,14
wi16,161,SIXTH,PSYC,Psychology,0,0,0,6,10,16,1,4,5,6,14,20,15,34,49,0,0,0,28,62,90
wi16,161,SIXTH,RELI,Relig/Stu,0,0,0,0,0,0,0,0,0,1,0,1,1,0,1,0,0,0,2,0,2
wi16,161,SIXTH,SE,Engin Sci,0,0,0,0,1,1,1,0,1,0,0,0,0,0,0,0,0,0,1,1,2
wi16,161,SIXTH,SE,Struct Eng,0,0,0,4,1,5,8,5,13,23,5,28,55,20,75,0,0,0,90,31,121
wi16,161,SIXTH,SIO,Earth Sci,0,0,0,0,1,1,0,1,1,2,0,2,0,1,1,0,0,0,2,3,5
wi16,161,SIXTH,SIO,Marine Bio,0,0,0,1,3,4,2,4,6,3,6,9,2,6,8,0,0,0,8,19,27
wi16,161,SIXTH,SOC,SocCulCom,0,0,0,0,0,0,0,0,0,0,2,2,1,2,3,0,0,0,1,4,5
wi16,161,SIXTH,SOC,SocEconSoc,0,0,0,0,0,0,0,0,0,0,1,1,1,0,1,0,0,0,1,1,2
wi16,161,SIXTH,SOC,SocIntlStu,0,0,0,0,0,0,0,0,0,0,0,0,0,1,1,0,0,0,0,1,1
wi16,161,SIXTH,SOC,Sociology,0,0,0,1,2,3,0,2,2,3,4,7,2,7,9,0,0,0,6,15,21
wi16,161,SIXTH,SOC,SocLawSoc,0,0,0,0,0,0,0,0,0,3,2,5,0,3,3,0,0,0,3,5,8
wi16,161,SIXTH,SOC,SocSciMed,0,0,0,0,1,1,0,0,0,0,0,0,0,0,0,0,0,0,0,1,1
wi16,161,SIXTH,SOC,SocSolneq,0,0,0,0,0,0,0,0,0,0,1,1,0,3,3,0,0,0,0,4,4
wi16,161,SIXTH,THEA,Theatre,0,0,0,0,6,6,2,2,4,2,8,10,3,4,7,0,0,0,7,20,27
wi16,161,SIXTH,UNAF,UndecHumAr,0,0,0,1,2,3,2,2,4,0,0,0,0,0,0,0,0,0,3,4,7
wi16,161,SIXTH,UNAF,Undeclared,0,0,0,58,30,88,51,16,67,4,1,5,0,0,0,0,0,0,113,47,160
wi16,161,SIXTH,UNAF,UndecPhysS,0,0,0,2,2,4,2,2,4,0,0,0,0,0,0,0,0,0,4,4,8
wi16,161,SIXTH,UNAF,UndecSocSc,0,0,0,1,3,4,3,3,6,0,0,0,0,0,0,0,0,0,4,6,10
wi16,161,SIXTH,USP,Urb Stu&Pl,0,0,0,2,0,2,1,1,2,0,3,3,4,9,13,0,0,0,7,13,20
wi16,161,SIXTH,VIS,Art Hst/Cr,0,0,0,0,0,0,0,0,0,0,4,4,0,3,3,0,0,0,0,7,7
wi16,161,SIXTH,VIS,Media,0,0,0,3,11,14,8,11,19,12,15,27,17,18,35,0,0,0,40,55,95
wi16,161,SIXTH,VIS,Spec Desgn,0,0,0,1,2,3,2,0,2,0,1,1,0,0,0,0,0,0,3,3,6
wi16,161,SIXTH,VIS,Studio VA,0,0,0,1,2,3,0,5,5,4,8,12,3,6,9,0,0,0,8,21,29
wi16,161,SIXTH,VIS,VA-CompArt,0,0,0,6,2,8,4,6,10,5,12,17,9,13,22,0,0,0,24,33,57
wi16,161,WARREN,ANTH,Anth-Arch,0,0,0,0,0,0,0,0,0,0,0,0,0,2,2,0,0,0,0,2,2
wi16,161,WARREN,ANTH,Anth-Biol,0,0,0,0,0,0,0,1,1,2,2,4,1,0,1,0,0,0,3,3,6
wi16,161,WARREN,ANTH,Anth-Soci,0,0,0,1,0,1,0,0,0,0,0,0,1,1,2,0,0,0,2,1,3
wi16,161,WARREN,BENG,Bioen:Binf,0,0,0,2,1,3,2,2,4,5,1,6,10,12,22,0,0,0,19,16,35
wi16,161,WARREN,BENG,BioengBioS,0,0,0,0,0,0,3,4,7,3,2,5,5,1,6,0,0,0,11,7,18
wi16,161,WARREN,BENG,BioengBiot,0,0,0,1,0,1,6,3,9,12,6,18,19,27,46,0,0,0,38,36,74
wi16,161,WARREN,BENG,Bioengin,0,0,0,2,1,3,3,2,5,9,5,14,23,15,38,0,0,0,37,23,60
wi16,161,WARREN,BIOL,Bioc/CellB,0,0,0,6,7,13,17,20,37,20,25,45,38,50,88,0,0,0,81,102,183
wi16,161,WARREN,BIOL,BiolBioinf,0,0,0,4,1,5,1,0,1,2,1,3,1,1,2,0,0,0,8,3,11
wi16,161,WARREN,BIOL,Ec/Beh/Evo,0,0,0,0,0,0,1,2,3,0,0,0,4,8,12,0,0,0,5,10,15
wi16,161,WARREN,BIOL,Genl Biol,0,0,0,3,6,9,7,4,11,2,15,17,26,44,70,0,0,0,38,69,107
wi16,161,WARREN,BIOL,Human Bio,0,0,0,7,9,16,10,20,30,14,23,37,36,49,85,0,0,0,67,101,168
wi16,161,WARREN,BIOL,Microbiol,0,0,0,1,1,2,5,2,7,4,0,4,4,7,11,0,0,0,14,10,24
wi16,161,WARREN,BIOL,Molec Biol,0,0,0,0,0,0,2,3,5,5,3,8,10,5,15,0,0,0,17,11,28
wi16,161,WARREN,BIOL,PhyslNeuro,0,0,0,1,6,7,5,13,18,8,12,20,33,28,61,0,0,0,47,59,106
wi16,161,WARREN,CENG,Chem Engin,0,0,0,2,2,4,5,3,8,18,11,29,76,33,109,0,0,0,101,49,150
wi16,161,WARREN,CGS,CritGendSt,0,0,0,0,0,0,0,0,0,0,0,0,1,0,1,0,0,0,1,0,1
wi16,161,WARREN,CHEM,Bioch/Chem,0,0,0,1,4,5,7,3,10,2,7,9,9,9,18,0,0,0,19,23,42
wi16,161,WARREN,CHEM,Bioinform,0,0,0,0,0,0,0,0,0,0,0,0,0,1,1,0,0,0,0,1,1
wi16,161,WARREN,CHEM,Chemistry,0,0,0,3,3,6,6,7,13,4,5,9,1,6,7,0,0,0,14,21,35
wi16,161,WARREN,CHEM,Envir Chem,0,0,0,0,0,0,0,0,0,0,0,0,3,0,3,0,0,0,3,0,3
wi16,161,WARREN,CHEM,MolecSynth,0,0,0,0,0,0,0,1,1,0,0,0,0,0,0,0,0,0,0,1,1
wi16,161,WARREN,CHEM,Pharm Chem,0,0,0,0,3,3,2,3,5,2,7,9,3,12,15,0,0,0,7,25,32
wi16,161,WARREN,CHIN,Chinese St,0,0,0,0,0,0,0,0,0,0,0,0,0,3,3,0,0,0,0,3,3
wi16,161,WARREN,COGS,Cog Sci,0,0,0,0,1,1,2,2,4,2,3,5,4,4,8,0,0,0,8,10,18
wi16,161,WARREN,COGS,CogSc/ClAs,0,0,0,0,0,0,0,0,0,0,0,0,2,2,4,0,0,0,2,2,4
wi16,161,WARREN,COGS,CogSc/Comp,0,0,0,0,0,0,1,0,1,0,1,1,1,3,4,0,0,0,2,4,6
wi16,161,WARREN,COGS,CogSc/HCI,0,0,0,1,1,2,4,4,8,5,2,7,5,9,14,0,0,0,15,16,31
wi16,161,WARREN,COGS,CogSc/HCog,0,0,0,0,0,0,0,0,0,0,0,0,1,1,2,0,0,0,1,1,2
wi16,161,WARREN,COGS,CogSc/Neur,0,0,0,0,2,2,1,3,4,1,3,4,0,9,9,0,0,0,2,17,19
wi16,161,WARREN,COMM,Communic,0,0,0,0,4,4,1,5,6,5,22,27,9,16,25,0,0,0,15,47,62
wi16,161,WARREN,CSE,Comp Sci,0,0,0,8,2,10,66,22,88,107,23,130,278,62,340,0,0,0,459,109,568
wi16,161,WARREN,CSE,CompEngCSE,0,0,0,3,1,4,14,1,15,19,4,23,69,6,75,0,0,0,105,12,117
wi16,161,WARREN,CSE,CompScBinf,0,0,0,0,0,0,1,0,1,2,2,4,2,2,4,0,0,0,5,4,9
wi16,161,WARREN,ECE,CompEngECE,0,0,0,5,0,5,13,3,16,39,2,41,29,5,34,0,0,0,86,10,96
wi16,161,WARREN,ECE,Electr Eng,0,0,0,13,1,14,33,7,40,35,12,47,140,22,162,0,0,0,221,42,263
wi16,161,WARREN,ECE,Engin Phys,0,0,0,0,0,0,1,0,1,1,0,1,2,0,2,0,0,0,4,0,4
wi16,161,WARREN,ECE,Pr-EngPhys,0,0,0,0,0,0,1,2,3,2,0,2,0,0,0,0,0,0,3,2,5
wi16,161,WARREN,ECON,Ec-Mth&Ecn,0,0,0,5,3,8,3,7,10,12,4,16,7,2,9,0,0,0,27,16,43
wi16,161,WARREN,ECON,Econ-MgtSc,0,0,0,1,2,3,8,5,13,16,15,31,43,21,64,0,0,0,68,43,111
wi16,161,WARREN,ECON,Economics,0,0,0,13,6,19,9,5,14,43,27,70,66,36,102,0,0,0,131,74,205
wi16,161,WARREN,ESYS,EnvSys(EB),0,0,0,0,0,0,0,1,1,0,0,0,0,2,2,0,0,0,0,3,3
wi16,161,WARREN,ESYS,EnvSys(EP),0,0,0,0,1,1,0,0,0,0,0,0,0,0,0,0,0,0,0,1,1
wi16,161,WARREN,ESYS,EnvSys(ES),0,0,0,0,0,0,0,0,0,1,1,2,0,0,0,0,0,0,1,1,2
wi16,161,WARREN,ETHN,Ethnic St,0,0,0,0,0,0,0,2,2,0,0,0,2,1,3,0,0,0,2,3,5
wi16,161,WARREN,FPMU,Public Hlt,0,0,0,0,0,0,1,4,5,5,6,11,4,9,13,0,0,0,10,19,29
wi16,161,WARREN,GLBH,Global Hlt,0,0,0,0,0,0,0,1,1,1,1,2,0,5,5,0,0,0,1,7,8
wi16,161,WARREN,HDP,Human Dev,0,0,0,0,0,0,0,0,0,0,4,4,2,10,12,0,0,0,2,14,16
wi16,161,WARREN,HDP,Pr-HumnDev,0,0,0,0,2,2,0,3,3,0,4,4,1,0,1,0,0,0,1,9,10
wi16,161,WARREN,HIST,History,0,0,0,0,0,0,2,2,4,1,2,3,6,1,7,0,0,0,9,5,14
wi16,161,WARREN,INTL,InSt-InBus,0,0,0,5,5,10,2,3,5,6,4,10,4,3,7,0,0,0,17,15,32
wi16,161,WARREN,INTL,Int-5yrEC,0,0,0,0,0,0,0,0,0,0,0,0,1,0,1,0,0,0,1,0,1
wi16,161,WARREN,INTL,Int-5yrPS,0,0,0,0,0,0,0,0,0,0,0,0,1,1,2,0,0,0,1,1,2
wi16,161,WARREN,INTL,IntSt-Anth,0,0,0,0,0,0,0,0,0,0,0,0,1,1,2,0,0,0,1,1,2
wi16,161,WARREN,INTL,IntSt-Econ,0,0,0,1,0,1,0,0,0,3,1,4,1,1,2,0,0,0,5,2,7
wi16,161,WARREN,INTL,IntSt-Hist,0,0,0,0,0,0,0,0,0,0,1,1,0,0,0,0,0,0,0,1,1
wi16,161,WARREN,INTL,IntSt-Ling,0,0,0,0,0,0,0,0,0,0,2,2,0,0,0,0,0,0,0,2,2
wi16,161,WARREN,INTL,IntSt-Lit,0,0,0,0,0,0,0,0,0,0,1,1,0,0,0,0,0,0,0,1,1
wi16,161,WARREN,INTL,IntSt-PolS,0,0,0,0,1,1,1,0,1,0,4,4,1,4,5,0,0,0,2,9,11
wi16,161,WARREN,INTL,IntSt-Soc,0,0,0,0,0,0,0,0,0,0,1,1,0,1,1,0,0,0,0,2,2
wi16,161,WARREN,LATI,LatinAm St,0,0,0,0,0,0,0,0,0,1,1,2,0,0,0,0,0,0,1,1,2
wi16,161,WARREN,LING,Lang Stu,0,0,0,0,0,0,0,0,0,0,0,0,0,1,1,0,0,0,0,1,1
wi16,161,WARREN,LING,Ling-CogLn,0,0,0,0,0,0,0,1,1,0,1,1,0,0,0,0,0,0,0,2,2
wi16,161,WARREN,LING,Linguistcs,0,0,0,0,0,0,1,0,1,0,1,1,3,0,3,0,0,0,4,1,5
wi16,161,WARREN,LING,French Lit,0,0,0,0,0,0,0,0,0,0,0,0,1,0,1,0,0,0,1,0,1
wi16,161,WARREN,LING,Lit/Engl,0,0,0,0,0,0,1,0,1,1,1,2,0,1,1,0,0,0,2,2,4
wi16,161,WARREN,LING,Lit/World,0,0,0,0,0,0,0,1,1,0,0,0,0,1,1,0,0,0,0,2,2
wi16,161,WARREN,LING,Lit/Writng,0,0,0,1,0,1,0,1,1,2,2,4,1,8,9,0,0,0,4,11,15
wi16,161,WARREN,LING,Spanish Lt,0,0,0,0,0,0,0,0,0,1,0,1,1,1,2,0,0,0,2,1,3
wi16,161,WARREN,MAE,Aerosp Eng,0,0,0,5,0,5,23,6,29,16,3,19,42,12,54,0,0,0,86,21,107
wi16,161,WARREN,MAE,Engin Sci,0,0,0,0,0,0,0,0,0,0,0,0,2,0,2,0,0,0,2,0,2
wi16,161,WARREN,MAE,Envir Eng,0,0,0,1,3,4,3,4,7,4,6,10,23,10,33,0,0,0,31,23,54
wi16,161,WARREN,MAE,Mech Engin,0,0,0,3,2,5,34,7,41,29,6,35,85,16,101,0,0,0,151,31,182
wi16,161,WARREN,MATH,Appld Math,0,0,0,10,11,21,5,5,10,9,1,10,6,10,16,0,0,0,30,27,57
wi16,161,WARREN,MATH,Math/SecEd,0,0,0,0,1,1,1,1,2,0,1,1,1,2,3,0,0,0,2,5,7
wi16,161,WARREN,MATH,Mathematcs,0,0,0,3,3,6,3,4,7,8,3,11,7,5,12,0,0,0,21,15,36
wi16,161,WARREN,MATH,Mth-CompSc,0,0,0,32,11,43,44,20,64,33,11,44,12,3,15,0,0,0,121,45,166
wi16,161,WARREN,MATH,Mth-Mth&Ec,0,0,0,6,5,11,5,5,10,3,11,14,8,6,14,0,0,0,22,27,49
wi16,161,WARREN,MATH,Mth-SciCom,0,0,0,0,0,0,1,0,1,0,0,0,0,0,0,0,0,0,1,0,1
wi16,161,WARREN,MATH,Mth/ApldSc,0,0,0,0,1,1,2,0,2,2,3,5,1,0,1,0,0,0,5,4,9
wi16,161,WARREN,MATH,Prob&Stats,0,0,0,1,1,2,1,5,6,8,5,13,1,4,5,0,0,0,11,15,26
wi16,161,WARREN,MUS,Mu-CompArt,0,0,0,1,0,1,2,1,3,0,0,0,3,0,3,0,0,0,6,1,7
wi16,161,WARREN,MUS,Music,0,0,0,0,0,0,1,0,1,2,0,2,2,0,2,0,0,0,5,0,5
wi16,161,WARREN,NENG,NanoEng,0,0,0,2,0,2,3,2,5,5,2,7,32,8,40,0,0,0,42,12,54
wi16,161,WARREN,PHIL,Philosophy,0,0,0,0,1,1,0,1,1,1,1,2,1,4,5,0,0,0,2,7,9
wi16,161,WARREN,PHYS,Biophysics,0,0,0,1,0,1,0,1,1,2,0,2,1,1,2,0,0,0,4,2,6
wi16,161,WARREN,PHYS,Gen Physcs,0,0,0,0,0,0,0,0,0,1,0,1,0,0,0,0,0,0,1,0,1
wi16,161,WARREN,PHYS,Phys/Astro,0,0,0,0,0,0,4,2,6,4,1,5,1,2,3,0,0,0,9,5,14
wi16,161,WARREN,PHYS,Phys/Comp,0,0,0,0,1,1,0,0,0,1,0,1,1,0,1,0,0,0,2,1,3
wi16,161,WARREN,PHYS,Phys/Mtrls,0,0,0,2,0,2,3,0,3,1,0,1,0,0,0,0,0,0,6,0,6
wi16,161,WARREN,PHYS,Physics,0,0,0,7,2,9,8,2,10,7,2,9,7,1,8,0,0,0,29,7,36
wi16,161,WARREN,POLI,Polit Sci,0,0,0,0,2,2,5,5,10,8,4,12,11,15,26,0,0,0,24,26,50
wi16,161,WARREN,POLI,PolSc-Amer,0,0,0,0,0,0,0,0,0,1,0,1,1,1,2,0,0,0,2,1,3
wi16,161,WARREN,POLI,PolSc-Comp,0,0,0,0,0,0,0,0,0,1,0,1,0,0,0,0,0,0,1,0,1
wi16,161,WARREN,POLI,PolSc-Intl,0,0,0,3,1,4,2,2,4,3,3,6,10,6,16,0,0,0,18,12,30
wi16,161,WARREN,POLI,PolSc-PLaw,0,0,0,0,2,2,4,5,9,2,3,5,5,5,10,0,0,0,11,15,26
wi16,161,WARREN,POLI,PolSc-PPol,0,0,0,0,0,0,0,0,0,1,0,1,2,0,2,0,0,0,3,0,3
wi16,161,WARREN,POLI,PolSc-Thry,0,0,0,0,0,0,0,0,0,1,0,1,0,1,1,0,0,0,1,1,2
wi16,161,WARREN,PSYC,Psyc/ClPsy,0,0,0,1,1,2,0,0,0,0,4,4,5,5,10,0,0,0,6,10,16
wi16,161,WARREN,PSYC,Psyc/CogPs,0,0,0,0,0,0,1,0,1,1,1,2,0,2,2,0,0,0,2,3,5
wi16,161,WARREN,PSYC,Psyc/DelPs,0,0,0,0,0,0,0,1,1,0,1,1,0,1,1,0,0,0,0,3,3
wi16,161,WARREN,PSYC,Psyc/HumHl,0,0,0,0,0,0,0,0,0,0,3,3,0,6,6,0,0,0,0,9,9
wi16,161,WARREN,PSYC,Psyc/SocPs,0,0,0,0,1,1,0,0,0,2,3,5,4,2,6,0,0,0,6,6,12
wi16,161,WARREN,PSYC,Psychology,0,0,0,1,1,2,1,3,4,6,18,24,11,27,38,0,0,0,19,49,68
wi16,161,WARREN,RELI,Relig/Stu,0,0,0,0,0,0,0,0,0,0,0,0,1,0,1,0,0,0,1,0,1
wi16,161,WARREN,RUSS,RusEE&EStd,0,0,0,0,0,0,0,0,0,0,0,0,0,1,1,0,0,0,0,1,1
wi16,161,WARREN,SE,Struct Eng,0,0,0,1,4,5,6,4,10,21,8,29,73,28,101,0,0,0,101,44,145
wi16,161,WARREN,SIO,Earth Sci,0,0,0,0,0,0,0,1,1,0,1,1,2,1,3,0,0,0,2,3,5
wi16,161,WARREN,SIO,Marine Bio,0,0,0,0,2,2,1,2,3,0,2,2,1,1,2,0,0,0,2,7,9
wi16,161,WARREN,SOC,SocCulCom,0,0,0,0,1,1,0,0,0,0,0,0,0,0,0,0,0,0,0,1,1
wi16,161,WARREN,SOC,SocEconSoc,0,0,0,0,0,0,0,0,0,0,0,0,1,1,2,0,0,0,1,1,2
wi16,161,WARREN,SOC,SocIntlStu,0,0,0,0,0,0,0,0,0,0,0,0,1,0,1,0,0,0,1,0,1
wi16,161,WARREN,SOC,Sociology,0,0,0,1,0,1,0,2,2,0,3,3,2,5,7,0,0,0,3,10,13
wi16,161,WARREN,SOC,SocLawSoc,0,0,0,0,2,2,1,1,2,2,2,4,2,3,5,0,0,0,5,8,13
wi16,161,WARREN,SOC,SocSolneq,0,0,0,0,0,0,0,1,1,0,0,0,0,3,3,0,0,0,0,4,4
wi16,161,WARREN,THEA,Dance,0,0,0,0,0,0,0,1,1,0,1,1,0,0,0,0,0,0,0,2,2
wi16,161,WARREN,THEA,Theatre,0,0,0,0,2,2,1,0,1,1,3,4,1,1,2,0,0,0,3,6,9
wi16,161,WARREN,UNAF,IntcampVis,0,0,0,0,0,0,0,1,1,0,1,1,0,0,0,0,0,0,0,2,2
wi16,161,WARREN,UNAF,UndecHumAr,0,0,0,0,1,1,0,0,0,0,0,0,0,0,0,0,0,0,0,1,1
wi16,161,WARREN,UNAF,Undeclared,0,0,0,42,13,55,45,20,65,5,0,5,0,0,0,0,0,0,92,33,125
wi16,161,WARREN,UNAF,UndecPhysS,0,0,0,12,1,13,6,1,7,1,0,1,0,0,0,0,0,0,19,2,21
wi16,161,WARREN,UNAF,UndecSocSc,0,0,0,0,3,3,1,1,2,0,1,1,0,0,0,0,0,0,1,5,6
wi16,161,WARREN,USP,Urb Stu&Pl,0,0,0,0,0,0,1,0,1,4,2,6,2,1,3,0,0,0,7,3,10
wi16,161,WARREN,VIS,Media,0,0,0,0,0,0,3,0,3,2,0,2,4,2,6,0,0,0,9,2,11
wi16,161,WARREN,VIS,Spec Desgn,0,0,0,0,0,0,0,0,0,0,1,1,0,0,0,0,0,0,0,1,1
wi16,161,WARREN,VIS,Studio VA,0,0,0,0,0,0,0,1,1,0,1,1,0,3,3,0,0,0,0,5,5
wi16,161,WARREN,VIS,VA-CompArt,0,0,0,1,0,1,0,0,0,1,0,1,1,3,4,0,0,0,3,3,6
fa14,143,MARSHALL,ANTH,Anth-Arch,0,1,1,0,0,0,0,0,0,1,0,1,1,0,1,0,0,0,2,1,3
fa14,143,MARSHALL,ANTH,Anth-Biol,0,0,0,0,0,0,0,1,1,0,0,0,0,2,2,0,0,0,0,3,3
fa14,143,MARSHALL,ANTH,Anth-Soci,0,1,1,0,0,0,0,0,0,2,4,6,1,3,4,0,0,0,3,8,11
fa14,143,MARSHALL,BENG,Bioen:Binf,3,3,6,0,0,0,1,0,1,3,3,6,2,5,7,0,0,0,9,11,20
fa14,143,MARSHALL,BENG,BioengBioS,0,2,2,0,0,0,2,0,2,4,0,4,0,0,0,0,0,0,6,2,8
fa14,143,MARSHALL,BENG,BioengBiot,1,2,3,0,0,0,0,0,0,3,2,5,7,4,11,0,0,0,11,8,19
fa14,143,MARSHALL,BENG,Bioengin,0,0,0,0,0,0,0,1,1,2,1,3,7,6,13,0,0,0,9,8,17
fa14,143,MARSHALL,BIOL,Bioc/CellB,12,23,35,2,0,2,14,20,34,22,30,52,34,61,95,0,0,0,84,134,218
fa14,143,MARSHALL,BIOL,BiolBioinf,0,2,2,0,0,0,0,0,0,1,3,4,0,0,0,0,0,0,1,5,6
fa14,143,MARSHALL,BIOL,Ec/Beh/Evo,0,1,1,0,0,0,1,2,3,1,1,2,1,1,2,0,0,0,3,5,8
fa14,143,MARSHALL,BIOL,Genl Biol,11,23,34,1,0,1,4,19,23,11,26,37,20,47,67,0,0,0,47,115,162
fa14,143,MARSHALL,BIOL,Human Bio,19,49,68,0,1,1,15,40,55,23,55,78,42,49,91,0,0,0,99,194,293
fa14,143,MARSHALL,BIOL,Microbiol,2,4,6,0,0,0,2,3,5,2,4,6,6,6,12,0,0,0,12,17,29
fa14,143,MARSHALL,BIOL,Molec Biol,6,0,6,0,0,0,3,2,5,4,2,6,3,5,8,0,0,0,16,9,25
fa14,143,MARSHALL,BIOL,PhyslNeuro,9,11,20,0,0,0,14,21,35,12,13,25,18,28,46,0,0,0,53,73,126
fa14,143,MARSHALL,CENG,Chem Engin,1,0,1,0,0,0,12,2,14,21,10,31,24,19,43,0,0,0,58,31,89
fa14,143,MARSHALL,CGS,CritGendSt,0,1,1,0,0,0,0,0,0,0,1,1,0,0,0,0,0,0,0,2,2
fa14,143,MARSHALL,CHEM,Bioch/Chem,3,6,9,1,0,1,2,3,5,6,8,14,6,10,16,0,0,0,18,27,45
fa14,143,MARSHALL,CHEM,Bioinform,2,1,3,0,0,0,0,0,0,0,0,0,1,0,1,0,0,0,3,1,4
fa14,143,MARSHALL,CHEM,Chem Educ,0,0,0,0,0,0,0,0,0,0,0,0,1,0,1,0,0,0,1,0,1
fa14,143,MARSHALL,CHEM,Chem Phys,1,1,2,0,0,0,0,0,0,0,0,0,0,1,1,0,0,0,1,2,3
fa14,143,MARSHALL,CHEM,Chemistry,8,10,18,0,0,0,2,3,5,3,2,5,7,8,15,0,0,0,20,23,43
fa14,143,MARSHALL,CHEM,Envir Chem,0,0,0,0,0,0,0,0,0,0,1,1,0,0,0,0,0,0,0,1,1
fa14,143,MARSHALL,CHEM,MolecSynth,0,0,0,0,0,0,0,0,0,0,0,0,1,1,2,0,0,0,1,1,2
fa14,143,MARSHALL,CHEM,Pharm Chem,4,6,10,0,1,1,5,4,9,4,4,8,8,6,14,0,0,0,21,21,42
fa14,143,MARSHALL,CLAS,Classic St,0,0,0,0,0,0,0,0,0,0,1,1,0,0,0,0,0,0,0,1,1
fa14,143,MARSHALL,COGS,Cog Sci,1,9,10,0,0,0,1,3,4,3,6,9,3,2,5,0,0,0,8,20,28
fa14,143,MARSHALL,COGS,CogSc/ClAs,0,0,0,0,0,0,0,1,1,0,1,1,0,2,2,0,0,0,0,4,4
fa14,143,MARSHALL,COGS,CogSc/Comp,1,0,1,0,0,0,0,0,0,1,0,1,0,0,0,0,0,0,2,0,2
fa14,143,MARSHALL,COGS,CogSc/HCI,1,1,2,0,0,0,0,2,2,4,4,8,0,7,7,0,0,0,5,14,19
fa14,143,MARSHALL,COGS,CogSc/HCog,0,0,0,0,0,0,0,0,0,0,1,1,0,2,2,0,0,0,0,3,3
fa14,143,MARSHALL,COGS,CogSc/Neur,0,1,1,1,0,1,0,1,1,1,2,3,5,10,15,0,0,0,7,14,21
fa14,143,MARSHALL,COMM,Communic,0,12,12,0,3,3,5,12,17,22,69,91,17,43,60,0,0,0,44,139,183
fa14,143,MARSHALL,CSE,Comp Sci,4,3,7,0,0,0,15,4,19,68,14,82,96,17,113,0,0,0,183,38,221
fa14,143,MARSHALL,CSE,CompEngCSE,3,0,3,1,0,1,3,0,3,13,2,15,15,2,17,0,0,0,35,4,39
fa14,143,MARSHALL,CSE,CompScBinf,1,0,1,0,1,1,2,7,9,6,0,6,1,2,3,0,0,0,10,10,20
fa14,143,MARSHALL,ECE,CompEngECE,9,1,10,1,0,1,7,2,9,11,1,12,6,1,7,0,0,0,34,5,39
fa14,143,MARSHALL,ECE,Electr Eng,7,2,9,0,0,0,12,3,15,42,6,48,49,13,62,0,0,0,110,24,134
fa14,143,MARSHALL,ECE,EleEng&Soc,0,0,0,0,0,0,0,0,0,0,0,0,0,1,1,0,0,0,0,1,1
fa14,143,MARSHALL,ECE,Pr-EngPhys,1,1,2,0,0,0,0,0,0,0,0,0,0,0,0,0,0,0,1,1,2
fa14,143,MARSHALL,ECON,Ec-Mth&Ecn,2,14,16,2,1,3,6,9,15,9,9,18,8,4,12,0,0,0,27,37,64
fa14,143,MARSHALL,ECON,Econ-MgtSc,5,8,13,0,3,3,9,10,19,20,31,51,46,36,82,0,0,0,80,88,168
fa14,143,MARSHALL,ECON,Economics,14,19,33,3,4,7,10,16,26,104,66,170,90,68,158,0,0,0,221,173,394
fa14,143,MARSHALL,ESYS,EnvSys(EB),0,1,1,0,0,0,2,2,4,0,2,2,3,6,9,0,0,0,5,11,16
fa14,143,MARSHALL,ESYS,EnvSys(EC),0,0,0,0,0,0,0,0,0,1,0,1,0,2,2,0,0,0,1,2,3
fa14,143,MARSHALL,ESYS,EnvSys(EP),0,1,1,0,0,0,0,1,1,0,1,1,2,1,3,0,0,0,2,4,6
fa14,143,MARSHALL,ESYS,EnvSys(ES),0,2,2,0,0,0,0,0,0,0,0,0,0,0,0,0,0,0,0,2,2
fa14,143,MARSHALL,ETHN,Ethnic St,0,1,1,0,0,0,0,2,2,0,0,0,1,2,3,0,0,0,1,5,6
fa14,143,MARSHALL,FPMU,Public Hlt,1,7,8,0,0,0,3,9,12,5,29,34,5,17,22,0,0,0,14,62,76
fa14,143,MARSHALL,GLBH,Global Hlt,0,0,0,0,0,0,0,1,1,0,1,1,0,0,0,0,0,0,0,2,2
fa14,143,MARSHALL,HDP,Human Dev,0,0,0,0,0,0,0,1,1,0,7,7,1,20,21,0,0,0,1,28,29
fa14,143,MARSHALL,HDP,Pr-HumnDev,0,1,1,0,0,0,0,11,11,1,9,10,0,4,4,0,0,0,1,25,26
fa14,143,MARSHALL,HIST,History,1,1,2,0,0,0,0,2,2,4,5,9,10,2,12,0,0,0,15,10,25
fa14,143,MARSHALL,INTL,Int-5yrPS,0,0,0,0,0,0,0,0,0,0,0,0,0,1,1,0,0,0,0,1,1
fa14,143,MARSHALL,INTL,IntSt-Anth,0,0,0,0,0,0,0,0,0,0,0,0,0,1,1,0,0,0,0,1,1
fa14,143,MARSHALL,INTL,IntSt-Econ,3,0,3,0,0,0,1,1,2,3,6,9,3,12,15,0,0,0,10,19,29
fa14,143,MARSHALL,INTL,IntSt-Hist,0,1,1,0,0,0,0,0,0,0,0,0,0,2,2,0,0,0,0,3,3
fa14,143,MARSHALL,INTL,IntSt-Ling,1,0,1,0,0,0,0,0,0,0,0,0,0,1,1,0,0,0,1,1,2
fa14,143,MARSHALL,INTL,IntSt-PolS,1,3,4,0,0,0,0,3,3,2,3,5,3,11,14,0,0,0,6,20,26
fa14,143,MARSHALL,INTL,IntSt-Soc,0,0,0,1,0,1,0,1,1,0,1,1,1,3,4,0,0,0,2,5,7
fa14,143,MARSHALL,JAPN,JapaneseSt,0,1,1,0,0,0,0,0,0,1,0,1,0,0,0,0,0,0,1,1,2
fa14,143,MARSHALL,LATI,LatinAm St,0,0,0,0,0,0,0,0,0,0,1,1,0,0,0,0,0,0,0,1,1
fa14,143,MARSHALL,LING,Lang Stu,0,0,0,0,0,0,0,0,0,0,0,0,1,0,1,0,0,0,1,0,1
fa14,143,MARSHALL,LING,Ling-CogLn,0,0,0,0,0,0,1,0,1,0,2,2,0,2,2,0,0,0,1,4,5
fa14,143,MARSHALL,LING,Ling-LSoc,0,1,1,0,0,0,0,0,0,0,0,0,0,3,3,0,0,0,0,4,4
fa14,143,MARSHALL,LING,Linguistcs,0,0,0,0,0,0,0,0,0,0,0,0,1,2,3,0,0,0,1,2,3
fa14,143,MARSHALL,LIT,Lit/Compos,0,1,1,0,0,0,0,0,0,0,0,0,0,1,1,0,0,0,0,2,2
fa14,143,MARSHALL,LIT,Lit/CultSt,0,0,0,1,0,1,0,0,0,0,0,0,0,0,0,0,0,0,1,0,1
fa14,143,MARSHALL,LIT,Lit/Engl,0,1,1,0,0,0,0,0,0,0,0,0,3,4,7,0,0,0,3,5,8
fa14,143,MARSHALL,LIT,Lit/World,0,0,0,0,0,0,0,1,1,0,0,0,0,1,1,0,0,0,0,2,2
fa14,143,MARSHALL,LIT,Lit/Writng,1,0,1,0,0,0,1,1,2,3,2,5,2,1,3,0,0,0,7,4,11
fa14,143,MARSHALL,MAE,Aerosp Eng,2,1,3,0,0,0,0,0,0,6,0,6,11,2,13,0,0,0,19,3,22
fa14,143,MARSHALL,MAE,Engin Sci,0,0,0,0,0,0,0,0,0,0,0,0,1,0,1,0,0,0,1,0,1
fa14,143,MARSHALL,MAE,Envir Eng,4,3,7,0,0,0,6,2,8,4,6,10,7,1,8,0,0,0,21,12,33
fa14,143,MARSHALL,MAE,Mech Engin,4,1,5,0,0,0,5,0,5,2,0,2,18,4,22,0,0,0,29,5,34
fa14,143,MARSHALL,MATH,Appld Math,8,11,19,1,0,1,2,4,6,5,6,11,6,3,9,0,0,0,22,24,46
fa14,143,MARSHALL,MATH,Math/SecEd,1,2,3,0,0,0,2,0,2,1,2,3,1,0,1,0,0,0,5,4,9
fa14,143,MARSHALL,MATH,Mathematcs,4,4,8,1,1,2,1,1,2,5,4,9,2,4,6,0,0,0,13,14,27
fa14,143,MARSHALL,MATH,Mth-CompSc,10,0,10,2,1,3,3,3,6,3,1,4,2,0,2,0,0,0,20,5,25
fa14,143,MARSHALL,MATH,Mth-Mth&Ec,1,3,4,1,0,1,2,2,4,4,3,7,4,4,8,0,0,0,12,12,24
fa14,143,MARSHALL,MATH,Mth-SciCom,0,1,1,0,0,0,0,0,0,0,0,0,0,1,1,0,0,0,0,2,2
fa14,143,MARSHALL,MATH,Mth/ApldSc,1,0,1,0,0,0,0,1,1,0,0,0,1,0,1,0,0,0,2,1,3
fa14,143,MARSHALL,MATH,Pr-Math CS,0,0,0,0,0,0,0,0,0,1,1,2,0,0,0,0,0,0,1,1,2
fa14,143,MARSHALL,MATH,Prob&Stats,0,5,5,1,0,1,1,2,3,0,4,4,2,3,5,0,0,0,4,14,18
fa14,143,MARSHALL,MUS,Mu-CompArt,0,0,0,0,0,0,0,0,0,1,1,2,1,0,1,0,0,0,2,1,3
fa14,143,MARSHALL,MUS,Music,0,0,0,0,0,0,1,0,1,2,0,2,1,0,1,0,0,0,4,0,4
fa14,143,MARSHALL,NENG,NanoEng,1,2,3,0,0,0,9,1,10,16,2,18,9,3,12,0,0,0,35,8,43
fa14,143,MARSHALL,PHIL,Philosophy,0,0,0,0,0,0,0,1,1,1,0,1,4,2,6,0,0,0,5,3,8
fa14,143,MARSHALL,PHYS,Biophysics,1,0,1,0,0,0,1,0,1,1,1,2,1,1,2,0,0,0,4,2,6
fa14,143,MARSHALL,PHYS,Gen Physcs,1,0,1,0,0,0,0,0,0,0,0,0,0,0,0,0,0,0,1,0,1
fa14,143,MARSHALL,PHYS,GenPys/SEd,0,0,0,0,0,0,0,0,0,0,0,0,1,1,2,0,0,0,1,1,2
fa14,143,MARSHALL,PHYS,Phys/Astro,0,0,0,1,0,1,2,0,2,1,0,1,1,0,1,0,0,0,5,0,5
fa14,143,MARSHALL,PHYS,Phys/Comp,1,0,1,0,0,0,0,0,0,0,0,0,0,0,0,0,0,0,1,0,1
fa14,143,MARSHALL,PHYS,Phys/Mtrls,1,0,1,0,0,0,0,0,0,0,0,0,1,0,1,0,0,0,2,0,2
fa14,143,MARSHALL,PHYS,Physics,9,3,12,0,0,0,0,1,1,3,1,4,3,2,5,0,0,0,15,7,22
fa14,143,MARSHALL,POLI,Polit Sci,4,4,8,0,0,0,5,6,11,9,8,17,17,14,31,0,0,0,35,32,67
fa14,143,MARSHALL,POLI,PolSc-Amer,0,1,1,0,0,0,0,1,1,2,3,5,3,2,5,0,0,0,5,7,12
fa14,143,MARSHALL,POLI,PolSc-Comp,1,0,1,0,0,0,0,0,0,0,0,0,0,0,0,0,0,0,1,0,1
fa14,143,MARSHALL,POLI,PolSc-Intl,1,1,2,0,1,1,2,2,4,7,3,10,8,7,15,0,0,0,18,14,32
fa14,143,MARSHALL,POLI,PolSc-PLaw,1,4,5,0,0,0,1,4,5,4,3,7,6,7,13,0,0,0,12,18,30
fa14,143,MARSHALL,POLI,PolSc-PPol,0,1,1,0,0,0,0,0,0,0,5,5,3,1,4,0,0,0,3,7,10
fa14,143,MARSHALL,POLI,PolSc-Thry,1,1,2,0,0,0,1,1,2,0,2,2,3,0,3,0,0,0,5,4,9
fa14,143,MARSHALL,PSYC,Psychology,7,18,25,0,3,3,11,19,30,16,57,73,29,69,98,0,0,0,63,166,229
fa14,143,MARSHALL,RELI,Relig/Stu,0,0,0,0,0,0,0,0,0,1,0,1,0,0,0,0,0,0,1,0,1
fa14,143,MARSHALL,SE,Engin Sci,0,0,0,0,0,0,0,0,0,0,0,0,1,0,1,0,0,0,1,0,1
fa14,143,MARSHALL,SE,Struct Eng,4,2,6,1,0,1,8,2,10,16,1,17,36,10,46,0,0,0,65,15,80
fa14,143,MARSHALL,SIO,Earth Sci,0,0,0,0,0,0,0,1,1,0,2,2,1,0,1,0,0,0,1,3,4
fa14,143,MARSHALL,SIO,Marine Bio,1,1,2,0,1,1,1,4,5,0,7,7,0,3,3,0,0,0,2,16,18
fa14,143,MARSHALL,SOC,SocAmSt,0,0,0,0,0,0,0,0,0,0,0,0,0,1,1,0,0,0,0,1,1
fa14,143,MARSHALL,SOC,SocCulCom,0,1,1,0,0,0,0,0,0,1,2,3,0,2,2,0,0,0,1,5,6
fa14,143,MARSHALL,SOC,SocEconSoc,0,1,1,0,0,0,0,0,0,0,0,0,0,0,0,0,0,0,0,1,1
fa14,143,MARSHALL,SOC,SocIntlStu,0,0,0,0,0,0,0,0,0,1,0,1,0,2,2,0,0,0,1,2,3
fa14,143,MARSHALL,SOC,Sociology,0,2,2,1,1,2,0,1,1,5,5,10,6,10,16,0,0,0,12,19,31
fa14,143,MARSHALL,SOC,SocLawSoc,0,0,0,0,0,0,0,1,1,2,2,4,0,3,3,0,0,0,2,6,8
fa14,143,MARSHALL,SOC,SocSciMed,0,1,1,0,0,0,0,0,0,0,0,0,3,1,4,0,0,0,3,2,5
fa14,143,MARSHALL,SOC,SocSolneq,0,0,0,0,0,0,0,1,1,0,2,2,0,6,6,0,0,0,0,9,9
fa14,143,MARSHALL,THEA,Dance,0,0,0,0,0,0,0,0,0,0,0,0,1,1,2,0,0,0,1,1,2
fa14,143,MARSHALL,THEA,Theatre,0,2,2,0,0,0,0,1,1,0,0,0,2,3,5,0,0,0,2,6,8
fa14,143,MARSHALL,UNAF,UndecHumAr,0,3,3,0,0,0,0,0,0,0,0,0,0,0,0,0,0,0,0,3,3
fa14,143,MARSHALL,UNAF,Undeclared,58,38,96,1,1,2,7,7,14,2,1,3,0,0,0,0,0,0,68,47,115
fa14,143,MARSHALL,UNAF,UndecPhysS,2,4,6,0,0,0,1,0,1,0,0,0,0,0,0,0,0,0,3,4,7
fa14,143,MARSHALL,UNAF,UndecSocSc,4,8,12,0,0,0,2,0,2,0,0,0,0,0,0,0,0,0,6,8,14
fa14,143,MARSHALL,USP,Urb Stu&Pl,0,0,0,0,0,0,0,2,2,3,4,7,4,5,9,0,0,0,7,11,18
fa14,143,MARSHALL,VIS,Art Hst/Cr,0,0,0,0,0,0,0,0,0,0,3,3,0,1,1,0,0,0,0,4,4
fa14,143,MARSHALL,VIS,Media,2,1,3,0,1,1,1,0,1,1,8,9,7,8,15,0,0,0,11,18,29
fa14,143,MARSHALL,VIS,Studio VA,0,0,0,0,0,0,1,0,1,0,1,1,0,1,1,0,0,0,1,2,3
fa14,143,MARSHALL,VIS,VA-CompArt,0,0,0,0,0,0,1,1,2,2,5,7,3,2,5,0,0,0,6,8,14
fa14,143,MUIR,ANTH,Anth-Arch,1,1,2,0,0,0,0,0,0,0,0,0,2,5,7,0,0,0,3,6,9
fa14,143,MUIR,ANTH,Anth-Biol,0,1,1,0,0,0,0,0,0,1,2,3,1,12,13,0,0,0,2,15,17
fa14,143,MUIR,ANTH,Anth-Soci,0,1,1,0,0,0,0,1,1,0,2,2,1,2,3,0,0,0,1,6,7
fa14,143,MUIR,BENG,Bioen:Binf,1,1,2,0,0,0,1,2,3,3,3,6,6,3,9,0,0,0,11,9,20
fa14,143,MUIR,BENG,BioengBioS,4,3,7,1,0,1,1,0,1,1,2,3,0,0,0,0,0,0,7,5,12
fa14,143,MUIR,BENG,BioengBiot,7,6,13,0,0,0,2,4,6,2,4,6,9,4,13,0,0,0,20,18,38
fa14,143,MUIR,BENG,Bioengin,9,5,14,0,0,0,2,1,3,5,2,7,12,6,18,0,0,0,28,14,42
fa14,143,MUIR,BIOL,Bioc/CellB,18,40,58,0,5,5,16,16,32,20,34,54,37,39,76,0,0,0,91,134,225
fa14,143,MUIR,BIOL,BiolBioinf,4,1,5,0,0,0,1,0,1,1,0,1,0,0,0,0,0,0,6,1,7
fa14,143,MUIR,BIOL,Ec/Beh/Evo,4,3,7,0,0,0,0,7,7,4,3,7,5,12,17,0,0,0,13,25,38
fa14,143,MUIR,BIOL,Genl Biol,12,29,41,1,1,2,14,18,32,20,36,56,27,51,78,0,0,0,74,135,209
fa14,143,MUIR,BIOL,Human Bio,35,58,93,1,2,3,21,49,70,29,62,91,26,49,75,0,0,0,112,220,332
fa14,143,MUIR,BIOL,Microbiol,1,4,5,0,0,0,0,4,4,5,3,8,0,4,4,0,0,0,6,15,21
fa14,143,MUIR,BIOL,Molec Biol,9,6,15,0,0,0,2,2,4,8,6,14,5,7,12,0,0,0,24,21,45
fa14,143,MUIR,BIOL,PhyslNeuro,23,24,47,0,3,3,17,26,43,11,22,33,24,28,52,0,0,0,75,103,178
fa14,143,MUIR,CENG,Chem Engin,9,2,11,1,0,1,14,7,21,18,15,33,20,14,34,0,0,0,62,38,100
fa14,143,MUIR,CGS,CritGendSt,0,0,0,0,0,0,1,2,3,1,3,4,0,2,2,0,0,0,2,7,9
fa14,143,MUIR,CHEM,Bioch/Chem,6,8,14,0,0,0,1,5,6,7,9,16,13,14,27,0,0,0,27,36,63
fa14,143,MUIR,CHEM,Bioinform,0,0,0,0,0,0,0,0,0,2,0,2,1,0,1,0,0,0,3,0,3
fa14,143,MUIR,CHEM,Chem Educ,0,0,0,0,0,0,0,1,1,0,0,0,0,0,0,0,0,0,0,1,1
fa14,143,MUIR,CHEM,Chem Phys,0,0,0,0,0,0,0,0,0,0,1,1,0,0,0,0,0,0,0,1,1
fa14,143,MUIR,CHEM,Chemistry,9,9,18,0,0,0,0,0,0,2,4,6,4,4,8,0,0,0,15,17,32
fa14,143,MUIR,CHEM,Envir Chem,1,0,1,0,0,0,0,0,0,0,1,1,2,0,2,0,0,0,3,1,4
fa14,143,MUIR,CHEM,MolecSynth,0,0,0,0,0,0,1,0,1,2,0,2,0,1,1,0,0,0,3,1,4
fa14,143,MUIR,CHEM,Pharm Chem,3,10,13,0,0,0,2,6,8,4,7,11,10,14,24,0,0,0,19,37,56
fa14,143,MUIR,CHIN,Chinese St,0,0,0,0,0,0,0,0,0,0,0,0,0,1,1,0,0,0,0,1,1
fa14,143,MUIR,COGS,Cog Sci,6,9,15,0,2,2,4,2,6,7,10,17,4,10,14,0,0,0,21,33,54
fa14,143,MUIR,COGS,CogSc/ClAs,0,1,1,0,0,0,0,1,1,0,1,1,1,1,2,0,0,0,1,4,5
fa14,143,MUIR,COGS,CogSc/Comp,0,0,0,0,0,0,1,0,1,0,0,0,1,1,2,0,0,0,2,1,3
fa14,143,MUIR,COGS,CogSc/HCI,0,0,0,0,0,0,2,1,3,2,5,7,2,4,6,0,0,0,6,10,16
fa14,143,MUIR,COGS,CogSc/HCog,0,0,0,0,0,0,0,2,2,1,1,2,0,3,3,0,0,0,1,6,7
fa14,143,MUIR,COGS,CogSc/Neur,0,2,2,0,1,1,0,4,4,2,5,7,11,14,25,0,0,0,13,26,39
fa14,143,MUIR,COMM,Communic,1,7,8,2,4,6,5,18,23,9,38,47,14,32,46,0,0,0,31,99,130
fa14,143,MUIR,CSE,Comp Sci,27,8,35,0,0,0,4,6,10,60,16,76,99,20,119,0,0,0,190,50,240
fa14,143,MUIR,CSE,CompEngCSE,10,1,11,0,0,0,2,0,2,11,2,13,13,0,13,0,0,0,36,3,39
fa14,143,MUIR,CSE,CompScBinf,1,1,2,0,0,0,3,3,6,1,0,1,6,1,7,0,0,0,11,5,16
fa14,143,MUIR,ECE,CompEngECE,1,1,2,0,0,0,7,1,8,8,1,9,6,1,7,0,0,0,22,4,26
fa14,143,MUIR,ECE,Electr Eng,12,2,14,2,1,3,16,0,16,30,3,33,34,6,40,0,0,0,94,12,106
fa14,143,MUIR,ECE,Pr-EngPhys,3,0,3,0,0,0,0,0,0,0,0,0,0,0,0,0,0,0,3,0,3
fa14,143,MUIR,ECON,Ec-Mth&Ecn,8,7,15,0,1,1,1,4,5,5,2,7,8,3,11,0,0,0,22,17,39
fa14,143,MUIR,ECON,Econ-MgtSc,7,5,12,3,0,3,8,8,16,22,19,41,26,24,50,0,0,0,66,56,122
fa14,143,MUIR,ECON,Economics,15,18,33,3,1,4,13,8,21,59,37,96,30,38,68,0,0,0,120,102,222
fa14,143,MUIR,ESYS,EnvSys(EB),0,1,1,0,0,0,0,3,3,3,1,4,7,7,14,0,0,0,10,12,22
fa14,143,MUIR,ESYS,EnvSys(EC),0,0,0,0,0,0,0,0,0,0,3,3,2,1,3,0,0,0,2,4,6
fa14,143,MUIR,ESYS,EnvSys(EP),1,2,3,0,0,0,2,0,2,0,0,0,1,1,2,0,0,0,4,3,7
fa14,143,MUIR,ESYS,EnvSys(ES),1,4,5,0,0,0,0,0,0,1,0,1,2,0,2,0,0,0,4,4,8
fa14,143,MUIR,ETHN,Ethnic St,0,1,1,0,1,1,1,1,2,0,2,2,2,0,2,0,0,0,3,5,8
fa14,143,MUIR,FPMU,Public Hlt,4,9,13,0,0,0,2,15,17,6,18,24,1,17,18,0,0,0,13,59,72
fa14,143,MUIR,GLBH,Global Hlt,1,0,1,0,0,0,0,0,0,0,1,1,0,0,0,0,0,0,1,1,2
fa14,143,MUIR,HDP,Human Dev,0,0,0,0,0,0,0,1,1,2,5,7,2,20,22,0,0,0,4,26,30
fa14,143,MUIR,HDP,Pr-HumnDev,0,3,3,0,0,0,0,11,11,1,6,7,0,4,4,0,0,0,1,24,25
fa14,143,MUIR,HIST,History,0,1,1,1,0,1,2,2,4,6,1,7,3,4,7,0,0,0,12,8,20
fa14,143,MUIR,INTD,Muir Sp Pr,0,0,0,0,0,0,0,0,0,0,0,0,0,1,1,0,0,0,0,1,1
fa14,143,MUIR,INTL,IntSt-Anth,0,0,0,0,0,0,0,0,0,0,1,1,0,0,0,0,0,0,0,1,1
fa14,143,MUIR,INTL,IntSt-Econ,0,2,2,0,0,0,1,7,8,2,2,4,2,9,11,0,0,0,5,20,25
fa14,143,MUIR,INTL,IntSt-Hist,0,0,0,0,0,0,0,0,0,0,0,0,1,0,1,0,0,0,1,0,1
fa14,143,MUIR,INTL,IntSt-Ling,0,0,0,0,0,0,0,0,0,0,0,0,0,1,1,0,0,0,0,1,1
fa14,143,MUIR,INTL,IntSt-PolS,0,1,1,0,0,0,0,0,0,1,5,6,6,4,10,0,0,0,7,10,17
fa14,143,MUIR,INTL,IntSt-Soc,0,0,0,0,0,0,0,2,2,0,0,0,2,6,8,0,0,0,2,8,10
fa14,143,MUIR,ITAL,Italian St,0,0,0,0,0,0,0,0,0,0,1,1,0,0,0,0,0,0,0,1,1
fa14,143,MUIR,JAPN,JapaneseSt,0,0,0,0,0,0,0,0,0,0,2,2,0,1,1,0,0,0,0,3,3
fa14,143,MUIR,LING,Lang Stu,0,1,1,0,0,0,0,1,1,0,0,0,2,1,3,0,0,0,2,3,5
fa14,143,MUIR,LING,Ling-CogLn,2,0,2,0,0,0,0,0,0,0,1,1,3,5,8,0,0,0,5,6,11
fa14,143,MUIR,LING,Linguistcs,1,1,2,0,0,0,1,0,1,0,3,3,1,2,3,0,0,0,3,6,9
fa14,143,MUIR,LIT,Lit/Compos,0,1,1,0,0,0,0,1,1,0,0,0,0,0,0,0,0,0,0,2,2
fa14,143,MUIR,LIT,Lit/CultSt,0,0,0,0,0,0,0,0,0,0,0,0,0,1,1,0,0,0,0,1,1
fa14,143,MUIR,LIT,Lit/Engl,0,4,4,0,0,0,0,3,3,0,2,2,1,7,8,0,0,0,1,16,17
fa14,143,MUIR,LIT,Lit/World,0,0,0,0,0,0,0,1,1,0,1,1,1,0,1,0,0,0,1,2,3
fa14,143,MUIR,LIT,Lit/Writng,1,4,5,0,0,0,1,4,5,6,7,13,5,9,14,0,0,0,13,24,37
fa14,143,MUIR,LIT,Spanish Lt,0,1,1,0,0,0,0,1,1,0,0,0,0,4,4,0,0,0,0,6,6
fa14,143,MUIR,MAE,Aerosp Eng,8,1,9,0,0,0,1,0,1,4,1,5,15,4,19,0,0,0,28,6,34
fa14,143,MUIR,MAE,Engin Sci,0,0,0,0,0,0,0,0,0,0,0,0,1,0,1,0,0,0,1,0,1
fa14,143,MUIR,MAE,Envir Eng,8,6,14,1,0,1,6,6,12,8,4,12,11,12,23,0,0,0,34,28,62
fa14,143,MUIR,MAE,Mech Engin,10,3,13,1,0,1,3,0,3,12,5,17,19,4,23,0,0,0,45,12,57
fa14,143,MUIR,MATH,Appld Math,10,10,20,0,0,0,2,6,8,3,3,6,8,3,11,0,0,0,23,22,45
fa14,143,MUIR,MATH,Math/SecEd,0,1,1,0,1,1,0,0,0,0,1,1,2,5,7,0,0,0,2,8,10
fa14,143,MUIR,MATH,Mathematcs,8,6,14,0,0,0,4,4,8,6,4,10,8,2,10,0,0,0,26,16,42
fa14,143,MUIR,MATH,Mth-CompSc,5,3,8,0,0,0,1,2,3,3,0,3,5,1,6,0,0,0,14,6,20
fa14,143,MUIR,MATH,Mth-Mth&Ec,2,4,6,0,0,0,2,1,3,3,1,4,7,3,10,0,0,0,14,9,23
fa14,143,MUIR,MATH,Mth/ApldSc,1,1,2,0,0,0,0,0,0,1,0,1,0,0,0,0,0,0,2,1,3
fa14,143,MUIR,MATH,Prob&Stats,1,2,3,0,0,0,1,1,2,4,0,4,2,3,5,0,0,0,8,6,14
fa14,143,MUIR,MUS,Mu-CompArt,0,2,2,1,0,1,2,0,2,2,1,3,5,1,6,0,0,0,10,4,14
fa14,143,MUIR,MUS,Music,1,0,1,0,1,1,3,0,3,2,1,3,3,3,6,0,0,0,9,5,14
fa14,143,MUIR,MUS,Music Hum,0,0,0,0,0,0,0,0,0,0,0,0,1,0,1,0,0,0,1,0,1
fa14,143,MUIR,NENG,NanoEng,8,0,8,0,0,0,5,1,6,8,3,11,12,3,15,0,0,0,33,7,40
fa14,143,MUIR,PHIL,Philosophy,1,0,1,0,0,0,0,0,0,0,0,0,2,1,3,0,0,0,3,1,4
fa14,143,MUIR,PHYS,Biophysics,0,0,0,0,0,0,1,0,1,0,1,1,1,2,3,0,0,0,2,3,5
fa14,143,MUIR,PHYS,Phy/ErthSc,0,0,0,0,0,0,0,0,0,1,0,1,0,0,0,0,0,0,1,0,1
fa14,143,MUIR,PHYS,Phys/Astro,4,2,6,1,0,1,0,0,0,1,0,1,3,0,3,0,0,0,9,2,11
fa14,143,MUIR,PHYS,Phys/Comp,0,0,0,0,0,0,1,0,1,0,0,0,1,0,1,0,0,0,2,0,2
fa14,143,MUIR,PHYS,Phys/Mtrls,2,0,2,0,0,0,0,0,0,0,0,0,2,0,2,0,0,0,4,0,4
fa14,143,MUIR,PHYS,Physics,7,5,12,0,0,0,3,0,3,5,1,6,5,0,5,0,0,0,20,6,26
fa14,143,MUIR,POLI,Polit Sci,1,4,5,0,2,2,0,7,7,6,3,9,12,6,18,0,0,0,19,22,41
fa14,143,MUIR,POLI,PolSc-Amer,0,0,0,0,0,0,0,0,0,2,3,5,4,3,7,0,0,0,6,6,12
fa14,143,MUIR,POLI,PolSc-Comp,0,0,0,0,0,0,1,0,1,1,1,2,1,0,1,0,0,0,3,1,4
fa14,143,MUIR,POLI,PolSc-Intl,1,0,1,1,0,1,1,3,4,6,0,6,9,9,18,0,0,0,18,12,30
fa14,143,MUIR,POLI,PolSc-PLaw,1,0,1,0,0,0,1,4,5,6,5,11,4,5,9,0,0,0,12,14,26
fa14,143,MUIR,POLI,PolSc-PPol,1,0,1,0,0,0,0,0,0,3,3,6,1,0,1,0,0,0,5,3,8
fa14,143,MUIR,POLI,PolSc-Thry,0,0,0,0,1,1,0,0,0,0,0,0,0,1,1,0,0,0,0,2,2
fa14,143,MUIR,PSYC,Psychology,10,32,42,0,2,2,8,26,34,13,64,77,30,89,119,0,0,0,61,213,274
fa14,143,MUIR,RELI,Relig/Stu,1,0,1,0,0,0,0,0,0,0,0,0,0,0,0,0,0,0,1,0,1
fa14,143,MUIR,RUSS,Russ&SovSt,0,0,0,0,0,0,0,0,0,0,0,0,0,1,1,0,0,0,0,1,1
fa14,143,MUIR,SE,Struct Eng,3,4,7,3,0,3,11,4,15,14,9,23,25,11,36,0,0,0,56,28,84
fa14,143,MUIR,SIO,Earth Sci,3,2,5,1,0,1,2,1,3,0,0,0,4,1,5,0,0,0,10,4,14
fa14,143,MUIR,SIO,Marine Bio,5,8,13,3,2,5,0,7,7,3,7,10,2,11,13,0,0,0,13,35,48
fa14,143,MUIR,SOC,SocCulCom,0,0,0,0,0,0,0,0,0,0,0,0,0,4,4,0,0,0,0,4,4
fa14,143,MUIR,SOC,SocEconSoc,0,0,0,0,0,0,0,1,1,0,1,1,0,0,0,0,0,0,0,2,2
fa14,143,MUIR,SOC,Sociology,0,6,6,0,1,1,0,1,1,3,5,8,4,18,22,0,0,0,7,31,38
fa14,143,MUIR,SOC,SocLawSoc,0,5,5,0,0,0,1,1,2,1,2,3,0,7,7,0,0,0,2,15,17
fa14,143,MUIR,SOC,SocSciMed,0,0,0,0,0,0,0,0,0,0,1,1,0,0,0,0,0,0,0,1,1
fa14,143,MUIR,SOC,SocSolneq,1,0,1,0,0,0,0,0,0,1,4,5,1,3,4,0,0,0,3,7,10
fa14,143,MUIR,THEA,Dance,0,0,0,0,0,0,0,0,0,0,0,0,0,1,1,0,0,0,0,1,1
fa14,143,MUIR,THEA,Theatre,1,3,4,0,1,1,0,5,5,2,4,6,2,7,9,0,0,0,5,20,25
fa14,143,MUIR,TWS,ThirdWldSt,0,1,1,0,0,0,0,0,0,0,0,0,0,0,0,0,0,0,0,1,1
fa14,143,MUIR,UNAF,UndecHumAr,0,3,3,0,0,0,1,2,3,1,0,1,0,0,0,0,0,0,2,5,7
fa14,143,MUIR,UNAF,Undeclared,61,44,105,3,4,7,7,10,17,0,1,1,0,0,0,0,0,0,71,59,130
fa14,143,MUIR,UNAF,UndecPhysS,4,14,18,1,0,1,0,1,1,0,0,0,0,0,0,0,0,0,5,15,20
fa14,143,MUIR,UNAF,UndecSocSc,6,10,16,0,0,0,2,5,7,1,0,1,0,0,0,0,0,0,9,15,24
fa14,143,MUIR,USP,Urb Stu&Pl,0,1,1,0,0,0,0,3,3,1,2,3,7,9,16,0,0,0,8,15,23
fa14,143,MUIR,VIS,Art Hst/Cr,0,1,1,0,0,0,0,0,0,0,2,2,2,0,2,0,0,0,2,3,5
fa14,143,MUIR,VIS,Media,2,0,2,0,0,0,1,0,1,2,5,7,13,5,18,0,0,0,18,10,28
fa14,143,MUIR,VIS,Studio VA,0,2,2,0,0,0,0,0,0,0,3,3,0,6,6,0,0,0,0,11,11
fa14,143,MUIR,VIS,VA-CompArt,0,0,0,0,1,1,1,1,2,0,1,1,3,3,6,0,0,0,4,6,10
fa14,143,REVELLE,ANTH,Anth-Arch,0,0,0,0,0,0,0,0,0,1,1,2,0,1,1,0,0,0,1,2,3
fa14,143,REVELLE,ANTH,Anth-Biol,0,0,0,0,0,0,0,0,0,0,4,4,1,3,4,0,0,0,1,7,8
fa14,143,REVELLE,ANTH,Anth-Soci,0,0,0,0,0,0,0,0,0,0,1,1,0,2,2,0,0,0,0,3,3
fa14,143,REVELLE,BENG,Bioen:Binf,3,1,4,0,0,0,2,3,5,8,2,10,8,5,13,0,0,0,21,11,32
fa14,143,REVELLE,BENG,BioengBioS,4,1,5,1,0,1,3,3,6,5,2,7,1,0,1,0,0,0,14,6,20
fa14,143,REVELLE,BENG,BioengBiot,3,5,8,0,0,0,3,1,4,9,3,12,21,8,29,0,0,0,36,17,53
fa14,143,REVELLE,BENG,Bioengin,6,0,6,0,0,0,2,0,2,10,3,13,14,12,26,0,0,0,32,15,47
fa14,143,REVELLE,BIOL,Bioc/CellB,41,37,78,0,1,1,15,23,38,40,63,103,50,59,109,0,0,0,146,183,329
fa14,143,REVELLE,BIOL,BiolBioinf,0,7,7,0,0,0,0,0,0,1,3,4,1,0,1,0,0,0,2,10,12
fa14,143,REVELLE,BIOL,Ec/Beh/Evo,1,1,2,0,0,0,0,1,1,2,3,5,0,6,6,0,0,0,3,11,14
fa14,143,REVELLE,BIOL,Genl Biol,18,24,42,0,1,1,6,18,24,16,25,41,36,45,81,0,0,0,76,113,189
fa14,143,REVELLE,BIOL,Human Bio,28,58,86,1,5,6,21,55,76,50,74,124,47,63,110,0,0,0,147,255,402
fa14,143,REVELLE,BIOL,Microbiol,3,3,6,0,0,0,3,4,7,4,10,14,8,7,15,0,0,0,18,24,42
fa14,143,REVELLE,BIOL,Molec Biol,11,8,19,0,0,0,4,3,7,15,7,22,5,8,13,0,0,0,35,26,61
fa14,143,REVELLE,BIOL,PhyslNeuro,26,22,48,1,0,1,16,23,39,29,30,59,34,28,62,0,0,0,106,103,209
fa14,143,REVELLE,CENG,Chem Engin,12,7,19,3,1,4,21,8,29,41,17,58,60,18,78,0,0,0,137,51,188
fa14,143,REVELLE,CGS,CritGendSt,0,0,0,0,0,0,0,0,0,0,0,0,0,1,1,0,0,0,0,1,1
fa14,143,REVELLE,CHEM,Bioch/Chem,3,10,13,1,1,2,3,2,5,14,8,22,18,9,27,0,0,0,39,30,69
fa14,143,REVELLE,CHEM,Bioinform,0,1,1,0,0,0,0,0,0,0,0,0,0,1,1,0,0,0,0,2,2
fa14,143,REVELLE,CHEM,Chem Educ,0,0,0,0,0,0,0,0,0,0,0,0,0,1,1,0,0,0,0,1,1
fa14,143,REVELLE,CHEM,Chem Phys,1,1,2,0,0,0,0,0,0,1,0,1,2,1,3,0,0,0,4,2,6
fa14,143,REVELLE,CHEM,Chemistry,14,10,24,1,0,1,3,2,5,9,6,15,10,8,18,0,0,0,37,26,63
fa14,143,REVELLE,CHEM,Envir Chem,1,0,1,0,0,0,0,0,0,3,1,4,0,2,2,0,0,0,4,3,7
fa14,143,REVELLE,CHEM,MolecSynth,0,0,0,0,0,0,0,1,1,1,0,1,0,0,0,0,0,0,1,1,2
fa14,143,REVELLE,CHEM,Pharm Chem,7,14,21,0,0,0,6,5,11,10,13,23,16,14,30,0,0,0,39,46,85
fa14,143,REVELLE,CLAS,Classic St,0,1,1,0,0,0,0,0,0,0,0,0,1,0,1,0,0,0,1,1,2
fa14,143,REVELLE,COGS,Cog Sci,1,5,6,0,2,2,2,3,5,1,8,9,7,6,13,0,0,0,11,24,35
fa14,143,REVELLE,COGS,CogSc/ClAs,0,0,0,0,0,0,0,1,1,0,0,0,0,5,5,0,0,0,0,6,6
fa14,143,REVELLE,COGS,CogSc/Comp,2,0,2,0,0,0,1,1,2,1,0,1,0,0,0,0,0,0,4,1,5
fa14,143,REVELLE,COGS,CogSc/HCI,0,1,1,0,0,0,3,0,3,1,3,4,4,6,10,0,0,0,8,10,18
fa14,143,REVELLE,COGS,CogSc/HCog,0,1,1,0,0,0,0,1,1,0,1,1,0,3,3,0,0,0,0,6,6
fa14,143,REVELLE,COGS,CogSc/Neur,0,0,0,0,0,0,3,1,4,5,8,13,5,11,16,0,0,0,13,20,33
fa14,143,REVELLE,COMM,Communic,4,0,4,0,0,0,0,5,5,10,15,25,4,6,10,0,0,0,18,26,44
fa14,143,REVELLE,CSE,Comp Sci,20,1,21,0,0,0,11,1,12,66,9,75,113,22,135,0,0,0,210,33,243
fa14,143,REVELLE,CSE,CompEngCSE,7,0,7,0,0,0,1,0,1,13,3,16,13,3,16,0,0,0,34,6,40
fa14,143,REVELLE,CSE,CompScBinf,1,1,2,0,0,0,5,0,5,1,3,4,6,1,7,0,0,0,13,5,18
fa14,143,REVELLE,ECE,CompEngECE,7,1,8,1,0,1,7,3,10,13,0,13,7,0,7,0,0,0,35,4,39
fa14,143,REVELLE,ECE,Electr Eng,20,5,25,2,1,3,18,8,26,28,2,30,67,7,74,0,0,0,135,23,158
fa14,143,REVELLE,ECE,Engin Phys,0,0,0,0,0,0,2,0,2,0,0,0,6,0,6,0,0,0,8,0,8
fa14,143,REVELLE,ECE,Pr-EngPhys,2,0,2,0,0,0,2,0,2,1,1,2,1,0,1,0,0,0,6,1,7
fa14,143,REVELLE,ECON,Ec-Mth&Ecn,8,3,11,0,1,1,6,3,9,5,3,8,8,2,10,0,0,0,27,12,39
fa14,143,REVELLE,ECON,Econ-MgtSc,2,4,6,0,1,1,11,7,18,10,15,25,27,10,37,0,0,0,50,37,87
fa14,143,REVELLE,ECON,Economics,10,3,13,3,0,3,19,12,31,59,24,83,37,21,58,0,0,0,128,60,188
fa14,143,REVELLE,ESYS,EnvSys(EB),0,1,1,0,0,0,0,2,2,0,3,3,4,2,6,0,0,0,4,8,12
fa14,143,REVELLE,ESYS,EnvSys(EC),0,0,0,0,0,0,0,0,0,1,0,1,1,0,1,0,0,0,2,0,2
fa14,143,REVELLE,ESYS,EnvSys(EP),0,0,0,0,0,0,0,0,0,0,0,0,0,1,1,0,0,0,0,1,1
fa14,143,REVELLE,ESYS,EnvSys(ES),1,1,2,0,0,0,0,0,0,1,1,2,2,0,2,0,0,0,4,2,6
fa14,143,REVELLE,ETHN,Ethnic St,0,0,0,0,0,0,0,0,0,0,0,0,1,5,6,0,0,0,1,5,6
fa14,143,REVELLE,FPMU,Public Hlt,1,2,3,0,3,3,3,13,16,5,15,20,1,20,21,0,0,0,10,53,63
fa14,143,REVELLE,GLBH,Global Hlt,0,1,1,0,0,0,0,1,1,1,1,2,0,0,0,0,0,0,1,3,4
fa14,143,REVELLE,HDP,Human Dev,0,0,0,0,0,0,0,0,0,0,2,2,0,9,9,0,0,0,0,11,11
fa14,143,REVELLE,HDP,Pr-HumnDev,0,0,0,0,1,1,0,2,2,1,6,7,0,0,0,0,0,0,1,9,10
fa14,143,REVELLE,HIST,History,0,1,1,0,0,0,2,1,3,3,2,5,1,2,3,0,0,0,6,6,12
fa14,143,REVELLE,INTL,IntSt-Econ,1,0,1,0,0,0,1,0,1,3,2,5,3,3,6,0,0,0,8,5,13
fa14,143,REVELLE,INTL,IntSt-Hist,0,0,0,0,0,0,0,0,0,0,1,1,0,0,0,0,0,0,0,1,1
fa14,143,REVELLE,INTL,IntSt-Ling,0,0,0,0,0,0,0,0,0,0,0,0,0,1,1,0,0,0,0,1,1
fa14,143,REVELLE,INTL,IntSt-Lit,0,0,0,0,0,0,0,0,0,0,1,1,0,0,0,0,0,0,0,1,1
fa14,143,REVELLE,INTL,IntSt-PolS,0,1,1,0,0,0,0,0,0,1,2,3,1,5,6,0,0,0,2,8,10
fa14,143,REVELLE,INTL,IntSt-Soc,0,0,0,0,0,0,0,1,1,0,0,0,0,1,1,0,0,0,0,2,2
fa14,143,REVELLE,LING,Lang Stu,0,0,0,0,0,0,0,0,0,1,1,2,0,0,0,0,0,0,1,1,2
fa14,143,REVELLE,LING,Ling-LSoc,0,0,0,0,0,0,0,0,0,0,1,1,0,0,0,0,0,0,0,1,1
fa14,143,REVELLE,LING,Linguistcs,0,0,0,0,0,0,0,0,0,0,2,2,1,1,2,0,0,0,1,3,4
fa14,143,REVELLE,LIT,Lit/Compos,0,1,1,0,0,0,0,0,0,0,0,0,0,0,0,0,0,0,0,1,1
fa14,143,REVELLE,LIT,Lit/CultSt,0,0,0,0,0,0,0,0,0,0,1,1,0,0,0,0,0,0,0,1,1
fa14,143,REVELLE,LIT,Lit/Engl,0,0,0,0,1,1,1,0,1,1,0,1,2,2,4,0,0,0,4,3,7
fa14,143,REVELLE,LIT,Lit/World,0,0,0,0,0,0,0,1,1,1,0,1,0,2,2,0,0,0,1,3,4
fa14,143,REVELLE,LIT,Lit/Writng,0,1,1,0,0,0,1,0,1,1,2,3,2,6,8,0,0,0,4,9,13
fa14,143,REVELLE,LIT,Spanish Lt,0,0,0,0,0,0,0,0,0,0,0,0,1,1,2,0,0,0,1,1,2
fa14,143,REVELLE,MAE,Aerosp Eng,10,0,10,0,0,0,3,2,5,15,2,17,20,4,24,0,0,0,48,8,56
fa14,143,REVELLE,MAE,Engin Sci,0,0,0,0,0,0,0,0,0,0,0,0,2,0,2,0,0,0,2,0,2
fa14,143,REVELLE,MAE,Envir Eng,4,2,6,0,1,1,8,3,11,3,6,9,13,4,17,0,0,0,28,16,44
fa14,143,REVELLE,MAE,Mech Engin,15,4,19,0,0,0,4,2,6,16,2,18,34,7,41,0,0,0,69,15,84
fa14,143,REVELLE,MATH,Appld Math,13,5,18,0,0,0,5,7,12,11,6,17,7,9,16,0,0,0,36,27,63
fa14,143,REVELLE,MATH,Math/SecEd,1,1,2,0,0,0,0,0,0,1,0,1,1,1,2,0,0,0,3,2,5
fa14,143,REVELLE,MATH,Mathematcs,13,5,18,0,1,1,1,1,2,7,2,9,4,3,7,0,0,0,25,12,37
fa14,143,REVELLE,MATH,Mth-CompSc,13,4,17,0,0,0,2,3,5,2,1,3,3,1,4,0,0,0,20,9,29
fa14,143,REVELLE,MATH,Mth-Mth&Ec,2,3,5,0,0,0,1,2,3,1,4,5,2,3,5,0,0,0,6,12,18
fa14,143,REVELLE,MATH,Mth-SciCom,0,1,1,0,0,0,0,0,0,1,0,1,0,0,0,0,0,0,1,1,2
fa14,143,REVELLE,MATH,Mth/ApldSc,5,0,5,0,0,0,2,1,3,3,1,4,2,0,2,0,0,0,12,2,14
fa14,143,REVELLE,MATH,Pr-Math CS,0,0,0,0,0,0,1,0,1,0,0,0,0,0,0,0,0,0,1,0,1
fa14,143,REVELLE,MATH,Prob&Stats,0,2,2,0,0,0,2,3,5,2,5,7,4,2,6,0,0,0,8,12,20
fa14,143,REVELLE,MUS,Mu-CompArt,0,0,0,0,0,0,1,0,1,1,2,3,0,0,0,0,0,0,2,2,4
fa14,143,REVELLE,MUS,Music,0,0,0,0,0,0,1,0,1,1,0,1,1,2,3,0,0,0,3,2,5
fa14,143,REVELLE,NENG,NanoEng,3,2,5,0,0,0,7,4,11,19,2,21,26,9,35,0,0,0,55,17,72
fa14,143,REVELLE,PHIL,Philosophy,0,0,0,0,0,0,1,0,1,1,1,2,3,0,3,0,0,0,5,1,6
fa14,143,REVELLE,PHYS,Biophysics,2,1,3,0,0,0,0,0,0,2,0,2,2,1,3,0,0,0,6,2,8
fa14,143,REVELLE,PHYS,Gen Physcs,1,1,2,0,0,0,0,0,0,0,0,0,0,1,1,0,0,0,1,2,3
fa14,143,REVELLE,PHYS,Phy/ErthSc,0,0,0,0,0,0,0,0,0,0,0,0,1,0,1,0,0,0,1,0,1
fa14,143,REVELLE,PHYS,Phys/Astro,9,2,11,0,0,0,2,0,2,8,3,11,5,4,9,0,0,0,24,9,33
fa14,143,REVELLE,PHYS,Phys/Comp,0,0,0,0,0,0,1,0,1,2,0,2,2,0,2,0,0,0,5,0,5
fa14,143,REVELLE,PHYS,Phys/Mtrls,0,1,1,0,0,0,0,1,1,2,0,2,0,0,0,0,0,0,2,2,4
fa14,143,REVELLE,PHYS,Physics,15,2,17,0,0,0,3,1,4,8,4,12,11,4,15,0,0,0,37,11,48
fa14,143,REVELLE,POLI,Polit Sci,1,1,2,0,0,0,0,0,0,2,2,4,4,3,7,0,0,0,7,6,13
fa14,143,REVELLE,POLI,PolSc-Amer,1,0,1,0,0,0,0,0,0,1,0,1,1,0,1,0,0,0,3,0,3
fa14,143,REVELLE,POLI,PolSc-Intl,1,0,1,0,1,1,0,2,2,5,1,6,2,1,3,0,0,0,8,5,13
fa14,143,REVELLE,POLI,PolSc-PLaw,1,1,2,0,0,0,1,0,1,0,0,0,1,4,5,0,0,0,3,5,8
fa14,143,REVELLE,POLI,PolSc-PPol,0,0,0,0,0,0,0,0,0,1,0,1,1,1,2,0,0,0,2,1,3
fa14,143,REVELLE,POLI,PolSc-Thry,0,0,0,0,0,0,0,0,0,0,1,1,0,1,1,0,0,0,0,2,2
fa14,143,REVELLE,PSYC,Psychology,2,14,16,0,0,0,2,11,13,22,32,54,16,51,67,0,0,0,42,108,150
fa14,143,REVELLE,RELI,Relig/Stu,0,0,0,0,0,0,0,0,0,0,0,0,0,1,1,0,0,0,0,1,1
fa14,143,REVELLE,SE,Struct Eng,5,3,8,1,1,2,15,4,19,18,8,26,35,7,42,0,0,0,74,23,97
fa14,143,REVELLE,SIO,Earth Sci,1,2,3,0,0,0,0,1,1,2,0,2,4,2,6,0,0,0,7,5,12
fa14,143,REVELLE,SIO,Marine Bio,2,6,8,1,0,1,4,8,12,1,6,7,2,8,10,0,0,0,10,28,38
fa14,143,REVELLE,SOC,SocEconSoc,0,0,0,0,0,0,0,0,0,0,0,0,0,1,1,0,0,0,0,1,1
fa14,143,REVELLE,SOC,SocIntlStu,0,0,0,0,0,0,0,0,0,1,0,1,0,0,0,0,0,0,1,0,1
fa14,143,REVELLE,SOC,Sociology,0,2,2,0,0,0,0,2,2,1,1,2,2,3,5,0,0,0,3,8,11
fa14,143,REVELLE,SOC,SocLawSoc,0,0,0,0,0,0,0,1,1,0,0,0,0,1,1,0,0,0,0,2,2
fa14,143,REVELLE,SOC,SocSciMed,0,0,0,0,0,0,0,0,0,0,2,2,1,2,3,0,0,0,1,4,5
fa14,143,REVELLE,THEA,Dance,0,0,0,0,0,0,0,0,0,1,0,1,0,0,0,0,0,0,1,0,1
fa14,143,REVELLE,THEA,Theatre,1,2,3,0,0,0,0,0,0,1,4,5,0,2,2,0,0,0,2,8,10
fa14,143,REVELLE,UNAF,Limited St,0,0,0,0,0,0,0,0,0,0,0,0,0,0,0,3,1,4,3,1,4
fa14,143,REVELLE,UNAF,Spec-Emply,0,0,0,0,0,0,0,0,0,0,0,0,0,0,0,2,1,3,2,1,3
fa14,143,REVELLE,UNAF,UndecHumAr,1,6,7,0,0,0,0,0,0,0,0,0,0,0,0,0,0,0,1,6,7
fa14,143,REVELLE,UNAF,Undeclared,92,28,120,2,1,3,7,6,13,8,2,10,0,0,0,0,0,0,109,37,146
fa14,143,REVELLE,UNAF,UndecPhysS,12,8,20,0,0,0,0,1,1,2,0,2,0,0,0,0,0,0,14,9,23
fa14,143,REVELLE,UNAF,UndecSocSc,3,5,8,0,0,0,1,0,1,0,0,0,0,0,0,0,0,0,4,5,9
fa14,143,REVELLE,USP,Urb Stu&Pl,0,0,0,0,0,0,0,0,0,0,1,1,0,0,0,0,0,0,0,1,1
fa14,143,REVELLE,VIS,Art Hst/Cr,0,1,1,0,0,0,0,0,0,0,0,0,0,1,1,0,0,0,0,2,2
fa14,143,REVELLE,VIS,Media,1,1,2,0,0,0,0,1,1,0,4,4,2,1,3,0,0,0,3,7,10
fa14,143,REVELLE,VIS,Studio VA,0,0,0,0,0,0,0,0,0,1,1,2,0,1,1,0,0,0,1,2,3
fa14,143,REVELLE,VIS,VA-CompArt,0,2,2,0,1,1,0,1,1,0,1,1,3,2,5,0,0,0,3,7,10
fa14,143,ROOSEVELT,ANTH,Anth-Arch,0,1,1,0,0,0,0,0,0,3,2,5,1,6,7,0,0,0,4,9,13
fa14,143,ROOSEVELT,ANTH,Anth-Biol,0,2,2,0,0,0,0,2,2,0,3,3,1,7,8,0,0,0,1,14,15
fa14,143,ROOSEVELT,ANTH,Anth-Soci,0,1,1,0,0,0,1,2,3,1,5,6,2,7,9,0,0,0,4,15,19
fa14,143,ROOSEVELT,BENG,Bioen:Binf,1,0,1,0,0,0,4,2,6,4,3,7,2,3,5,0,0,0,11,8,19
fa14,143,ROOSEVELT,BENG,BioengBioS,0,2,2,0,0,0,2,2,4,1,1,2,1,0,1,0,0,0,4,5,9
fa14,143,ROOSEVELT,BENG,BioengBiot,0,1,1,0,0,0,0,0,0,3,1,4,2,2,4,0,0,0,5,4,9
fa14,143,ROOSEVELT,BENG,Bioengin,0,0,0,0,0,0,0,0,0,2,0,2,4,3,7,0,0,0,6,3,9
fa14,143,ROOSEVELT,BIOL,Bioc/CellB,23,26,49,0,2,2,13,19,32,17,26,43,30,36,66,0,0,0,83,109,192
fa14,143,ROOSEVELT,BIOL,BiolBioinf,1,4,5,0,0,0,0,0,0,2,0,2,0,1,1,0,0,0,3,5,8
fa14,143,ROOSEVELT,BIOL,Ec/Beh/Evo,1,0,1,0,0,0,1,4,5,1,1,2,8,6,14,0,0,0,11,11,22
fa14,143,ROOSEVELT,BIOL,Genl Biol,10,22,32,0,3,3,7,14,21,16,23,39,22,33,55,0,0,0,55,95,150
fa14,143,ROOSEVELT,BIOL,Human Bio,22,64,86,1,2,3,23,48,71,15,43,58,31,47,78,0,0,0,92,204,296
fa14,143,ROOSEVELT,BIOL,Microbiol,4,2,6,0,0,0,0,0,0,2,2,4,2,6,8,0,0,0,8,10,18
fa14,143,ROOSEVELT,BIOL,Molec Biol,2,5,7,0,0,0,0,1,1,0,7,7,3,2,5,0,0,0,5,15,20
fa14,143,ROOSEVELT,BIOL,PhyslNeuro,15,25,40,1,0,1,9,21,30,19,21,40,14,20,34,0,0,0,58,87,145
fa14,143,ROOSEVELT,CENG,Chem Engin,1,0,1,1,1,2,5,5,10,10,5,15,20,10,30,0,0,0,37,21,58
fa14,143,ROOSEVELT,CGS,CritGendSt,0,0,0,0,0,0,0,0,0,0,1,1,0,0,0,0,0,0,0,1,1
fa14,143,ROOSEVELT,CHEM,Bioch/Chem,8,6,14,1,0,1,2,7,9,4,6,10,13,4,17,0,0,0,28,23,51
fa14,143,ROOSEVELT,CHEM,Bioinform,1,0,1,0,0,0,0,0,0,0,0,0,0,0,0,0,0,0,1,0,1
fa14,143,ROOSEVELT,CHEM,Chem Phys,0,1,1,0,0,0,0,0,0,0,0,0,0,0,0,0,0,0,0,1,1
fa14,143,ROOSEVELT,CHEM,Chemistry,2,8,10,0,0,0,0,2,2,4,5,9,3,2,5,0,0,0,9,17,26
fa14,143,ROOSEVELT,CHEM,Envir Chem,0,3,3,0,0,0,0,0,0,0,0,0,2,1,3,0,0,0,2,4,6
fa14,143,ROOSEVELT,CHEM,Pharm Chem,3,16,19,0,0,0,4,3,7,3,4,7,9,12,21,0,0,0,19,35,54
fa14,143,ROOSEVELT,CHIN,Chinese St,0,0,0,0,0,0,0,0,0,0,1,1,0,0,0,0,0,0,0,1,1
fa14,143,ROOSEVELT,CLAS,Classic St,0,1,1,0,0,0,0,0,0,0,1,1,1,1,2,0,0,0,1,3,4
fa14,143,ROOSEVELT,COGS,Cog Sci,7,4,11,0,0,0,3,5,8,3,4,7,3,4,7,0,0,0,16,17,33
fa14,143,ROOSEVELT,COGS,CogSc/ClAs,0,0,0,0,0,0,0,0,0,0,0,0,0,2,2,0,0,0,0,2,2
fa14,143,ROOSEVELT,COGS,CogSc/Comp,1,0,1,0,0,0,0,0,0,0,0,0,1,1,2,0,0,0,2,1,3
fa14,143,ROOSEVELT,COGS,CogSc/HCI,1,0,1,0,0,0,1,0,1,1,6,7,4,4,8,0,0,0,7,10,17
fa14,143,ROOSEVELT,COGS,CogSc/HCog,1,2,3,0,0,0,0,0,0,0,0,0,0,2,2,0,0,0,1,4,5
fa14,143,ROOSEVELT,COGS,CogSc/Neur,1,1,2,0,0,0,1,2,3,1,3,4,5,5,10,0,0,0,8,11,19
fa14,143,ROOSEVELT,COMM,Communic,1,15,16,3,2,5,3,13,16,16,50,66,9,35,44,0,0,0,32,115,147
fa14,143,ROOSEVELT,CSE,Comp Sci,4,0,4,0,0,0,6,0,6,32,9,41,67,12,79,0,0,0,109,21,130
fa14,143,ROOSEVELT,CSE,CompEngCSE,6,3,9,0,0,0,2,1,3,11,1,12,8,1,9,0,0,0,27,6,33
fa14,143,ROOSEVELT,CSE,CompScBinf,1,0,1,0,0,0,3,1,4,1,0,1,3,2,5,0,0,0,8,3,11
fa14,143,ROOSEVELT,ECE,CompEngECE,2,1,3,0,0,0,9,0,9,5,2,7,3,0,3,0,0,0,19,3,22
fa14,143,ROOSEVELT,ECE,Electr Eng,5,1,6,2,0,2,16,3,19,28,7,35,40,8,48,0,0,0,91,19,110
fa14,143,ROOSEVELT,ECE,EleEng&Soc,0,0,0,0,0,0,2,0,2,1,0,1,0,0,0,0,0,0,3,0,3
fa14,143,ROOSEVELT,ECE,Engin Phys,0,0,0,0,0,0,1,0,1,0,0,0,1,0,1,0,0,0,2,0,2
fa14,143,ROOSEVELT,ECE,Pr-EngPhys,2,1,3,0,0,0,1,0,1,0,0,0,0,0,0,0,0,0,3,1,4
fa14,143,ROOSEVELT,ECON,Ec-Mth&Ecn,10,18,28,1,0,1,5,5,10,6,2,8,4,8,12,0,0,0,26,33,59
fa14,143,ROOSEVELT,ECON,Econ-MgtSc,12,10,22,2,1,3,12,10,22,22,9,31,23,31,54,0,0,0,71,61,132
fa14,143,ROOSEVELT,ECON,Economics,37,32,69,6,3,9,22,19,41,60,34,94,61,43,104,0,0,0,186,131,317
fa14,143,ROOSEVELT,ESYS,EnvSys(EB),1,3,4,0,0,0,0,2,2,1,4,5,3,2,5,0,0,0,5,11,16
fa14,143,ROOSEVELT,ESYS,EnvSys(EC),1,1,2,0,0,0,0,0,0,0,0,0,0,1,1,0,0,0,1,2,3
fa14,143,ROOSEVELT,ESYS,EnvSys(EP),2,1,3,0,0,0,3,0,3,0,1,1,1,2,3,0,0,0,6,4,10
fa14,143,ROOSEVELT,ESYS,EnvSys(ES),1,3,4,0,0,0,1,0,1,0,1,1,2,4,6,0,0,0,4,8,12
fa14,143,ROOSEVELT,ETHN,Ethnic St,0,0,0,0,0,0,0,0,0,0,0,0,0,1,1,0,0,0,0,1,1
fa14,143,ROOSEVELT,FPMU,Public Hlt,1,12,13,0,1,1,2,10,12,5,19,24,2,11,13,0,0,0,10,53,63
fa14,143,ROOSEVELT,GLBH,Global Hlt,0,0,0,0,0,0,0,1,1,0,4,4,0,1,1,0,0,0,0,6,6
fa14,143,ROOSEVELT,GMST,German Stu,0,0,0,0,0,0,0,0,0,0,0,0,1,0,1,0,0,0,1,0,1
fa14,143,ROOSEVELT,HDP,Human Dev,0,0,0,0,0,0,0,0,0,0,2,2,1,21,22,0,0,0,1,23,24
fa14,143,ROOSEVELT,HDP,Pr-HumnDev,0,2,2,0,0,0,0,12,12,1,7,8,0,3,3,0,0,0,1,24,25
fa14,143,ROOSEVELT,HIST,History,3,2,5,0,1,1,4,8,12,5,9,14,13,9,22,0,0,0,25,29,54
fa14,143,ROOSEVELT,INTL,Int-5yrEC,0,0,0,0,0,0,0,0,0,0,0,0,2,0,2,0,0,0,2,0,2
fa14,143,ROOSEVELT,INTL,Int-5yrPS,0,0,0,0,0,0,0,0,0,0,0,0,0,1,1,0,0,0,0,1,1
fa14,143,ROOSEVELT,INTL,IntSt-Anth,0,1,1,0,0,0,0,0,0,1,0,1,0,2,2,0,0,0,1,3,4
fa14,143,ROOSEVELT,INTL,IntSt-Econ,3,7,10,0,0,0,2,4,6,7,14,21,3,13,16,0,0,0,15,38,53
fa14,143,ROOSEVELT,INTL,IntSt-Hist,0,1,1,0,0,0,0,0,0,0,1,1,1,4,5,0,0,0,1,6,7
fa14,143,ROOSEVELT,INTL,IntSt-Ling,0,1,1,0,0,0,0,2,2,2,4,6,0,1,1,0,0,0,2,8,10
fa14,143,ROOSEVELT,INTL,IntSt-Lit,0,2,2,0,0,0,1,1,2,1,1,2,0,0,0,0,0,0,2,4,6
fa14,143,ROOSEVELT,INTL,IntSt-PolS,6,9,15,0,0,0,3,7,10,11,19,30,13,25,38,0,0,0,33,60,93
fa14,143,ROOSEVELT,INTL,IntSt-Soc,0,3,3,0,1,1,0,2,2,2,15,17,1,7,8,0,0,0,3,28,31
fa14,143,ROOSEVELT,JAPN,JapaneseSt,0,0,0,0,0,0,1,1,2,0,1,1,2,1,3,0,0,0,3,3,6
fa14,143,ROOSEVELT,LATI,LatinAm St,0,0,0,0,0,0,0,1,1,0,0,0,0,0,0,0,0,0,0,1,1
fa14,143,ROOSEVELT,LING,Lang Stu,0,0,0,0,0,0,0,4,4,0,1,1,2,0,2,0,0,0,2,5,7
fa14,143,ROOSEVELT,LING,Ling-CogLn,0,1,1,0,0,0,0,2,2,1,3,4,0,3,3,0,0,0,1,9,10
fa14,143,ROOSEVELT,LING,Ling-LSoc,1,1,2,0,0,0,0,1,1,1,3,4,1,1,2,0,0,0,3,6,9
fa14,143,ROOSEVELT,LING,Linguistcs,0,0,0,0,0,0,0,2,2,1,2,3,1,4,5,0,0,0,2,8,10
fa14,143,ROOSEVELT,LIT,French Lit,0,0,0,0,0,0,0,0,0,0,1,1,0,0,0,0,0,0,0,1,1
fa14,143,ROOSEVELT,LIT,Lit/Compos,1,0,1,0,0,0,0,1,1,0,0,0,0,0,0,0,0,0,1,1,2
fa14,143,ROOSEVELT,LIT,Lit/CultSt,0,0,0,0,0,0,0,0,0,0,2,2,0,1,1,0,0,0,0,3,3
fa14,143,ROOSEVELT,LIT,Lit/Engl,1,2,3,0,0,0,2,1,3,1,1,2,0,6,6,0,0,0,4,10,14
fa14,143,ROOSEVELT,LIT,Lit/World,0,0,0,0,0,0,0,0,0,0,2,2,0,4,4,0,0,0,0,6,6
fa14,143,ROOSEVELT,LIT,Lit/Writng,0,2,2,0,0,0,0,1,1,1,4,5,2,13,15,0,0,0,3,20,23
fa14,143,ROOSEVELT,LIT,Spanish Lt,0,1,1,0,0,0,0,0,0,0,2,2,0,1,1,0,0,0,0,4,4
fa14,143,ROOSEVELT,MAE,Aerosp Eng,2,1,3,0,0,0,0,1,1,1,0,1,6,0,6,0,0,0,9,2,11
fa14,143,ROOSEVELT,MAE,Engin Sci,0,0,0,0,0,0,0,0,0,0,0,0,3,0,3,0,0,0,3,0,3
fa14,143,ROOSEVELT,MAE,Envir Eng,3,3,6,3,0,3,4,3,7,5,3,8,5,5,10,0,0,0,20,14,34
fa14,143,ROOSEVELT,MAE,Mech Engin,3,0,3,0,1,1,2,1,3,0,0,0,7,2,9,0,0,0,12,4,16
fa14,143,ROOSEVELT,MATH,Appld Math,10,8,18,1,2,3,5,6,11,2,4,6,4,3,7,0,0,0,22,23,45
fa14,143,ROOSEVELT,MATH,Math/SecEd,0,0,0,0,0,0,0,2,2,0,2,2,1,2,3,0,0,0,1,6,7
fa14,143,ROOSEVELT,MATH,Mathematcs,7,2,9,2,0,2,1,2,3,2,3,5,1,2,3,0,0,0,13,9,22
fa14,143,ROOSEVELT,MATH,Mth-CompSc,12,2,14,0,0,0,9,1,10,1,1,2,1,2,3,0,0,0,23,6,29
fa14,143,ROOSEVELT,MATH,Mth-Mth&Ec,0,1,1,0,0,0,6,7,13,7,2,9,2,3,5,0,0,0,15,13,28
fa14,143,ROOSEVELT,MATH,Mth-SciCom,1,0,1,0,0,0,0,0,0,0,0,0,0,0,0,0,0,0,1,0,1
fa14,143,ROOSEVELT,MATH,Mth/ApldSc,1,2,3,0,0,0,2,1,3,1,0,1,0,0,0,0,0,0,4,3,7
fa14,143,ROOSEVELT,MATH,Prob&Stats,5,4,9,2,0,2,1,2,3,0,1,1,1,1,2,0,0,0,9,8,17
fa14,143,ROOSEVELT,MUS,Mu-CompArt,2,0,2,0,0,0,0,0,0,1,0,1,0,1,1,0,0,0,3,1,4
fa14,143,ROOSEVELT,MUS,Music,0,0,0,0,1,1,0,0,0,1,0,1,0,0,0,0,0,0,1,1,2
fa14,143,ROOSEVELT,MUS,Music Hum,0,0,0,0,0,0,0,0,0,0,0,0,0,1,1,0,0,0,0,1,1
fa14,143,ROOSEVELT,NENG,NanoEng,1,1,2,0,0,0,3,2,5,7,3,10,17,7,24,0,0,0,28,13,41
fa14,143,ROOSEVELT,PHIL,Philosophy,0,1,1,0,0,0,0,0,0,1,3,4,3,0,3,0,0,0,4,4,8
fa14,143,ROOSEVELT,PHYS,Biophysics,2,0,2,0,0,0,0,1,1,0,0,0,1,0,1,0,0,0,3,1,4
fa14,143,ROOSEVELT,PHYS,Gen Physcs,0,1,1,0,0,0,0,0,0,0,0,0,0,0,0,0,0,0,0,1,1
fa14,143,ROOSEVELT,PHYS,Phys/Astro,3,1,4,1,0,1,1,0,1,0,1,1,0,0,0,0,0,0,5,2,7
fa14,143,ROOSEVELT,PHYS,Phys/Comp,0,0,0,0,0,0,0,0,0,0,0,0,1,0,1,0,0,0,1,0,1
fa14,143,ROOSEVELT,PHYS,Physics,6,0,6,1,0,1,4,0,4,3,1,4,0,2,2,0,0,0,14,3,17
fa14,143,ROOSEVELT,POLI,Polit Sci,5,11,16,1,1,2,4,9,13,12,15,27,15,22,37,0,0,0,37,58,95
fa14,143,ROOSEVELT,POLI,PolSc-Amer,0,0,0,0,0,0,0,1,1,4,4,8,1,2,3,0,0,0,5,7,12
fa14,143,ROOSEVELT,POLI,PolSc-Comp,1,1,2,0,0,0,0,0,0,0,2,2,2,2,4,0,0,0,3,5,8
fa14,143,ROOSEVELT,POLI,PolSc-Intl,9,4,13,0,0,0,7,8,15,17,16,33,21,12,33,0,0,0,54,40,94
fa14,143,ROOSEVELT,POLI,PolSc-PLaw,1,2,3,0,0,0,2,6,8,3,13,16,5,1,6,0,0,0,11,22,33
fa14,143,ROOSEVELT,POLI,PolSc-PPol,0,0,0,0,0,0,2,0,2,2,2,4,3,2,5,0,0,0,7,4,11
fa14,143,ROOSEVELT,POLI,PolSc-Thry,0,0,0,0,0,0,0,0,0,0,2,2,0,0,0,0,0,0,0,2,2
fa14,143,ROOSEVELT,PSYC,Psychology,2,22,24,2,6,8,5,31,36,9,46,55,23,48,71,0,0,0,41,153,194
fa14,143,ROOSEVELT,RUSS,Russ&SovSt,0,0,0,0,0,0,0,0,0,1,0,1,0,0,0,0,0,0,1,0,1
fa14,143,ROOSEVELT,SE,Engin Sci,2,1,3,0,0,0,0,0,0,0,0,0,0,0,0,0,0,0,2,1,3
fa14,143,ROOSEVELT,SE,Struct Eng,8,1,9,3,2,5,6,2,8,8,7,15,28,7,35,0,0,0,53,19,72
fa14,143,ROOSEVELT,SIO,Earth Sci,0,0,0,0,0,0,0,0,0,1,1,2,2,4,6,0,0,0,3,5,8
fa14,143,ROOSEVELT,SIO,Marine Bio,2,7,9,0,1,1,1,6,7,3,1,4,3,6,9,0,0,0,9,21,30
fa14,143,ROOSEVELT,SOC,SocCulCom,0,0,0,0,0,0,0,2,2,0,1,1,0,1,1,0,0,0,0,4,4
fa14,143,ROOSEVELT,SOC,SocEconSoc,0,0,0,0,0,0,0,1,1,1,0,1,0,1,1,0,0,0,1,2,3
fa14,143,ROOSEVELT,SOC,SocIntlStu,0,1,1,0,0,0,0,1,1,0,2,2,0,1,1,0,0,0,0,5,5
fa14,143,ROOSEVELT,SOC,Sociology,2,4,6,0,0,0,1,2,3,3,7,10,1,14,15,0,0,0,7,27,34
fa14,143,ROOSEVELT,SOC,SocLawSoc,1,1,2,0,0,0,0,2,2,2,0,2,2,3,5,0,0,0,5,6,11
fa14,143,ROOSEVELT,SOC,SocSciMed,0,0,0,0,0,0,1,0,1,0,2,2,0,0,0,0,0,0,1,2,3
fa14,143,ROOSEVELT,SOC,SocSolneq,0,0,0,0,0,0,0,0,0,0,1,1,0,2,2,0,0,0,0,3,3
fa14,143,ROOSEVELT,THEA,Theatre,1,1,2,0,0,0,2,1,3,1,4,5,1,3,4,0,0,0,5,9,14
fa14,143,ROOSEVELT,TWS,ThirdWldSt,0,0,0,0,0,0,0,0,0,0,1,1,0,1,1,0,0,0,0,2,2
fa14,143,ROOSEVELT,UNAF,UndecHumAr,2,8,10,0,0,0,1,3,4,0,0,0,0,0,0,0,0,0,3,11,14
fa14,143,ROOSEVELT,UNAF,Undeclared,93,53,146,6,2,8,5,13,18,2,1,3,0,0,0,0,0,0,106,69,175
fa14,143,ROOSEVELT,UNAF,UndecPhysS,6,12,18,0,0,0,2,2,4,1,0,1,0,0,0,0,0,0,9,14,23
fa14,143,ROOSEVELT,UNAF,UndecSocSc,12,18,30,0,0,0,1,2,3,0,0,0,0,0,0,0,0,0,13,20,33
fa14,143,ROOSEVELT,USP,Urb Stu&Pl,0,0,0,0,0,0,1,0,1,0,3,3,1,2,3,0,0,0,2,5,7
fa14,143,ROOSEVELT,VIS,Art Hst/Cr,0,0,0,0,0,0,0,1,1,0,2,2,0,3,3,0,0,0,0,6,6
fa14,143,ROOSEVELT,VIS,Media,0,1,1,0,3,3,0,0,0,1,3,4,3,3,6,0,0,0,4,10,14
fa14,143,ROOSEVELT,VIS,Studio VA,0,1,1,1,0,1,0,1,1,0,1,1,1,5,6,0,0,0,2,8,10
fa14,143,ROOSEVELT,VIS,VA-CompArt,1,2,3,0,0,0,0,1,1,2,3,5,1,2,3,0,0,0,4,8,12
fa14,143,SIXTH,ANTH,Anth-Arch,0,0,0,0,0,0,0,0,0,0,2,2,1,1,2,0,0,0,1,3,4
fa14,143,SIXTH,ANTH,Anth-Biol,0,0,0,0,0,0,0,0,0,0,0,0,0,3,3,0,0,0,0,3,3
fa14,143,SIXTH,ANTH,Anth-Soci,0,1,1,0,0,0,1,0,1,2,1,3,0,5,5,0,0,0,3,7,10
fa14,143,SIXTH,BENG,Bioen:Binf,1,0,1,0,0,0,1,4,5,2,6,8,6,4,10,0,0,0,10,14,24
fa14,143,SIXTH,BENG,Bioeng:PM,0,0,0,0,0,0,0,0,0,0,0,0,1,0,1,0,0,0,1,0,1
fa14,143,SIXTH,BENG,BioengBioS,2,1,3,0,0,0,4,2,6,1,5,6,1,0,1,0,0,0,8,8,16
fa14,143,SIXTH,BENG,BioengBiot,1,3,4,0,0,0,1,0,1,3,1,4,11,8,19,0,0,0,16,12,28
fa14,143,SIXTH,BENG,Bioengin,0,0,0,0,0,0,0,1,1,4,0,4,8,7,15,0,0,0,12,8,20
fa14,143,SIXTH,BIOL,Bioc/CellB,18,25,43,2,0,2,16,18,34,33,11,44,30,43,73,0,0,0,99,97,196
fa14,143,SIXTH,BIOL,BiolBioinf,3,1,4,0,0,0,1,1,2,2,0,2,0,1,1,0,0,0,6,3,9
fa14,143,SIXTH,BIOL,Ec/Beh/Evo,3,0,3,0,0,0,1,2,3,1,2,3,2,7,9,0,0,0,7,11,18
fa14,143,SIXTH,BIOL,Genl Biol,17,18,35,0,3,3,5,12,17,14,22,36,20,25,45,0,0,0,56,80,136
fa14,143,SIXTH,BIOL,Human Bio,25,36,61,1,3,4,19,23,42,32,29,61,39,35,74,0,0,0,116,126,242
fa14,143,SIXTH,BIOL,Microbiol,3,5,8,0,1,1,0,1,1,1,6,7,3,4,7,0,0,0,7,17,24
fa14,143,SIXTH,BIOL,Molec Biol,4,7,11,0,0,0,3,2,5,3,3,6,2,3,5,0,0,0,12,15,27
fa14,143,SIXTH,BIOL,PhyslNeuro,12,24,36,0,1,1,13,17,30,9,10,19,17,11,28,0,0,0,51,63,114
fa14,143,SIXTH,CENG,Chem Engin,2,0,2,0,1,1,15,8,23,24,12,36,17,9,26,0,0,0,58,30,88
fa14,143,SIXTH,CGS,CritGendSt,0,0,0,0,0,0,0,0,0,0,0,0,1,1,2,0,0,0,1,1,2
fa14,143,SIXTH,CHEM,Bioch/Chem,6,11,17,1,0,1,1,4,5,2,2,4,14,6,20,0,0,0,24,23,47
fa14,143,SIXTH,CHEM,Bioinform,0,0,0,0,0,0,1,0,1,0,0,0,0,0,0,0,0,0,1,0,1
fa14,143,SIXTH,CHEM,Chem Educ,0,0,0,0,0,0,0,0,0,1,0,1,0,0,0,0,0,0,1,0,1
fa14,143,SIXTH,CHEM,Chemistry,5,7,12,0,0,0,2,3,5,2,2,4,5,6,11,0,0,0,14,18,32
fa14,143,SIXTH,CHEM,Envir Chem,0,0,0,0,0,0,0,0,0,0,1,1,0,2,2,0,0,0,0,3,3
fa14,143,SIXTH,CHEM,MolecSynth,1,0,1,0,0,0,0,0,0,1,0,1,0,1,1,0,0,0,2,1,3
fa14,143,SIXTH,CHEM,Pharm Chem,2,15,17,0,1,1,4,11,15,3,9,12,13,8,21,0,0,0,22,44,66
fa14,143,SIXTH,CHIN,Chinese St,0,0,0,0,0,0,0,0,0,0,0,0,1,0,1,0,0,0,1,0,1
fa14,143,SIXTH,COGS,Cog Sci,1,7,8,0,0,0,4,3,7,7,3,10,4,2,6,0,0,0,16,15,31
fa14,143,SIXTH,COGS,CogSc/Comp,4,1,5,0,0,0,0,0,0,0,0,0,0,1,1,0,0,0,4,2,6
fa14,143,SIXTH,COGS,CogSc/HCI,0,0,0,0,0,0,3,1,4,4,1,5,6,10,16,0,0,0,13,12,25
fa14,143,SIXTH,COGS,CogSc/HCog,0,0,0,0,0,0,1,0,1,1,1,2,0,1,1,0,0,0,2,2,4
fa14,143,SIXTH,COGS,CogSc/Neur,0,1,1,0,0,0,2,0,2,4,3,7,8,8,16,0,0,0,14,12,26
fa14,143,SIXTH,COMM,Communic,7,5,12,1,2,3,9,7,16,15,51,66,17,38,55,0,0,0,49,103,152
fa14,143,SIXTH,CSE,Comp Sci,15,8,23,2,0,2,23,7,30,116,23,139,133,33,166,0,0,0,289,71,360
fa14,143,SIXTH,CSE,CompEngCSE,7,0,7,1,0,1,7,1,8,24,1,25,30,2,32,0,0,0,69,4,73
fa14,143,SIXTH,CSE,CompScBinf,0,0,0,1,0,1,3,1,4,7,3,10,2,3,5,0,0,0,13,7,20
fa14,143,SIXTH,ECE,CompEngECE,10,0,10,2,0,2,21,0,21,11,2,13,6,0,6,0,0,0,50,2,52
fa14,143,SIXTH,ECE,Electr Eng,18,1,19,4,0,4,41,3,44,55,6,61,68,9,77,0,0,0,186,19,205
fa14,143,SIXTH,ECE,EleEng&Soc,0,0,0,0,0,0,0,0,0,0,0,0,1,1,2,0,0,0,1,1,2
fa14,143,SIXTH,ECE,Engin Phys,0,0,0,0,0,0,1,0,1,0,0,0,1,1,2,0,0,0,2,1,3
fa14,143,SIXTH,ECE,Pr-EngPhys,3,1,4,0,0,0,1,0,1,0,1,1,1,0,1,0,0,0,5,2,7
fa14,143,SIXTH,ECON,Ec-Mth&Ecn,4,6,10,1,1,2,6,6,12,8,8,16,8,0,8,0,0,0,27,21,48
fa14,143,SIXTH,ECON,Econ-MgtSc,3,8,11,3,0,3,13,8,21,30,9,39,36,19,55,0,0,0,85,44,129
fa14,143,SIXTH,ECON,Economics,23,11,34,5,1,6,22,10,32,55,34,89,38,31,69,0,0,0,143,87,230
fa14,143,SIXTH,ESYS,EnvSys(EB),1,1,2,0,0,0,1,0,1,0,2,2,2,6,8,0,0,0,4,9,13
fa14,143,SIXTH,ESYS,EnvSys(EC),2,1,3,0,0,0,0,0,0,0,0,0,1,1,2,0,0,0,3,2,5
fa14,143,SIXTH,ESYS,EnvSys(EP),2,1,3,0,0,0,0,0,0,0,0,0,0,4,4,0,0,0,2,5,7
fa14,143,SIXTH,ESYS,EnvSys(ES),0,2,2,0,0,0,0,1,1,2,1,3,1,2,3,0,0,0,3,6,9
fa14,143,SIXTH,ETHN,Ethnic St,0,0,0,0,0,0,0,0,0,0,1,1,2,0,2,0,0,0,2,1,3
fa14,143,SIXTH,FPMU,Public Hlt,0,6,6,0,0,0,1,5,6,5,18,23,2,7,9,0,0,0,8,36,44
fa14,143,SIXTH,GLBH,Global Hlt,0,1,1,0,0,0,0,2,2,0,0,0,0,0,0,0,0,0,0,3,3
fa14,143,SIXTH,HDP,Human Dev,0,0,0,0,0,0,0,0,0,0,4,4,3,16,19,0,0,0,3,20,23
fa14,143,SIXTH,HDP,Pr-HumnDev,0,2,2,0,0,0,0,5,5,2,8,10,0,3,3,0,0,0,2,18,20
fa14,143,SIXTH,HIST,History,1,1,2,0,0,0,1,0,1,1,3,4,6,6,12,0,0,0,9,10,19
fa14,143,SIXTH,INTD,Si Ind St,0,0,0,0,0,0,0,0,0,0,0,0,1,0,1,0,0,0,1,0,1
fa14,143,SIXTH,INTL,IntSt-Anth,0,0,0,0,0,0,0,1,1,0,1,1,0,0,0,0,0,0,0,2,2
fa14,143,SIXTH,INTL,IntSt-Econ,2,2,4,0,2,2,1,2,3,9,2,11,0,8,8,0,0,0,12,16,28
fa14,143,SIXTH,INTL,IntSt-Hist,0,0,0,0,0,0,0,0,0,1,0,1,0,1,1,0,0,0,1,1,2
fa14,143,SIXTH,INTL,IntSt-Ling,0,1,1,0,0,0,0,1,1,0,0,0,0,1,1,0,0,0,0,3,3
fa14,143,SIXTH,INTL,IntSt-Lit,0,0,0,0,0,0,0,0,0,0,0,0,0,1,1,0,0,0,0,1,1
fa14,143,SIXTH,INTL,IntSt-PolS,1,1,2,0,0,0,1,0,1,0,4,4,2,6,8,0,0,0,4,11,15
fa14,143,SIXTH,INTL,IntSt-Soc,0,0,0,1,0,1,0,1,1,1,1,2,0,0,0,0,0,0,2,2,4
fa14,143,SIXTH,JUDA,Judaic Stu,0,0,0,0,0,0,0,0,0,0,1,1,0,0,0,0,0,0,0,1,1
fa14,143,SIXTH,LING,Lang Stu,0,0,0,0,0,0,1,0,1,0,0,0,0,1,1,0,0,0,1,1,2
fa14,143,SIXTH,LING,Ling-CogLn,0,0,0,0,0,0,0,0,0,0,0,0,1,2,3,0,0,0,1,2,3
fa14,143,SIXTH,LING,Ling-LSoc,0,0,0,0,0,0,0,0,0,0,1,1,0,1,1,0,0,0,0,2,2
fa14,143,SIXTH,LING,Linguistcs,0,1,1,0,0,0,1,1,2,0,1,1,2,2,4,0,0,0,3,5,8
fa14,143,SIXTH,LIT,Ital Lit,0,0,0,0,0,0,0,0,0,0,1,1,0,0,0,0,0,0,0,1,1
fa14,143,SIXTH,LIT,Lit/CultSt,0,0,0,0,0,0,0,0,0,0,0,0,0,1,1,0,0,0,0,1,1
fa14,143,SIXTH,LIT,Lit/Engl,1,1,2,0,0,0,0,0,0,1,2,3,0,3,3,0,0,0,2,6,8
fa14,143,SIXTH,LIT,Lit/World,0,0,0,0,0,0,0,0,0,0,0,0,0,1,1,0,0,0,0,1,1
fa14,143,SIXTH,LIT,Lit/Writng,0,4,4,0,0,0,1,4,5,2,3,5,3,2,5,0,0,0,6,13,19
fa14,143,SIXTH,MAE,Aerosp Eng,6,2,8,0,0,0,1,1,2,8,2,10,12,3,15,0,0,0,27,8,35
fa14,143,SIXTH,MAE,Engin Sci,0,0,0,0,0,0,0,0,0,0,0,0,4,0,4,0,0,0,4,0,4
fa14,143,SIXTH,MAE,Envir Eng,3,2,5,0,0,0,12,2,14,5,3,8,12,11,23,0,0,0,32,18,50
fa14,143,SIXTH,MAE,Mech Engin,8,3,11,0,0,0,2,1,3,13,3,16,29,7,36,0,0,0,52,14,66
fa14,143,SIXTH,MATH,Appld Math,9,11,20,0,0,0,5,5,10,4,3,7,8,7,15,0,0,0,26,26,52
fa14,143,SIXTH,MATH,Math/SecEd,0,1,1,0,0,0,1,0,1,1,1,2,0,1,1,0,0,0,2,3,5
fa14,143,SIXTH,MATH,Mathematcs,7,5,12,0,0,0,4,1,5,4,4,8,3,0,3,0,0,0,18,10,28
fa14,143,SIXTH,MATH,Mth-CompSc,21,9,30,1,0,1,5,2,7,6,4,10,3,3,6,0,0,0,36,18,54
fa14,143,SIXTH,MATH,Mth-Mth&Ec,0,1,1,0,0,0,2,0,2,6,3,9,3,4,7,0,0,0,11,8,19
fa14,143,SIXTH,MATH,Mth-SciCom,0,0,0,0,0,0,0,0,0,0,1,1,0,0,0,0,0,0,0,1,1
fa14,143,SIXTH,MATH,Mth/ApldSc,2,1,3,0,0,0,2,0,2,1,0,1,0,1,1,0,0,0,5,2,7
fa14,143,SIXTH,MATH,Prob&Stats,5,1,6,0,0,0,1,2,3,3,1,4,2,1,3,0,0,0,11,5,16
fa14,143,SIXTH,MUS,Mu-CompArt,2,1,3,0,0,0,0,1,1,7,1,8,11,0,11,0,0,0,20,3,23
fa14,143,SIXTH,MUS,Music,1,1,2,0,0,0,1,0,1,2,0,2,2,2,4,0,0,0,6,3,9
fa14,143,SIXTH,MUS,Music Hum,0,0,0,0,0,0,0,0,0,1,0,1,0,0,0,0,0,0,1,0,1
fa14,143,SIXTH,NENG,NanoEng,10,0,10,0,0,0,11,2,13,10,4,14,23,3,26,0,0,0,54,9,63
fa14,143,SIXTH,PHIL,Philosophy,0,0,0,1,0,1,1,3,4,0,2,2,2,1,3,0,0,0,4,6,10
fa14,143,SIXTH,PHYS,Biophysics,0,1,1,0,0,0,1,0,1,1,1,2,2,0,2,0,0,0,4,2,6
fa14,143,SIXTH,PHYS,Gen Physcs,2,0,2,0,0,0,1,0,1,0,0,0,0,0,0,0,0,0,3,0,3
fa14,143,SIXTH,PHYS,GenPys/SEd,0,0,0,0,0,0,1,0,1,0,0,0,0,0,0,0,0,0,1,0,1
fa14,143,SIXTH,PHYS,Phy/ErthSc,0,0,0,0,0,0,1,0,1,0,0,0,1,0,1,0,0,0,2,0,2
fa14,143,SIXTH,PHYS,Phys/Astro,3,0,3,0,0,0,0,2,2,1,1,2,3,2,5,0,0,0,7,5,12
fa14,143,SIXTH,PHYS,Phys/Comp,2,0,2,0,0,0,0,0,0,1,0,1,1,0,1,0,0,0,4,0,4
fa14,143,SIXTH,PHYS,Phys/Mtrls,2,2,4,0,0,0,1,0,1,1,0,1,0,0,0,0,0,0,4,2,6
fa14,143,SIXTH,PHYS,Physics,11,2,13,1,0,1,4,0,4,2,0,2,7,0,7,0,0,0,25,2,27
fa14,143,SIXTH,POLI,Polit Sci,2,4,6,0,0,0,2,0,2,6,8,14,7,6,13,0,0,0,17,18,35
fa14,143,SIXTH,POLI,PolSc-Amer,0,1,1,0,0,0,1,1,2,0,1,1,4,1,5,0,0,0,5,4,9
fa14,143,SIXTH,POLI,PolSc-Intl,0,0,0,0,0,0,1,1,2,3,3,6,4,7,11,0,0,0,8,11,19
fa14,143,SIXTH,POLI,PolSc-PLaw,0,0,0,0,1,1,1,3,4,0,2,2,3,4,7,0,0,0,4,10,14
fa14,143,SIXTH,POLI,PolSc-PPol,0,0,0,0,0,0,0,0,0,2,0,2,2,1,3,0,0,0,4,1,5
fa14,143,SIXTH,POLI,PolSc-Thry,0,0,0,0,0,0,0,0,0,0,1,1,1,0,1,0,0,0,1,1,2
fa14,143,SIXTH,PSYC,Psychology,2,8,10,0,3,3,3,14,17,20,40,60,16,56,72,0,0,0,41,121,162
fa14,143,SIXTH,SE,Engin Sci,0,0,0,1,0,1,1,0,1,0,0,0,0,0,0,0,0,0,2,0,2
fa14,143,SIXTH,SE,Struct Eng,8,6,14,1,0,1,25,7,32,24,11,35,45,12,57,0,0,0,103,36,139
fa14,143,SIXTH,SIO,Earth Sci,0,0,0,0,0,0,0,1,1,0,0,0,1,1,2,0,0,0,1,2,3
fa14,143,SIXTH,SIO,Marine Bio,5,5,10,0,0,0,0,5,5,1,4,5,4,7,11,0,0,0,10,21,31
fa14,143,SIXTH,SOC,SocCulCom,0,0,0,0,0,0,0,1,1,0,0,0,0,1,1,0,0,0,0,2,2
fa14,143,SIXTH,SOC,SocEconSoc,0,0,0,0,0,0,0,0,0,2,0,2,0,0,0,0,0,0,2,0,2
fa14,143,SIXTH,SOC,Sociology,1,2,3,1,0,1,1,1,2,2,7,9,3,9,12,0,0,0,8,19,27
fa14,143,SIXTH,SOC,SocLawSoc,1,0,1,0,0,0,0,0,0,0,1,1,1,4,5,0,0,0,2,5,7
fa14,143,SIXTH,SOC,SocSciMed,0,0,0,0,0,0,0,0,0,0,1,1,0,1,1,0,0,0,0,2,2
fa14,143,SIXTH,SOC,SocSolneq,0,0,0,0,0,0,0,0,0,0,1,1,0,3,3,0,0,0,0,4,4
fa14,143,SIXTH,THEA,Dance,0,0,0,0,0,0,0,0,0,0,0,0,0,2,2,0,0,0,0,2,2
fa14,143,SIXTH,THEA,Theatre,1,3,4,0,0,0,0,6,6,2,5,7,9,6,15,0,0,0,12,20,32
fa14,143,SIXTH,UNAF,UndecHumAr,3,4,7,0,0,0,0,0,0,0,0,0,0,0,0,0,0,0,3,4,7
fa14,143,SIXTH,UNAF,Undeclared,134,52,186,2,1,3,17,15,32,2,1,3,0,0,0,0,0,0,155,69,224
fa14,143,SIXTH,UNAF,UndecPhysS,10,9,19,0,0,0,2,2,4,0,0,0,0,0,0,0,0,0,12,11,23
fa14,143,SIXTH,UNAF,UndecSocSc,3,10,13,0,0,0,1,4,5,0,0,0,0,0,0,0,0,0,4,14,18
fa14,143,SIXTH,USP,Urb Stu&Pl,0,2,2,1,0,1,0,2,2,4,4,8,5,11,16,0,0,0,10,19,29
fa14,143,SIXTH,VIS,Art Hst/Cr,0,1,1,0,1,1,0,1,1,0,2,2,0,5,5,0,0,0,0,10,10
fa14,143,SIXTH,VIS,Media,5,4,9,2,1,3,8,7,15,12,19,31,14,14,28,0,0,0,41,45,86
fa14,143,SIXTH,VIS,Studio VA,1,3,4,0,0,0,2,0,2,4,7,11,0,13,13,0,0,0,7,23,30
fa14,143,SIXTH,VIS,VA-CompArt,2,7,9,0,1,1,2,11,13,6,8,14,1,6,7,0,0,0,11,33,44
fa14,143,WARREN,ANTH,Anth-Arch,0,1,1,0,0,0,0,1,1,1,0,1,0,2,2,0,0,0,1,4,5
fa14,143,WARREN,ANTH,Anth-Biol,0,0,0,0,0,0,0,0,0,1,1,2,0,1,1,0,0,0,1,2,3
fa14,143,WARREN,ANTH,Anth-Soci,0,0,0,0,0,0,0,0,0,0,1,1,0,3,3,0,0,0,0,4,4
fa14,143,WARREN,BENG,Bioen:Binf,5,1,6,1,0,1,3,5,8,6,6,12,5,8,13,0,0,0,20,20,40
fa14,143,WARREN,BENG,Bioeng:PM,0,0,0,0,0,0,0,0,0,0,0,0,0,1,1,0,0,0,0,1,1
fa14,143,WARREN,BENG,BioengBioS,1,1,2,1,1,2,3,0,3,4,0,4,1,0,1,0,0,0,10,2,12
fa14,143,WARREN,BENG,BioengBiot,11,7,18,0,0,0,4,1,5,9,13,22,23,20,43,0,0,0,47,41,88
fa14,143,WARREN,BENG,Bioengin,10,5,15,0,0,0,4,2,6,8,4,12,21,13,34,0,0,0,43,24,67
fa14,143,WARREN,BIOL,Bioc/CellB,15,20,35,2,0,2,7,16,23,19,22,41,40,39,79,0,0,0,83,97,180
fa14,143,WARREN,BIOL,BiolBioinf,1,1,2,0,0,0,1,0,1,1,2,3,0,0,0,0,0,0,3,3,6
fa14,143,WARREN,BIOL,Ec/Beh/Evo,0,0,0,0,0,0,0,3,3,4,1,5,1,8,9,0,0,0,5,12,17
fa14,143,WARREN,BIOL,Genl Biol,5,9,14,0,0,0,3,13,16,12,15,27,24,33,57,0,0,0,44,70,114
fa14,143,WARREN,BIOL,Human Bio,11,10,21,0,0,0,11,32,43,16,33,49,38,44,82,0,0,0,76,119,195
fa14,143,WARREN,BIOL,Microbiol,3,2,5,0,0,0,0,2,2,1,1,2,3,7,10,0,0,0,7,12,19
fa14,143,WARREN,BIOL,Molec Biol,3,0,3,0,0,0,2,0,2,3,3,6,8,2,10,0,0,0,16,5,21
fa14,143,WARREN,BIOL,PhyslNeuro,5,9,14,0,0,0,5,11,16,18,12,30,17,18,35,0,0,0,45,50,95
fa14,143,WARREN,CENG,Chem Engin,6,6,12,2,0,2,17,5,22,37,15,52,57,35,92,0,0,0,119,61,180
fa14,143,WARREN,CGS,CritGendSt,0,0,0,0,0,0,0,0,0,1,0,1,0,0,0,0,0,0,1,0,1
fa14,143,WARREN,CHEM,Bioch/Chem,4,4,8,0,0,0,5,3,8,5,3,8,10,16,26,0,0,0,24,26,50
fa14,143,WARREN,CHEM,Chem Educ,0,0,0,0,0,0,0,1,1,0,0,0,0,0,0,0,0,0,0,1,1
fa14,143,WARREN,CHEM,Chem Phys,0,0,0,0,0,0,0,0,0,0,0,0,0,1,1,0,0,0,0,1,1
fa14,143,WARREN,CHEM,Chemistry,3,6,9,0,0,0,0,4,4,5,4,9,3,7,10,0,0,0,11,21,32
fa14,143,WARREN,CHEM,Envir Chem,0,0,0,0,0,0,0,0,0,1,0,1,0,3,3,0,0,0,1,3,4
fa14,143,WARREN,CHEM,MolecSynth,0,1,1,0,0,0,0,0,0,0,0,0,3,0,3,0,0,0,3,1,4
fa14,143,WARREN,CHEM,Pharm Chem,0,6,6,0,0,0,1,1,2,2,7,9,8,21,29,0,0,0,11,35,46
fa14,143,WARREN,CHIN,Chinese St,0,0,0,0,0,0,0,0,0,0,1,1,0,1,1,0,0,0,0,2,2
fa14,143,WARREN,COGS,Cog Sci,2,3,5,0,0,0,1,7,8,3,4,7,5,3,8,0,0,0,11,17,28
fa14,143,WARREN,COGS,CogSc/ClAs,0,0,0,0,0,0,0,0,0,1,1,2,1,2,3,0,0,0,2,3,5
fa14,143,WARREN,COGS,CogSc/Comp,0,0,0,0,0,0,0,1,1,0,2,2,2,0,2,0,0,0,2,3,5
fa14,143,WARREN,COGS,CogSc/HCI,0,0,0,0,0,0,0,1,1,0,4,4,6,3,9,0,0,0,6,8,14
fa14,143,WARREN,COGS,CogSc/HCog,0,0,0,0,0,0,0,0,0,1,0,1,1,2,3,0,0,0,2,2,4
fa14,143,WARREN,COGS,CogSc/Neur,0,0,0,0,0,0,0,1,1,0,4,4,6,15,21,0,0,0,6,20,26
fa14,143,WARREN,COMM,Communic,1,3,4,1,2,3,3,6,9,8,16,24,10,29,39,0,0,0,23,56,79
fa14,143,WARREN,CSE,Comp Sci,68,13,81,1,0,1,38,11,49,128,25,153,189,37,226,0,0,0,424,86,510
fa14,143,WARREN,CSE,CompEngCSE,28,7,35,0,0,0,5,0,5,33,7,40,51,4,55,0,0,0,117,18,135
fa14,143,WARREN,CSE,CompScBinf,3,1,4,0,0,0,7,3,10,1,1,2,5,5,10,0,0,0,16,10,26
fa14,143,WARREN,ECE,CompEngECE,15,3,18,3,0,3,17,2,19,20,2,22,17,0,17,0,0,0,72,7,79
fa14,143,WARREN,ECE,Electr Eng,25,3,28,7,0,7,34,15,49,73,12,85,99,13,112,0,0,0,238,43,281
fa14,143,WARREN,ECE,Engin Phys,0,0,0,0,0,0,0,0,0,2,0,2,2,0,2,0,0,0,4,0,4
fa14,143,WARREN,ECE,Pr-EngPhys,3,0,3,1,0,1,0,0,0,0,0,0,1,0,1,0,0,0,5,0,5
fa14,143,WARREN,ECON,Ec-Mth&Ecn,1,3,4,1,0,1,6,1,7,7,3,10,4,0,4,0,0,0,19,7,26
fa14,143,WARREN,ECON,Econ-MgtSc,3,1,4,1,0,1,9,9,18,30,10,40,36,29,65,0,0,0,79,49,128
fa14,143,WARREN,ECON,Economics,9,6,15,2,3,5,15,11,26,57,22,79,70,39,109,0,0,0,153,81,234
fa14,143,WARREN,ESYS,EnvSys(EB),0,0,0,0,0,0,0,0,0,1,2,3,0,2,2,0,0,0,1,4,5
fa14,143,WARREN,ESYS,EnvSys(EP),0,0,0,1,0,1,0,0,0,0,0,0,1,0,1,0,0,0,2,0,2
fa14,143,WARREN,ESYS,EnvSys(ES),1,0,1,0,0,0,0,1,1,0,0,0,1,1,2,0,0,0,2,2,4
fa14,143,WARREN,ETHN,Ethnic St,0,0,0,0,0,0,0,1,1,1,1,2,1,1,2,0,0,0,2,3,5
fa14,143,WARREN,FPMU,Public Hlt,2,2,4,0,0,0,0,2,2,2,9,11,3,6,9,0,0,0,7,19,26
fa14,143,WARREN,GLBH,Global Hlt,0,0,0,0,0,0,0,0,0,1,0,1,0,1,1,0,0,0,1,1,2
fa14,143,WARREN,HDP,Human Dev,0,0,0,0,0,0,0,0,0,1,1,2,0,18,18,0,0,0,1,19,20
fa14,143,WARREN,HDP,Pr-HumnDev,0,0,0,0,0,0,0,4,4,0,3,3,1,2,3,0,0,0,1,9,10
fa14,143,WARREN,HIST,History,0,1,1,0,0,0,1,1,2,3,1,4,6,3,9,0,0,0,10,6,16
fa14,143,WARREN,INTL,IntSt-Anth,0,0,0,0,0,0,0,0,0,1,0,1,0,0,0,0,0,0,1,0,1
fa14,143,WARREN,INTL,IntSt-Econ,0,1,1,0,0,0,0,2,2,1,1,2,0,2,2,0,0,0,1,6,7
fa14,143,WARREN,INTL,IntSt-Ling,0,0,0,0,1,1,0,0,0,0,0,0,0,1,1,0,0,0,0,2,2
fa14,143,WARREN,INTL,IntSt-PolS,0,1,1,0,0,0,0,0,0,0,6,6,4,1,5,0,0,0,4,8,12
fa14,143,WARREN,INTL,IntSt-Soc,0,0,0,0,0,0,0,2,2,0,0,0,0,2,2,0,0,0,0,4,4
fa14,143,WARREN,JAPN,JapaneseSt,0,0,0,0,0,0,0,0,0,0,0,0,1,0,1,0,0,0,1,0,1
fa14,143,WARREN,JUDA,Judaic Stu,0,0,0,0,0,0,0,0,0,0,0,0,2,0,2,0,0,0,2,0,2
fa14,143,WARREN,LING,Lang Stu,0,1,1,0,0,0,0,1,1,0,0,0,0,0,0,0,0,0,0,2,2
fa14,143,WARREN,LING,Ling-CogLn,0,0,0,0,0,0,0,0,0,0,2,2,0,1,1,0,0,0,0,3,3
fa14,143,WARREN,LING,Ling-LSoc,0,0,0,0,0,0,1,0,1,0,0,0,0,1,1,0,0,0,1,1,2
fa14,143,WARREN,LING,Linguistcs,1,1,2,0,0,0,0,0,0,0,1,1,1,2,3,0,0,0,2,4,6
fa14,143,WARREN,LIT,Lit/Compos,0,1,1,0,0,0,0,0,0,0,0,0,0,0,0,0,0,0,0,1,1
fa14,143,WARREN,LIT,Lit/Engl,0,0,0,0,0,0,1,0,1,0,2,2,0,3,3,0,0,0,1,5,6
fa14,143,WARREN,LIT,Lit/Writng,1,2,3,0,0,0,0,1,1,1,5,6,6,6,12,0,0,0,8,14,22
fa14,143,WARREN,LIT,Russian Lt,0,0,0,0,0,0,0,0,0,0,1,1,0,0,0,0,0,0,0,1,1
fa14,143,WARREN,LIT,Spanish Lt,0,0,0,0,0,0,0,1,1,0,0,0,1,1,2,0,0,0,1,2,3
fa14,143,WARREN,MAE,Aerosp Eng,16,4,20,0,0,0,10,1,11,20,5,25,25,7,32,0,0,0,71,17,88
fa14,143,WARREN,MAE,Engin Sci,0,0,0,0,0,0,0,0,0,1,0,1,5,1,6,0,0,0,6,1,7
fa14,143,WARREN,MAE,Envir Eng,3,11,14,1,0,1,12,2,14,11,6,17,15,8,23,0,0,0,42,27,69
fa14,143,WARREN,MAE,Mech Engin,24,7,31,1,0,1,15,3,18,34,7,41,54,15,69,0,0,0,128,32,160
fa14,143,WARREN,MATH,Appld Math,10,3,13,1,2,3,2,3,5,6,4,10,7,10,17,0,0,0,26,22,48
fa14,143,WARREN,MATH,Math/SecEd,0,0,0,0,0,0,0,1,1,0,3,3,0,2,2,0,0,0,0,6,6
fa14,143,WARREN,MATH,Mathematcs,1,3,4,0,0,0,4,2,6,3,4,7,5,4,9,0,0,0,13,13,26
fa14,143,WARREN,MATH,Mth-CompSc,11,4,15,1,1,2,8,2,10,3,2,5,4,0,4,0,0,0,27,9,36
fa14,143,WARREN,MATH,Mth-Mth&Ec,0,4,4,0,3,3,6,5,11,4,5,9,10,7,17,0,0,0,20,24,44
fa14,143,WARREN,MATH,Mth-SciCom,0,0,0,0,0,0,1,0,1,0,0,0,0,0,0,0,0,0,1,0,1
fa14,143,WARREN,MATH,Mth/ApldSc,0,3,3,0,0,0,1,1,2,1,1,2,1,2,3,0,0,0,3,7,10
fa14,143,WARREN,MATH,Prob&Stats,2,1,3,0,0,0,3,1,4,0,3,3,1,0,1,0,0,0,6,5,11
fa14,143,WARREN,MUS,Mu-CompArt,1,0,1,0,0,0,0,0,0,2,0,2,4,0,4,0,0,0,7,0,7
fa14,143,WARREN,MUS,Music,1,0,1,1,0,1,0,0,0,2,0,2,0,1,1,0,0,0,4,1,5
fa14,143,WARREN,NENG,NanoEng,5,1,6,0,0,0,11,3,14,17,3,20,31,6,37,0,0,0,64,13,77
fa14,143,WARREN,PHIL,Philosophy,0,0,0,0,0,0,0,3,3,3,0,3,4,2,6,0,0,0,7,5,12
fa14,143,WARREN,PHYS,Biophysics,2,1,3,0,0,0,0,0,0,1,2,3,2,2,4,0,0,0,5,5,10
fa14,143,WARREN,PHYS,Phys/Astro,0,2,2,1,0,1,0,1,1,1,0,1,1,2,3,0,0,0,3,5,8
fa14,143,WARREN,PHYS,Phys/Comp,1,0,1,0,0,0,0,0,0,0,0,0,1,1,2,0,0,0,2,1,3
fa14,143,WARREN,PHYS,Phys/Mtrls,1,0,1,0,0,0,0,0,0,1,0,1,0,0,0,0,0,0,2,0,2
fa14,143,WARREN,PHYS,Physics,5,2,7,0,0,0,2,0,2,5,0,5,5,2,7,0,0,0,17,4,21
fa14,143,WARREN,POLI,Polit Sci,4,3,7,0,0,0,2,1,3,10,8,18,21,13,34,0,0,0,37,25,62
fa14,143,WARREN,POLI,PolSc-Amer,1,0,1,0,0,0,1,0,1,1,2,3,7,1,8,0,0,0,10,3,13
fa14,143,WARREN,POLI,PolSc-Comp,0,0,0,0,0,0,0,0,0,0,0,0,0,1,1,0,0,0,0,1,1
fa14,143,WARREN,POLI,PolSc-Intl,2,2,4,0,1,1,3,2,5,7,5,12,5,2,7,0,0,0,17,12,29
fa14,143,WARREN,POLI,PolSc-PLaw,0,6,6,0,1,1,0,1,1,5,5,10,2,2,4,0,0,0,7,15,22
fa14,143,WARREN,POLI,PolSc-PPol,1,0,1,0,0,0,0,0,0,1,1,2,3,2,5,0,0,0,5,3,8
fa14,143,WARREN,POLI,PolSc-Thry,0,0,0,0,0,0,0,0,0,0,1,1,2,0,2,0,0,0,2,1,3
fa14,143,WARREN,PSYC,Psychology,2,5,7,0,1,1,5,13,18,12,23,35,26,51,77,0,0,0,45,93,138
fa14,143,WARREN,RELI,Relig/Stu,0,0,0,0,0,0,0,0,0,0,0,0,2,0,2,0,0,0,2,0,2
fa14,143,WARREN,SE,Engin Sci,2,0,2,0,0,0,1,1,2,0,0,0,0,0,0,0,0,0,3,1,4
fa14,143,WARREN,SE,Struct Eng,5,7,12,2,0,2,33,11,44,29,9,38,69,24,93,0,0,0,138,51,189
fa14,143,WARREN,SIO,Earth Sci,0,0,0,0,0,0,0,0,0,0,1,1,1,1,2,0,0,0,1,2,3
fa14,143,WARREN,SIO,Marine Bio,1,2,3,0,0,0,0,1,1,0,0,0,1,4,5,0,0,0,2,7,9
fa14,143,WARREN,SOC,SocCulCom,0,0,0,0,0,0,0,0,0,0,1,1,0,0,0,0,0,0,0,1,1
fa14,143,WARREN,SOC,SocEconSoc,0,1,1,0,0,0,0,0,0,0,1,1,1,0,1,0,0,0,1,2,3
fa14,143,WARREN,SOC,Sociology,0,0,0,0,0,0,0,1,1,4,4,8,3,4,7,0,0,0,7,9,16
fa14,143,WARREN,SOC,SocLawSoc,0,1,1,0,0,0,0,0,0,1,4,5,3,4,7,0,0,0,4,9,13
fa14,143,WARREN,SOC,SocSciMed,0,0,0,0,0,0,0,0,0,0,1,1,0,0,0,0,0,0,0,1,1
fa14,143,WARREN,SOC,SocSolneq,0,0,0,0,0,0,0,0,0,0,1,1,0,1,1,0,0,0,0,2,2
fa14,143,WARREN,THEA,Dance,0,0,0,0,0,0,0,0,0,0,0,0,0,1,1,0,0,0,0,1,1
fa14,143,WARREN,THEA,Theatre,0,0,0,0,0,0,2,0,2,1,0,1,0,3,3,0,0,0,3,3,6
fa14,143,WARREN,UNAF,IntcampVis,0,0,0,0,0,0,0,2,2,1,1,2,0,0,0,0,0,0,1,3,4
fa14,143,WARREN,UNAF,Limited St,0,0,0,0,0,0,0,0,0,0,0,0,0,0,0,2,0,2,2,0,2
fa14,143,WARREN,UNAF,UndecHumAr,0,1,1,0,0,0,0,0,0,0,0,0,0,0,0,0,0,0,0,1,1
fa14,143,WARREN,UNAF,Undeclared,81,26,107,4,2,6,11,3,14,1,1,2,0,0,0,0,0,0,97,32,129
fa14,143,WARREN,UNAF,UndecPhysS,6,4,10,1,0,1,0,0,0,0,0,0,0,0,0,0,0,0,7,4,11
fa14,143,WARREN,UNAF,UndecSocSc,2,3,5,0,0,0,0,0,0,1,0,1,0,0,0,0,0,0,3,3,6
fa14,143,WARREN,USP,Urb Stu&Pl,0,0,0,0,0,0,1,1,2,0,1,1,2,2,4,0,0,0,3,4,7
fa14,143,WARREN,VIS,Media,1,0,1,0,0,0,1,2,3,3,2,5,5,3,8,0,0,0,10,7,17
fa14,143,WARREN,VIS,Studio VA,0,1,1,0,0,0,0,1,1,0,3,3,0,0,0,0,0,0,0,5,5
fa14,143,WARREN,VIS,VA-CompArt,0,1,1,1,0,1,0,1,1,1,1,2,0,2,2,0,0,0,2,5,7
sp08,82,MARSHALL,ANTH,Anth-Arch,0,0,0,0,0,0,0,3,3,1,0,1,0,2,2,0,0,0,1,5,6
sp08,82,MARSHALL,ANTH,Anth-Biol,0,0,0,0,0,0,0,0,0,2,2,4,1,4,5,0,0,0,3,6,9
sp08,82,MARSHALL,ANTH,Anth-Soci,0,0,0,0,1,1,0,1,1,1,4,5,0,2,2,0,0,0,1,8,9
sp08,82,MARSHALL,ANTH,Anthropol,0,0,0,0,0,0,0,1,1,1,1,2,0,7,7,0,0,0,1,9,10
sp08,82,MARSHALL,BENG,Bioen:Binf,0,0,0,0,0,0,0,0,0,0,0,0,1,0,1,0,0,0,1,0,1
sp08,82,MARSHALL,BENG,Bioeng:PM,0,0,0,0,0,0,1,0,1,7,1,8,14,9,23,0,0,0,22,10,32
sp08,82,MARSHALL,BENG,BioengBiot,0,0,0,0,0,0,1,1,2,2,0,2,11,7,18,0,0,0,14,8,22
sp08,82,MARSHALL,BENG,Bioengin,0,0,0,0,0,0,1,2,3,0,3,3,5,5,10,0,0,0,6,10,16
sp08,82,MARSHALL,BENG,Pr-BioenPM,0,0,0,2,0,2,8,2,10,8,3,11,2,1,3,0,0,0,20,6,26
sp08,82,MARSHALL,BIOL,Anml Physl,0,0,0,0,0,0,0,0,0,0,0,0,6,10,16,0,0,0,6,10,16
sp08,82,MARSHALL,BIOL,Bioc/CellB,0,0,0,2,3,5,5,15,20,19,23,42,49,37,86,0,0,0,75,78,153
sp08,82,MARSHALL,BIOL,BiolBioinf,0,0,0,0,0,0,0,0,0,0,0,0,1,0,1,0,0,0,1,0,1
sp08,82,MARSHALL,BIOL,Ec/Beh/Evo,0,0,0,0,0,0,2,1,3,3,4,7,2,6,8,0,0,0,7,11,18
sp08,82,MARSHALL,BIOL,Genl Biol,0,0,0,1,9,10,16,22,38,26,27,53,31,44,75,0,0,0,74,102,176
sp08,82,MARSHALL,BIOL,Human Bio,0,0,0,5,19,24,24,41,65,26,40,66,51,79,130,0,0,0,106,179,285
sp08,82,MARSHALL,BIOL,Microbiol,0,0,0,0,1,1,2,2,4,1,2,3,2,3,5,0,0,0,5,8,13
sp08,82,MARSHALL,BIOL,Molec Biol,0,0,0,1,1,2,4,2,6,5,3,8,5,5,10,0,0,0,15,11,26
sp08,82,MARSHALL,BIOL,PhyslNeuro,0,0,0,2,7,9,6,12,18,6,13,19,11,9,20,0,0,0,25,41,66
sp08,82,MARSHALL,BIOL,Pr-BioBinf,0,0,0,0,0,0,0,0,0,0,0,0,1,1,2,0,0,0,1,1,2
sp08,82,MARSHALL,CENG,Chem Engin,0,0,0,0,1,1,3,2,5,4,3,7,10,5,15,0,0,0,17,11,28
sp08,82,MARSHALL,CGS,CritGendSt,0,0,0,0,1,1,0,0,0,0,1,1,0,4,4,0,0,0,0,6,6
sp08,82,MARSHALL,CHEM,Bioch/Chem,0,0,0,5,3,8,3,7,10,12,12,24,11,9,20,0,0,0,31,31,62
sp08,82,MARSHALL,CHEM,Chem Phys,0,0,0,0,0,0,0,0,0,0,0,0,0,1,1,0,0,0,0,1,1
sp08,82,MARSHALL,CHEM,Chemistry,0,0,0,1,1,2,4,7,11,5,2,7,2,4,6,0,0,0,12,14,26
sp08,82,MARSHALL,CHEM,Pharm Chem,0,0,0,1,3,4,4,10,14,9,8,17,11,12,23,0,0,0,25,33,58
sp08,82,MARSHALL,CHIN,Chinese St,0,0,0,0,1,1,0,0,0,0,0,0,1,2,3,0,0,0,1,3,4
sp08,82,MARSHALL,CLAS,Classic St,0,0,0,0,0,0,0,0,0,0,1,1,1,0,1,0,0,0,1,1,2
sp08,82,MARSHALL,COGS,Cog Sci,0,0,0,0,3,3,3,1,4,3,3,6,8,4,12,0,0,0,14,11,25
sp08,82,MARSHALL,COGS,CogSc/ClAs,0,0,0,0,0,0,0,1,1,0,0,0,0,2,2,0,0,0,0,3,3
sp08,82,MARSHALL,COGS,CogSc/Comp,0,0,0,0,0,0,0,0,0,1,0,1,0,0,0,0,0,0,1,0,1
sp08,82,MARSHALL,COGS,CogSc/HCI,0,0,0,0,0,0,0,0,0,0,1,1,5,0,5,0,0,0,5,1,6
sp08,82,MARSHALL,COGS,CogSc/HCog,0,0,0,0,0,0,0,0,0,0,0,0,1,1,2,0,0,0,1,1,2
sp08,82,MARSHALL,COGS,CogSc/Neur,0,0,0,0,0,0,0,2,2,4,3,7,6,2,8,0,0,0,10,7,17
sp08,82,MARSHALL,COMM,Communic,0,0,0,2,8,10,4,16,20,14,33,47,13,59,72,0,0,0,33,116,149
sp08,82,MARSHALL,CSE,Comp Sci,0,0,0,1,0,1,7,0,7,6,1,7,22,3,25,0,0,0,36,4,40
sp08,82,MARSHALL,CSE,CompEngCSE,0,0,0,2,0,2,5,0,5,8,0,8,6,0,6,0,0,0,21,0,21
sp08,82,MARSHALL,ECE,CompEngECE,0,0,0,0,0,0,1,0,1,0,0,0,1,0,1,0,0,0,2,0,2
sp08,82,MARSHALL,ECE,Electr Eng,0,0,0,1,0,1,6,0,6,14,5,19,19,7,26,0,0,0,40,12,52
sp08,82,MARSHALL,ECE,Engin Phys,0,0,0,0,0,0,0,0,0,0,0,0,2,0,2,0,0,0,2,0,2
sp08,82,MARSHALL,ECE,Pr-ElecEng,0,0,0,0,0,0,0,1,1,1,0,1,1,0,1,0,0,0,2,1,3
sp08,82,MARSHALL,ECON,Ec-Mth&Ecn,0,0,0,1,0,1,1,3,4,5,0,5,3,4,7,0,0,0,10,7,17
sp08,82,MARSHALL,ECON,Econ-MgtSc,0,0,0,4,2,6,15,9,24,35,28,63,51,37,88,0,0,0,105,76,181
sp08,82,MARSHALL,ECON,Economics,0,0,0,12,2,14,29,7,36,65,39,104,76,43,119,0,0,0,182,91,273
sp08,82,MARSHALL,ERTH,Earth Scis,0,0,0,0,0,0,0,0,0,0,0,0,0,1,1,0,0,0,0,1,1
sp08,82,MARSHALL,ESYS,EnvSys(EB),0,0,0,0,0,0,0,2,2,2,4,6,2,6,8,0,0,0,4,12,16
sp08,82,MARSHALL,ESYS,EnvSys(EC),0,0,0,0,0,0,0,0,0,1,0,1,1,0,1,0,0,0,2,0,2
sp08,82,MARSHALL,ESYS,EnvSys(EP),0,0,0,0,1,1,1,0,1,1,0,1,0,1,1,0,0,0,2,2,4
sp08,82,MARSHALL,ESYS,EnvSys(ES),0,0,0,0,0,0,0,0,0,1,1,2,1,1,2,0,0,0,2,2,4
sp08,82,MARSHALL,ETHN,Ethnic St,0,0,0,0,0,0,0,6,6,0,6,6,3,16,19,0,0,0,3,28,31
sp08,82,MARSHALL,GMST,German Stu,0,0,0,0,0,0,0,1,1,0,0,0,0,0,0,0,0,0,0,1,1
sp08,82,MARSHALL,HDP,Human Dev,0,0,0,0,0,0,0,1,1,1,11,12,0,30,30,0,0,0,1,42,43
sp08,82,MARSHALL,HDP,Pr-HumnDev,0,0,0,0,1,1,1,15,16,0,10,10,0,5,5,0,0,0,1,31,32
sp08,82,MARSHALL,HIST,History,0,0,0,2,0,2,3,4,7,9,12,21,15,21,36,0,0,0,29,37,66
sp08,82,MARSHALL,INTL,IntSt-Anth,0,0,0,0,0,0,0,0,0,0,5,5,0,0,0,0,0,0,0,5,5
sp08,82,MARSHALL,INTL,IntSt-Econ,0,0,0,0,4,4,1,8,9,4,5,9,6,20,26,0,0,0,11,37,48
sp08,82,MARSHALL,INTL,IntSt-Hist,0,0,0,0,0,0,0,0,0,2,3,5,1,1,2,0,0,0,3,4,7
sp08,82,MARSHALL,INTL,IntSt-Ling,0,0,0,0,0,0,3,2,5,0,2,2,1,1,2,0,0,0,4,5,9
sp08,82,MARSHALL,INTL,IntSt-PolS,0,0,0,1,1,2,4,1,5,3,6,9,5,14,19,0,0,0,13,22,35
sp08,82,MARSHALL,INTL,IntSt-Soc,0,0,0,0,0,0,0,4,4,4,8,12,0,7,7,0,0,0,4,19,23
sp08,82,MARSHALL,JAPN,JapaneseSt,0,0,0,0,0,0,0,1,1,1,0,1,0,2,2,0,0,0,1,3,4
sp08,82,MARSHALL,JUDA,Judaic Stu,0,0,0,1,0,1,0,1,1,0,0,0,0,1,1,0,0,0,1,2,3
sp08,82,MARSHALL,LATI,LatinAm St,0,0,0,0,1,1,0,2,2,1,2,3,1,2,3,0,0,0,2,7,9
sp08,82,MARSHALL,LING,Lang Stu,0,0,0,0,0,0,0,1,1,0,0,0,0,2,2,0,0,0,0,3,3
sp08,82,MARSHALL,LING,Linguistcs,0,0,0,0,1,1,0,1,1,0,1,1,2,1,3,0,0,0,2,4,6
sp08,82,MARSHALL,LIT,Lit/Compos,0,0,0,0,0,0,0,0,0,0,1,1,0,0,0,0,0,0,0,1,1
sp08,82,MARSHALL,LIT,Lit/Engl,0,0,0,0,0,0,3,2,5,0,5,5,3,8,11,0,0,0,6,15,21
sp08,82,MARSHALL,LIT,Lit/World,0,0,0,0,0,0,0,1,1,0,1,1,0,2,2,0,0,0,0,4,4
sp08,82,MARSHALL,LIT,Lit/Writng,0,0,0,0,1,1,0,0,0,0,1,1,4,3,7,0,0,0,4,5,9
sp08,82,MARSHALL,LIT,Pre-Lit/Wr,0,0,0,0,0,0,2,5,7,1,5,6,1,3,4,0,0,0,4,13,17
sp08,82,MARSHALL,LIT,Russian Lt,0,0,0,0,0,0,0,0,0,0,0,0,0,1,1,0,0,0,0,1,1
sp08,82,MARSHALL,LIT,Spanish Lt,0,0,0,0,0,0,0,0,0,0,2,2,0,5,5,0,0,0,0,7,7
sp08,82,MARSHALL,MAE,Aerosp Eng,0,0,0,0,0,0,4,2,6,8,1,9,21,0,21,0,0,0,33,3,36
sp08,82,MARSHALL,MAE,Engin Sci,0,0,0,0,0,0,1,0,1,0,0,0,1,0,1,0,0,0,2,0,2
sp08,82,MARSHALL,MAE,Envir Eng,0,0,0,1,2,3,1,0,1,0,0,0,1,0,1,0,0,0,3,2,5
sp08,82,MARSHALL,MAE,Mech Engin,0,0,0,3,2,5,18,3,21,27,2,29,52,4,56,0,0,0,100,11,111
sp08,82,MARSHALL,MATH,Appld Math,0,0,0,0,1,1,1,0,1,1,2,3,2,1,3,0,0,0,4,4,8
sp08,82,MARSHALL,MATH,Math/SecEd,0,0,0,0,0,0,1,0,1,3,1,4,2,3,5,0,0,0,6,4,10
sp08,82,MARSHALL,MATH,Mathematcs,0,0,0,1,3,4,2,2,4,3,2,5,4,0,4,0,0,0,10,7,17
sp08,82,MARSHALL,MATH,Mth-CompSc,0,0,0,0,0,0,0,0,0,0,0,0,1,0,1,0,0,0,1,0,1
sp08,82,MARSHALL,MATH,Mth-Mth&Ec,0,0,0,0,1,1,0,0,0,3,3,6,2,2,4,0,0,0,5,6,11
sp08,82,MARSHALL,MATH,Mth-SciCom,0,0,0,0,0,0,0,0,0,0,1,1,0,0,0,0,0,0,0,1,1
sp08,82,MARSHALL,MATH,Mth/ApldSc,0,0,0,0,0,0,0,1,1,0,0,0,2,0,2,0,0,0,2,1,3
sp08,82,MARSHALL,MATH,Pr-Math CS,0,0,0,0,1,1,1,0,1,1,0,1,0,1,1,0,0,0,2,2,4
sp08,82,MARSHALL,MATH,Prob&Stats,0,0,0,0,0,0,0,0,0,1,0,1,0,2,2,0,0,0,1,2,3
sp08,82,MARSHALL,MUS,Mu-CompArt,0,0,0,0,0,0,0,0,0,1,0,1,2,0,2,0,0,0,3,0,3
sp08,82,MARSHALL,MUS,Music,0,0,0,1,1,2,0,0,0,4,5,9,2,1,3,0,0,0,7,7,14
sp08,82,MARSHALL,MUS,Music Hum,0,0,0,0,0,0,0,0,0,0,2,2,0,1,1,0,0,0,0,3,3
sp08,82,MARSHALL,PHIL,Philosophy,0,0,0,1,1,2,2,0,2,0,1,1,12,5,17,0,0,0,15,7,22
sp08,82,MARSHALL,PHYS,Biophysics,0,0,0,0,0,0,0,0,0,0,0,0,0,2,2,0,0,0,0,2,2
sp08,82,MARSHALL,PHYS,Gen Physcs,0,0,0,0,0,0,0,0,0,1,1,2,1,0,1,0,0,0,2,1,3
sp08,82,MARSHALL,PHYS,Phys/Astro,0,0,0,2,1,3,0,1,1,1,0,1,1,4,5,0,0,0,4,6,10
sp08,82,MARSHALL,PHYS,Phys/Comp,0,0,0,0,0,0,0,0,0,0,0,0,1,0,1,0,0,0,1,0,1
sp08,82,MARSHALL,PHYS,Physics,0,0,0,0,0,0,3,0,3,2,0,2,4,0,4,0,0,0,9,0,9
sp08,82,MARSHALL,POLI,Polit Sci,0,0,0,2,2,4,11,12,23,18,17,35,24,25,49,0,0,0,55,56,111
sp08,82,MARSHALL,POLI,PolSc-Amer,0,0,0,0,2,2,3,1,4,5,0,5,4,6,10,0,0,0,12,9,21
sp08,82,MARSHALL,POLI,PolSc-Comp,0,0,0,0,0,0,0,0,0,0,0,0,1,1,2,0,0,0,1,1,2
sp08,82,MARSHALL,POLI,PolSc-Intl,0,0,0,1,3,4,3,7,10,10,8,18,8,17,25,0,0,0,22,35,57
sp08,82,MARSHALL,POLI,PolSc-PLaw,0,0,0,2,2,4,6,7,13,9,6,15,7,7,14,0,0,0,24,22,46
sp08,82,MARSHALL,POLI,PolSc-PPol,0,0,0,0,0,0,0,0,0,1,2,3,3,1,4,0,0,0,4,3,7
sp08,82,MARSHALL,POLI,PolSc-Thry,0,0,0,0,0,0,0,1,1,0,1,1,1,1,2,0,0,0,1,3,4
sp08,82,MARSHALL,PSYC,Psychology,0,0,0,3,18,21,13,20,33,23,60,83,36,69,105,0,0,0,75,167,242
sp08,82,MARSHALL,RELI,Relig/Stu,0,0,0,0,0,0,0,0,0,1,0,1,0,2,2,0,0,0,1,2,3
sp08,82,MARSHALL,SE,Struct Eng,0,0,0,4,1,5,3,2,5,5,4,9,24,9,33,0,0,0,36,16,52
sp08,82,MARSHALL,SOC,Sociology,0,0,0,1,3,4,0,7,7,9,30,39,8,29,37,0,0,0,18,69,87
sp08,82,MARSHALL,THEA,Dance,0,0,0,0,0,0,0,0,0,0,0,0,0,1,1,0,0,0,0,1,1
sp08,82,MARSHALL,THEA,Theatre,0,0,0,0,0,0,0,2,2,2,2,4,3,4,7,0,0,0,5,8,13
sp08,82,MARSHALL,TWS,ThirdWldSt,0,0,0,0,0,0,0,1,1,0,1,1,1,0,1,0,0,0,1,2,3
sp08,82,MARSHALL,UNAF,UndecBiolS,0,0,0,5,8,13,5,25,30,1,3,4,0,0,0,0,0,0,11,36,47
sp08,82,MARSHALL,UNAF,UndecHumAr,0,0,0,1,3,4,0,12,12,0,1,1,0,0,0,0,0,0,1,16,17
sp08,82,MARSHALL,UNAF,Undeclared,0,0,0,16,27,43,29,38,67,6,5,11,0,1,1,0,0,0,51,71,122
sp08,82,MARSHALL,UNAF,UndecPhysS,0,0,0,2,1,3,5,2,7,1,1,2,0,0,0,0,0,0,8,4,12
sp08,82,MARSHALL,UNAF,UndecSocSc,0,0,0,2,6,8,2,11,13,0,1,1,0,0,0,0,0,0,4,18,22
sp08,82,MARSHALL,USP,Urb Stu&Pl,0,0,0,0,1,1,0,2,2,3,6,9,10,11,21,0,0,0,13,20,33
sp08,82,MARSHALL,VIS,Art Hst/Cr,0,0,0,0,0,0,0,2,2,0,6,6,0,2,2,0,0,0,0,10,10
sp08,82,MARSHALL,VIS,Media,0,0,0,0,2,2,3,2,5,2,3,5,10,4,14,0,0,0,15,11,26
sp08,82,MARSHALL,VIS,Studio VA,0,0,0,0,0,0,1,0,1,1,4,5,3,6,9,0,0,0,5,10,15
sp08,82,MARSHALL,VIS,VA-CompArt,0,0,0,0,0,0,0,0,0,1,1,2,1,0,1,0,0,0,2,1,3
sp08,82,MUIR,ANTH,Anth-Arch,0,0,0,0,0,0,1,0,1,2,2,4,2,3,5,0,0,0,5,5,10
sp08,82,MUIR,ANTH,Anth-Biol,0,0,0,0,0,0,1,0,1,4,4,8,0,12,12,0,0,0,5,16,21
sp08,82,MUIR,ANTH,Anth-Soci,0,0,0,1,0,1,0,1,1,1,4,5,1,1,2,0,0,0,3,6,9
sp08,82,MUIR,ANTH,Anthropol,0,0,0,0,0,0,1,1,2,0,1,1,0,8,8,0,0,0,1,10,11
sp08,82,MUIR,BENG,Bioen:Binf,0,0,0,0,0,0,0,0,0,0,0,0,1,0,1,0,0,0,1,0,1
sp08,82,MUIR,BENG,Bioeng:PM,0,0,0,0,0,0,0,0,0,5,0,5,16,9,25,0,0,0,21,9,30
sp08,82,MUIR,BENG,BioengBiot,0,0,0,0,1,1,3,1,4,6,0,6,9,10,19,0,0,0,18,12,30
sp08,82,MUIR,BENG,Bioengin,0,0,0,1,0,1,6,3,9,4,3,7,11,5,16,0,0,0,22,11,33
sp08,82,MUIR,BENG,Pr-BioenBf,0,0,0,0,0,0,0,0,0,0,0,0,0,1,1,0,0,0,0,1,1
sp08,82,MUIR,BENG,Pr-BioenPM,0,0,0,2,2,4,8,7,15,5,3,8,1,2,3,0,0,0,16,14,30
sp08,82,MUIR,BIOL,Anml Physl,0,0,0,0,0,0,0,0,0,0,0,0,5,13,18,0,0,0,5,13,18
sp08,82,MUIR,BIOL,Bioc/CellB,0,0,0,0,4,4,11,10,21,36,27,63,37,61,98,0,0,0,84,102,186
sp08,82,MUIR,BIOL,BiolBioinf,0,0,0,0,0,0,0,0,0,0,0,0,1,0,1,0,0,0,1,0,1
sp08,82,MUIR,BIOL,Ec/Beh/Evo,0,0,0,0,0,0,3,3,6,2,11,13,3,16,19,0,0,0,8,30,38
sp08,82,MUIR,BIOL,Genl Biol,0,0,0,2,6,8,14,20,34,26,44,70,29,55,84,0,0,0,71,125,196
sp08,82,MUIR,BIOL,Human Bio,0,0,0,1,8,9,34,44,78,53,60,113,53,75,128,0,0,0,141,187,328
sp08,82,MUIR,BIOL,Microbiol,0,0,0,0,0,0,0,1,1,2,2,4,7,6,13,0,0,0,9,9,18
sp08,82,MUIR,BIOL,Molec Biol,0,0,0,1,0,1,5,5,10,7,7,14,6,13,19,0,0,0,19,25,44
sp08,82,MUIR,BIOL,PhyslNeuro,0,0,0,2,1,3,4,8,12,21,22,43,10,12,22,0,0,0,37,43,80
sp08,82,MUIR,BIOL,Pr-BioBinf,0,0,0,0,0,0,0,0,0,0,1,1,0,0,0,0,0,0,0,1,1
sp08,82,MUIR,CENG,Chem Engin,0,0,0,0,1,1,1,3,4,13,3,16,10,2,12,0,0,0,24,9,33
sp08,82,MUIR,CGS,CritGendSt,0,0,0,0,0,0,0,0,0,0,1,1,1,3,4,0,0,0,1,4,5
sp08,82,MUIR,CHEM,Bioch/Chem,0,0,0,3,3,6,11,10,21,10,14,24,28,10,38,0,0,0,52,37,89
sp08,82,MUIR,CHEM,Chem Educ,0,0,0,0,0,0,0,0,0,0,0,0,1,1,2,0,0,0,1,1,2
sp08,82,MUIR,CHEM,Chem Phys,0,0,0,0,0,0,0,0,0,1,0,1,0,1,1,0,0,0,1,1,2
sp08,82,MUIR,CHEM,Chemistry,0,0,0,0,0,0,3,4,7,9,3,12,6,8,14,0,0,0,18,15,33
sp08,82,MUIR,CHEM,MolecSynth,0,0,0,0,0,0,0,0,0,1,0,1,0,1,1,0,0,0,1,1,2
sp08,82,MUIR,CHEM,Pharm Chem,0,0,0,5,1,6,8,7,15,10,9,19,8,15,23,0,0,0,31,32,63
sp08,82,MUIR,CHEM,Pr-Bioinf,0,0,0,0,0,0,0,0,0,1,0,1,0,0,0,0,0,0,1,0,1
sp08,82,MUIR,CHIN,Chinese St,0,0,0,1,0,1,0,0,0,0,0,0,0,2,2,0,0,0,1,2,3
sp08,82,MUIR,CLAS,Classic St,0,0,0,0,0,0,0,0,0,1,1,2,1,1,2,0,0,0,2,2,4
sp08,82,MUIR,COGS,Cog Sci,0,0,0,0,2,2,5,3,8,11,12,23,12,9,21,0,0,0,28,26,54
sp08,82,MUIR,COGS,CogSc/ClAs,0,0,0,0,0,0,1,0,1,1,3,4,3,2,5,0,0,0,5,5,10
sp08,82,MUIR,COGS,CogSc/Comp,0,0,0,0,0,0,1,0,1,0,0,0,0,0,0,0,0,0,1,0,1
sp08,82,MUIR,COGS,CogSc/HCI,0,0,0,0,0,0,1,0,1,2,1,3,6,2,8,0,0,0,9,3,12
sp08,82,MUIR,COGS,CogSc/HCog,0,0,0,0,0,0,0,0,0,0,0,0,2,0,2,0,0,0,2,0,2
sp08,82,MUIR,COGS,CogSc/Neur,0,0,0,0,0,0,1,1,2,1,2,3,5,6,11,0,0,0,7,9,16
sp08,82,MUIR,COMM,Communic,0,0,0,2,4,6,2,23,25,26,55,81,19,53,72,0,0,0,49,135,184
sp08,82,MUIR,CSE,Comp Sci,0,0,0,0,2,2,9,1,10,10,2,12,33,3,36,0,0,0,52,8,60
sp08,82,MUIR,CSE,CompEngCSE,0,0,0,0,0,0,4,0,4,6,0,6,3,0,3,0,0,0,13,0,13
sp08,82,MUIR,CSE,CompScBinf,0,0,0,0,0,0,0,0,0,0,0,0,1,0,1,0,0,0,1,0,1
sp08,82,MUIR,ECE,CompEngECE,0,0,0,1,0,1,1,2,3,5,0,5,3,0,3,0,0,0,10,2,12
sp08,82,MUIR,ECE,Electr Eng,0,0,0,1,0,1,4,0,4,6,3,9,20,4,24,0,0,0,31,7,38
sp08,82,MUIR,ECE,Pr-EngPhys,0,0,0,0,0,0,0,0,0,1,1,2,0,0,0,0,0,0,1,1,2
sp08,82,MUIR,ECON,Ec-Mth&Ecn,0,0,0,0,0,0,7,3,10,3,1,4,0,1,1,0,0,0,10,5,15
sp08,82,MUIR,ECON,Econ-MgtSc,0,0,0,2,0,2,10,7,17,20,23,43,31,29,60,0,0,0,63,59,122
sp08,82,MUIR,ECON,Economics,0,0,0,5,2,7,22,14,36,51,40,91,72,36,108,0,0,0,150,92,242
sp08,82,MUIR,ERTH,Earth Scis,0,0,0,0,0,0,0,0,0,0,0,0,2,0,2,0,0,0,2,0,2
sp08,82,MUIR,ERTH,ErSc-GeoCh,0,0,0,0,0,0,0,1,1,0,0,0,0,1,1,0,0,0,0,2,2
sp08,82,MUIR,ESYS,EnvSys(EB),0,0,0,0,0,0,0,2,2,1,5,6,7,10,17,0,0,0,8,17,25
sp08,82,MUIR,ESYS,EnvSys(EC),0,0,0,0,0,0,0,0,0,0,0,0,2,1,3,0,0,0,2,1,3
sp08,82,MUIR,ESYS,EnvSys(EP),0,0,0,0,0,0,0,2,2,0,3,3,2,3,5,0,0,0,2,8,10
sp08,82,MUIR,ESYS,EnvSys(ES),0,0,0,0,0,0,1,0,1,3,0,3,0,1,1,0,0,0,4,1,5
sp08,82,MUIR,ETHN,Ethnic St,0,0,0,0,2,2,1,3,4,0,1,1,6,9,15,0,0,0,7,15,22
sp08,82,MUIR,HDP,Human Dev,0,0,0,0,0,0,0,1,1,0,7,7,1,25,26,0,0,0,1,33,34
sp08,82,MUIR,HDP,Pr-HumnDev,0,0,0,1,2,3,1,9,10,1,13,14,0,7,7,0,0,0,3,31,34
sp08,82,MUIR,HIST,History,0,0,0,2,0,2,3,1,4,11,9,20,21,17,38,0,0,0,37,27,64
sp08,82,MUIR,INTD,Muir Sp Pr,0,0,0,0,0,0,0,0,0,0,0,0,1,0,1,0,0,0,1,0,1
sp08,82,MUIR,INTL,IntSt-Anth,0,0,0,0,0,0,0,0,0,0,2,2,2,7,9,0,0,0,2,9,11
sp08,82,MUIR,INTL,IntSt-Econ,0,0,0,1,3,4,1,11,12,10,6,16,10,14,24,0,0,0,22,34,56
sp08,82,MUIR,INTL,IntSt-Hist,0,0,0,1,0,1,0,0,0,2,3,5,1,3,4,0,0,0,4,6,10
sp08,82,MUIR,INTL,IntSt-Ling,0,0,0,0,0,0,0,1,1,2,0,2,0,3,3,0,0,0,2,4,6
sp08,82,MUIR,INTL,IntSt-Lit,0,0,0,0,0,0,0,0,0,0,0,0,0,1,1,0,0,0,0,1,1
sp08,82,MUIR,INTL,IntSt-PolS,0,0,0,0,0,0,1,5,6,6,11,17,3,20,23,0,0,0,10,36,46
sp08,82,MUIR,INTL,IntSt-Soc,0,0,0,0,0,0,1,1,2,2,12,14,2,12,14,0,0,0,5,25,30
sp08,82,MUIR,JAPN,JapaneseSt,0,0,0,1,0,1,0,0,0,4,0,4,1,1,2,0,0,0,6,1,7
sp08,82,MUIR,JUDA,Judaic Stu,0,0,0,0,0,0,0,0,0,0,1,1,0,0,0,0,0,0,0,1,1
sp08,82,MUIR,LATI,LatinAm St,0,0,0,0,0,0,0,1,1,0,2,2,2,3,5,0,0,0,2,6,8
sp08,82,MUIR,LING,Lang Stu,0,0,0,0,0,0,1,1,2,0,2,2,0,2,2,0,0,0,1,5,6
sp08,82,MUIR,LING,Ling-CogLn,0,0,0,0,0,0,0,0,0,0,1,1,0,2,2,0,0,0,0,3,3
sp08,82,MUIR,LING,Ling-LSoc,0,0,0,0,0,0,0,1,1,0,0,0,0,3,3,0,0,0,0,4,4
sp08,82,MUIR,LING,Linguistcs,0,0,0,0,0,0,0,2,2,0,0,0,0,3,3,0,0,0,0,5,5
sp08,82,MUIR,LIT,Lit/Compos,0,0,0,0,0,0,0,0,0,0,1,1,1,1,2,0,0,0,1,2,3
sp08,82,MUIR,LIT,Lit/Engl,0,0,0,0,1,1,1,3,4,2,5,7,7,11,18,0,0,0,10,20,30
sp08,82,MUIR,LIT,Lit/World,0,0,0,0,0,0,1,0,1,1,3,4,2,7,9,0,0,0,4,10,14
sp08,82,MUIR,LIT,Lit/Writng,0,0,0,0,0,0,0,0,0,1,3,4,4,22,26,0,0,0,5,25,30
sp08,82,MUIR,LIT,Pre-Lit/Wr,0,0,0,0,0,0,1,9,10,8,11,19,2,3,5,0,0,0,11,23,34
sp08,82,MUIR,LIT,Spanish Lt,0,0,0,0,0,0,0,0,0,1,3,4,3,1,4,0,0,0,4,4,8
sp08,82,MUIR,MAE,Aerosp Eng,0,0,0,1,0,1,11,0,11,6,3,9,16,4,20,0,0,0,34,7,41
sp08,82,MUIR,MAE,Envir Eng,0,0,0,0,0,0,0,1,1,0,1,1,2,4,6,0,0,0,2,6,8
sp08,82,MUIR,MAE,Mech Engin,0,0,0,2,1,3,10,2,12,25,3,28,41,4,45,0,0,0,78,10,88
sp08,82,MUIR,MATH,Appld Math,0,0,0,3,0,3,3,1,4,3,0,3,4,3,7,0,0,0,13,4,17
sp08,82,MUIR,MATH,Math/SecEd,0,0,0,0,0,0,0,2,2,2,1,3,2,1,3,0,0,0,4,4,8
sp08,82,MUIR,MATH,Mathematcs,0,0,0,1,1,2,4,4,8,9,6,15,10,6,16,0,0,0,24,17,41
sp08,82,MUIR,MATH,Mth-CompSc,0,0,0,0,0,0,0,1,1,1,1,2,1,1,2,0,0,0,2,3,5
sp08,82,MUIR,MATH,Mth-Mth&Ec,0,0,0,0,0,0,1,2,3,0,2,2,5,4,9,0,0,0,6,8,14
sp08,82,MUIR,MATH,Mth-SciCom,0,0,0,0,0,0,0,1,1,0,0,0,1,0,1,0,0,0,1,1,2
sp08,82,MUIR,MATH,Mth/ApldSc,0,0,0,0,0,0,0,1,1,0,1,1,0,1,1,0,0,0,0,3,3
sp08,82,MUIR,MATH,Pr-Math CS,0,0,0,0,0,0,0,0,0,0,0,0,1,0,1,0,0,0,1,0,1
sp08,82,MUIR,MATH,Prob&Stats,0,0,0,0,0,0,0,0,0,0,0,0,1,0,1,0,0,0,1,0,1
sp08,82,MUIR,MUS,Mu-CompArt,0,0,0,0,0,0,4,1,5,2,2,4,5,2,7,0,0,0,11,5,16
sp08,82,MUIR,MUS,Music,0,0,0,1,0,1,2,2,4,2,2,4,6,4,10,0,0,0,11,8,19
sp08,82,MUIR,MUS,Music Hum,0,0,0,0,0,0,0,0,0,1,0,1,0,0,0,0,0,0,1,0,1
sp08,82,MUIR,PHIL,Philosophy,0,0,0,0,0,0,2,0,2,5,5,10,6,8,14,0,0,0,13,13,26
sp08,82,MUIR,PHYS,Biophysics,0,0,0,1,0,1,0,0,0,2,0,2,7,1,8,0,0,0,10,1,11
sp08,82,MUIR,PHYS,Gen Physcs,0,0,0,0,1,1,0,0,0,0,0,0,0,0,0,0,0,0,0,1,1
sp08,82,MUIR,PHYS,Phy/ErthSc,0,0,0,0,0,0,0,0,0,1,0,1,0,0,0,0,0,0,1,0,1
sp08,82,MUIR,PHYS,Phys/Astro,0,0,0,0,0,0,1,1,2,0,0,0,2,2,4,0,0,0,3,3,6
sp08,82,MUIR,PHYS,Physics,0,0,0,0,0,0,1,0,1,4,1,5,6,0,6,0,0,0,11,1,12
sp08,82,MUIR,POLI,Polit Sci,0,0,0,0,2,2,6,4,10,16,15,31,32,19,51,0,0,0,54,40,94
sp08,82,MUIR,POLI,PolSc-Amer,0,0,0,1,0,1,0,1,1,1,2,3,1,3,4,0,0,0,3,6,9
sp08,82,MUIR,POLI,PolSc-Comp,0,0,0,0,0,0,0,0,0,1,0,1,2,1,3,0,0,0,3,1,4
sp08,82,MUIR,POLI,PolSc-Intl,0,0,0,1,0,1,2,2,4,8,10,18,14,14,28,0,0,0,25,26,51
sp08,82,MUIR,POLI,PolSc-PLaw,0,0,0,1,1,2,4,7,11,8,3,11,5,4,9,0,0,0,18,15,33
sp08,82,MUIR,POLI,PolSc-PPol,0,0,0,0,0,0,1,0,1,0,0,0,1,0,1,0,0,0,2,0,2
sp08,82,MUIR,POLI,PolSc-Thry,0,0,0,0,0,0,0,1,1,3,0,3,0,0,0,0,0,0,3,1,4
sp08,82,MUIR,PSYC,Psychology,0,0,0,4,14,18,11,46,57,27,66,93,35,112,147,0,0,0,77,238,315
sp08,82,MUIR,RELI,Relig/Stu,0,0,0,1,0,1,2,0,2,2,1,3,0,2,2,0,0,0,5,3,8
sp08,82,MUIR,RUSS,Russ&SovSt,0,0,0,0,0,0,0,0,0,0,0,0,0,1,1,0,0,0,0,1,1
sp08,82,MUIR,SE,Engin Sci,0,0,0,0,0,0,1,0,1,1,0,1,0,0,0,0,0,0,2,0,2
sp08,82,MUIR,SE,Struct Eng,0,0,0,4,1,5,9,0,9,10,6,16,35,8,43,0,0,0,58,15,73
sp08,82,MUIR,SOC,Sociology,0,0,0,0,2,2,1,4,5,7,22,29,9,31,40,0,0,0,17,59,76
sp08,82,MUIR,THEA,Dance,0,0,0,0,0,0,0,0,0,0,1,1,0,3,3,0,0,0,0,4,4
sp08,82,MUIR,THEA,Theatre,0,0,0,0,0,0,3,4,7,4,7,11,9,9,18,0,0,0,16,20,36
sp08,82,MUIR,TWS,ThirdWldSt,0,0,0,0,0,0,0,1,1,0,0,0,0,1,1,0,0,0,0,2,2
sp08,82,MUIR,UNAF,Limited St,0,0,0,0,0,0,0,0,0,0,0,0,0,0,0,1,0,1,1,0,1
sp08,82,MUIR,UNAF,UndecBiolS,0,0,0,3,7,10,9,14,23,1,3,4,0,0,0,0,0,0,13,24,37
sp08,82,MUIR,UNAF,UndecHumAr,0,0,0,0,3,3,4,9,13,1,2,3,0,0,0,0,0,0,5,14,19
sp08,82,MUIR,UNAF,Undeclared,0,0,0,17,18,35,29,49,78,5,4,9,0,0,0,0,0,0,51,71,122
sp08,82,MUIR,UNAF,UndecPhysS,0,0,0,2,1,3,5,4,9,0,0,0,0,0,0,0,0,0,7,5,12
sp08,82,MUIR,UNAF,UndecSocSc,0,0,0,4,4,8,6,8,14,1,0,1,0,0,0,0,0,0,11,12,23
sp08,82,MUIR,USP,Urb Stu&Pl,0,0,0,0,0,0,1,1,2,4,4,8,12,4,16,0,0,0,17,9,26
sp08,82,MUIR,VIS,Art Hst/Cr,0,0,0,0,0,0,0,2,2,0,6,6,1,6,7,0,0,0,1,14,15
sp08,82,MUIR,VIS,Media,0,0,0,2,1,3,3,8,11,12,9,21,12,8,20,0,0,0,29,26,55
sp08,82,MUIR,VIS,Studio VA,0,0,0,1,0,1,0,2,2,0,4,4,2,9,11,0,0,0,3,15,18
sp08,82,MUIR,VIS,VA-CompArt,0,0,0,2,0,2,2,0,2,4,2,6,0,1,1,0,0,0,8,3,11
sp08,82,REVELLE,ANTH,Anth-Arch,0,0,0,0,0,0,0,0,0,0,1,1,0,3,3,0,0,0,0,4,4
sp08,82,REVELLE,ANTH,Anth-Biol,0,0,0,0,0,0,0,1,1,0,0,0,0,7,7,0,0,0,0,8,8
sp08,82,REVELLE,ANTH,Anth-Soci,0,0,0,1,0,1,0,2,2,2,1,3,1,0,1,0,0,0,4,3,7
sp08,82,REVELLE,ANTH,Anthropol,0,0,0,0,0,0,0,0,0,0,0,0,0,3,3,0,0,0,0,3,3
sp08,82,REVELLE,BENG,Bioen:Binf,0,0,0,0,0,0,0,0,0,0,0,0,2,0,2,0,0,0,2,0,2
sp08,82,REVELLE,BENG,Bioeng:PM,0,0,0,0,0,0,0,0,0,5,2,7,30,15,45,0,0,0,35,17,52
sp08,82,REVELLE,BENG,BioengBiot,0,0,0,1,0,1,2,3,5,3,3,6,20,5,25,0,0,0,26,11,37
sp08,82,REVELLE,BENG,Bioengin,0,0,0,2,1,3,4,5,9,6,5,11,13,9,22,0,0,0,25,20,45
sp08,82,REVELLE,BENG,Pr-BioenPM,0,0,0,7,7,14,22,10,32,10,5,15,0,2,2,0,0,0,39,24,63
sp08,82,REVELLE,BIOL,Anml Physl,0,0,0,0,0,0,0,0,0,0,0,0,8,8,16,0,0,0,8,8,16
sp08,82,REVELLE,BIOL,Bioc/CellB,0,0,0,4,6,10,19,25,44,31,42,73,83,73,156,0,0,0,137,146,283
sp08,82,REVELLE,BIOL,BiolBioinf,0,0,0,0,0,0,0,0,0,0,0,0,2,0,2,0,0,0,2,0,2
sp08,82,REVELLE,BIOL,Ec/Beh/Evo,0,0,0,0,0,0,1,0,1,3,0,3,7,6,13,0,0,0,11,6,17
sp08,82,REVELLE,BIOL,Genl Biol,0,0,0,13,13,26,12,35,47,28,41,69,35,77,112,0,0,0,88,166,254
sp08,82,REVELLE,BIOL,Human Bio,0,0,0,10,27,37,32,67,99,64,83,147,78,110,188,0,0,0,184,287,471
sp08,82,REVELLE,BIOL,Microbiol,0,0,0,2,0,2,3,1,4,7,9,16,10,12,22,0,0,0,22,22,44
sp08,82,REVELLE,BIOL,Molec Biol,0,0,0,0,2,2,8,4,12,9,6,15,17,20,37,0,0,0,34,32,66
sp08,82,REVELLE,BIOL,PhyslNeuro,0,0,0,1,5,6,13,18,31,11,15,26,11,23,34,0,0,0,36,61,97
sp08,82,REVELLE,BIOL,Pr-BioBinf,0,0,0,0,0,0,0,0,0,1,0,1,0,0,0,0,0,0,1,0,1
sp08,82,REVELLE,CENG,Chem Engin,0,0,0,1,3,4,6,5,11,9,3,12,10,9,19,0,0,0,26,20,46
sp08,82,REVELLE,CGS,CritGendSt,0,0,0,0,0,0,0,0,0,0,2,2,0,2,2,0,0,0,0,4,4
sp08,82,REVELLE,CHEM,Bioch/Chem,0,0,0,5,9,14,16,24,40,7,15,22,23,27,50,0,0,0,51,75,126
sp08,82,REVELLE,CHEM,Chem Phys,0,0,0,0,0,0,0,0,0,0,0,0,4,0,4,0,0,0,4,0,4
sp08,82,REVELLE,CHEM,Chemistry,0,0,0,3,2,5,5,5,10,9,5,14,7,10,17,0,0,0,24,22,46
sp08,82,REVELLE,CHEM,Envir Chem,0,0,0,1,0,1,0,0,0,0,0,0,0,1,1,0,0,0,1,1,2
sp08,82,REVELLE,CHEM,MolecSynth,0,0,0,0,0,0,0,0,0,1,0,1,0,1,1,0,0,0,1,1,2
sp08,82,REVELLE,CHEM,Pharm Chem,0,0,0,4,3,7,6,10,16,13,23,36,24,26,50,0,0,0,47,62,109
sp08,82,REVELLE,CHIN,Chinese St,0,0,0,0,1,1,0,0,0,0,0,0,0,2,2,0,0,0,0,3,3
sp08,82,REVELLE,CLAS,Classic St,0,0,0,0,0,0,0,0,0,0,0,0,1,0,1,0,0,0,1,0,1
sp08,82,REVELLE,COGS,Cog Sci,0,0,0,0,2,2,0,0,0,2,2,4,3,5,8,0,0,0,5,9,14
sp08,82,REVELLE,COGS,CogSc/ClAs,0,0,0,0,0,0,1,0,1,2,0,2,1,0,1,0,0,0,4,0,4
sp08,82,REVELLE,COGS,CogSc/Clin,0,0,0,0,0,0,0,1,1,0,0,0,0,0,0,0,0,0,0,1,1
sp08,82,REVELLE,COGS,CogSc/HCI,0,0,0,0,0,0,0,0,0,1,1,2,7,3,10,0,0,0,8,4,12
sp08,82,REVELLE,COGS,CogSc/HCog,0,0,0,0,0,0,0,0,0,0,0,0,0,1,1,0,0,0,0,1,1
sp08,82,REVELLE,COGS,CogSc/Neur,0,0,0,0,1,1,0,1,1,1,1,2,6,8,14,0,0,0,7,11,18
sp08,82,REVELLE,COMM,Communic,0,0,0,1,6,7,1,7,8,5,20,25,6,10,16,0,0,0,13,43,56
sp08,82,REVELLE,CSE,Comp Sci,0,0,0,4,0,4,9,1,10,11,1,12,24,1,25,0,0,0,48,3,51
sp08,82,REVELLE,CSE,CompEngCSE,0,0,0,3,1,4,5,0,5,3,1,4,3,1,4,0,0,0,14,3,17
sp08,82,REVELLE,CSE,CompScBinf,0,0,0,0,0,0,0,0,0,0,0,0,2,0,2,0,0,0,2,0,2
sp08,82,REVELLE,ECE,CompEngECE,0,0,0,0,0,0,2,0,2,0,0,0,2,0,2,0,0,0,4,0,4
sp08,82,REVELLE,ECE,Electr Eng,0,0,0,1,0,1,2,0,2,10,1,11,33,3,36,0,0,0,46,4,50
sp08,82,REVELLE,ECE,Engin Phys,0,0,0,0,0,0,1,0,1,0,0,0,1,0,1,0,0,0,2,0,2
sp08,82,REVELLE,ECE,Pr-EngPhys,0,0,0,0,0,0,1,0,1,1,0,1,0,0,0,0,0,0,2,0,2
sp08,82,REVELLE,ECON,Ec-Mth&Ecn,0,0,0,0,1,1,3,1,4,2,1,3,3,2,5,0,0,0,8,5,13
sp08,82,REVELLE,ECON,Econ-MgtSc,0,0,0,1,1,2,8,6,14,17,20,37,36,29,65,0,0,0,62,56,118
sp08,82,REVELLE,ECON,Economics,0,0,0,3,2,5,12,2,14,30,13,43,36,28,64,0,0,0,81,45,126
sp08,82,REVELLE,ERTH,ErSc-Geol,0,0,0,0,0,0,0,0,0,0,0,0,0,1,1,0,0,0,0,1,1
sp08,82,REVELLE,ERTH,ErSc-GeoPh,0,0,0,0,0,0,0,0,0,0,0,0,1,0,1,0,0,0,1,0,1
sp08,82,REVELLE,ERTH,ErthSc-Chm,0,0,0,0,0,0,0,0,0,0,0,0,0,1,1,0,0,0,0,1,1
sp08,82,REVELLE,ERTH,ErthSc-Phy,0,0,0,0,0,0,0,0,0,0,0,0,1,0,1,0,0,0,1,0,1
sp08,82,REVELLE,ESYS,EnvSys(EB),0,0,0,1,0,1,0,1,1,2,3,5,1,4,5,0,0,0,4,8,12
sp08,82,REVELLE,ESYS,EnvSys(EC),0,0,0,0,0,0,0,0,0,0,0,0,0,1,1,0,0,0,0,1,1
sp08,82,REVELLE,ESYS,EnvSys(EP),0,0,0,0,0,0,0,1,1,0,0,0,1,3,4,0,0,0,1,4,5
sp08,82,REVELLE,ESYS,EnvSys(ES),0,0,0,0,0,0,0,0,0,0,1,1,3,0,3,0,0,0,3,1,4
sp08,82,REVELLE,ETHN,Ethnic St,0,0,0,0,0,0,0,0,0,0,0,0,0,3,3,0,0,0,0,3,3
sp08,82,REVELLE,HDP,Human Dev,0,0,0,0,0,0,0,0,0,0,0,0,2,14,16,0,0,0,2,14,16
sp08,82,REVELLE,HDP,Pr-HumnDev,0,0,0,0,1,1,1,9,10,0,9,9,0,5,5,0,0,0,1,24,25
sp08,82,REVELLE,HIST,History,0,0,0,0,0,0,4,2,6,4,8,12,14,5,19,0,0,0,22,15,37
sp08,82,REVELLE,INTL,IntSt-Anth,0,0,0,0,0,0,0,0,0,0,0,0,1,1,2,0,0,0,1,1,2
sp08,82,REVELLE,INTL,IntSt-Econ,0,0,0,0,2,2,0,0,0,3,3,6,6,5,11,0,0,0,9,10,19
sp08,82,REVELLE,INTL,IntSt-Hist,0,0,0,0,0,0,0,0,0,0,1,1,0,3,3,0,0,0,0,4,4
sp08,82,REVELLE,INTL,IntSt-Ling,0,0,0,0,0,0,0,1,1,0,1,1,0,1,1,0,0,0,0,3,3
sp08,82,REVELLE,INTL,IntSt-Lit,0,0,0,0,0,0,0,0,0,0,1,1,0,2,2,0,0,0,0,3,3
sp08,82,REVELLE,INTL,IntSt-PolS,0,0,0,0,0,0,1,3,4,1,5,6,2,11,13,0,0,0,4,19,23
sp08,82,REVELLE,INTL,IntSt-Soc,0,0,0,0,1,1,0,1,1,1,3,4,0,1,1,0,0,0,1,6,7
sp08,82,REVELLE,ITAL,Italian St,0,0,0,0,0,0,0,0,0,0,0,0,0,1,1,0,0,0,0,1,1
sp08,82,REVELLE,JAPN,JapaneseSt,0,0,0,0,1,1,1,0,1,0,0,0,2,0,2,0,0,0,3,1,4
sp08,82,REVELLE,LING,Lang Stu,0,0,0,0,0,0,0,1,1,0,1,1,0,1,1,0,0,0,0,3,3
sp08,82,REVELLE,LING,Ling-CogLn,0,0,0,0,0,0,0,0,0,1,1,2,0,0,0,0,0,0,1,1,2
sp08,82,REVELLE,LING,Ling-LSoc,0,0,0,0,0,0,0,1,1,0,0,0,0,0,0,0,0,0,0,1,1
sp08,82,REVELLE,LING,Linguistcs,0,0,0,0,0,0,0,0,0,2,0,2,2,1,3,0,0,0,4,1,5
sp08,82,REVELLE,LIT,Ital Lit,0,0,0,0,0,0,0,0,0,0,1,1,0,0,0,0,0,0,0,1,1
sp08,82,REVELLE,LIT,Lit/Compos,0,0,0,0,0,0,1,1,2,0,0,0,0,0,0,0,0,0,1,1,2
sp08,82,REVELLE,LIT,Lit/CultSt,0,0,0,0,0,0,0,0,0,0,1,1,0,0,0,0,0,0,0,1,1
sp08,82,REVELLE,LIT,Lit/Engl,0,0,0,1,1,2,1,0,1,0,8,8,3,10,13,0,0,0,5,19,24
sp08,82,REVELLE,LIT,Lit/World,0,0,0,0,0,0,0,0,0,0,1,1,0,3,3,0,0,0,0,4,4
sp08,82,REVELLE,LIT,Lit/Writng,0,0,0,0,0,0,0,0,0,0,1,1,5,6,11,0,0,0,5,7,12
sp08,82,REVELLE,LIT,Pre-Lit/Wr,0,0,0,1,0,1,3,2,5,0,4,4,3,0,3,0,0,0,7,6,13
sp08,82,REVELLE,LIT,Spanish Lt,0,0,0,0,1,1,0,1,1,0,1,1,0,2,2,0,0,0,0,5,5
sp08,82,REVELLE,MAE,Aerosp Eng,0,0,0,2,0,2,6,2,8,9,3,12,30,7,37,0,0,0,47,12,59
sp08,82,REVELLE,MAE,Engin Sci,0,0,0,0,0,0,1,0,1,0,0,0,0,0,0,0,0,0,1,0,1
sp08,82,REVELLE,MAE,Envir Eng,0,0,0,0,0,0,0,0,0,1,1,2,0,1,1,0,0,0,1,2,3
sp08,82,REVELLE,MAE,Mech Engin,0,0,0,3,1,4,11,1,12,19,4,23,54,10,64,0,0,0,87,16,103
sp08,82,REVELLE,MATH,Appld Math,0,0,0,0,0,0,1,0,1,3,2,5,2,2,4,0,0,0,6,4,10
sp08,82,REVELLE,MATH,Math/SecEd,0,0,0,0,0,0,0,2,2,0,1,1,1,3,4,0,0,0,1,6,7
sp08,82,REVELLE,MATH,Mathematcs,0,0,0,0,4,4,9,6,15,5,5,10,10,4,14,0,0,0,24,19,43
sp08,82,REVELLE,MATH,Mth-CompSc,0,0,0,0,0,0,0,0,0,0,0,0,7,0,7,0,0,0,7,0,7
sp08,82,REVELLE,MATH,Mth-Mth&Ec,0,0,0,0,1,1,2,0,2,2,2,4,4,3,7,0,0,0,8,6,14
sp08,82,REVELLE,MATH,Mth-SciCom,0,0,0,0,0,0,0,0,0,0,1,1,1,0,1,0,0,0,1,1,2
sp08,82,REVELLE,MATH,Mth/ApldSc,0,0,0,0,1,1,1,0,1,0,2,2,0,1,1,0,0,0,1,4,5
sp08,82,REVELLE,MUS,Mu-CompArt,0,0,0,0,0,0,1,0,1,0,0,0,5,0,5,0,0,0,6,0,6
sp08,82,REVELLE,MUS,Music,0,0,0,0,0,0,0,1,1,1,0,1,2,1,3,0,0,0,3,2,5
sp08,82,REVELLE,MUS,Music Hum,0,0,0,0,0,0,0,0,0,1,0,1,0,0,0,0,0,0,1,0,1
sp08,82,REVELLE,PHIL,Philosophy,0,0,0,0,0,0,2,1,3,0,0,0,2,3,5,0,0,0,4,4,8
sp08,82,REVELLE,PHYS,Biophysics,0,0,0,0,0,0,0,0,0,1,1,2,1,1,2,0,0,0,2,2,4
sp08,82,REVELLE,PHYS,Phys/Astro,0,0,0,1,0,1,0,1,1,2,2,4,4,2,6,0,0,0,7,5,12
sp08,82,REVELLE,PHYS,Phys/Comp,0,0,0,0,0,0,0,0,0,0,0,0,1,0,1,0,0,0,1,0,1
sp08,82,REVELLE,PHYS,Phys/Mtrls,0,0,0,0,0,0,0,0,0,0,0,0,2,0,2,0,0,0,2,0,2
sp08,82,REVELLE,PHYS,Physics,0,0,0,0,1,1,3,1,4,2,1,3,10,1,11,0,0,0,15,4,19
sp08,82,REVELLE,POLI,Polit Sci,0,0,0,0,0,0,3,3,6,7,4,11,10,13,23,0,0,0,20,20,40
sp08,82,REVELLE,POLI,PolSc-Amer,0,0,0,0,0,0,0,1,1,0,2,2,2,2,4,0,0,0,2,5,7
sp08,82,REVELLE,POLI,PolSc-Comp,0,0,0,0,0,0,0,0,0,0,0,0,1,0,1,0,0,0,1,0,1
sp08,82,REVELLE,POLI,PolSc-Intl,0,0,0,0,1,1,0,2,2,4,3,7,7,4,11,0,0,0,11,10,21
sp08,82,REVELLE,POLI,PolSc-PLaw,0,0,0,1,1,2,1,0,1,1,3,4,3,1,4,0,0,0,6,5,11
sp08,82,REVELLE,POLI,PolSc-PPol,0,0,0,0,0,0,0,1,1,1,0,1,0,0,0,0,0,0,1,1,2
sp08,82,REVELLE,POLI,PolSc-Thry,0,0,0,0,0,0,0,0,0,0,1,1,0,0,0,0,0,0,0,1,1
sp08,82,REVELLE,PSYC,Psychology,0,0,0,2,11,13,6,23,29,20,47,67,30,96,126,0,0,0,58,177,235
sp08,82,REVELLE,SE,Engin Sci,0,0,0,0,0,0,0,0,0,0,0,0,1,0,1,0,0,0,1,0,1
sp08,82,REVELLE,SE,Struct Eng,0,0,0,1,1,2,7,4,11,13,4,17,21,6,27,0,0,0,42,15,57
sp08,82,REVELLE,SIO,ErSc-Geol,0,0,0,0,0,0,0,0,0,1,1,2,0,0,0,0,0,0,1,1,2
sp08,82,REVELLE,SOC,Sociology,0,0,0,0,0,0,2,1,3,1,2,3,0,7,7,0,0,0,3,10,13
sp08,82,REVELLE,THEA,Dance,0,0,0,0,0,0,0,0,0,1,0,1,0,0,0,0,0,0,1,0,1
sp08,82,REVELLE,THEA,Theatre,0,0,0,0,0,0,1,1,2,2,5,7,1,2,3,0,0,0,4,8,12
sp08,82,REVELLE,UNAF,Limited St,0,0,0,0,0,0,0,0,0,0,0,0,0,0,0,5,12,17,5,12,17
sp08,82,REVELLE,UNAF,Spec-Emply,0,0,0,0,0,0,0,0,0,0,0,0,0,0,0,1,2,3,1,2,3
sp08,82,REVELLE,UNAF,UndecBiolS,0,0,0,6,8,14,19,25,44,3,3,6,0,0,0,0,0,0,28,36,64
sp08,82,REVELLE,UNAF,UndecHumAr,0,0,0,0,4,4,2,7,9,0,0,0,0,0,0,0,0,0,2,11,13
sp08,82,REVELLE,UNAF,Undeclared,0,0,0,11,19,30,23,27,50,6,1,7,1,0,1,0,0,0,41,47,88
sp08,82,REVELLE,UNAF,UndecPhysS,0,0,0,3,2,5,7,5,12,1,0,1,0,0,0,0,0,0,11,7,18
sp08,82,REVELLE,UNAF,UndecSocSc,0,0,0,2,2,4,4,8,12,0,0,0,0,0,0,0,0,0,6,10,16
sp08,82,REVELLE,USP,Urb Stu&Pl,0,0,0,0,2,2,1,0,1,2,1,3,5,3,8,0,0,0,8,6,14
sp08,82,REVELLE,VIS,Art Hst/Cr,0,0,0,0,0,0,0,1,1,0,0,0,1,7,8,0,0,0,1,8,9
sp08,82,REVELLE,VIS,Media,0,0,0,0,0,0,2,1,3,2,3,5,4,3,7,0,0,0,8,7,15
sp08,82,REVELLE,VIS,Studio VA,0,0,0,0,0,0,0,0,0,0,0,0,2,4,6,0,0,0,2,4,6
sp08,82,REVELLE,VIS,VA-CompArt,0,0,0,0,0,0,0,0,0,0,1,1,1,2,3,0,0,0,1,3,4
sp08,82,ROOSEVELT,ANTH,Anth-Arch,0,0,0,0,0,0,2,1,3,1,5,6,0,3,3,0,0,0,3,9,12
sp08,82,ROOSEVELT,ANTH,Anth-Biol,0,0,0,0,0,0,0,1,1,0,3,3,4,8,12,0,0,0,4,12,16
sp08,82,ROOSEVELT,ANTH,Anth-Soci,0,0,0,0,0,0,0,0,0,0,4,4,0,0,0,0,0,0,0,4,4
sp08,82,ROOSEVELT,ANTH,Anthropol,0,0,0,0,0,0,0,1,1,0,1,1,2,5,7,0,0,0,2,7,9
sp08,82,ROOSEVELT,BENG,Bioeng:PM,0,0,0,0,0,0,0,0,0,2,2,4,5,5,10,0,0,0,7,7,14
sp08,82,ROOSEVELT,BENG,BioengBiot,0,0,0,1,0,1,0,0,0,0,1,1,4,3,7,0,0,0,5,4,9
sp08,82,ROOSEVELT,BENG,Bioengin,0,0,0,0,0,0,2,0,2,1,1,2,5,1,6,0,0,0,8,2,10
sp08,82,ROOSEVELT,BENG,Pr-BioenPM,0,0,0,2,3,5,8,3,11,4,3,7,2,0,2,0,0,0,16,9,25
sp08,82,ROOSEVELT,BIOL,Anml Physl,0,0,0,0,0,0,0,0,0,0,0,0,4,7,11,0,0,0,4,7,11
sp08,82,ROOSEVELT,BIOL,Bioc/CellB,0,0,0,1,7,8,7,9,16,9,18,27,27,41,68,0,0,0,44,75,119
sp08,82,ROOSEVELT,BIOL,BiolBioinf,0,0,0,0,0,0,0,0,0,0,0,0,1,0,1,0,0,0,1,0,1
sp08,82,ROOSEVELT,BIOL,Ec/Beh/Evo,0,0,0,1,0,1,0,4,4,1,1,2,5,7,12,0,0,0,7,12,19
sp08,82,ROOSEVELT,BIOL,Genl Biol,0,0,0,0,4,4,9,14,23,12,20,32,25,39,64,0,0,0,46,77,123
sp08,82,ROOSEVELT,BIOL,Human Bio,0,0,0,4,11,15,13,29,42,15,46,61,26,46,72,0,0,0,58,132,190
sp08,82,ROOSEVELT,BIOL,Microbiol,0,0,0,0,0,0,1,1,2,1,3,4,2,6,8,0,0,0,4,10,14
sp08,82,ROOSEVELT,BIOL,Molec Biol,0,0,0,0,0,0,2,4,6,3,4,7,7,7,14,0,0,0,12,15,27
sp08,82,ROOSEVELT,BIOL,PhyslNeuro,0,0,0,0,2,2,1,4,5,6,11,17,11,13,24,0,0,0,18,30,48
sp08,82,ROOSEVELT,CENG,Chem Engin,0,0,0,0,1,1,1,4,5,2,1,3,2,6,8,0,0,0,5,12,17
sp08,82,ROOSEVELT,CGS,CritGendSt,0,0,0,0,0,0,0,0,0,0,0,0,0,1,1,0,0,0,0,1,1
sp08,82,ROOSEVELT,CHEM,Bioch/Chem,0,0,0,1,4,5,3,4,7,2,7,9,5,7,12,0,0,0,11,22,33
sp08,82,ROOSEVELT,CHEM,Chem Phys,0,0,0,0,0,0,0,0,0,0,0,0,1,0,1,0,0,0,1,0,1
sp08,82,ROOSEVELT,CHEM,Chemistry,0,0,0,1,1,2,3,0,3,1,4,5,3,1,4,0,0,0,8,6,14
sp08,82,ROOSEVELT,CHEM,Chm/ErthSc,0,0,0,0,1,1,0,0,0,0,0,0,0,0,0,0,0,0,0,1,1
sp08,82,ROOSEVELT,CHEM,Envir Chem,0,0,0,0,0,0,0,0,0,0,0,0,1,0,1,0,0,0,1,0,1
sp08,82,ROOSEVELT,CHEM,MolecSynth,0,0,0,0,0,0,0,0,0,1,0,1,0,0,0,0,0,0,1,0,1
sp08,82,ROOSEVELT,CHEM,Pharm Chem,0,0,0,0,1,1,0,3,3,3,3,6,15,7,22,0,0,0,18,14,32
sp08,82,ROOSEVELT,CHIN,Chinese St,0,0,0,0,0,0,0,0,0,2,1,3,3,3,6,0,0,0,5,4,9
sp08,82,ROOSEVELT,CLAS,Classic St,0,0,0,0,0,0,0,1,1,0,0,0,1,0,1,0,0,0,1,1,2
sp08,82,ROOSEVELT,COGS,Cog Sci,0,0,0,0,2,2,1,5,6,3,3,6,4,9,13,0,0,0,8,19,27
sp08,82,ROOSEVELT,COGS,CogSc/ClAs,0,0,0,0,0,0,0,0,0,0,0,0,0,1,1,0,0,0,0,1,1
sp08,82,ROOSEVELT,COGS,CogSc/Comp,0,0,0,0,0,0,0,0,0,0,0,0,1,1,2,0,0,0,1,1,2
sp08,82,ROOSEVELT,COGS,CogSc/HCI,0,0,0,0,0,0,1,0,1,0,2,2,2,0,2,0,0,0,3,2,5
sp08,82,ROOSEVELT,COGS,CogSc/HCog,0,0,0,0,0,0,0,0,0,0,1,1,1,1,2,0,0,0,1,2,3
sp08,82,ROOSEVELT,COGS,CogSc/Neur,0,0,0,0,0,0,0,3,3,0,2,2,7,5,12,0,0,0,7,10,17
sp08,82,ROOSEVELT,COMM,Communic,0,0,0,1,3,4,5,34,39,7,37,44,20,58,78,0,0,0,33,132,165
sp08,82,ROOSEVELT,CSE,Comp Sci,0,0,0,1,0,1,5,1,6,4,1,5,23,2,25,0,0,0,33,4,37
sp08,82,ROOSEVELT,CSE,CompEngCSE,0,0,0,0,0,0,2,0,2,4,0,4,4,3,7,0,0,0,10,3,13
sp08,82,ROOSEVELT,ECE,CompEngECE,0,0,0,1,0,1,0,0,0,0,0,0,0,1,1,0,0,0,1,1,2
sp08,82,ROOSEVELT,ECE,Electr Eng,0,0,0,1,0,1,2,2,4,13,2,15,21,3,24,0,0,0,37,7,44
sp08,82,ROOSEVELT,ECON,Ec-Mth&Ecn,0,0,0,1,0,1,1,3,4,3,1,4,3,2,5,0,0,0,8,6,14
sp08,82,ROOSEVELT,ECON,Econ-MgtSc,0,0,0,3,0,3,9,12,21,26,17,43,41,35,76,0,0,0,79,64,143
sp08,82,ROOSEVELT,ECON,Economics,0,0,0,1,5,6,18,12,30,46,30,76,47,44,91,0,0,0,112,91,203
sp08,82,ROOSEVELT,ERTH,Earth Scis,0,0,0,0,0,0,0,0,0,0,0,0,1,0,1,0,0,0,1,0,1
sp08,82,ROOSEVELT,ERTH,ErSc-Geol,0,0,0,0,0,0,0,1,1,0,0,0,1,0,1,0,0,0,1,1,2
sp08,82,ROOSEVELT,ERTH,ErthSc-Phy,0,0,0,0,0,0,0,0,0,0,1,1,0,0,0,0,0,0,0,1,1
sp08,82,ROOSEVELT,ESYS,EnvSys(EB),0,0,0,0,0,0,0,1,1,1,0,1,3,9,12,0,0,0,4,10,14
sp08,82,ROOSEVELT,ESYS,EnvSys(EC),0,0,0,0,0,0,0,0,0,0,3,3,2,0,2,0,0,0,2,3,5
sp08,82,ROOSEVELT,ESYS,EnvSys(EP),0,0,0,0,0,0,0,0,0,0,1,1,0,1,1,0,0,0,0,2,2
sp08,82,ROOSEVELT,ESYS,EnvSys(ES),0,0,0,0,0,0,0,0,0,0,0,0,2,1,3,0,0,0,2,1,3
sp08,82,ROOSEVELT,ETHN,Ethnic St,0,0,0,0,0,0,0,4,4,1,4,5,3,6,9,0,0,0,4,14,18
sp08,82,ROOSEVELT,GMST,German Stu,0,0,0,0,1,1,0,0,0,0,0,0,1,0,1,0,0,0,1,1,2
sp08,82,ROOSEVELT,HDP,Human Dev,0,0,0,0,0,0,0,2,2,0,7,7,2,20,22,0,0,0,2,29,31
sp08,82,ROOSEVELT,HDP,Pr-HumnDev,0,0,0,0,2,2,1,4,5,2,6,8,1,3,4,0,0,0,4,15,19
sp08,82,ROOSEVELT,HIST,History,0,0,0,0,1,1,4,9,13,11,17,28,21,30,51,0,0,0,36,57,93
sp08,82,ROOSEVELT,INTL,IntSt-Anth,0,0,0,0,0,0,1,0,1,0,5,5,1,8,9,0,0,0,2,13,15
sp08,82,ROOSEVELT,INTL,IntSt-Econ,0,0,0,2,6,8,11,16,27,9,30,39,11,23,34,0,0,0,33,75,108
sp08,82,ROOSEVELT,INTL,IntSt-Hist,0,0,0,1,0,1,1,3,4,1,6,7,2,13,15,0,0,0,5,22,27
sp08,82,ROOSEVELT,INTL,IntSt-Ling,0,0,0,0,0,0,1,3,4,1,7,8,0,4,4,0,0,0,2,14,16
sp08,82,ROOSEVELT,INTL,IntSt-Lit,0,0,0,0,2,2,0,2,2,0,4,4,0,2,2,0,0,0,0,10,10
sp08,82,ROOSEVELT,INTL,IntSt-PolS,0,0,0,2,6,8,1,16,17,12,30,42,15,33,48,0,0,0,30,85,115
sp08,82,ROOSEVELT,INTL,IntSt-Soc,0,0,0,0,0,0,0,10,10,2,19,21,4,18,22,0,0,0,6,47,53
sp08,82,ROOSEVELT,JAPN,JapaneseSt,0,0,0,0,1,1,0,0,0,2,1,3,1,3,4,0,0,0,3,5,8
sp08,82,ROOSEVELT,JUDA,Judaic Stu,0,0,0,0,0,0,0,1,1,0,0,0,0,0,0,0,0,0,0,1,1
sp08,82,ROOSEVELT,LATI,LatinAm St,0,0,0,0,0,0,0,0,0,1,1,2,0,2,2,0,0,0,1,3,4
sp08,82,ROOSEVELT,LING,Lang Stu,0,0,0,0,2,2,0,1,1,0,0,0,3,0,3,0,0,0,3,3,6
sp08,82,ROOSEVELT,LING,Ling-LSoc,0,0,0,0,0,0,1,2,3,1,0,1,2,2,4,0,0,0,4,4,8
sp08,82,ROOSEVELT,LING,Linguistcs,0,0,0,0,0,0,0,2,2,1,4,5,0,4,4,0,0,0,1,10,11
sp08,82,ROOSEVELT,LIT,French Lit,0,0,0,0,0,0,0,0,0,0,1,1,0,0,0,0,0,0,0,1,1
sp08,82,ROOSEVELT,LIT,Lit/Compos,0,0,0,0,0,0,1,1,2,0,0,0,0,0,0,0,0,0,1,1,2
sp08,82,ROOSEVELT,LIT,Lit/CultSt,0,0,0,0,0,0,0,0,0,0,0,0,0,1,1,0,0,0,0,1,1
sp08,82,ROOSEVELT,LIT,Lit/Engl,0,0,0,0,1,1,1,3,4,1,3,4,1,11,12,0,0,0,3,18,21
sp08,82,ROOSEVELT,LIT,Lit/World,0,0,0,0,0,0,0,1,1,0,2,2,1,4,5,0,0,0,1,7,8
sp08,82,ROOSEVELT,LIT,Lit/Writng,0,0,0,0,0,0,0,0,0,0,1,1,6,10,16,0,0,0,6,11,17
sp08,82,ROOSEVELT,LIT,Pre-Lit/Wr,0,0,0,0,0,0,1,6,7,2,6,8,5,3,8,0,0,0,8,15,23
sp08,82,ROOSEVELT,LIT,Spanish Lt,0,0,0,0,1,1,0,0,0,1,2,3,2,6,8,0,0,0,3,9,12
sp08,82,ROOSEVELT,MAE,Aerosp Eng,0,0,0,2,1,3,5,0,5,3,1,4,11,4,15,0,0,0,21,6,27
sp08,82,ROOSEVELT,MAE,Engin Sci,0,0,0,0,0,0,0,0,0,0,0,0,1,0,1,0,0,0,1,0,1
sp08,82,ROOSEVELT,MAE,Envir Eng,0,0,0,0,0,0,0,2,2,0,0,0,0,0,0,0,0,0,0,2,2
sp08,82,ROOSEVELT,MAE,Mech Engin,0,0,0,1,0,1,4,1,5,4,6,10,30,8,38,0,0,0,39,15,54
sp08,82,ROOSEVELT,MATH,Appld Math,0,0,0,0,1,1,1,1,2,1,0,1,1,2,3,0,0,0,3,4,7
sp08,82,ROOSEVELT,MATH,Math/SecEd,0,0,0,0,1,1,0,0,0,0,3,3,0,0,0,0,0,0,0,4,4
sp08,82,ROOSEVELT,MATH,Mathematcs,0,0,0,1,1,2,2,0,2,5,5,10,7,0,7,0,0,0,15,6,21
sp08,82,ROOSEVELT,MATH,Mth-CompSc,0,0,0,0,0,0,0,0,0,0,1,1,1,0,1,0,0,0,1,1,2
sp08,82,ROOSEVELT,MATH,Mth-Mth&Ec,0,0,0,1,1,2,1,0,1,2,2,4,4,4,8,0,0,0,8,7,15
sp08,82,ROOSEVELT,MATH,Mth-SciCom,0,0,0,0,1,1,0,0,0,0,0,0,0,0,0,0,0,0,0,1,1
sp08,82,ROOSEVELT,MATH,Mth/ApldSc,0,0,0,0,0,0,0,0,0,0,0,0,2,0,2,0,0,0,2,0,2
sp08,82,ROOSEVELT,MATH,Pr-Math CS,0,0,0,0,0,0,0,0,0,0,1,1,0,0,0,0,0,0,0,1,1
sp08,82,ROOSEVELT,MUS,Mu-CompArt,0,0,0,0,0,0,4,0,4,0,0,0,6,0,6,0,0,0,10,0,10
sp08,82,ROOSEVELT,MUS,Music,0,0,0,0,0,0,0,1,1,1,0,1,1,3,4,0,0,0,2,4,6
sp08,82,ROOSEVELT,PHIL,Philosophy,0,0,0,1,1,2,0,1,1,3,3,6,4,2,6,0,0,0,8,7,15
sp08,82,ROOSEVELT,PHYS,Biophysics,0,0,0,0,0,0,0,0,0,0,1,1,1,0,1,0,0,0,1,1,2
sp08,82,ROOSEVELT,PHYS,Phys/Astro,0,0,0,0,0,0,1,0,1,1,1,2,2,0,2,0,0,0,4,1,5
sp08,82,ROOSEVELT,PHYS,Phys/Comp,0,0,0,0,0,0,0,0,0,0,1,1,1,0,1,0,0,0,1,1,2
sp08,82,ROOSEVELT,PHYS,Physics,0,0,0,0,0,0,1,1,2,2,0,2,1,0,1,0,0,0,4,1,5
sp08,82,ROOSEVELT,POLI,Polit Sci,0,0,0,3,4,7,3,11,14,21,17,38,22,29,51,0,0,0,49,61,110
sp08,82,ROOSEVELT,POLI,PolSc-Amer,0,0,0,0,1,1,1,0,1,1,3,4,2,6,8,0,0,0,4,10,14
sp08,82,ROOSEVELT,POLI,PolSc-Comp,0,0,0,0,0,0,1,0,1,1,1,2,2,2,4,0,0,0,4,3,7
sp08,82,ROOSEVELT,POLI,PolSc-Intl,0,0,0,0,5,5,5,20,25,12,25,37,17,19,36,0,0,0,34,69,103
sp08,82,ROOSEVELT,POLI,PolSc-PLaw,0,0,0,2,2,4,3,9,12,5,11,16,4,7,11,0,0,0,14,29,43
sp08,82,ROOSEVELT,POLI,PolSc-PPol,0,0,0,0,0,0,0,0,0,0,2,2,2,0,2,0,0,0,2,2,4
sp08,82,ROOSEVELT,POLI,PolSc-Thry,0,0,0,0,0,0,0,0,0,0,0,0,2,1,3,0,0,0,2,1,3
sp08,82,ROOSEVELT,PSYC,Psychology,0,1,1,7,11,18,9,32,41,12,38,50,22,74,96,0,0,0,50,156,206
sp08,82,ROOSEVELT,RELI,Relig/Stu,0,0,0,0,0,0,0,0,0,1,0,1,0,0,0,0,0,0,1,0,1
sp08,82,ROOSEVELT,RUSS,Russ&SovSt,0,0,0,0,0,0,0,0,0,0,1,1,0,0,0,0,0,0,0,1,1
sp08,82,ROOSEVELT,SE,Struct Eng,0,0,0,4,0,4,4,2,6,8,3,11,17,10,27,0,0,0,33,15,48
sp08,82,ROOSEVELT,SOC,Sociology,0,0,0,0,2,2,2,6,8,3,20,23,6,24,30,0,0,0,11,52,63
sp08,82,ROOSEVELT,THEA,Dance,0,0,0,0,0,0,1,0,1,0,1,1,0,1,1,0,0,0,1,2,3
sp08,82,ROOSEVELT,THEA,Theatre,0,0,0,0,0,0,1,1,2,1,5,6,3,7,10,0,0,0,5,13,18
sp08,82,ROOSEVELT,TWS,ThirdWldSt,0,0,0,0,0,0,1,1,2,0,1,1,1,1,2,0,0,0,2,3,5
sp08,82,ROOSEVELT,UNAF,UndecBiolS,0,0,0,1,4,5,5,15,20,1,3,4,0,0,0,0,0,0,7,22,29
sp08,82,ROOSEVELT,UNAF,UndecHumAr,0,0,0,0,7,7,2,11,13,0,4,4,0,0,0,0,0,0,2,22,24
sp08,82,ROOSEVELT,UNAF,Undeclared,0,0,0,12,22,34,28,42,70,5,2,7,0,0,0,0,0,0,45,66,111
sp08,82,ROOSEVELT,UNAF,UndecPhysS,0,0,0,1,1,2,3,2,5,1,0,1,0,0,0,0,0,0,5,3,8
sp08,82,ROOSEVELT,UNAF,UndecSocSc,0,0,0,3,4,7,8,12,20,0,0,0,0,0,0,0,0,0,11,16,27
sp08,82,ROOSEVELT,USP,Urb Stu&Pl,0,0,0,1,0,1,0,2,2,4,3,7,3,7,10,0,0,0,8,12,20
sp08,82,ROOSEVELT,VIS,Art Hst/Cr,0,0,0,0,0,0,0,4,4,2,9,11,0,6,6,0,0,0,2,19,21
sp08,82,ROOSEVELT,VIS,Media,0,0,0,0,3,3,4,5,9,5,5,10,6,7,13,0,0,0,15,20,35
sp08,82,ROOSEVELT,VIS,Studio VA,0,0,0,0,0,0,1,6,7,0,0,0,2,2,4,0,0,0,3,8,11
sp08,82,ROOSEVELT,VIS,VA-CompArt,0,0,0,1,0,1,0,0,0,1,0,1,1,1,2,0,0,0,3,1,4
sp08,82,SIXTH,ANTH,Anth-Arch,0,0,0,0,0,0,0,0,0,1,2,3,0,1,1,0,0,0,1,3,4
sp08,82,SIXTH,ANTH,Anth-Biol,0,0,0,0,2,2,0,1,1,1,2,3,1,4,5,0,0,0,2,9,11
sp08,82,SIXTH,ANTH,Anth-Soci,0,0,0,0,1,1,0,0,0,1,1,2,1,0,1,0,0,0,2,2,4
sp08,82,SIXTH,ANTH,Anthropol,0,0,0,0,0,0,1,0,1,1,3,4,0,3,3,0,0,0,2,6,8
sp08,82,SIXTH,BENG,Bioen:Binf,0,0,0,0,0,0,0,0,0,0,1,1,2,0,2,0,0,0,2,1,3
sp08,82,SIXTH,BENG,Bioeng:PM,0,0,0,0,0,0,0,0,0,1,1,2,6,3,9,0,0,0,7,4,11
sp08,82,SIXTH,BENG,BioengBiot,0,0,0,0,0,0,3,2,5,0,1,1,11,4,15,0,0,0,14,7,21
sp08,82,SIXTH,BENG,Bioengin,0,0,0,1,0,1,3,1,4,4,1,5,8,4,12,0,0,0,16,6,22
sp08,82,SIXTH,BENG,Pr-BioenPM,0,0,0,1,1,2,13,5,18,9,3,12,2,1,3,0,0,0,25,10,35
sp08,82,SIXTH,BIOL,Anml Physl,0,0,0,0,0,0,0,0,0,0,0,0,6,1,7,0,0,0,6,1,7
sp08,82,SIXTH,BIOL,Bioc/CellB,0,0,0,4,4,8,8,6,14,12,18,30,20,22,42,0,0,0,44,50,94
sp08,82,SIXTH,BIOL,BiolBioinf,0,0,0,0,0,0,0,0,0,0,0,0,1,1,2,0,0,0,1,1,2
sp08,82,SIXTH,BIOL,Ec/Beh/Evo,0,0,0,0,1,1,0,1,1,1,4,5,3,3,6,0,0,0,4,9,13
sp08,82,SIXTH,BIOL,Genl Biol,0,0,0,4,6,10,13,18,31,16,15,31,12,22,34,0,0,0,45,61,106
sp08,82,SIXTH,BIOL,Human Bio,0,0,0,6,11,17,16,18,34,24,36,60,25,26,51,0,0,0,71,91,162
sp08,82,SIXTH,BIOL,Microbiol,0,0,0,0,2,2,1,1,2,1,2,3,2,2,4,0,0,0,4,7,11
sp08,82,SIXTH,BIOL,Molec Biol,0,0,0,1,0,1,4,2,6,5,2,7,4,3,7,0,0,0,14,7,21
sp08,82,SIXTH,BIOL,PhyslNeuro,0,0,0,3,1,4,3,5,8,10,6,16,4,3,7,0,0,0,20,15,35
sp08,82,SIXTH,CENG,Chem Engin,0,0,0,3,0,3,5,1,6,3,4,7,5,1,6,0,0,0,16,6,22
sp08,82,SIXTH,CGS,CritGendSt,0,0,0,0,0,0,0,0,0,0,0,0,0,1,1,0,0,0,0,1,1
sp08,82,SIXTH,CHEM,Bioch/Chem,0,0,0,1,2,3,3,8,11,6,6,12,8,6,14,0,0,0,18,22,40
sp08,82,SIXTH,CHEM,Chem Educ,0,0,0,1,0,1,0,0,0,0,0,0,1,0,1,0,0,0,2,0,2
sp08,82,SIXTH,CHEM,Chemistry,0,0,0,1,2,3,6,5,11,3,3,6,6,3,9,0,0,0,16,13,29
sp08,82,SIXTH,CHEM,Envir Chem,0,0,0,0,0,0,0,0,0,1,0,1,0,1,1,0,0,0,1,1,2
sp08,82,SIXTH,CHEM,MolecSynth,0,0,0,0,0,0,0,0,0,1,0,1,1,0,1,0,0,0,2,0,2
sp08,82,SIXTH,CHEM,Pharm Chem,0,0,0,3,5,8,2,7,9,5,8,13,8,10,18,0,0,0,18,30,48
sp08,82,SIXTH,CHIN,Chinese St,0,0,0,0,0,0,1,0,1,0,0,0,0,1,1,0,0,0,1,1,2
sp08,82,SIXTH,CLAS,Classic St,0,0,0,0,0,0,1,0,1,0,0,0,0,0,0,0,0,0,1,0,1
sp08,82,SIXTH,COGS,Cog Sci,0,0,0,2,1,3,5,2,7,9,6,15,7,3,10,0,0,0,23,12,35
sp08,82,SIXTH,COGS,CogSc/ClAs,0,0,0,0,0,0,0,0,0,0,0,0,1,2,3,0,0,0,1,2,3
sp08,82,SIXTH,COGS,CogSc/Comp,0,0,0,0,0,0,1,0,1,0,0,0,2,0,2,0,0,0,3,0,3
sp08,82,SIXTH,COGS,CogSc/HCI,0,0,0,0,0,0,2,1,3,0,0,0,6,2,8,0,0,0,8,3,11
sp08,82,SIXTH,COGS,CogSc/HCog,0,0,0,0,0,0,0,0,0,0,0,0,1,1,2,0,0,0,1,1,2
sp08,82,SIXTH,COGS,CogSc/Neur,0,0,0,0,1,1,0,0,0,0,1,1,4,2,6,0,0,0,4,4,8
sp08,82,SIXTH,COMM,Communic,0,0,0,1,7,8,6,15,21,15,31,46,15,31,46,0,0,0,37,84,121
sp08,82,SIXTH,CSE,Comp Sci,0,0,0,7,1,8,12,4,16,19,5,24,26,7,33,0,0,0,64,17,81
sp08,82,SIXTH,CSE,CompEngCSE,0,0,0,8,1,9,9,1,10,10,0,10,13,2,15,0,0,0,40,4,44
sp08,82,SIXTH,CSE,CompScBinf,0,0,0,0,0,0,0,0,0,0,0,0,0,1,1,0,0,0,0,1,1
sp08,82,SIXTH,ECE,CompEngECE,0,0,0,4,0,4,6,0,6,2,1,3,4,0,4,0,0,0,16,1,17
sp08,82,SIXTH,ECE,Electr Eng,0,0,0,2,0,2,12,2,14,16,2,18,24,3,27,0,0,0,54,7,61
sp08,82,SIXTH,ECE,Engin Phys,0,0,0,0,0,0,0,0,0,1,0,1,2,0,2,0,0,0,3,0,3
sp08,82,SIXTH,ECE,Pr-ElecEng,0,0,0,0,0,0,0,0,0,1,0,1,0,0,0,0,0,0,1,0,1
sp08,82,SIXTH,ECE,Pr-EngPhys,0,0,0,0,0,0,0,0,0,3,1,4,1,0,1,0,0,0,4,1,5
sp08,82,SIXTH,ECON,Ec-Mth&Ecn,0,0,0,1,0,1,1,1,2,5,1,6,5,1,6,0,0,0,12,3,15
sp08,82,SIXTH,ECON,Econ-MgtSc,0,0,0,4,1,5,17,9,26,37,12,49,31,19,50,0,0,0,89,41,130
sp08,82,SIXTH,ECON,Economics,0,0,0,7,3,10,15,7,22,43,25,68,37,19,56,0,0,0,102,54,156
sp08,82,SIXTH,ERTH,ErSc-Geol,0,0,0,0,0,0,0,0,0,0,0,0,1,0,1,0,0,0,1,0,1
sp08,82,SIXTH,ERTH,ErSc-GeoPh,0,0,0,0,0,0,0,1,1,0,0,0,0,0,0,0,0,0,0,1,1
sp08,82,SIXTH,ESYS,EnvSys(EB),0,0,0,0,1,1,1,4,5,2,4,6,1,4,5,0,0,0,4,13,17
sp08,82,SIXTH,ESYS,EnvSys(EC),0,0,0,0,0,0,0,0,0,0,0,0,1,0,1,0,0,0,1,0,1
sp08,82,SIXTH,ESYS,EnvSys(EP),0,0,0,1,0,1,0,1,1,0,1,1,2,1,3,0,0,0,3,3,6
sp08,82,SIXTH,ESYS,EnvSys(ES),0,0,0,0,0,0,1,1,2,0,1,1,0,1,1,0,0,0,1,3,4
sp08,82,SIXTH,ETHN,Ethnic St,0,0,0,0,0,0,1,1,2,2,2,4,1,4,5,0,0,0,4,7,11
sp08,82,SIXTH,HDP,Human Dev,0,0,0,0,0,0,0,0,0,0,2,2,0,11,11,0,0,0,0,13,13
sp08,82,SIXTH,HDP,Pr-HumnDev,0,0,0,0,2,2,1,8,9,2,4,6,0,0,0,0,0,0,3,14,17
sp08,82,SIXTH,HIST,History,0,0,0,1,0,1,1,2,3,4,2,6,8,1,9,0,0,0,14,5,19
sp08,82,SIXTH,INTL,IntSt-Anth,0,0,0,0,0,0,0,0,0,1,0,1,2,1,3,0,0,0,3,1,4
sp08,82,SIXTH,INTL,IntSt-Econ,0,0,0,1,2,3,5,6,11,6,9,15,4,11,15,0,0,0,16,28,44
sp08,82,SIXTH,INTL,IntSt-Hist,0,0,0,0,0,0,0,2,2,0,0,0,1,0,1,0,0,0,1,2,3
sp08,82,SIXTH,INTL,IntSt-Ling,0,0,0,1,0,1,1,0,1,2,0,2,0,2,2,0,0,0,4,2,6
sp08,82,SIXTH,INTL,IntSt-Lit,0,0,0,0,1,1,0,0,0,0,1,1,0,1,1,0,0,0,0,3,3
sp08,82,SIXTH,INTL,IntSt-PolS,0,0,0,0,3,3,2,5,7,3,4,7,2,7,9,0,0,0,7,19,26
sp08,82,SIXTH,INTL,IntSt-Soc,0,0,0,0,0,0,0,0,0,2,3,5,1,3,4,0,0,0,3,6,9
sp08,82,SIXTH,JAPN,JapaneseSt,0,0,0,0,0,0,0,1,1,1,0,1,2,0,2,0,0,0,3,1,4
sp08,82,SIXTH,LING,Ling-CogLn,0,0,0,0,0,0,0,1,1,0,0,0,0,1,1,0,0,0,0,2,2
sp08,82,SIXTH,LING,Ling-LSoc,0,0,0,0,0,0,0,0,0,1,1,2,0,0,0,0,0,0,1,1,2
sp08,82,SIXTH,LING,Linguistcs,0,0,0,0,1,1,0,0,0,0,1,1,1,5,6,0,0,0,1,7,8
sp08,82,SIXTH,LIT,Lit/Compos,0,0,0,0,0,0,0,0,0,0,1,1,0,0,0,0,0,0,0,1,1
sp08,82,SIXTH,LIT,Lit/Engl,0,0,0,1,0,1,1,3,4,2,1,3,0,1,1,0,0,0,4,5,9
sp08,82,SIXTH,LIT,Lit/World,0,0,0,0,0,0,0,0,0,2,0,2,0,0,0,0,0,0,2,0,2
sp08,82,SIXTH,LIT,Lit/Writng,0,0,0,0,0,0,0,0,0,0,1,1,0,12,12,0,0,0,0,13,13
sp08,82,SIXTH,LIT,Pre-Lit/Wr,0,0,0,0,1,1,0,7,7,4,4,8,2,2,4,0,0,0,6,14,20
sp08,82,SIXTH,LIT,Spanish Lt,0,0,0,0,0,0,0,0,0,1,0,1,0,1,1,0,0,0,1,1,2
sp08,82,SIXTH,MAE,Aerosp Eng,0,0,0,4,1,5,13,0,13,12,2,14,21,4,25,0,0,0,50,7,57
sp08,82,SIXTH,MAE,Engin Sci,0,0,0,0,0,0,0,1,1,0,0,0,0,0,0,0,0,0,0,1,1
sp08,82,SIXTH,MAE,Envir Eng,0,0,0,1,0,1,1,0,1,1,2,3,1,2,3,0,0,0,4,4,8
sp08,82,SIXTH,MAE,Mech Engin,0,0,0,9,0,9,19,5,24,25,5,30,52,4,56,0,0,0,105,14,119
sp08,82,SIXTH,MATH,Appld Math,0,0,0,3,0,3,0,0,0,1,2,3,2,0,2,0,0,0,6,2,8
sp08,82,SIXTH,MATH,Math/SecEd,0,0,0,2,0,2,0,2,2,1,0,1,0,2,2,0,0,0,3,4,7
sp08,82,SIXTH,MATH,Mathematcs,0,0,0,1,4,5,1,4,5,3,1,4,5,1,6,0,0,0,10,10,20
sp08,82,SIXTH,MATH,Mth-Mth&Ec,0,0,0,0,0,0,2,1,3,1,3,4,1,0,1,0,0,0,4,4,8
sp08,82,SIXTH,MATH,Mth-SciCom,0,0,0,0,0,0,0,0,0,1,0,1,0,0,0,0,0,0,1,0,1
sp08,82,SIXTH,MATH,Mth/ApldSc,0,0,0,0,0,0,0,0,0,0,0,0,1,0,1,0,0,0,1,0,1
sp08,82,SIXTH,MATH,Pr-Math CS,0,0,0,0,0,0,1,0,1,1,0,1,0,0,0,0,0,0,2,0,2
sp08,82,SIXTH,MATH,Prob&Stats,0,0,0,0,0,0,0,0,0,1,0,1,0,0,0,0,0,0,1,0,1
sp08,82,SIXTH,MUS,Mu-CompArt,0,0,0,1,0,1,4,1,5,4,3,7,5,1,6,0,0,0,14,5,19
sp08,82,SIXTH,MUS,Music,0,0,0,0,0,0,1,0,1,3,1,4,4,5,9,0,0,0,8,6,14
sp08,82,SIXTH,MUS,Music Hum,0,0,0,0,0,0,0,0,0,0,1,1,0,0,0,0,0,0,0,1,1
sp08,82,SIXTH,PHIL,Philosophy,0,1,1,2,0,2,1,1,2,1,0,1,4,3,7,0,0,0,8,5,13
sp08,82,SIXTH,PHYS,Biophysics,0,0,0,0,0,0,1,1,2,2,1,3,1,1,2,0,0,0,4,3,7
sp08,82,SIXTH,PHYS,Phy/ErthSc,0,0,0,0,0,0,0,0,0,0,0,0,1,0,1,0,0,0,1,0,1
sp08,82,SIXTH,PHYS,Phys/Astro,0,0,0,3,0,3,2,0,2,0,0,0,2,1,3,0,0,0,7,1,8
sp08,82,SIXTH,PHYS,Phys/Mtrls,0,0,0,0,0,0,1,0,1,0,0,0,2,0,2,0,0,0,3,0,3
sp08,82,SIXTH,PHYS,Physics,0,0,0,2,0,2,2,0,2,5,0,5,8,2,10,0,0,0,17,2,19
sp08,82,SIXTH,POLI,Polit Sci,0,0,0,1,3,4,4,1,5,8,10,18,3,7,10,0,0,0,16,21,37
sp08,82,SIXTH,POLI,PolSc-Amer,0,0,0,1,0,1,2,1,3,2,1,3,0,1,1,0,0,0,5,3,8
sp08,82,SIXTH,POLI,PolSc-Comp,0,0,0,0,0,0,0,0,0,0,0,0,0,1,1,0,0,0,0,1,1
sp08,82,SIXTH,POLI,PolSc-Intl,0,0,0,0,2,2,7,5,12,11,5,16,3,8,11,0,0,0,21,20,41
sp08,82,SIXTH,POLI,PolSc-PLaw,0,0,0,1,0,1,1,6,7,1,6,7,3,1,4,0,0,0,6,13,19
sp08,82,SIXTH,POLI,PolSc-PPol,0,0,0,1,0,1,1,0,1,0,1,1,0,0,0,0,0,0,2,1,3
sp08,82,SIXTH,POLI,PolSc-Thry,0,0,0,0,0,0,0,0,0,0,1,1,0,0,0,0,0,0,0,1,1
sp08,82,SIXTH,PSYC,Psychology,0,0,0,3,10,13,5,20,25,17,25,42,16,34,50,0,0,0,41,89,130
sp08,82,SIXTH,RELI,Relig/Stu,0,0,0,0,0,0,0,0,0,0,0,0,1,0,1,0,0,0,1,0,1
sp08,82,SIXTH,SE,Engin Sci,0,0,0,0,0,0,1,0,1,1,0,1,0,0,0,0,0,0,2,0,2
sp08,82,SIXTH,SE,Struct Eng,0,0,0,5,0,5,8,6,14,12,4,16,22,10,32,0,0,0,47,20,67
sp08,82,SIXTH,SIO,ErSc-Geol,0,0,0,0,0,0,1,0,1,0,0,0,0,0,0,0,0,0,1,0,1
sp08,82,SIXTH,SOC,Sociology,0,0,0,1,3,4,0,6,6,7,13,20,3,11,14,0,0,0,11,33,44
sp08,82,SIXTH,THEA,Dance,0,0,0,0,0,0,0,0,0,0,2,2,1,5,6,0,0,0,1,7,8
sp08,82,SIXTH,THEA,Theatre,0,0,0,1,0,1,1,1,2,1,6,7,3,9,12,0,0,0,6,16,22
sp08,82,SIXTH,TWS,ThirdWldSt,0,0,0,0,0,0,0,2,2,0,0,0,0,1,1,0,0,0,0,3,3
sp08,82,SIXTH,UNAF,UndecBiolS,0,0,0,2,5,7,7,10,17,0,1,1,0,0,0,0,0,0,9,16,25
sp08,82,SIXTH,UNAF,UndecHumAr,0,0,0,6,0,6,1,5,6,0,0,0,0,0,0,0,0,0,7,5,12
sp08,82,SIXTH,UNAF,Undeclared,0,0,0,18,17,35,25,26,51,8,4,12,0,0,0,0,0,0,51,47,98
sp08,82,SIXTH,UNAF,UndecPhysS,0,0,0,5,2,7,4,2,6,0,0,0,0,0,0,0,0,0,9,4,13
sp08,82,SIXTH,UNAF,UndecSocSc,0,0,0,0,5,5,4,5,9,0,0,0,0,0,0,0,0,0,4,10,14
sp08,82,SIXTH,USP,Urb Stu&Pl,0,0,0,0,1,1,2,1,3,2,4,6,3,5,8,0,0,0,7,11,18
sp08,82,SIXTH,VIS,Art Hst/Cr,0,0,0,0,0,0,0,4,4,0,4,4,2,9,11,0,0,0,2,17,19
sp08,82,SIXTH,VIS,Media,0,0,0,3,1,4,7,8,15,12,13,25,25,11,36,0,0,0,47,33,80
sp08,82,SIXTH,VIS,Studio VA,0,0,0,1,0,1,0,1,1,1,3,4,3,8,11,0,0,0,5,12,17
sp08,82,SIXTH,VIS,VA-CompArt,0,0,0,0,1,1,6,4,10,4,3,7,6,5,11,0,0,0,16,13,29
sp08,82,WARREN,ANTH,Anth-Arch,0,0,0,0,0,0,0,0,0,1,2,3,2,4,6,0,0,0,3,6,9
sp08,82,WARREN,ANTH,Anth-Biol,0,0,0,0,0,0,1,1,2,0,4,4,1,5,6,0,0,0,2,10,12
sp08,82,WARREN,ANTH,Anth-Soci,0,0,0,0,0,0,0,1,1,0,0,0,0,0,0,0,0,0,0,1,1
sp08,82,WARREN,ANTH,Anthropol,0,0,0,0,0,0,0,0,0,0,0,0,2,6,8,0,0,0,2,6,8
sp08,82,WARREN,BENG,Bioen:Binf,0,0,0,0,0,0,0,0,0,0,0,0,3,1,4,0,0,0,3,1,4
sp08,82,WARREN,BENG,Bioeng:PM,0,0,0,0,0,0,0,1,1,9,5,14,18,10,28,0,0,0,27,16,43
sp08,82,WARREN,BENG,BioengBiot,0,0,0,0,1,1,7,4,11,15,3,18,25,16,41,0,0,0,47,24,71
sp08,82,WARREN,BENG,Bioengin,0,0,0,1,0,1,4,2,6,10,10,20,15,8,23,0,0,0,30,20,50
sp08,82,WARREN,BENG,Pr-BioenBf,0,0,0,0,0,0,0,0,0,1,0,1,0,0,0,0,0,0,1,0,1
sp08,82,WARREN,BENG,Pr-BioenPM,0,0,0,3,2,5,16,10,26,16,6,22,3,1,4,0,0,0,38,19,57
sp08,82,WARREN,BIOL,Anml Physl,0,0,0,0,0,0,0,0,0,0,0,0,5,7,12,0,0,0,5,7,12
sp08,82,WARREN,BIOL,Bioc/CellB,0,0,0,0,3,3,9,14,23,28,29,57,56,70,126,0,0,0,93,116,209
sp08,82,WARREN,BIOL,BiolBioinf,0,0,0,0,0,0,0,0,0,1,0,1,0,0,0,0,0,0,1,0,1
sp08,82,WARREN,BIOL,Ec/Beh/Evo,0,0,0,0,1,1,1,4,5,1,5,6,2,3,5,0,0,0,4,13,17
sp08,82,WARREN,BIOL,Genl Biol,0,0,0,0,6,6,10,14,24,21,24,45,47,74,121,0,0,0,78,118,196
sp08,82,WARREN,BIOL,Human Bio,0,1,1,4,17,21,26,33,59,26,53,79,70,87,157,0,0,0,126,191,317
sp08,82,WARREN,BIOL,Microbiol,0,0,0,0,0,0,2,3,5,2,4,6,10,9,19,0,0,0,14,16,30
sp08,82,WARREN,BIOL,Molec Biol,0,0,0,0,1,1,2,4,6,10,6,16,8,9,17,0,0,0,20,20,40
sp08,82,WARREN,BIOL,PhyslNeuro,0,0,0,0,6,6,3,5,8,8,10,18,15,13,28,0,0,0,26,34,60
sp08,82,WARREN,BIOL,Pr-BioBinf,0,0,0,0,0,0,0,0,0,0,1,1,0,0,0,0,0,0,0,1,1
sp08,82,WARREN,BIOL,Pr-BiochCB,0,0,0,0,0,0,0,0,0,0,0,0,1,0,1,0,0,0,1,0,1
sp08,82,WARREN,CENG,Chem Engin,0,0,0,2,0,2,6,6,12,11,7,18,18,6,24,0,0,0,37,19,56
sp08,82,WARREN,CGS,CritGendSt,0,0,0,0,0,0,0,0,0,0,2,2,0,0,0,0,0,0,0,2,2
sp08,82,WARREN,CHEM,Bioch/Chem,0,0,0,3,3,6,10,6,16,12,16,28,16,27,43,0,0,0,41,52,93
sp08,82,WARREN,CHEM,Chem Educ,0,0,0,0,0,0,0,0,0,0,0,0,0,1,1,0,0,0,0,1,1
sp08,82,WARREN,CHEM,Chem Phys,0,0,0,0,0,0,1,0,1,0,0,0,0,1,1,0,0,0,1,1,2
sp08,82,WARREN,CHEM,Chemistry,0,0,0,1,1,2,4,4,8,5,4,9,8,5,13,0,0,0,18,14,32
sp08,82,WARREN,CHEM,Envir Chem,0,0,0,0,0,0,1,0,1,1,0,1,0,0,0,0,0,0,2,0,2
sp08,82,WARREN,CHEM,MolecSynth,0,0,0,0,0,0,0,0,0,1,0,1,1,0,1,0,0,0,2,0,2
sp08,82,WARREN,CHEM,Pharm Chem,0,0,0,2,6,8,3,13,16,12,9,21,17,33,50,0,0,0,34,61,95
sp08,82,WARREN,CHIN,Chinese St,0,0,0,0,0,0,0,0,0,0,4,4,1,5,6,0,0,0,1,9,10
sp08,82,WARREN,COGS,Cog Sci,0,0,0,0,2,2,1,5,6,6,5,11,3,6,9,0,0,0,10,18,28
sp08,82,WARREN,COGS,CogSc/ClAs,0,0,0,0,0,0,0,1,1,0,0,0,0,0,0,0,0,0,0,1,1
sp08,82,WARREN,COGS,CogSc/HCI,0,0,0,0,0,0,0,0,0,1,1,2,4,1,5,0,0,0,5,2,7
sp08,82,WARREN,COGS,CogSc/HCog,0,0,0,0,1,1,0,0,0,0,0,0,1,2,3,0,0,0,1,3,4
sp08,82,WARREN,COGS,CogSc/Neur,0,0,0,0,0,0,0,0,0,1,2,3,4,3,7,0,0,0,5,5,10
sp08,82,WARREN,COMM,Communic,0,1,1,0,4,4,4,18,22,11,29,40,17,43,60,0,0,0,32,95,127
sp08,82,WARREN,CSE,Comp Sci,0,0,0,4,1,5,21,2,23,23,6,29,47,8,55,0,0,0,95,17,112
sp08,82,WARREN,CSE,CompEngCSE,1,0,1,2,1,3,10,5,15,6,1,7,13,3,16,0,0,0,32,10,42
sp08,82,WARREN,CSE,CompScBinf,0,0,0,0,0,0,0,0,0,0,0,0,4,0,4,0,0,0,4,0,4
sp08,82,WARREN,ECE,CompEngECE,0,0,0,5,0,5,3,0,3,3,0,3,6,2,8,0,0,0,17,2,19
sp08,82,WARREN,ECE,Electr Eng,0,0,0,2,0,2,14,2,16,43,6,49,72,7,79,0,0,0,131,15,146
sp08,82,WARREN,ECE,Engin Phys,0,0,0,0,0,0,0,0,0,0,0,0,3,0,3,0,0,0,3,0,3
sp08,82,WARREN,ECE,Pr-ElecEng,0,0,0,0,0,0,0,0,0,0,0,0,1,0,1,0,0,0,1,0,1
sp08,82,WARREN,ECE,Pr-EngPhys,0,0,0,1,0,1,0,0,0,1,1,2,1,0,1,0,0,0,3,1,4
sp08,82,WARREN,ECON,Ec-Mth&Ecn,0,0,0,1,0,1,3,2,5,9,6,15,3,0,3,0,0,0,16,8,24
sp08,82,WARREN,ECON,Econ-MgtSc,0,0,0,3,2,5,12,5,17,26,24,50,48,36,84,0,0,0,89,67,156
sp08,82,WARREN,ECON,Economics,1,0,1,4,3,7,19,10,29,55,37,92,75,27,102,0,0,0,154,77,231
sp08,82,WARREN,ERTH,ErSc-Geol,0,0,0,0,0,0,0,0,0,0,0,0,1,0,1,0,0,0,1,0,1
sp08,82,WARREN,ESYS,EnvSys(EB),0,0,0,0,0,0,0,1,1,0,3,3,1,2,3,0,0,0,1,6,7
sp08,82,WARREN,ESYS,EnvSys(EC),0,0,0,0,0,0,0,0,0,0,1,1,0,2,2,0,0,0,0,3,3
sp08,82,WARREN,ESYS,EnvSys(EP),0,0,0,0,0,0,0,0,0,0,1,1,0,1,1,0,0,0,0,2,2
sp08,82,WARREN,ESYS,EnvSys(ES),0,0,0,0,1,1,0,0,0,2,1,3,1,4,5,0,0,0,3,6,9
sp08,82,WARREN,ETHN,Ethnic St,0,0,0,0,1,1,0,0,0,0,1,1,2,2,4,0,0,0,2,4,6
sp08,82,WARREN,GMST,German Stu,0,0,0,0,0,0,0,0,0,0,0,0,1,0,1,0,0,0,1,0,1
sp08,82,WARREN,HDP,Human Dev,0,0,0,0,0,0,0,1,1,0,7,7,2,17,19,0,0,0,2,25,27
sp08,82,WARREN,HDP,Pr-HumnDev,0,0,0,0,0,0,0,1,1,5,10,15,1,3,4,0,0,0,6,14,20
sp08,82,WARREN,HIST,History,0,0,0,2,0,2,6,6,12,8,11,19,17,23,40,0,0,0,33,40,73
sp08,82,WARREN,INTD,Wa Ind St,0,0,0,0,0,0,0,0,0,0,0,0,1,3,4,0,0,0,1,3,4
sp08,82,WARREN,INTL,IntSt-Anth,0,0,0,0,1,1,0,1,1,0,0,0,1,0,1,0,0,0,1,2,3
sp08,82,WARREN,INTL,IntSt-Econ,0,0,0,1,1,2,2,1,3,6,10,16,5,7,12,0,0,0,14,19,33
sp08,82,WARREN,INTL,IntSt-Hist,0,0,0,0,0,0,1,0,1,1,1,2,2,3,5,0,0,0,4,4,8
sp08,82,WARREN,INTL,IntSt-Ling,0,0,0,0,0,0,0,0,0,0,1,1,2,0,2,0,0,0,2,1,3
sp08,82,WARREN,INTL,IntSt-PolS,0,0,0,0,1,1,2,3,5,1,6,7,5,13,18,0,0,0,8,23,31
sp08,82,WARREN,INTL,IntSt-Soc,0,0,0,0,0,0,1,2,3,0,4,4,1,4,5,0,0,0,2,10,12
sp08,82,WARREN,ITAL,Italian St,0,0,0,0,0,0,0,0,0,1,0,1,0,1,1,0,0,0,1,1,2
sp08,82,WARREN,JAPN,JapaneseSt,0,0,0,0,0,0,0,0,0,1,1,2,2,1,3,0,0,0,3,2,5
sp08,82,WARREN,LING,Lang Stu,0,0,0,0,0,0,0,1,1,0,1,1,0,1,1,0,0,0,0,3,3
sp08,82,WARREN,LING,Ling-CogLn,0,0,0,0,1,1,0,0,0,0,0,0,0,0,0,0,0,0,0,1,1
sp08,82,WARREN,LING,Ling-LSoc,0,0,0,0,0,0,0,0,0,0,0,0,0,1,1,0,0,0,0,1,1
sp08,82,WARREN,LING,Linguistcs,0,0,0,0,0,0,1,0,1,1,0,1,0,0,0,0,0,0,2,0,2
sp08,82,WARREN,LIT,German Lit,0,0,0,0,0,0,0,0,0,0,0,0,0,1,1,0,0,0,0,1,1
sp08,82,WARREN,LIT,Lit/Engl,0,0,0,0,0,0,1,3,4,2,2,4,0,8,8,0,0,0,3,13,16
sp08,82,WARREN,LIT,Lit/World,0,0,0,0,0,0,0,0,0,0,2,2,2,2,4,0,0,0,2,4,6
sp08,82,WARREN,LIT,Lit/Writng,0,0,0,0,0,0,0,0,0,0,1,1,3,4,7,0,0,0,3,5,8
sp08,82,WARREN,LIT,Pre-Lit/Wr,0,0,0,0,1,1,1,5,6,1,4,5,0,1,1,0,0,0,2,11,13
sp08,82,WARREN,LIT,Spanish Lt,0,0,0,0,0,0,0,1,1,1,1,2,4,5,9,0,0,0,5,7,12
sp08,82,WARREN,MAE,Aerosp Eng,0,0,0,2,1,3,11,2,13,20,3,23,52,5,57,0,0,0,85,11,96
sp08,82,WARREN,MAE,Engin Sci,0,0,0,0,0,0,0,1,1,1,0,1,1,0,1,0,0,0,2,1,3
sp08,82,WARREN,MAE,Envir Eng,0,0,0,0,0,0,0,0,0,1,2,3,3,1,4,0,0,0,4,3,7
sp08,82,WARREN,MAE,Mech Engin,0,0,0,9,3,12,26,4,30,28,5,33,112,12,124,0,0,0,175,24,199
sp08,82,WARREN,MATH,Appld Math,0,0,0,2,0,2,2,4,6,2,2,4,2,4,6,0,0,0,8,10,18
sp08,82,WARREN,MATH,Math/SecEd,0,0,0,0,0,0,0,0,0,1,0,1,0,3,3,0,0,0,1,3,4
sp08,82,WARREN,MATH,Mathematcs,0,0,0,2,1,3,1,3,4,8,1,9,11,7,18,0,0,0,22,12,34
sp08,82,WARREN,MATH,Mth-CompSc,0,0,0,0,0,0,0,0,0,3,1,4,4,1,5,0,0,0,7,2,9
sp08,82,WARREN,MATH,Mth-Mth&Ec,0,0,0,0,0,0,2,1,3,2,1,3,5,4,9,0,0,0,9,6,15
sp08,82,WARREN,MATH,Mth-SciCom,0,0,0,1,0,1,0,0,0,2,1,3,1,2,3,0,0,0,4,3,7
sp08,82,WARREN,MATH,Mth/ApldSc,0,0,0,0,2,2,0,0,0,1,0,1,1,1,2,0,0,0,2,3,5
sp08,82,WARREN,MATH,Pr-Math CS,0,0,0,0,0,0,0,0,0,1,0,1,0,0,0,0,0,0,1,0,1
sp08,82,WARREN,MATH,Prob&Stats,0,0,0,0,0,0,1,0,1,1,0,1,3,0,3,0,0,0,5,0,5
sp08,82,WARREN,MUS,Mu-CompArt,0,0,0,1,0,1,2,0,2,4,2,6,3,3,6,0,0,0,10,5,15
sp08,82,WARREN,MUS,Music,0,0,0,0,0,0,0,0,0,5,1,6,8,1,9,0,0,0,13,2,15
sp08,82,WARREN,MUS,Music Hum,0,0,0,0,0,0,0,0,0,0,1,1,0,0,0,0,0,0,0,1,1
sp08,82,WARREN,PHIL,Philosophy,0,0,0,0,1,1,3,0,3,6,4,10,8,7,15,0,0,0,17,12,29
sp08,82,WARREN,PHYS,Biophysics,0,0,0,0,0,0,0,0,0,3,3,6,3,0,3,0,0,0,6,3,9
sp08,82,WARREN,PHYS,GenPys/SEd,0,0,0,0,0,0,0,0,0,0,0,0,1,0,1,0,0,0,1,0,1
sp08,82,WARREN,PHYS,Phy/ErthSc,0,0,0,0,0,0,0,0,0,0,0,0,1,0,1,0,0,0,1,0,1
sp08,82,WARREN,PHYS,Phys/Astro,0,0,0,1,0,1,0,0,0,2,0,2,3,0,3,0,0,0,6,0,6
sp08,82,WARREN,PHYS,Phys/Comp,0,0,0,0,0,0,0,0,0,1,0,1,3,0,3,0,0,0,4,0,4
sp08,82,WARREN,PHYS,Phys/Mtrls,0,0,0,0,0,0,0,0,0,1,0,1,1,0,1,0,0,0,2,0,2
sp08,82,WARREN,PHYS,Physics,0,0,0,1,0,1,1,0,1,4,1,5,7,4,11,0,0,0,13,5,18
sp08,82,WARREN,POLI,Polit Sci,0,0,0,2,3,5,8,4,12,18,21,39,32,21,53,0,0,0,60,49,109
sp08,82,WARREN,POLI,PolSc-Amer,0,0,0,0,1,1,1,0,1,5,3,8,2,5,7,0,0,0,8,9,17
sp08,82,WARREN,POLI,PolSc-Comp,0,0,0,0,0,0,1,0,1,0,0,0,0,0,0,0,0,0,1,0,1
sp08,82,WARREN,POLI,PolSc-Intl,0,0,0,0,3,3,8,3,11,11,16,27,16,9,25,0,0,0,35,31,66
sp08,82,WARREN,POLI,PolSc-PLaw,0,0,0,0,5,5,3,5,8,5,9,14,5,13,18,0,0,0,13,32,45
sp08,82,WARREN,POLI,PolSc-PPol,0,0,0,1,1,2,0,1,1,0,1,1,1,2,3,0,0,0,2,5,7
sp08,82,WARREN,POLI,PolSc-Thry,0,0,0,0,0,0,1,0,1,0,0,0,1,1,2,0,0,0,2,1,3
sp08,82,WARREN,PSYC,Psychology,0,0,0,4,13,17,6,27,33,16,42,58,29,69,98,0,0,0,55,151,206
sp08,82,WARREN,RELI,Relig/Stu,0,0,0,0,0,0,0,0,0,1,0,1,3,0,3,0,0,0,4,0,4
sp08,82,WARREN,RUSS,Russ&SovSt,0,0,0,1,0,1,0,0,0,0,0,0,0,0,0,0,0,0,1,0,1
sp08,82,WARREN,SE,Engin Sci,0,0,0,1,0,1,0,0,0,1,1,2,0,0,0,0,0,0,2,1,3
sp08,82,WARREN,SE,Struct Eng,0,0,0,4,3,7,25,6,31,19,12,31,69,29,98,0,0,0,117,50,167
sp08,82,WARREN,SIO,ErSc-Geol,0,0,0,0,0,0,0,0,0,0,0,0,0,1,1,0,0,0,0,1,1
sp08,82,WARREN,SOC,Sociology,0,0,0,1,0,1,0,4,4,5,11,16,9,22,31,0,0,0,15,37,52
sp08,82,WARREN,THEA,Dance,0,0,0,0,0,0,0,0,0,0,1,1,1,1,2,0,0,0,1,2,3
sp08,82,WARREN,THEA,Theatre,0,0,0,0,0,0,0,2,2,0,5,5,5,6,11,0,0,0,5,13,18
sp08,82,WARREN,UNAF,IntcampVis,0,0,0,0,0,0,0,1,1,2,0,2,1,1,2,0,0,0,3,2,5
sp08,82,WARREN,UNAF,Limited St,0,0,0,0,0,0,0,0,0,0,0,0,0,0,0,1,1,2,1,1,2
sp08,82,WARREN,UNAF,UndecBiolS,0,0,0,5,4,9,4,10,14,1,5,6,0,0,0,0,0,0,10,19,29
sp08,82,WARREN,UNAF,UndecHumAr,0,0,0,0,1,1,0,4,4,0,1,1,0,0,0,0,0,0,0,6,6
sp08,82,WARREN,UNAF,Undeclared,0,0,0,8,14,22,17,25,42,5,2,7,0,0,0,0,0,0,30,41,71
sp08,82,WARREN,UNAF,UndecPhysS,0,0,0,1,0,1,0,1,1,0,1,1,0,0,0,0,0,0,1,2,3
sp08,82,WARREN,UNAF,UndecSocSc,0,0,0,1,2,3,5,4,9,0,1,1,0,0,0,0,0,0,6,7,13
sp08,82,WARREN,USP,Urb Stu&Pl,0,0,0,0,0,0,1,0,1,2,3,5,8,9,17,0,0,0,11,12,23
sp08,82,WARREN,VIS,Art Hst/Cr,0,0,0,0,0,0,0,2,2,1,4,5,0,6,6,0,0,0,1,12,13
sp08,82,WARREN,VIS,Media,0,0,0,0,1,1,1,3,4,6,6,12,6,6,12,0,0,0,13,16,29
sp08,82,WARREN,VIS,Studio VA,0,0,0,1,0,1,0,1,1,2,5,7,2,5,7,0,0,0,5,11,16
sp08,82,WARREN,VIS,VA-CompArt,0,0,0,0,0,0,1,1,2,2,0,2,0,5,5,0,0,0,3,6,9
sp12,122,MARSHALL,ANTH,Anth-Arch,0,0,0,0,0,0,0,1,1,2,3,5,1,1,2,0,0,0,3,5,8
sp12,122,MARSHALL,ANTH,Anth-Biol,0,0,0,0,1,1,0,2,2,1,4,5,4,3,7,0,0,0,5,10,15
sp12,122,MARSHALL,ANTH,Anth-Soci,0,0,0,0,0,0,0,2,2,0,3,3,1,6,7,0,0,0,1,11,12
sp12,122,MARSHALL,BENG,Bioen:Binf,0,0,0,1,0,1,2,1,3,2,2,4,3,2,5,0,0,0,8,5,13
sp12,122,MARSHALL,BENG,Bioeng:PM,0,0,0,0,0,0,0,0,0,0,1,1,7,4,11,0,0,0,7,5,12
sp12,122,MARSHALL,BENG,BioengBiot,0,0,0,0,0,0,1,2,3,2,3,5,19,11,30,0,0,0,22,16,38
sp12,122,MARSHALL,BENG,Bioengin,0,0,0,1,0,1,7,6,13,0,1,1,4,2,6,0,0,0,12,9,21
sp12,122,MARSHALL,BIOL,Bioc/CellB,0,0,0,1,2,3,6,11,17,6,11,17,45,57,102,0,0,0,58,81,139
sp12,122,MARSHALL,BIOL,BiolBioinf,0,0,0,1,0,1,0,0,0,1,0,1,0,0,0,0,0,0,2,0,2
sp12,122,MARSHALL,BIOL,Ec/Beh/Evo,0,0,0,0,0,0,1,0,1,1,4,5,4,7,11,0,0,0,6,11,17
sp12,122,MARSHALL,BIOL,Genl Biol,0,0,0,1,1,2,3,10,13,15,19,34,38,78,116,0,0,0,57,108,165
sp12,122,MARSHALL,BIOL,Human Bio,0,0,0,6,8,14,13,19,32,11,35,46,60,77,137,0,0,0,90,139,229
sp12,122,MARSHALL,BIOL,Microbiol,0,0,0,0,2,2,0,2,2,1,4,5,4,10,14,0,0,0,5,18,23
sp12,122,MARSHALL,BIOL,Molec Biol,0,0,0,0,1,1,0,2,2,1,1,2,3,5,8,0,0,0,4,9,13
sp12,122,MARSHALL,BIOL,PhyslNeuro,0,0,0,1,6,7,3,5,8,4,5,9,23,35,58,0,0,0,31,51,82
sp12,122,MARSHALL,CENG,Chem Engin,0,0,0,1,1,2,6,6,12,8,6,14,21,10,31,0,0,0,36,23,59
sp12,122,MARSHALL,CGS,CritGendSt,0,0,0,0,0,0,0,0,0,0,0,0,0,1,1,0,0,0,0,1,1
sp12,122,MARSHALL,CHEM,Bioch/Chem,0,0,0,0,0,0,6,11,17,12,20,32,23,32,55,0,0,0,41,63,104
sp12,122,MARSHALL,CHEM,Bioinform,0,0,0,0,0,0,1,0,1,1,0,1,0,0,0,0,0,0,2,0,2
sp12,122,MARSHALL,CHEM,Chem Phys,0,0,0,0,0,0,0,0,0,2,0,2,0,0,0,0,0,0,2,0,2
sp12,122,MARSHALL,CHEM,Chemistry,0,0,0,0,1,1,2,3,5,8,3,11,11,10,21,0,0,0,21,17,38
sp12,122,MARSHALL,CHEM,Envir Chem,0,0,0,0,0,0,0,0,0,0,2,2,2,0,2,0,0,0,2,2,4
sp12,122,MARSHALL,CHEM,Pharm Chem,0,0,0,0,4,4,1,4,5,6,10,16,12,22,34,0,0,0,19,40,59
sp12,122,MARSHALL,CHIN,Chinese St,0,0,0,0,0,0,0,0,0,0,0,0,1,0,1,0,0,0,1,0,1
sp12,122,MARSHALL,CLAS,Classic St,0,0,0,0,0,0,0,0,0,0,1,1,0,0,0,0,0,0,0,1,1
sp12,122,MARSHALL,COGS,Cog Sci,0,0,0,0,3,3,2,1,3,5,9,14,5,6,11,0,0,0,12,19,31
sp12,122,MARSHALL,COGS,CogSc/ClAs,0,0,0,0,2,2,0,0,0,0,2,2,1,5,6,0,0,0,1,9,10
sp12,122,MARSHALL,COGS,CogSc/Comp,0,0,0,0,0,0,0,0,0,0,1,1,1,0,1,0,0,0,1,1,2
sp12,122,MARSHALL,COGS,CogSc/HCI,0,0,0,0,1,1,1,2,3,2,2,4,6,1,7,0,0,0,9,6,15
sp12,122,MARSHALL,COGS,CogSc/HCog,0,0,0,1,1,2,0,1,1,0,0,0,2,1,3,0,0,0,3,3,6
sp12,122,MARSHALL,COGS,CogSc/Neur,0,0,0,0,0,0,1,4,5,9,10,19,4,18,22,0,0,0,14,32,46
sp12,122,MARSHALL,COMM,Communic,0,0,0,0,2,2,1,13,14,13,44,57,26,86,112,0,0,0,40,145,185
sp12,122,MARSHALL,CSE,Comp Sci,0,0,0,5,0,5,18,4,22,23,5,28,47,18,65,0,0,0,93,27,120
sp12,122,MARSHALL,CSE,CompEngCSE,0,0,0,0,1,1,5,1,6,6,1,7,9,2,11,0,0,0,20,5,25
sp12,122,MARSHALL,CSE,CompScBinf,0,0,0,0,0,0,0,0,0,1,0,1,2,1,3,0,0,0,3,1,4
sp12,122,MARSHALL,ECE,CompEngECE,0,0,0,1,0,1,0,0,0,0,0,0,2,0,2,0,0,0,3,0,3
sp12,122,MARSHALL,ECE,Electr Eng,0,0,0,1,0,1,7,2,9,18,4,22,37,6,43,0,0,0,63,12,75
sp12,122,MARSHALL,ECE,EleEng&Soc,0,0,0,0,0,0,0,0,0,0,0,0,1,0,1,0,0,0,1,0,1
sp12,122,MARSHALL,ECE,Engin Phys,0,0,0,0,0,0,0,0,0,0,0,0,1,0,1,0,0,0,1,0,1
sp12,122,MARSHALL,ECON,Ec-Mth&Ecn,0,0,0,2,0,2,3,1,4,3,2,5,7,7,14,0,0,0,15,10,25
sp12,122,MARSHALL,ECON,Econ-MgtSc,0,0,0,4,5,9,11,15,26,28,19,47,66,57,123,0,0,0,109,96,205
sp12,122,MARSHALL,ECON,Economics,0,0,0,4,4,8,18,9,27,56,39,95,79,73,152,0,0,0,157,125,282
sp12,122,MARSHALL,ESYS,EnvSys(EB),0,0,0,1,1,2,0,3,3,4,10,14,6,10,16,0,0,0,11,24,35
sp12,122,MARSHALL,ESYS,EnvSys(EC),0,0,0,0,0,0,0,0,0,2,0,2,2,0,2,0,0,0,4,0,4
sp12,122,MARSHALL,ESYS,EnvSys(EP),0,0,0,0,0,0,0,0,0,1,2,3,0,4,4,0,0,0,1,6,7
sp12,122,MARSHALL,ESYS,EnvSys(ES),0,0,0,0,0,0,0,0,0,0,0,0,5,2,7,0,0,0,5,2,7
sp12,122,MARSHALL,ETHN,Ethnic St,0,0,0,0,0,0,2,3,5,1,2,3,6,9,15,0,0,0,9,14,23
sp12,122,MARSHALL,GMST,German Stu,0,0,0,0,0,0,0,0,0,0,0,0,1,0,1,0,0,0,1,0,1
sp12,122,MARSHALL,HDP,Human Dev,0,0,0,0,0,0,1,0,1,3,7,10,2,35,37,0,0,0,6,42,48
sp12,122,MARSHALL,HDP,Pr-HumnDev,0,0,0,1,6,7,1,9,10,2,12,14,1,8,9,0,0,0,5,35,40
sp12,122,MARSHALL,HIST,History,0,0,0,0,0,0,4,1,5,12,10,22,19,14,33,0,0,0,35,25,60
sp12,122,MARSHALL,INTL,Int-5yrEC,0,0,0,0,0,0,0,0,0,0,0,0,2,1,3,0,0,0,2,1,3
sp12,122,MARSHALL,INTL,IntSt-Anth,0,0,0,0,0,0,0,2,2,0,1,1,0,1,1,0,0,0,0,4,4
sp12,122,MARSHALL,INTL,IntSt-Econ,0,0,0,2,0,2,1,10,11,6,11,17,16,11,27,0,0,0,25,32,57
sp12,122,MARSHALL,INTL,IntSt-Hist,0,0,0,0,0,0,0,0,0,1,0,1,0,3,3,0,0,0,1,3,4
sp12,122,MARSHALL,INTL,IntSt-Ling,0,0,0,0,0,0,0,1,1,2,3,5,0,1,1,0,0,0,2,5,7
sp12,122,MARSHALL,INTL,IntSt-Lit,0,0,0,0,0,0,0,0,0,0,0,0,0,1,1,0,0,0,0,1,1
sp12,122,MARSHALL,INTL,IntSt-PolS,0,0,0,0,1,1,0,2,2,3,9,12,7,17,24,0,0,0,10,29,39
sp12,122,MARSHALL,INTL,IntSt-Soc,0,0,0,1,3,4,1,2,3,1,5,6,1,8,9,0,0,0,4,18,22
sp12,122,MARSHALL,ITAL,Italian St,0,0,0,0,0,0,1,0,1,0,0,0,0,0,0,0,0,0,1,0,1
sp12,122,MARSHALL,JAPN,JapaneseSt,0,0,0,0,0,0,0,0,0,0,1,1,0,0,0,0,0,0,0,1,1
sp12,122,MARSHALL,LATI,LatinAm St,0,0,0,0,0,0,0,1,1,0,0,0,0,2,2,0,0,0,0,3,3
sp12,122,MARSHALL,LING,Lang Stu,0,0,0,0,0,0,0,0,0,1,0,1,0,1,1,0,0,0,1,1,2
sp12,122,MARSHALL,LING,Ling-CogLn,0,0,0,0,1,1,0,0,0,0,0,0,0,1,1,0,0,0,0,2,2
sp12,122,MARSHALL,LING,Ling-LSoc,0,0,0,0,0,0,0,0,0,0,2,2,0,2,2,0,0,0,0,4,4
sp12,122,MARSHALL,LING,Linguistcs,0,0,0,0,0,0,0,1,1,1,1,2,4,5,9,0,0,0,5,7,12
sp12,122,MARSHALL,LIT,Lit/CultSt,0,0,0,0,0,0,0,0,0,0,0,0,0,1,1,0,0,0,0,1,1
sp12,122,MARSHALL,LIT,Lit/Engl,0,0,0,1,1,2,0,2,2,2,2,4,5,9,14,0,0,0,8,14,22
sp12,122,MARSHALL,LIT,Lit/World,0,0,0,0,0,0,0,0,0,0,0,0,0,3,3,0,0,0,0,3,3
sp12,122,MARSHALL,LIT,Lit/Writng,0,0,0,0,0,0,0,0,0,1,5,6,6,8,14,0,0,0,7,13,20
sp12,122,MARSHALL,LIT,Pre-Lit/Wr,0,0,0,0,0,0,0,0,0,0,0,0,1,0,1,0,0,0,1,0,1
sp12,122,MARSHALL,LIT,Spanish Lt,0,0,0,0,0,0,0,0,0,0,1,1,1,2,3,0,0,0,1,3,4
sp12,122,MARSHALL,MAE,Aerosp Eng,0,0,0,1,0,1,4,1,5,8,3,11,14,5,19,0,0,0,27,9,36
sp12,122,MARSHALL,MAE,Engin Sci,0,0,0,0,0,0,1,2,3,3,0,3,1,0,1,0,0,0,5,2,7
sp12,122,MARSHALL,MAE,Envir Eng,0,0,0,1,0,1,4,0,4,3,2,5,5,2,7,0,0,0,13,4,17
sp12,122,MARSHALL,MAE,Mech Engin,0,0,0,2,0,2,6,1,7,7,3,10,41,6,47,0,0,0,56,10,66
sp12,122,MARSHALL,MATH,Appld Math,0,0,0,1,0,1,2,4,6,3,2,5,1,2,3,0,0,0,7,8,15
sp12,122,MARSHALL,MATH,Math/SecEd,0,0,0,0,0,0,0,0,0,0,1,1,3,1,4,0,0,0,3,2,5
sp12,122,MARSHALL,MATH,Mathematcs,0,0,0,0,1,1,3,2,5,3,4,7,8,8,16,0,0,0,14,15,29
sp12,122,MARSHALL,MATH,Mth-CompSc,0,0,0,1,0,1,0,0,0,0,0,0,2,1,3,0,0,0,3,1,4
sp12,122,MARSHALL,MATH,Mth-Mth&Ec,0,0,0,0,0,0,0,1,1,7,5,12,6,3,9,0,0,0,13,9,22
sp12,122,MARSHALL,MATH,Mth/ApldSc,0,0,0,0,0,0,0,1,1,0,0,0,1,0,1,0,0,0,1,1,2
sp12,122,MARSHALL,MATH,Pr-Math CS,0,0,0,0,0,0,0,0,0,0,1,1,0,0,0,0,0,0,0,1,1
sp12,122,MARSHALL,MATH,Prob&Stats,0,0,0,1,0,1,1,1,2,0,2,2,0,2,2,0,0,0,2,5,7
sp12,122,MARSHALL,MUS,Mu-CompArt,0,0,0,0,0,0,1,0,1,0,0,0,2,2,4,0,0,0,3,2,5
sp12,122,MARSHALL,MUS,Music,0,0,0,0,0,0,0,0,0,3,3,6,3,2,5,0,0,0,6,5,11
sp12,122,MARSHALL,NENG,NanoEng,0,0,0,1,0,1,1,0,1,2,1,3,7,3,10,0,0,0,11,4,15
sp12,122,MARSHALL,PHIL,Philosophy,0,0,0,1,0,1,0,0,0,5,2,7,7,2,9,0,0,0,13,4,17
sp12,122,MARSHALL,PHYS,Biophysics,0,0,0,0,0,0,0,0,0,0,0,0,4,3,7,0,0,0,4,3,7
sp12,122,MARSHALL,PHYS,Gen Physcs,0,0,0,0,0,0,0,0,0,1,0,1,0,0,0,0,0,0,1,0,1
sp12,122,MARSHALL,PHYS,GenPys/SEd,0,0,0,0,0,0,0,1,1,0,0,0,0,0,0,0,0,0,0,1,1
sp12,122,MARSHALL,PHYS,Phy/ErthSc,0,0,0,0,0,0,0,0,0,1,0,1,0,0,0,0,0,0,1,0,1
sp12,122,MARSHALL,PHYS,Phys/Astro,0,0,0,0,0,0,0,0,0,0,0,0,1,1,2,0,0,0,1,1,2
sp12,122,MARSHALL,PHYS,Phys/Comp,0,0,0,0,0,0,1,0,1,0,0,0,0,1,1,0,0,0,1,1,2
sp12,122,MARSHALL,PHYS,Physics,0,0,0,0,0,0,1,0,1,0,0,0,7,2,9,0,0,0,8,2,10
sp12,122,MARSHALL,POLI,Polit Sci,0,0,0,2,3,5,5,3,8,21,15,36,33,31,64,0,0,0,61,52,113
sp12,122,MARSHALL,POLI,PolSc-Amer,0,0,0,0,0,0,2,0,2,3,4,7,5,3,8,0,0,0,10,7,17
sp12,122,MARSHALL,POLI,PolSc-Comp,0,0,0,0,0,0,0,0,0,0,0,0,0,4,4,0,0,0,0,4,4
sp12,122,MARSHALL,POLI,PolSc-Intl,0,0,0,0,2,2,2,4,6,11,10,21,21,10,31,0,0,0,34,26,60
sp12,122,MARSHALL,POLI,PolSc-PLaw,0,0,0,2,2,4,2,7,9,7,4,11,6,4,10,0,0,0,17,17,34
sp12,122,MARSHALL,POLI,PolSc-PPol,0,0,0,0,0,0,0,0,0,1,3,4,2,2,4,0,0,0,3,5,8
sp12,122,MARSHALL,POLI,PolSc-Thry,0,0,0,0,0,0,3,0,3,1,0,1,1,2,3,0,0,0,5,2,7
sp12,122,MARSHALL,PSYC,Psychology,0,0,0,3,11,14,8,19,27,31,56,87,50,111,161,0,0,0,92,197,289
sp12,122,MARSHALL,RELI,Relig/Stu,0,0,0,0,0,0,0,0,0,0,0,0,0,1,1,0,0,0,0,1,1
sp12,122,MARSHALL,SE,Engin Sci,0,0,0,0,0,0,1,1,2,0,0,0,0,0,0,0,0,0,1,1,2
sp12,122,MARSHALL,SE,Struct Eng,0,0,0,4,2,6,10,3,13,15,3,18,36,14,50,0,0,0,65,22,87
sp12,122,MARSHALL,SIO,Earth Sci,0,0,0,0,0,0,0,0,0,1,1,2,3,1,4,0,0,0,4,2,6
sp12,122,MARSHALL,SOC,SocAmSt,0,0,0,0,0,0,0,0,0,0,0,0,1,0,1,0,0,0,1,0,1
sp12,122,MARSHALL,SOC,SocCulCom,0,0,0,0,0,0,0,0,0,0,0,0,0,1,1,0,0,0,0,1,1
sp12,122,MARSHALL,SOC,SocEconSoc,0,0,0,0,0,0,0,0,0,1,2,3,2,5,7,0,0,0,3,7,10
sp12,122,MARSHALL,SOC,SocIntlStu,0,0,0,0,0,0,0,0,0,0,0,0,0,1,1,0,0,0,0,1,1
sp12,122,MARSHALL,SOC,Sociology,0,0,0,0,1,1,1,1,2,9,36,45,10,27,37,0,0,0,20,65,85
sp12,122,MARSHALL,SOC,SocLawSoc,0,0,0,0,0,0,0,0,0,2,3,5,3,5,8,0,0,0,5,8,13
sp12,122,MARSHALL,SOC,SocSciMed,0,0,0,0,0,0,0,0,0,3,2,5,1,3,4,0,0,0,4,5,9
sp12,122,MARSHALL,SOC,SocSolneq,0,0,0,0,0,0,0,0,0,0,0,0,1,2,3,0,0,0,1,2,3
sp12,122,MARSHALL,THEA,Dance,0,0,0,0,0,0,1,0,1,0,0,0,0,2,2,0,0,0,1,2,3
sp12,122,MARSHALL,THEA,Theatre,0,0,0,0,0,0,0,0,0,1,2,3,2,5,7,0,0,0,3,7,10
sp12,122,MARSHALL,UNAF,UndecHumAr,0,0,0,0,0,0,0,3,3,0,0,0,0,0,0,0,0,0,0,3,3
sp12,122,MARSHALL,UNAF,Undeclared,0,0,0,7,6,13,9,14,23,0,3,3,0,0,0,0,0,0,16,23,39
sp12,122,MARSHALL,UNAF,UndecPhysS,0,0,0,1,2,3,0,2,2,0,0,0,0,0,0,0,0,0,1,4,5
sp12,122,MARSHALL,UNAF,UndecSocSc,0,0,0,1,0,1,1,4,5,0,0,0,0,0,0,0,0,0,2,4,6
sp12,122,MARSHALL,USP,Urb Stu&Pl,0,0,0,0,1,1,0,2,2,8,7,15,6,18,24,0,0,0,14,28,42
sp12,122,MARSHALL,VIS,Art Hst/Cr,0,0,0,0,1,1,0,0,0,0,0,0,0,5,5,0,0,0,0,6,6
sp12,122,MARSHALL,VIS,Media,0,0,0,0,0,0,2,0,2,5,3,8,12,5,17,0,0,0,19,8,27
sp12,122,MARSHALL,VIS,Studio VA,0,0,0,0,0,0,0,0,0,0,6,6,0,5,5,0,0,0,0,11,11
sp12,122,MARSHALL,VIS,VA-CompArt,0,0,0,0,0,0,0,0,0,0,2,2,4,1,5,0,0,0,4,3,7
sp12,122,MUIR,ANTH,Anth-Arch,0,0,0,0,1,1,1,4,5,1,3,4,0,3,3,0,0,0,2,11,13
sp12,122,MUIR,ANTH,Anth-Biol,0,0,0,1,1,2,0,1,1,0,4,4,0,3,3,0,0,0,1,9,10
sp12,122,MUIR,ANTH,Anth-Soci,0,0,0,0,1,1,0,0,0,3,5,8,5,10,15,0,0,0,8,16,24
sp12,122,MUIR,BENG,Bioen:Binf,0,0,0,0,2,2,1,1,2,1,0,1,1,0,1,0,0,0,3,3,6
sp12,122,MUIR,BENG,Bioeng:PM,0,0,0,0,0,0,0,0,0,0,0,0,6,2,8,0,0,0,6,2,8
sp12,122,MUIR,BENG,BioengBiot,0,0,0,0,1,1,2,2,4,3,2,5,12,11,23,0,0,0,17,16,33
sp12,122,MUIR,BENG,Bioengin,0,0,0,1,0,1,1,6,7,5,1,6,20,5,25,0,0,0,27,12,39
sp12,122,MUIR,BENG,Pr-BioenPM,0,0,0,1,0,1,0,0,0,0,0,0,1,0,1,0,0,0,2,0,2
sp12,122,MUIR,BIOL,Bioc/CellB,0,0,0,2,4,6,3,5,8,12,7,19,40,55,95,0,0,0,57,71,128
sp12,122,MUIR,BIOL,BiolBioinf,0,0,0,0,0,0,0,1,1,0,1,1,1,0,1,0,0,0,1,2,3
sp12,122,MUIR,BIOL,Ec/Beh/Evo,0,0,0,1,1,2,1,3,4,1,8,9,8,18,26,0,0,0,11,30,41
sp12,122,MUIR,BIOL,Genl Biol,0,0,0,2,5,7,5,12,17,10,25,35,38,73,111,0,0,0,55,115,170
sp12,122,MUIR,BIOL,Human Bio,0,0,0,1,11,12,15,23,38,13,32,45,48,77,125,0,0,0,77,143,220
sp12,122,MUIR,BIOL,Microbiol,0,0,0,1,0,1,0,2,2,5,0,5,6,5,11,0,0,0,12,7,19
sp12,122,MUIR,BIOL,Molec Biol,0,0,0,0,0,0,0,4,4,1,3,4,12,12,24,0,0,0,13,19,32
sp12,122,MUIR,BIOL,PhyslNeuro,0,0,0,2,3,5,4,12,16,15,8,23,30,31,61,0,0,0,51,54,105
sp12,122,MUIR,CENG,Chem Engin,0,0,0,0,2,2,5,2,7,8,5,13,15,13,28,0,0,0,28,22,50
sp12,122,MUIR,CGS,CritGendSt,0,0,0,0,1,1,0,1,1,0,0,0,1,1,2,0,0,0,1,3,4
sp12,122,MUIR,CHEM,Bioch/Chem,0,0,0,1,4,5,3,11,14,16,22,38,30,17,47,0,0,0,50,54,104
sp12,122,MUIR,CHEM,Chem Educ,0,0,0,0,0,0,0,0,0,0,0,0,0,1,1,0,0,0,0,1,1
sp12,122,MUIR,CHEM,Chemistry,0,0,0,0,0,0,4,1,5,8,3,11,9,7,16,0,0,0,21,11,32
sp12,122,MUIR,CHEM,Envir Chem,0,0,0,1,1,2,0,0,0,1,1,2,2,0,2,0,0,0,4,2,6
sp12,122,MUIR,CHEM,MolecSynth,0,0,0,0,1,1,0,0,0,2,1,3,0,1,1,0,0,0,2,3,5
sp12,122,MUIR,CHEM,Pharm Chem,0,0,0,3,2,5,4,3,7,10,9,19,11,22,33,0,0,0,28,36,64
sp12,122,MUIR,CHIN,Chinese St,0,0,0,0,0,0,0,0,0,0,1,1,1,0,1,0,0,0,1,1,2
sp12,122,MUIR,CLAS,Classic St,0,0,0,0,0,0,0,0,0,0,0,0,0,2,2,0,0,0,0,2,2
sp12,122,MUIR,COGS,Cog Sci,0,0,0,0,1,1,2,12,14,6,7,13,4,11,15,0,0,0,12,31,43
sp12,122,MUIR,COGS,CogSc/ClAs,0,0,0,0,1,1,0,0,0,0,3,3,0,5,5,0,0,0,0,9,9
sp12,122,MUIR,COGS,CogSc/Comp,0,0,0,0,0,0,2,1,3,2,1,3,3,0,3,0,0,0,7,2,9
sp12,122,MUIR,COGS,CogSc/HCI,0,0,0,0,0,0,1,0,1,2,5,7,4,6,10,0,0,0,7,11,18
sp12,122,MUIR,COGS,CogSc/HCog,0,0,0,0,0,0,0,1,1,2,1,3,1,2,3,0,0,0,3,4,7
sp12,122,MUIR,COGS,CogSc/Neur,0,0,0,2,1,3,4,1,5,7,21,28,15,20,35,0,0,0,28,43,71
sp12,122,MUIR,COMM,Communic,0,0,0,0,5,5,4,9,13,13,35,48,22,58,80,0,0,0,39,107,146
sp12,122,MUIR,CSE,Comp Sci,0,0,0,2,3,5,12,6,18,29,7,36,54,19,73,0,0,0,97,35,132
sp12,122,MUIR,CSE,CompEngCSE,0,0,0,1,1,2,2,0,2,10,1,11,11,2,13,0,0,0,24,4,28
sp12,122,MUIR,CSE,CompScBinf,0,0,0,1,0,1,0,0,0,2,0,2,4,0,4,0,0,0,7,0,7
sp12,122,MUIR,ECE,CompEngECE,0,0,0,1,0,1,0,0,0,2,0,2,1,0,1,0,0,0,4,0,4
sp12,122,MUIR,ECE,Electr Eng,0,0,0,4,0,4,4,4,8,15,3,18,25,3,28,0,0,0,48,10,58
sp12,122,MUIR,ECE,Pr-EngPhys,0,0,0,0,0,0,0,0,0,1,0,1,0,0,0,0,0,0,1,0,1
sp12,122,MUIR,ECON,Ec-Mth&Ecn,0,0,0,4,1,5,0,4,4,5,3,8,5,2,7,0,0,0,14,10,24
sp12,122,MUIR,ECON,Econ-MgtSc,0,0,0,3,10,13,7,8,15,30,25,55,53,27,80,0,0,0,93,70,163
sp12,122,MUIR,ECON,Economics,0,0,0,7,3,10,15,13,28,54,24,78,68,42,110,0,0,0,144,82,226
sp12,122,MUIR,ESYS,EnvSys(EB),0,0,0,0,3,3,2,7,9,8,12,20,9,23,32,0,0,0,19,45,64
sp12,122,MUIR,ESYS,EnvSys(EC),0,0,0,0,1,1,0,1,1,0,1,1,1,1,2,0,0,0,1,4,5
sp12,122,MUIR,ESYS,EnvSys(EP),0,0,0,0,0,0,0,0,0,0,4,4,1,4,5,0,0,0,1,8,9
sp12,122,MUIR,ESYS,EnvSys(ES),0,0,0,0,0,0,0,1,1,2,0,2,0,3,3,0,0,0,2,4,6
sp12,122,MUIR,ETHN,Ethnic St,0,0,0,0,0,0,0,0,0,2,1,3,1,5,6,0,0,0,3,6,9
sp12,122,MUIR,HDP,Human Dev,0,0,0,0,0,0,1,1,2,2,7,9,5,28,33,0,0,0,8,36,44
sp12,122,MUIR,HDP,Pr-HumnDev,0,0,0,0,2,2,3,7,10,2,14,16,0,5,5,0,0,0,5,28,33
sp12,122,MUIR,HIST,History,0,0,0,0,0,0,1,2,3,7,6,13,15,16,31,0,0,0,23,24,47
sp12,122,MUIR,INTD,Muir Sp Pr,0,0,0,0,0,0,0,0,0,0,0,0,1,0,1,0,0,0,1,0,1
sp12,122,MUIR,INTL,IntSt-Anth,0,0,0,0,0,0,1,1,2,0,1,1,0,2,2,0,0,0,1,4,5
sp12,122,MUIR,INTL,IntSt-Econ,0,0,0,2,0,2,2,3,5,1,7,8,7,17,24,0,0,0,12,27,39
sp12,122,MUIR,INTL,IntSt-Hist,0,0,0,0,0,0,0,0,0,2,0,2,2,0,2,0,0,0,4,0,4
sp12,122,MUIR,INTL,IntSt-Ling,0,0,0,0,0,0,0,1,1,0,1,1,0,0,0,0,0,0,0,2,2
sp12,122,MUIR,INTL,IntSt-Lit,0,0,0,0,0,0,0,2,2,0,0,0,0,1,1,0,0,0,0,3,3
sp12,122,MUIR,INTL,IntSt-PolS,0,0,0,0,1,1,1,2,3,5,5,10,2,15,17,0,0,0,8,23,31
sp12,122,MUIR,INTL,IntSt-Soc,0,0,0,0,2,2,0,0,0,1,6,7,1,10,11,0,0,0,2,18,20
sp12,122,MUIR,JAPN,JapaneseSt,0,0,0,0,0,0,0,0,0,2,0,2,2,2,4,0,0,0,4,2,6
sp12,122,MUIR,LATI,LatinAm St,0,0,0,0,0,0,0,0,0,1,0,1,0,1,1,0,0,0,1,1,2
sp12,122,MUIR,LING,Lang Stu,0,0,0,0,0,0,0,0,0,1,1,2,0,0,0,0,0,0,1,1,2
sp12,122,MUIR,LING,Ling-CogLn,0,0,0,0,0,0,0,2,2,0,2,2,1,1,2,0,0,0,1,5,6
sp12,122,MUIR,LING,Ling-LSoc,0,0,0,0,0,0,0,0,0,1,2,3,0,1,1,0,0,0,1,3,4
sp12,122,MUIR,LING,Linguistcs,0,0,0,0,1,1,0,0,0,5,4,9,3,5,8,0,0,0,8,10,18
sp12,122,MUIR,LIT,Lit/CultSt,0,0,0,0,0,0,0,1,1,0,0,0,0,1,1,0,0,0,0,2,2
sp12,122,MUIR,LIT,Lit/Engl,0,0,0,0,0,0,0,2,2,1,6,7,4,9,13,0,0,0,5,17,22
sp12,122,MUIR,LIT,Lit/World,0,0,0,0,0,0,0,0,0,0,1,1,0,2,2,0,0,0,0,3,3
sp12,122,MUIR,LIT,Lit/Writng,0,0,0,0,3,3,0,5,5,4,6,10,5,14,19,0,0,0,9,28,37
sp12,122,MUIR,LIT,Pre-Lit/Wr,0,0,0,0,0,0,0,0,0,0,0,0,1,0,1,0,0,0,1,0,1
sp12,122,MUIR,LIT,Spanish Lt,0,0,0,0,0,0,0,1,1,1,1,2,1,3,4,0,0,0,2,5,7
sp12,122,MUIR,MAE,Aerosp Eng,0,0,0,1,0,1,6,2,8,6,2,8,21,3,24,0,0,0,34,7,41
sp12,122,MUIR,MAE,Engin Sci,0,0,0,1,0,1,1,0,1,2,1,3,3,0,3,0,0,0,7,1,8
sp12,122,MUIR,MAE,Envir Eng,0,0,0,4,1,5,4,7,11,7,6,13,13,8,21,0,0,0,28,22,50
sp12,122,MUIR,MAE,Mech Engin,0,0,0,2,1,3,4,0,4,8,1,9,45,4,49,0,0,0,59,6,65
sp12,122,MUIR,MATH,Appld Math,0,0,0,3,0,3,4,2,6,2,4,6,1,3,4,0,0,0,10,9,19
sp12,122,MUIR,MATH,Math/SecEd,0,0,0,0,1,1,0,4,4,0,3,3,3,1,4,0,0,0,3,9,12
sp12,122,MUIR,MATH,Mathematcs,0,0,0,1,2,3,0,1,1,4,1,5,9,6,15,0,0,0,14,10,24
sp12,122,MUIR,MATH,Mth-CompSc,0,0,0,0,0,0,1,0,1,1,0,1,2,0,2,0,0,0,4,0,4
sp12,122,MUIR,MATH,Mth-Mth&Ec,0,0,0,1,0,1,1,2,3,5,4,9,3,3,6,0,0,0,10,9,19
sp12,122,MUIR,MATH,Mth/ApldSc,0,0,0,0,0,0,0,0,0,1,0,1,2,0,2,0,0,0,3,0,3
sp12,122,MUIR,MATH,Prob&Stats,0,0,0,1,0,1,0,0,0,1,0,1,6,0,6,0,0,0,8,0,8
sp12,122,MUIR,MUS,Mu-CompArt,0,0,0,0,0,0,2,1,3,4,0,4,7,0,7,0,0,0,13,1,14
sp12,122,MUIR,MUS,Music,0,0,0,1,0,1,1,2,3,1,0,1,1,4,5,0,0,0,4,6,10
sp12,122,MUIR,MUS,Music Hum,0,0,0,0,0,0,0,0,0,1,0,1,0,0,0,0,0,0,1,0,1
sp12,122,MUIR,NENG,NanoEng,0,0,0,2,0,2,4,1,5,8,3,11,3,2,5,0,0,0,17,6,23
sp12,122,MUIR,PHIL,Philosophy,0,0,0,1,0,1,0,0,0,5,3,8,5,3,8,0,0,0,11,6,17
sp12,122,MUIR,PHYS,Biophysics,0,0,0,0,0,0,0,2,2,1,1,2,3,1,4,0,0,0,4,4,8
sp12,122,MUIR,PHYS,Phy/ErthSc,0,0,0,0,0,0,0,0,0,0,0,0,0,1,1,0,0,0,0,1,1
sp12,122,MUIR,PHYS,Phys/Astro,0,0,0,0,0,0,0,0,0,0,0,0,5,0,5,0,0,0,5,0,5
sp12,122,MUIR,PHYS,Phys/Mtrls,0,0,0,0,0,0,0,0,0,1,0,1,0,0,0,0,0,0,1,0,1
sp12,122,MUIR,PHYS,Physics,0,0,0,1,0,1,1,0,1,2,0,2,11,1,12,0,0,0,15,1,16
sp12,122,MUIR,POLI,Polit Sci,0,0,0,2,0,2,4,5,9,20,15,35,24,22,46,0,0,0,50,42,92
sp12,122,MUIR,POLI,PolSc-Amer,0,0,0,0,0,0,0,1,1,3,2,5,3,2,5,0,0,0,6,5,11
sp12,122,MUIR,POLI,PolSc-Comp,0,0,0,0,0,0,0,0,0,0,0,0,0,2,2,0,0,0,0,2,2
sp12,122,MUIR,POLI,PolSc-Intl,0,0,0,0,2,2,2,5,7,2,7,9,17,11,28,0,0,0,21,25,46
sp12,122,MUIR,POLI,PolSc-PLaw,0,0,0,1,0,1,5,2,7,4,3,7,5,5,10,0,0,0,15,10,25
sp12,122,MUIR,POLI,PolSc-PPol,0,0,0,0,1,1,0,0,0,1,0,1,3,0,3,0,0,0,4,1,5
sp12,122,MUIR,POLI,PolSc-Thry,0,0,0,0,0,0,1,0,1,1,0,1,2,1,3,0,0,0,4,1,5
sp12,122,MUIR,PSYC,Psychology,0,0,0,4,25,29,8,37,45,24,64,88,48,123,171,0,0,0,84,249,333
sp12,122,MUIR,RELI,Relig/Stu,0,0,0,0,0,0,0,0,0,0,1,1,3,0,3,0,0,0,3,1,4
sp12,122,MUIR,RUSS,Russ&SovSt,0,0,0,0,0,0,0,0,0,0,1,1,0,0,0,0,0,0,0,1,1
sp12,122,MUIR,SE,Engin Sci,0,0,0,0,0,0,1,0,1,1,0,1,0,0,0,0,0,0,2,0,2
sp12,122,MUIR,SE,Struct Eng,0,0,0,6,1,7,9,5,14,13,6,19,29,10,39,0,0,0,57,22,79
sp12,122,MUIR,SIO,Earth Sci,0,0,0,0,1,1,1,0,1,1,1,2,4,2,6,0,0,0,6,4,10
sp12,122,MUIR,SIO,ErSc-Geol,0,0,0,0,0,0,0,0,0,0,0,0,2,0,2,0,0,0,2,0,2
sp12,122,MUIR,SOC,SocAmSt,0,0,0,0,0,0,0,1,1,0,0,0,1,0,1,0,0,0,1,1,2
sp12,122,MUIR,SOC,SocCulCom,0,0,0,0,0,0,1,0,1,2,1,3,1,5,6,0,0,0,4,6,10
sp12,122,MUIR,SOC,SocEconSoc,0,0,0,0,0,0,0,0,0,1,0,1,0,1,1,0,0,0,1,1,2
sp12,122,MUIR,SOC,SocIntlStu,0,0,0,0,1,1,0,0,0,0,1,1,0,2,2,0,0,0,0,4,4
sp12,122,MUIR,SOC,Sociology,0,0,0,2,1,3,3,4,7,9,13,22,10,20,30,0,0,0,24,38,62
sp12,122,MUIR,SOC,SocLawSoc,0,0,0,0,1,1,1,2,3,0,3,3,3,3,6,0,0,0,4,9,13
sp12,122,MUIR,SOC,SocSciMed,0,0,0,0,0,0,0,1,1,0,2,2,1,6,7,0,0,0,1,9,10
sp12,122,MUIR,SOC,SocSolneq,0,0,0,0,1,1,0,1,1,0,1,1,0,3,3,0,0,0,0,6,6
sp12,122,MUIR,THEA,Dance,0,0,0,0,0,0,1,1,2,0,1,1,0,3,3,0,0,0,1,5,6
sp12,122,MUIR,THEA,Theatre,0,0,0,2,3,5,0,1,1,3,3,6,3,11,14,0,0,0,8,18,26
sp12,122,MUIR,TWS,ThirdWldSt,0,0,0,0,0,0,0,0,0,0,1,1,0,0,0,0,0,0,0,1,1
sp12,122,MUIR,UNAF,Limited St,0,0,0,0,0,0,0,0,0,0,0,0,0,0,0,0,1,1,0,1,1
sp12,122,MUIR,UNAF,UndecHumAr,0,0,0,1,1,2,0,2,2,0,0,0,0,0,0,0,0,0,1,3,4
sp12,122,MUIR,UNAF,Undeclared,0,0,0,14,25,39,18,14,32,2,1,3,0,0,0,0,0,0,34,40,74
sp12,122,MUIR,UNAF,UndecPhysS,0,0,0,2,1,3,2,2,4,0,0,0,0,0,0,0,0,0,4,3,7
sp12,122,MUIR,UNAF,UndecSocSc,0,0,0,0,3,3,2,3,5,0,0,0,0,0,0,0,0,0,2,6,8
sp12,122,MUIR,USP,Urb Stu&Pl,0,0,0,1,0,1,1,1,2,2,6,8,8,10,18,0,0,0,12,17,29
sp12,122,MUIR,VIS,Art Hst/Cr,0,0,0,0,0,0,1,0,1,0,2,2,1,3,4,0,0,0,2,5,7
sp12,122,MUIR,VIS,Media,0,0,0,0,1,1,1,1,2,10,7,17,7,17,24,0,0,0,18,26,44
sp12,122,MUIR,VIS,Studio VA,0,0,0,0,0,0,0,2,2,1,3,4,4,9,13,0,0,0,5,14,19
sp12,122,MUIR,VIS,VA-CompArt,0,0,0,1,0,1,1,0,1,1,3,4,5,2,7,0,0,0,8,5,13
sp12,122,REVELLE,ANTH,Anth-Arch,0,0,0,0,1,1,0,1,1,0,1,1,1,2,3,0,0,0,1,5,6
sp12,122,REVELLE,ANTH,Anth-Biol,0,0,0,0,1,1,1,0,1,2,1,3,2,5,7,0,0,0,5,7,12
sp12,122,REVELLE,ANTH,Anth-Soci,0,0,0,0,0,0,0,3,3,0,0,0,1,8,9,0,0,0,1,11,12
sp12,122,REVELLE,BENG,Bioen:Binf,0,0,0,1,2,3,3,5,8,2,1,3,3,3,6,0,0,0,9,11,20
sp12,122,REVELLE,BENG,Bioeng:PM,0,0,0,0,0,0,0,0,0,0,0,0,14,3,17,0,0,0,14,3,17
sp12,122,REVELLE,BENG,BioengBiot,0,0,0,1,0,1,4,3,7,7,3,10,26,15,41,0,0,0,38,21,59
sp12,122,REVELLE,BENG,Bioengin,0,0,0,0,2,2,6,6,12,2,4,6,21,7,28,0,0,0,29,19,48
sp12,122,REVELLE,BIOL,Bioc/CellB,0,0,0,3,9,12,3,10,13,11,15,26,76,56,132,0,0,0,93,90,183
sp12,122,REVELLE,BIOL,BiolBioinf,0,0,0,0,1,1,1,0,1,0,0,0,1,0,1,0,0,0,2,1,3
sp12,122,REVELLE,BIOL,Ec/Beh/Evo,0,0,0,0,0,0,2,1,3,1,4,5,3,10,13,0,0,0,6,15,21
sp12,122,REVELLE,BIOL,Genl Biol,0,0,0,1,6,7,2,10,12,10,24,34,50,98,148,0,0,0,63,138,201
sp12,122,REVELLE,BIOL,Human Bio,0,0,0,8,14,22,15,28,43,21,43,64,94,104,198,0,0,0,138,189,327
sp12,122,REVELLE,BIOL,Microbiol,0,0,0,1,1,2,3,0,3,2,2,4,8,11,19,0,0,0,14,14,28
sp12,122,REVELLE,BIOL,Molec Biol,0,0,0,0,1,1,1,1,2,0,3,3,11,12,23,0,0,0,12,17,29
sp12,122,REVELLE,BIOL,PhyslNeuro,0,0,0,2,4,6,4,10,14,6,10,16,36,43,79,0,0,0,48,67,115
sp12,122,REVELLE,CENG,Chem Engin,0,0,0,4,0,4,9,6,15,11,4,15,25,11,36,0,0,0,49,21,70
sp12,122,REVELLE,CGS,CritGendSt,0,0,0,0,0,0,0,0,0,0,0,0,1,1,2,0,0,0,1,1,2
sp12,122,REVELLE,CHEM,Bioch/Chem,0,0,0,4,7,11,11,8,19,19,20,39,23,20,43,0,0,0,57,55,112
sp12,122,REVELLE,CHEM,Bioinform,0,0,0,0,0,0,0,1,1,0,0,0,0,0,0,0,0,0,0,1,1
sp12,122,REVELLE,CHEM,Chem Educ,0,0,0,0,0,0,0,0,0,0,0,0,0,1,1,0,0,0,0,1,1
sp12,122,REVELLE,CHEM,Chem Phys,0,0,0,0,0,0,0,0,0,0,1,1,1,0,1,0,0,0,1,1,2
sp12,122,REVELLE,CHEM,Chemistry,0,0,0,1,1,2,5,6,11,7,8,15,13,13,26,0,0,0,26,28,54
sp12,122,REVELLE,CHEM,Envir Chem,0,0,0,0,0,0,0,0,0,0,2,2,1,1,2,0,0,0,1,3,4
sp12,122,REVELLE,CHEM,MolecSynth,0,0,0,0,0,0,0,0,0,1,0,1,2,0,2,0,0,0,3,0,3
sp12,122,REVELLE,CHEM,Pharm Chem,0,0,0,2,4,6,7,7,14,13,24,37,29,44,73,0,0,0,51,79,130
sp12,122,REVELLE,CHIN,Chinese St,0,0,0,1,0,1,0,0,0,0,0,0,0,0,0,0,0,0,1,0,1
sp12,122,REVELLE,CLAS,Classic St,0,0,0,0,0,0,0,0,0,1,0,1,0,1,1,0,0,0,1,1,2
sp12,122,REVELLE,COGS,Cog Sci,0,0,0,0,1,1,0,5,5,9,5,14,6,5,11,0,0,0,15,16,31
sp12,122,REVELLE,COGS,CogSc/ClAs,0,0,0,1,0,1,0,0,0,0,4,4,1,4,5,0,0,0,2,8,10
sp12,122,REVELLE,COGS,CogSc/Comp,0,0,0,0,0,0,0,0,0,0,1,1,2,0,2,0,0,0,2,1,3
sp12,122,REVELLE,COGS,CogSc/HCI,0,0,0,0,0,0,0,0,0,1,1,2,3,0,3,0,0,0,4,1,5
sp12,122,REVELLE,COGS,CogSc/HCog,0,0,0,0,0,0,0,1,1,1,2,3,0,2,2,0,0,0,1,5,6
sp12,122,REVELLE,COGS,CogSc/Neur,0,0,0,1,0,1,1,8,9,5,11,16,5,22,27,0,0,0,12,41,53
sp12,122,REVELLE,COMM,Communic,0,0,0,2,2,4,3,3,6,7,8,15,8,14,22,0,0,0,20,27,47
sp12,122,REVELLE,CSE,Comp Sci,0,0,0,7,3,10,12,1,13,32,3,35,62,8,70,0,0,0,113,15,128
sp12,122,REVELLE,CSE,CompEngCSE,0,0,0,6,0,6,6,0,6,6,2,8,9,0,9,0,0,0,27,2,29
sp12,122,REVELLE,CSE,CompScBinf,0,0,0,0,0,0,1,1,2,2,1,3,3,3,6,0,0,0,6,5,11
sp12,122,REVELLE,ECE,CompEngECE,0,0,0,0,0,0,2,1,3,3,0,3,2,0,2,0,0,0,7,1,8
sp12,122,REVELLE,ECE,Electr Eng,0,0,0,9,3,12,11,1,12,17,1,18,35,8,43,0,0,0,72,13,85
sp12,122,REVELLE,ECE,Engin Phys,0,0,0,0,0,0,1,0,1,2,0,2,1,0,1,0,0,0,4,0,4
sp12,122,REVELLE,ECE,Pr-EngPhys,0,0,0,2,0,2,1,0,1,0,0,0,0,0,0,0,0,0,3,0,3
sp12,122,REVELLE,ECON,Ec-Mth&Ecn,0,0,0,2,2,4,3,1,4,2,1,3,7,3,10,0,0,0,14,7,21
sp12,122,REVELLE,ECON,Econ-MgtSc,0,0,0,4,7,11,3,3,6,19,6,25,38,9,47,0,0,0,64,25,89
sp12,122,REVELLE,ECON,Economics,0,0,0,6,3,9,10,5,15,33,17,50,44,31,75,0,0,0,93,56,149
sp12,122,REVELLE,ESYS,EnvSys(EB),0,0,0,0,0,0,3,2,5,8,15,23,3,11,14,0,0,0,14,28,42
sp12,122,REVELLE,ESYS,EnvSys(EC),0,0,0,0,0,0,0,0,0,0,0,0,0,1,1,0,0,0,0,1,1
sp12,122,REVELLE,ESYS,EnvSys(EP),0,0,0,1,0,1,0,1,1,0,0,0,1,2,3,0,0,0,2,3,5
sp12,122,REVELLE,ESYS,EnvSys(ES),0,0,0,0,1,1,2,1,3,1,0,1,1,1,2,0,0,0,4,3,7
sp12,122,REVELLE,ETHN,Ethnic St,0,0,0,0,0,0,0,1,1,1,1,2,1,5,6,0,0,0,2,7,9
sp12,122,REVELLE,HDP,Human Dev,0,0,0,0,0,0,0,0,0,0,1,1,1,15,16,0,0,0,1,16,17
sp12,122,REVELLE,HDP,Pr-HumnDev,0,0,0,2,0,2,1,4,5,0,9,9,0,1,1,0,0,0,3,14,17
sp12,122,REVELLE,HIST,History,0,0,0,0,1,1,0,1,1,3,1,4,8,10,18,0,0,0,11,13,24
sp12,122,REVELLE,INTD,Rev Ind Mj,0,0,0,0,0,0,0,0,0,0,0,0,1,1,2,0,0,0,1,1,2
sp12,122,REVELLE,INTL,IntSt-Anth,0,0,0,0,0,0,0,0,0,1,0,1,1,0,1,0,0,0,2,0,2
sp12,122,REVELLE,INTL,IntSt-Econ,0,0,0,1,1,2,0,3,3,4,3,7,9,5,14,0,0,0,14,12,26
sp12,122,REVELLE,INTL,IntSt-Hist,0,0,0,0,0,0,0,0,0,0,2,2,0,2,2,0,0,0,0,4,4
sp12,122,REVELLE,INTL,IntSt-Ling,0,0,0,0,0,0,0,2,2,0,1,1,1,0,1,0,0,0,1,3,4
sp12,122,REVELLE,INTL,IntSt-PolS,0,0,0,0,1,1,0,1,1,0,2,2,5,7,12,0,0,0,5,11,16
sp12,122,REVELLE,INTL,IntSt-Soc,0,0,0,0,2,2,0,0,0,0,1,1,0,4,4,0,0,0,0,7,7
sp12,122,REVELLE,ITAL,Italian St,0,0,0,0,0,0,0,0,0,0,0,0,0,1,1,0,0,0,0,1,1
sp12,122,REVELLE,JAPN,JapaneseSt,0,0,0,0,0,0,0,0,0,0,0,0,1,1,2,0,0,0,1,1,2
sp12,122,REVELLE,JUDA,Judaic Stu,0,0,0,0,0,0,0,0,0,0,0,0,1,0,1,0,0,0,1,0,1
sp12,122,REVELLE,LING,Ling-CogLn,0,0,0,1,0,1,0,0,0,0,2,2,2,3,5,0,0,0,3,5,8
sp12,122,REVELLE,LING,Ling-LSoc,0,0,0,0,0,0,0,0,0,0,0,0,0,1,1,0,0,0,0,1,1
sp12,122,REVELLE,LING,Linguistcs,0,0,0,0,0,0,0,0,0,1,1,2,1,2,3,0,0,0,2,3,5
sp12,122,REVELLE,LIT,Lit/Compos,0,0,0,0,0,0,0,0,0,1,0,1,0,0,0,0,0,0,1,0,1
sp12,122,REVELLE,LIT,Lit/Engl,0,0,0,0,1,1,0,2,2,2,0,2,1,1,2,0,0,0,3,4,7
sp12,122,REVELLE,LIT,Lit/World,0,0,0,0,0,0,0,0,0,0,0,0,1,1,2,0,0,0,1,1,2
sp12,122,REVELLE,LIT,Lit/Writng,0,0,0,0,0,0,0,1,1,0,5,5,2,7,9,0,0,0,2,13,15
sp12,122,REVELLE,LIT,Pre-Lit/Wr,0,0,0,0,0,0,0,0,0,0,0,0,0,1,1,0,0,0,0,1,1
sp12,122,REVELLE,LIT,Spanish Lt,0,0,0,1,1,2,0,0,0,0,2,2,1,0,1,0,0,0,2,3,5
sp12,122,REVELLE,MAE,Aerosp Eng,0,0,0,1,2,3,4,2,6,5,1,6,19,5,24,0,0,0,29,10,39
sp12,122,REVELLE,MAE,Engin Sci,0,0,0,0,0,0,1,0,1,6,1,7,5,2,7,0,0,0,12,3,15
sp12,122,REVELLE,MAE,Envir Eng,0,0,0,1,0,1,5,8,13,6,0,6,11,3,14,0,0,0,23,11,34
sp12,122,REVELLE,MAE,Mech Engin,0,0,0,2,0,2,10,1,11,9,2,11,38,10,48,0,0,0,59,13,72
sp12,122,REVELLE,MATH,Appld Math,0,0,0,3,0,3,3,1,4,4,2,6,5,5,10,0,0,0,15,8,23
sp12,122,REVELLE,MATH,Math/SecEd,0,0,0,1,0,1,1,1,2,0,0,0,3,2,5,0,0,0,5,3,8
sp12,122,REVELLE,MATH,Mathematcs,0,0,0,3,1,4,1,4,5,2,3,5,8,6,14,0,0,0,14,14,28
sp12,122,REVELLE,MATH,Mth-CompSc,0,0,0,0,0,0,0,0,0,0,0,0,2,1,3,0,0,0,2,1,3
sp12,122,REVELLE,MATH,Mth-Mth&Ec,0,0,0,0,3,3,0,1,1,1,2,3,3,1,4,0,0,0,4,7,11
sp12,122,REVELLE,MATH,Mth-SciCom,0,0,0,0,0,0,0,0,0,0,1,1,0,0,0,0,0,0,0,1,1
sp12,122,REVELLE,MATH,Mth/ApldSc,0,0,0,1,0,1,0,0,0,1,0,1,0,2,2,0,0,0,2,2,4
sp12,122,REVELLE,MATH,Prob&Stats,0,0,0,0,0,0,0,0,0,3,2,5,3,0,3,0,0,0,6,2,8
sp12,122,REVELLE,MUS,Mu-CompArt,0,0,0,0,0,0,0,0,0,2,0,2,6,0,6,0,0,0,8,0,8
sp12,122,REVELLE,MUS,Music,0,0,0,1,0,1,0,1,1,1,0,1,6,2,8,0,0,0,8,3,11
sp12,122,REVELLE,NENG,NanoEng,0,0,0,3,1,4,9,2,11,10,4,14,15,4,19,0,0,0,37,11,48
sp12,122,REVELLE,PHIL,Philosophy,0,0,0,0,0,0,2,0,2,3,2,5,7,2,9,0,0,0,12,4,16
sp12,122,REVELLE,PHYS,Biophysics,0,0,0,0,0,0,1,0,1,2,2,4,3,2,5,0,0,0,6,4,10
sp12,122,REVELLE,PHYS,GenPys/SEd,0,0,0,0,0,0,0,0,0,1,0,1,0,0,0,0,0,0,1,0,1
sp12,122,REVELLE,PHYS,Phy/ErthSc,0,0,0,0,0,0,0,0,0,0,0,0,1,0,1,0,0,0,1,0,1
sp12,122,REVELLE,PHYS,Phys/Astro,0,0,0,0,1,1,1,1,2,3,0,3,3,1,4,0,0,0,7,3,10
sp12,122,REVELLE,PHYS,Phys/Comp,0,0,0,0,0,0,0,0,0,1,0,1,0,0,0,0,0,0,1,0,1
sp12,122,REVELLE,PHYS,Phys/Mtrls,0,0,0,0,0,0,1,1,2,1,0,1,2,0,2,0,0,0,4,1,5
sp12,122,REVELLE,PHYS,Physics,0,0,0,0,1,1,4,1,5,3,0,3,9,2,11,0,0,0,16,4,20
sp12,122,REVELLE,POLI,Polit Sci,0,0,0,0,0,0,2,2,4,2,9,11,13,11,24,0,0,0,17,22,39
sp12,122,REVELLE,POLI,PolSc-Amer,0,0,0,1,0,1,0,0,0,1,2,3,4,6,10,0,0,0,6,8,14
sp12,122,REVELLE,POLI,PolSc-Comp,0,0,0,0,0,0,0,0,0,0,0,0,0,1,1,0,0,0,0,1,1
sp12,122,REVELLE,POLI,PolSc-Intl,0,0,0,0,1,1,1,2,3,2,4,6,5,4,9,0,0,0,8,11,19
sp12,122,REVELLE,POLI,PolSc-PLaw,0,0,0,0,2,2,0,2,2,2,3,5,5,4,9,0,0,0,7,11,18
sp12,122,REVELLE,POLI,PolSc-PPol,0,0,0,0,0,0,1,0,1,1,2,3,0,0,0,0,0,0,2,2,4
sp12,122,REVELLE,POLI,PolSc-Thry,0,0,0,0,0,0,0,1,1,2,0,2,0,1,1,0,0,0,2,2,4
sp12,122,REVELLE,PSYC,Psychology,0,0,0,6,15,21,8,25,33,15,43,58,38,92,130,0,0,0,67,175,242
sp12,122,REVELLE,RELI,Relig/Stu,0,0,0,0,0,0,0,0,0,0,1,1,0,1,1,0,0,0,0,2,2
sp12,122,REVELLE,SE,Engin Sci,0,0,0,1,0,1,1,0,1,0,0,0,1,0,1,0,0,0,3,0,3
sp12,122,REVELLE,SE,Struct Eng,0,0,0,5,0,5,13,4,17,16,5,21,24,9,33,0,0,0,58,18,76
sp12,122,REVELLE,SIO,Earth Sci,0,0,0,0,0,0,0,2,2,0,1,1,3,3,6,0,0,0,3,6,9
sp12,122,REVELLE,SOC,SocCulCom,0,0,0,0,0,0,0,0,0,0,0,0,0,2,2,0,0,0,0,2,2
sp12,122,REVELLE,SOC,SocEconSoc,0,0,0,0,0,0,0,0,0,0,1,1,1,1,2,0,0,0,1,2,3
sp12,122,REVELLE,SOC,Sociology,0,0,0,1,0,1,0,3,3,2,1,3,6,4,10,0,0,0,9,8,17
sp12,122,REVELLE,SOC,SocLawSoc,0,0,0,0,2,2,1,0,1,0,1,1,1,0,1,0,0,0,2,3,5
sp12,122,REVELLE,SOC,SocSciMed,0,0,0,0,0,0,0,3,3,0,2,2,0,3,3,0,0,0,0,8,8
sp12,122,REVELLE,SOC,SocSolneq,0,0,0,0,0,0,0,0,0,0,1,1,0,0,0,0,0,0,0,1,1
sp12,122,REVELLE,THEA,Dance,0,0,0,0,0,0,0,0,0,0,0,0,0,2,2,0,0,0,0,2,2
sp12,122,REVELLE,THEA,Theatre,0,0,0,0,1,1,0,0,0,1,1,2,1,3,4,0,0,0,2,5,7
sp12,122,REVELLE,TWS,ThirdWldSt,0,0,0,0,0,0,0,0,0,0,1,1,0,1,1,0,0,0,0,2,2
sp12,122,REVELLE,UNAF,Limited St,0,0,0,0,0,0,0,0,0,0,0,0,0,0,0,6,8,14,6,8,14
sp12,122,REVELLE,UNAF,Spec-Emply,0,0,0,0,0,0,0,0,0,0,0,0,0,0,0,2,3,5,2,3,5
sp12,122,REVELLE,UNAF,UndecHumAr,0,0,0,2,0,2,0,1,1,0,0,0,0,0,0,0,0,0,2,1,3
sp12,122,REVELLE,UNAF,Undeclared,0,0,0,11,7,18,17,20,37,1,1,2,0,0,0,0,0,0,29,28,57
sp12,122,REVELLE,UNAF,UndecPhysS,0,0,0,0,0,0,0,2,2,0,0,0,0,0,0,0,0,0,0,2,2
sp12,122,REVELLE,UNAF,UndecSocSc,0,0,0,0,1,1,0,2,2,0,0,0,0,0,0,0,0,0,0,3,3
sp12,122,REVELLE,USP,Urb Stu&Pl,0,0,0,0,0,0,0,0,0,2,1,3,4,2,6,0,0,0,6,3,9
sp12,122,REVELLE,VIS,Art Hst/Cr,0,0,0,0,0,0,0,0,0,0,1,1,0,1,1,0,0,0,0,2,2
sp12,122,REVELLE,VIS,Media,0,0,0,0,0,0,0,1,1,0,2,2,4,4,8,0,0,0,4,7,11
sp12,122,REVELLE,VIS,Studio VA,0,0,0,0,1,1,0,1,1,1,1,2,3,4,7,0,0,0,4,7,11
sp12,122,REVELLE,VIS,VA-CompArt,0,0,0,0,0,0,0,0,0,1,2,3,3,2,5,0,0,0,4,4,8
sp12,122,ROOSEVELT,ANTH,Anth-Arch,0,0,0,0,0,0,0,2,2,0,4,4,0,3,3,0,0,0,0,9,9
sp12,122,ROOSEVELT,ANTH,Anth-Biol,0,0,0,0,1,1,0,1,1,0,2,2,1,7,8,0,0,0,1,11,12
sp12,122,ROOSEVELT,ANTH,Anth-Soci,0,0,0,0,1,1,1,0,1,5,6,11,1,6,7,0,0,0,7,13,20
sp12,122,ROOSEVELT,BENG,Bioen:Binf,0,0,0,2,3,5,2,3,5,1,1,2,2,2,4,0,0,0,7,9,16
sp12,122,ROOSEVELT,BENG,Bioeng:PM,0,0,0,0,0,0,0,0,0,1,0,1,9,3,12,0,0,0,10,3,13
sp12,122,ROOSEVELT,BENG,BioengBiot,0,0,0,0,0,0,3,1,4,2,2,4,15,6,21,0,0,0,20,9,29
sp12,122,ROOSEVELT,BENG,Bioengin,0,0,0,1,0,1,1,4,5,1,0,1,4,7,11,0,0,0,7,11,18
sp12,122,ROOSEVELT,BIOL,Bioc/CellB,0,0,0,1,0,1,10,5,15,3,5,8,15,34,49,0,0,0,29,44,73
sp12,122,ROOSEVELT,BIOL,Ec/Beh/Evo,0,0,0,0,0,0,0,3,3,1,0,1,4,8,12,0,0,0,5,11,16
sp12,122,ROOSEVELT,BIOL,Genl Biol,0,0,0,2,7,9,6,4,10,14,9,23,28,60,88,0,0,0,50,80,130
sp12,122,ROOSEVELT,BIOL,Human Bio,0,0,0,3,4,7,8,25,33,16,21,37,38,69,107,0,0,0,65,119,184
sp12,122,ROOSEVELT,BIOL,Microbiol,0,0,0,0,1,1,0,4,4,0,0,0,2,3,5,0,0,0,2,8,10
sp12,122,ROOSEVELT,BIOL,Molec Biol,0,0,0,1,1,2,2,1,3,0,3,3,4,5,9,0,0,0,7,10,17
sp12,122,ROOSEVELT,BIOL,PhyslNeuro,0,0,0,0,7,7,3,11,14,5,3,8,15,20,35,0,0,0,23,41,64
sp12,122,ROOSEVELT,CENG,Chem Engin,0,0,0,0,0,0,4,3,7,9,2,11,10,3,13,0,0,0,23,8,31
sp12,122,ROOSEVELT,CGS,CritGendSt,0,0,0,0,0,0,0,0,0,0,1,1,0,0,0,0,0,0,0,1,1
sp12,122,ROOSEVELT,CHEM,Bioch/Chem,0,1,1,0,4,4,2,5,7,20,20,40,8,24,32,0,0,0,30,54,84
sp12,122,ROOSEVELT,CHEM,Chem Educ,0,0,0,1,0,1,0,0,0,0,0,0,0,0,0,0,0,0,1,0,1
sp12,122,ROOSEVELT,CHEM,Chemistry,0,0,0,1,0,1,4,4,8,4,3,7,6,4,10,0,0,0,15,11,26
sp12,122,ROOSEVELT,CHEM,Envir Chem,0,0,0,0,0,0,0,0,0,2,0,2,2,0,2,0,0,0,4,0,4
sp12,122,ROOSEVELT,CHEM,MolecSynth,0,0,0,0,0,0,0,0,0,0,1,1,0,1,1,0,0,0,0,2,2
sp12,122,ROOSEVELT,CHEM,Pharm Chem,0,0,0,2,2,4,9,6,15,6,4,10,13,16,29,0,0,0,30,28,58
sp12,122,ROOSEVELT,CHIN,Chinese St,0,0,0,0,1,1,0,0,0,0,4,4,1,1,2,0,0,0,1,6,7
sp12,122,ROOSEVELT,CLAS,Classic St,0,0,0,0,0,0,0,0,0,0,2,2,0,1,1,0,0,0,0,3,3
sp12,122,ROOSEVELT,COGS,Cog Sci,0,0,0,0,1,1,1,3,4,2,5,7,5,7,12,0,0,0,8,16,24
sp12,122,ROOSEVELT,COGS,CogSc/ClAs,0,0,0,0,0,0,0,2,2,1,2,3,0,3,3,0,0,0,1,7,8
sp12,122,ROOSEVELT,COGS,CogSc/Comp,0,0,0,0,0,0,0,0,0,0,0,0,2,1,3,0,0,0,2,1,3
sp12,122,ROOSEVELT,COGS,CogSc/HCI,0,0,0,0,0,0,1,0,1,0,3,3,3,1,4,0,0,0,4,4,8
sp12,122,ROOSEVELT,COGS,CogSc/HCog,0,0,0,0,1,1,1,1,2,1,2,3,1,2,3,0,0,0,3,6,9
sp12,122,ROOSEVELT,COGS,CogSc/Neur,0,0,0,1,1,2,2,4,6,2,17,19,6,12,18,0,0,0,11,34,45
sp12,122,ROOSEVELT,COMM,Communic,0,0,0,2,4,6,2,13,15,8,37,45,29,60,89,0,0,0,41,114,155
sp12,122,ROOSEVELT,CSE,Comp Sci,0,0,0,1,0,1,11,1,12,14,2,16,39,7,46,0,0,0,65,10,75
sp12,122,ROOSEVELT,CSE,CompEngCSE,0,0,0,0,0,0,6,1,7,5,2,7,4,0,4,0,0,0,15,3,18
sp12,122,ROOSEVELT,CSE,CompScBinf,0,0,0,0,0,0,1,0,1,0,1,1,0,1,1,0,0,0,1,2,3
sp12,122,ROOSEVELT,ECE,CompEngECE,0,0,0,1,0,1,1,1,2,1,0,1,2,0,2,0,0,0,5,1,6
sp12,122,ROOSEVELT,ECE,Electr Eng,0,0,0,3,1,4,10,1,11,8,6,14,19,2,21,0,0,0,40,10,50
sp12,122,ROOSEVELT,ECE,Engin Phys,0,0,0,0,0,0,1,0,1,0,0,0,1,0,1,0,0,0,2,0,2
sp12,122,ROOSEVELT,ECON,Ec-Mth&Ecn,0,0,0,0,2,2,3,3,6,7,0,7,7,3,10,0,0,0,17,8,25
sp12,122,ROOSEVELT,ECON,Econ-MgtSc,0,0,0,5,1,6,9,7,16,16,17,33,47,25,72,0,0,0,77,50,127
sp12,122,ROOSEVELT,ECON,Economics,0,0,0,3,6,9,9,8,17,47,33,80,54,45,99,0,0,0,113,92,205
sp12,122,ROOSEVELT,ESYS,EnvSys(EB),0,0,0,0,1,1,3,4,7,2,16,18,4,14,18,0,0,0,9,35,44
sp12,122,ROOSEVELT,ESYS,EnvSys(EC),0,0,0,0,0,0,0,1,1,0,2,2,1,3,4,0,0,0,1,6,7
sp12,122,ROOSEVELT,ESYS,EnvSys(EP),0,0,0,0,0,0,0,0,0,1,0,1,0,3,3,0,0,0,1,3,4
sp12,122,ROOSEVELT,ESYS,EnvSys(ES),0,0,0,0,1,1,0,0,0,0,2,2,1,3,4,0,0,0,1,6,7
sp12,122,ROOSEVELT,ETHN,Ethnic St,0,0,0,0,0,0,0,0,0,0,1,1,1,7,8,0,0,0,1,8,9
sp12,122,ROOSEVELT,HDP,Human Dev,0,0,0,0,0,0,0,1,1,0,5,5,4,24,28,0,0,0,4,30,34
sp12,122,ROOSEVELT,HDP,Pr-HumnDev,0,0,0,0,3,3,0,11,11,0,9,9,0,2,2,0,0,0,0,25,25
sp12,122,ROOSEVELT,HIST,History,0,0,0,2,1,3,1,3,4,18,11,29,11,23,34,0,0,0,32,38,70
sp12,122,ROOSEVELT,INTL,Int-5yrEC,0,0,0,0,0,0,0,0,0,0,0,0,0,1,1,0,0,0,0,1,1
sp12,122,ROOSEVELT,INTL,IntSt-Anth,0,0,0,0,0,0,0,1,1,0,2,2,2,8,10,0,0,0,2,11,13
sp12,122,ROOSEVELT,INTL,IntSt-Econ,0,0,0,1,1,2,6,10,16,6,15,21,9,25,34,0,0,0,22,51,73
sp12,122,ROOSEVELT,INTL,IntSt-Hist,0,0,0,0,0,0,0,1,1,2,4,6,5,13,18,0,0,0,7,18,25
sp12,122,ROOSEVELT,INTL,IntSt-Ling,0,0,0,1,0,1,0,4,4,1,2,3,1,6,7,0,0,0,3,12,15
sp12,122,ROOSEVELT,INTL,IntSt-Lit,0,0,0,0,0,0,0,0,0,0,1,1,0,1,1,0,0,0,0,2,2
sp12,122,ROOSEVELT,INTL,IntSt-PolS,0,0,0,0,1,1,2,11,13,13,17,30,15,48,63,0,0,0,30,77,107
sp12,122,ROOSEVELT,INTL,IntSt-Soc,0,0,0,0,3,3,1,3,4,3,12,15,2,23,25,0,0,0,6,41,47
sp12,122,ROOSEVELT,ITAL,Italian St,0,0,0,0,0,0,1,0,1,0,0,0,0,0,0,0,0,0,1,0,1
sp12,122,ROOSEVELT,JAPN,JapaneseSt,0,0,0,0,0,0,0,0,0,0,1,1,3,1,4,0,0,0,3,2,5
sp12,122,ROOSEVELT,LATI,LatinAm St,0,0,0,0,0,0,0,0,0,0,1,1,1,2,3,0,0,0,1,3,4
sp12,122,ROOSEVELT,LING,Lang Stu,0,0,0,0,0,0,1,3,4,1,1,2,0,1,1,0,0,0,2,5,7
sp12,122,ROOSEVELT,LING,Ling-CogLn,0,0,0,0,0,0,0,1,1,1,3,4,0,1,1,0,0,0,1,5,6
sp12,122,ROOSEVELT,LING,Ling-LSoc,0,0,0,0,0,0,0,0,0,1,0,1,1,5,6,0,0,0,2,5,7
sp12,122,ROOSEVELT,LING,Linguistcs,0,0,0,0,0,0,0,0,0,1,1,2,1,5,6,0,0,0,2,6,8
sp12,122,ROOSEVELT,LIT,Lit/CultSt,0,0,0,0,0,0,0,0,0,1,1,2,0,1,1,0,0,0,1,2,3
sp12,122,ROOSEVELT,LIT,Lit/Engl,0,0,0,0,0,0,0,1,1,0,3,3,3,9,12,0,0,0,3,13,16
sp12,122,ROOSEVELT,LIT,Lit/World,0,0,0,0,0,0,0,2,2,0,0,0,2,3,5,0,0,0,2,5,7
sp12,122,ROOSEVELT,LIT,Lit/Writng,0,0,0,0,0,0,0,8,8,3,7,10,9,19,28,0,0,0,12,34,46
sp12,122,ROOSEVELT,LIT,Pre-Lit/Wr,0,0,0,0,0,0,0,0,0,0,0,0,0,1,1,0,0,0,0,1,1
sp12,122,ROOSEVELT,LIT,Spanish Lt,0,0,0,0,0,0,0,0,0,0,0,0,3,1,4,0,0,0,3,1,4
sp12,122,ROOSEVELT,MAE,Aerosp Eng,0,0,0,1,0,1,2,1,3,4,1,5,18,4,22,0,0,0,25,6,31
sp12,122,ROOSEVELT,MAE,Engin Sci,0,0,0,0,0,0,0,0,0,1,0,1,4,0,4,0,0,0,5,0,5
sp12,122,ROOSEVELT,MAE,Envir Eng,0,0,0,1,1,2,4,1,5,7,3,10,4,3,7,0,0,0,16,8,24
sp12,122,ROOSEVELT,MAE,Mech Engin,0,0,0,2,0,2,3,1,4,5,0,5,36,5,41,0,0,0,46,6,52
sp12,122,ROOSEVELT,MATH,Appld Math,0,0,0,1,1,2,0,1,1,0,1,1,0,1,1,0,0,0,1,4,5
sp12,122,ROOSEVELT,MATH,Math/SecEd,0,0,0,0,1,1,0,0,0,0,0,0,0,1,1,0,0,0,0,2,2
sp12,122,ROOSEVELT,MATH,Mathematcs,0,0,0,1,0,1,2,0,2,1,1,2,2,3,5,0,0,0,6,4,10
sp12,122,ROOSEVELT,MATH,Mth-CompSc,0,0,0,0,0,0,0,0,0,1,0,1,1,0,1,0,0,0,2,0,2
sp12,122,ROOSEVELT,MATH,Mth-Mth&Ec,0,0,0,2,0,2,0,7,7,2,4,6,8,1,9,0,0,0,12,12,24
sp12,122,ROOSEVELT,MATH,Mth/ApldSc,0,0,0,1,1,2,0,0,0,0,0,0,0,0,0,0,0,0,1,1,2
sp12,122,ROOSEVELT,MATH,Pr-Math CS,0,0,0,0,0,0,0,0,0,0,0,0,0,1,1,0,0,0,0,1,1
sp12,122,ROOSEVELT,MATH,Prob&Stats,0,0,0,0,0,0,0,0,0,0,0,0,0,1,1,0,0,0,0,1,1
sp12,122,ROOSEVELT,MUS,Mu-CompArt,0,0,0,0,0,0,0,0,0,1,2,3,1,0,1,0,0,0,2,2,4
sp12,122,ROOSEVELT,MUS,Music,0,0,0,0,0,0,0,1,1,0,0,0,3,4,7,0,0,0,3,5,8
sp12,122,ROOSEVELT,MUS,Music Hum,0,0,0,0,0,0,0,0,0,0,1,1,0,0,0,0,0,0,0,1,1
sp12,122,ROOSEVELT,NENG,NanoEng,0,0,0,0,1,1,6,1,7,9,3,12,7,1,8,0,0,0,22,6,28
sp12,122,ROOSEVELT,PHIL,Philosophy,0,0,0,0,0,0,1,0,1,5,0,5,4,2,6,0,0,0,10,2,12
sp12,122,ROOSEVELT,PHYS,Biophysics,0,0,0,0,0,0,0,0,0,0,2,2,1,0,1,0,0,0,1,2,3
sp12,122,ROOSEVELT,PHYS,Phy/ErthSc,0,0,0,0,0,0,0,0,0,0,0,0,0,1,1,0,0,0,0,1,1
sp12,122,ROOSEVELT,PHYS,Phys/Astro,0,0,0,0,0,0,0,0,0,0,1,1,1,0,1,0,0,0,1,1,2
sp12,122,ROOSEVELT,PHYS,Phys/Mtrls,0,0,0,0,0,0,0,1,1,0,0,0,1,0,1,0,0,0,1,1,2
sp12,122,ROOSEVELT,PHYS,Physics,0,0,0,0,0,0,2,1,3,0,0,0,3,0,3,0,0,0,5,1,6
sp12,122,ROOSEVELT,POLI,Polit Sci,0,0,0,0,3,3,7,7,14,19,14,33,30,33,63,0,0,0,56,57,113
sp12,122,ROOSEVELT,POLI,PolSc-Amer,0,0,0,0,0,0,1,0,1,1,3,4,9,5,14,0,0,0,11,8,19
sp12,122,ROOSEVELT,POLI,PolSc-Comp,0,0,0,0,0,0,0,0,0,0,0,0,4,4,8,0,0,0,4,4,8
sp12,122,ROOSEVELT,POLI,PolSc-Intl,0,0,0,0,2,2,1,3,4,19,23,42,25,24,49,0,0,0,45,52,97
sp12,122,ROOSEVELT,POLI,PolSc-PLaw,0,0,0,2,1,3,4,6,10,5,9,14,12,3,15,0,0,0,23,19,42
sp12,122,ROOSEVELT,POLI,PolSc-PPol,0,0,0,0,0,0,0,0,0,1,1,2,1,0,1,0,0,0,2,1,3
sp12,122,ROOSEVELT,POLI,PolSc-Thry,0,0,0,0,0,0,0,0,0,1,0,1,1,0,1,0,0,0,2,0,2
sp12,122,ROOSEVELT,PSYC,Psychology,0,0,0,2,12,14,8,22,30,22,41,63,39,118,157,0,0,0,71,193,264
sp12,122,ROOSEVELT,RELI,Relig/Stu,0,0,0,0,0,0,0,0,0,0,2,2,0,2,2,0,0,0,0,4,4
sp12,122,ROOSEVELT,SE,Engin Sci,0,0,0,0,0,0,1,0,1,1,0,1,0,0,0,0,0,0,2,0,2
sp12,122,ROOSEVELT,SE,Struct Eng,0,0,0,2,1,3,4,3,7,10,4,14,30,4,34,0,0,0,46,12,58
sp12,122,ROOSEVELT,SIO,Earth Sci,0,0,0,0,0,0,0,1,1,0,0,0,0,1,1,0,0,0,0,2,2
sp12,122,ROOSEVELT,SIO,ErSc-Geol,0,0,0,0,0,0,0,1,1,0,0,0,0,0,0,0,0,0,0,1,1
sp12,122,ROOSEVELT,SOC,SocAmSt,0,0,0,0,0,0,0,0,0,0,2,2,0,0,0,0,0,0,0,2,2
sp12,122,ROOSEVELT,SOC,SocCulCom,0,0,0,0,0,0,0,0,0,0,1,1,3,3,6,0,0,0,3,4,7
sp12,122,ROOSEVELT,SOC,SocEconSoc,0,0,0,0,0,0,0,0,0,1,2,3,0,1,1,0,0,0,1,3,4
sp12,122,ROOSEVELT,SOC,SocIntlStu,0,0,0,0,0,0,0,0,0,1,1,2,1,2,3,0,0,0,2,3,5
sp12,122,ROOSEVELT,SOC,Sociology,0,0,0,1,2,3,1,2,3,8,12,20,8,25,33,0,0,0,18,41,59
sp12,122,ROOSEVELT,SOC,SocLawSoc,0,0,0,0,0,0,0,1,1,1,4,5,2,2,4,0,0,0,3,7,10
sp12,122,ROOSEVELT,SOC,SocSciMed,0,0,0,0,0,0,0,0,0,0,1,1,1,3,4,0,0,0,1,4,5
sp12,122,ROOSEVELT,SOC,SocSolneq,0,0,0,0,0,0,0,0,0,0,2,2,0,4,4,0,0,0,0,6,6
sp12,122,ROOSEVELT,THEA,Dance,0,0,0,0,1,1,0,0,0,0,0,0,0,1,1,0,0,0,0,2,2
sp12,122,ROOSEVELT,THEA,Theatre,0,0,0,0,1,1,2,1,3,2,3,5,4,13,17,0,0,0,8,18,26
sp12,122,ROOSEVELT,TWS,ThirdWldSt,0,0,0,0,0,0,1,1,2,0,2,2,0,1,1,0,0,0,1,4,5
sp12,122,ROOSEVELT,UNAF,UndecHumAr,0,0,0,0,1,1,1,2,3,0,0,0,0,0,0,0,0,0,1,3,4
sp12,122,ROOSEVELT,UNAF,Undeclared,0,0,0,9,9,18,17,29,46,2,2,4,0,0,0,0,0,0,28,40,68
sp12,122,ROOSEVELT,UNAF,UndecPhysS,0,0,0,1,0,1,2,1,3,0,2,2,0,0,0,0,0,0,3,3,6
sp12,122,ROOSEVELT,UNAF,UndecSocSc,0,0,0,1,0,1,1,5,6,0,0,0,0,0,0,0,0,0,2,5,7
sp12,122,ROOSEVELT,USP,Urb Stu&Pl,0,0,0,0,1,1,0,3,3,4,8,12,7,15,22,0,0,0,11,27,38
sp12,122,ROOSEVELT,VIS,Art Hst/Cr,0,0,0,0,0,0,0,0,0,0,1,1,2,3,5,0,0,0,2,4,6
sp12,122,ROOSEVELT,VIS,Media,0,0,0,0,0,0,3,1,4,1,6,7,7,14,21,0,0,0,11,21,32
sp12,122,ROOSEVELT,VIS,Studio VA,0,0,0,0,0,0,2,1,3,1,2,3,2,3,5,0,0,0,5,6,11
sp12,122,ROOSEVELT,VIS,VA-CompArt,0,0,0,0,0,0,1,0,1,0,0,0,1,4,5,0,0,0,2,4,6
sp12,122,SIXTH,ANTH,Anth-Arch,0,0,0,0,0,0,0,1,1,0,1,1,1,3,4,0,0,0,1,5,6
sp12,122,SIXTH,ANTH,Anth-Biol,0,0,0,0,0,0,0,1,1,2,4,6,2,10,12,0,0,0,4,15,19
sp12,122,SIXTH,ANTH,Anth-Soci,0,0,0,0,1,1,0,1,1,1,3,4,0,6,6,0,0,0,1,11,12
sp12,122,SIXTH,BENG,Bioen:Binf,0,0,0,0,0,0,1,0,1,5,1,6,4,2,6,0,0,0,10,3,13
sp12,122,SIXTH,BENG,Bioeng:PM,0,0,0,0,0,0,0,0,0,1,0,1,10,1,11,0,0,0,11,1,12
sp12,122,SIXTH,BENG,BioengBiot,0,0,0,1,0,1,6,2,8,4,2,6,15,5,20,0,0,0,26,9,35
sp12,122,SIXTH,BENG,Bioengin,0,0,0,0,0,0,3,4,7,3,1,4,10,3,13,0,0,0,16,8,24
sp12,122,SIXTH,BIOL,Bioc/CellB,0,0,0,2,3,5,10,16,26,5,2,7,33,34,67,0,0,0,50,55,105
sp12,122,SIXTH,BIOL,BiolBioinf,0,0,0,0,0,0,1,0,1,0,0,0,0,0,0,0,0,0,1,0,1
sp12,122,SIXTH,BIOL,Ec/Beh/Evo,0,0,0,0,0,0,0,2,2,3,1,4,2,4,6,0,0,0,5,7,12
sp12,122,SIXTH,BIOL,Genl Biol,0,0,0,0,4,4,4,9,13,6,5,11,28,39,67,0,0,0,38,57,95
sp12,122,SIXTH,BIOL,Human Bio,0,0,0,2,5,7,11,13,24,17,17,34,47,36,83,0,0,0,77,71,148
sp12,122,SIXTH,BIOL,Microbiol,0,0,0,0,0,0,1,2,3,2,0,2,2,4,6,0,0,0,5,6,11
sp12,122,SIXTH,BIOL,Molec Biol,0,0,0,0,0,0,0,0,0,3,4,7,4,1,5,0,0,0,7,5,12
sp12,122,SIXTH,BIOL,PhyslNeuro,0,0,0,1,0,1,2,6,8,7,9,16,12,17,29,0,0,0,22,32,54
sp12,122,SIXTH,CENG,Chem Engin,0,0,0,1,1,2,4,4,8,10,1,11,19,3,22,0,0,0,34,9,43
sp12,122,SIXTH,CGS,CritGendSt,0,0,0,0,0,0,0,0,0,1,0,1,0,1,1,0,0,0,1,1,2
sp12,122,SIXTH,CHEM,Bioch/Chem,0,0,0,1,6,7,3,14,17,27,8,35,23,14,37,0,0,0,54,42,96
sp12,122,SIXTH,CHEM,Chem Phys,0,0,0,0,0,0,0,0,0,1,0,1,0,0,0,0,0,0,1,0,1
sp12,122,SIXTH,CHEM,Chemistry,0,0,0,0,1,1,4,3,7,2,2,4,7,5,12,0,0,0,13,11,24
sp12,122,SIXTH,CHEM,Envir Chem,0,0,0,0,0,0,0,2,2,0,1,1,0,1,1,0,0,0,0,4,4
sp12,122,SIXTH,CHEM,MolecSynth,0,0,0,0,0,0,1,0,1,1,0,1,0,2,2,0,0,0,2,2,4
sp12,122,SIXTH,CHEM,Pharm Chem,0,0,0,1,5,6,12,7,19,15,14,29,12,19,31,0,0,0,40,45,85
sp12,122,SIXTH,CHIN,Chinese St,0,0,0,0,0,0,0,0,0,1,1,2,0,1,1,0,0,0,1,2,3
sp12,122,SIXTH,CLAS,Classic St,0,0,0,0,0,0,0,0,0,0,0,0,0,1,1,0,0,0,0,1,1
sp12,122,SIXTH,COGS,Cog Sci,0,0,0,0,0,0,0,5,5,5,5,10,9,1,10,0,0,0,14,11,25
sp12,122,SIXTH,COGS,CogSc/ClAs,0,0,0,0,0,0,0,0,0,0,1,1,0,4,4,0,0,0,0,5,5
sp12,122,SIXTH,COGS,CogSc/Comp,0,0,0,0,0,0,0,1,1,0,1,1,2,0,2,0,0,0,2,2,4
sp12,122,SIXTH,COGS,CogSc/HCI,0,0,0,0,0,0,0,0,0,4,4,8,4,4,8,0,0,0,8,8,16
sp12,122,SIXTH,COGS,CogSc/HCog,0,0,0,0,0,0,0,0,0,0,1,1,1,0,1,0,0,0,1,1,2
sp12,122,SIXTH,COGS,CogSc/Neur,0,0,0,1,2,3,2,2,4,7,10,17,9,13,22,0,0,0,19,27,46
sp12,122,SIXTH,COMM,Communic,0,0,0,1,8,9,7,15,22,13,50,63,25,52,77,0,0,0,46,125,171
sp12,122,SIXTH,CSE,Comp Sci,0,0,0,11,4,15,32,7,39,45,12,57,79,16,95,0,0,0,167,39,206
sp12,122,SIXTH,CSE,CompEngCSE,0,0,0,3,2,5,13,3,16,8,2,10,12,0,12,0,0,0,36,7,43
sp12,122,SIXTH,CSE,CompScBinf,0,0,0,0,0,0,1,1,2,0,2,2,6,0,6,0,0,0,7,3,10
sp12,122,SIXTH,ECE,CompEngECE,0,0,0,2,0,2,4,0,4,0,0,0,4,0,4,0,0,0,10,0,10
sp12,122,SIXTH,ECE,Electr Eng,0,0,0,5,0,5,12,2,14,23,1,24,45,3,48,0,0,0,85,6,91
sp12,122,SIXTH,ECE,Engin Phys,0,0,0,0,0,0,1,0,1,0,0,0,2,1,3,0,0,0,3,1,4
sp12,122,SIXTH,ECON,Ec-Mth&Ecn,0,0,0,0,2,2,0,2,2,5,0,5,5,4,9,0,0,0,10,8,18
sp12,122,SIXTH,ECON,Econ-MgtSc,0,0,0,3,2,5,13,8,21,23,26,49,33,32,65,0,0,0,72,68,140
sp12,122,SIXTH,ECON,Economics,0,0,0,3,2,5,9,6,15,44,23,67,64,35,99,0,0,0,120,66,186
sp12,122,SIXTH,ESYS,EnvSys(EB),0,0,0,0,1,1,1,3,4,4,12,16,5,14,19,0,0,0,10,30,40
sp12,122,SIXTH,ESYS,EnvSys(EC),0,0,0,0,0,0,1,0,1,1,1,2,2,0,2,0,0,0,4,1,5
sp12,122,SIXTH,ESYS,EnvSys(EP),0,0,0,0,0,0,0,3,3,1,6,7,1,2,3,0,0,0,2,11,13
sp12,122,SIXTH,ESYS,EnvSys(ES),0,0,0,1,0,1,0,1,1,0,1,1,2,1,3,0,0,0,3,3,6
sp12,122,SIXTH,ETHN,Ethnic St,0,0,0,0,0,0,1,1,2,1,2,3,3,3,6,0,0,0,5,6,11
sp12,122,SIXTH,GMST,German Stu,0,0,0,0,0,0,0,0,0,0,1,1,0,0,0,0,0,0,0,1,1
sp12,122,SIXTH,HDP,Human Dev,0,0,0,0,0,0,0,1,1,2,6,8,1,28,29,0,0,0,3,35,38
sp12,122,SIXTH,HDP,Pr-HumnDev,0,0,0,1,1,2,1,5,6,2,6,8,0,2,2,0,0,0,4,14,18
sp12,122,SIXTH,HIST,History,0,0,0,0,0,0,4,3,7,6,3,9,7,6,13,0,0,0,17,12,29
sp12,122,SIXTH,INTL,Int-5yrEC,0,0,0,0,0,0,0,0,0,0,0,0,2,0,2,0,0,0,2,0,2
sp12,122,SIXTH,INTL,IntSt-Anth,0,0,0,0,0,0,1,1,2,0,1,1,0,2,2,0,0,0,1,4,5
sp12,122,SIXTH,INTL,IntSt-Econ,0,0,0,0,0,0,1,3,4,5,7,12,7,14,21,0,0,0,13,24,37
sp12,122,SIXTH,INTL,IntSt-Hist,0,0,0,1,0,1,0,1,1,0,0,0,0,3,3,0,0,0,1,4,5
sp12,122,SIXTH,INTL,IntSt-Ling,0,0,0,0,0,0,0,0,0,0,4,4,1,1,2,0,0,0,1,5,6
sp12,122,SIXTH,INTL,IntSt-PolS,0,0,0,0,1,1,0,2,2,4,7,11,5,12,17,0,0,0,9,22,31
sp12,122,SIXTH,INTL,IntSt-Soc,0,0,0,0,0,0,0,2,2,0,0,0,0,7,7,0,0,0,0,9,9
sp12,122,SIXTH,ITAL,Italian St,0,0,0,0,0,0,0,0,0,0,0,0,0,2,2,0,0,0,0,2,2
sp12,122,SIXTH,JAPN,JapaneseSt,0,0,0,0,0,0,0,0,0,0,1,1,0,1,1,0,0,0,0,2,2
sp12,122,SIXTH,LING,Lang Stu,0,0,0,0,0,0,0,0,0,0,1,1,1,1,2,0,0,0,1,2,3
sp12,122,SIXTH,LING,Ling-CogLn,0,0,0,0,0,0,0,2,2,0,0,0,3,0,3,0,0,0,3,2,5
sp12,122,SIXTH,LING,Ling-LSoc,0,0,0,0,0,0,0,1,1,0,1,1,0,1,1,0,0,0,0,3,3
sp12,122,SIXTH,LING,Linguistcs,0,0,0,0,0,0,0,0,0,0,1,1,3,5,8,0,0,0,3,6,9
sp12,122,SIXTH,LIT,Lit/Engl,0,0,0,0,1,1,1,0,1,0,3,3,2,1,3,0,0,0,3,5,8
sp12,122,SIXTH,LIT,Lit/World,0,0,0,0,0,0,0,0,0,0,1,1,0,2,2,0,0,0,0,3,3
sp12,122,SIXTH,LIT,Lit/Writng,0,0,0,0,0,0,0,2,2,1,4,5,4,13,17,0,0,0,5,19,24
sp12,122,SIXTH,LIT,Pre-Lit/Wr,0,0,0,0,0,0,0,0,0,0,0,0,0,1,1,0,0,0,0,1,1
sp12,122,SIXTH,LIT,Spanish Lt,0,0,0,0,0,0,0,0,0,0,0,0,0,1,1,0,0,0,0,1,1
sp12,122,SIXTH,MAE,Aerosp Eng,0,0,0,2,1,3,8,1,9,7,2,9,34,5,39,0,0,0,51,9,60
sp12,122,SIXTH,MAE,Engin Sci,0,0,0,0,0,0,4,0,4,2,0,2,5,0,5,0,0,0,11,0,11
sp12,122,SIXTH,MAE,Envir Eng,0,0,0,1,2,3,6,4,10,5,5,10,7,7,14,0,0,0,19,18,37
sp12,122,SIXTH,MAE,Mech Engin,0,0,0,2,1,3,12,1,13,15,3,18,63,10,73,0,0,0,92,15,107
sp12,122,SIXTH,MATH,Appld Math,0,0,0,2,0,2,1,3,4,1,0,1,2,2,4,0,0,0,6,5,11
sp12,122,SIXTH,MATH,Math/SecEd,0,0,0,0,0,0,0,0,0,0,1,1,1,2,3,0,0,0,1,3,4
sp12,122,SIXTH,MATH,Mathematcs,0,0,0,0,0,0,2,1,3,0,1,1,10,5,15,0,0,0,12,7,19
sp12,122,SIXTH,MATH,Mth-CompSc,0,0,0,0,0,0,0,1,1,0,1,1,2,0,2,0,0,0,2,2,4
sp12,122,SIXTH,MATH,Mth-Mth&Ec,0,0,0,1,0,1,2,0,2,4,0,4,3,4,7,0,0,0,10,4,14
sp12,122,SIXTH,MATH,Mth-SciCom,0,0,0,0,0,0,0,0,0,0,0,0,0,1,1,0,0,0,0,1,1
sp12,122,SIXTH,MATH,Mth/ApldSc,0,0,0,0,0,0,0,0,0,1,0,1,0,0,0,0,0,0,1,0,1
sp12,122,SIXTH,MATH,Pr-Math CS,0,0,0,0,0,0,2,0,2,1,0,1,0,0,0,0,0,0,3,0,3
sp12,122,SIXTH,MATH,Prob&Stats,0,0,0,1,0,1,0,0,0,2,2,4,1,1,2,0,0,0,4,3,7
sp12,122,SIXTH,MUS,Mu-CompArt,0,0,0,0,0,0,2,0,2,9,1,10,12,2,14,0,0,0,23,3,26
sp12,122,SIXTH,MUS,Music,0,0,0,0,1,1,3,1,4,2,3,5,11,4,15,0,0,0,16,9,25
sp12,122,SIXTH,MUS,Music Hum,0,0,0,0,0,0,0,0,0,0,1,1,0,1,1,0,0,0,0,2,2
sp12,122,SIXTH,NENG,NanoEng,0,0,0,3,1,4,7,0,7,7,1,8,8,2,10,0,0,0,25,4,29
sp12,122,SIXTH,PHIL,Philosophy,0,0,0,0,0,0,0,0,0,2,1,3,5,1,6,0,0,0,7,2,9
sp12,122,SIXTH,PHYS,Biophysics,0,0,0,0,0,0,0,0,0,4,0,4,3,0,3,0,0,0,7,0,7
sp12,122,SIXTH,PHYS,Phys/Astro,0,0,0,0,0,0,0,1,1,0,0,0,1,0,1,0,0,0,1,1,2
sp12,122,SIXTH,PHYS,Phys/Mtrls,0,0,0,0,0,0,0,0,0,0,0,0,1,0,1,0,0,0,1,0,1
sp12,122,SIXTH,PHYS,Physics,0,0,0,0,0,0,2,0,2,2,0,2,9,0,9,0,0,0,13,0,13
sp12,122,SIXTH,POLI,Polit Sci,0,0,0,0,0,0,2,0,2,6,8,14,18,11,29,0,0,0,26,19,45
sp12,122,SIXTH,POLI,PolSc-Amer,0,0,0,1,0,1,0,1,1,0,1,1,3,3,6,0,0,0,4,5,9
sp12,122,SIXTH,POLI,PolSc-Intl,0,0,0,0,1,1,3,2,5,4,7,11,8,5,13,0,0,0,15,15,30
sp12,122,SIXTH,POLI,PolSc-PLaw,0,0,0,0,1,1,5,2,7,3,2,5,3,4,7,0,0,0,11,9,20
sp12,122,SIXTH,POLI,PolSc-PPol,0,0,0,0,0,0,1,0,1,0,1,1,2,1,3,0,0,0,3,2,5
sp12,122,SIXTH,POLI,PolSc-Thry,0,0,0,0,0,0,0,0,0,0,0,0,1,2,3,0,0,0,1,2,3
sp12,122,SIXTH,PSYC,Psychology,0,0,0,6,6,12,9,23,32,21,31,52,38,58,96,0,0,0,74,118,192
sp12,122,SIXTH,RUSS,Russ&SovSt,0,0,0,0,0,0,0,0,0,0,0,0,0,1,1,0,0,0,0,1,1
sp12,122,SIXTH,SE,Engin Sci,0,0,0,0,0,0,0,1,1,0,0,0,0,0,0,0,0,0,0,1,1
sp12,122,SIXTH,SE,Struct Eng,0,0,0,5,2,7,10,3,13,24,4,28,39,13,52,0,0,0,78,22,100
sp12,122,SIXTH,SIO,Earth Sci,0,0,0,1,0,1,0,0,0,0,0,0,3,2,5,0,0,0,4,2,6
sp12,122,SIXTH,SIO,ErSc-Geoph,0,0,0,0,0,0,0,0,0,0,0,0,0,1,1,0,0,0,0,1,1
sp12,122,SIXTH,SOC,SocCulCom,0,0,0,0,0,0,0,0,0,1,3,4,0,4,4,0,0,0,1,7,8
sp12,122,SIXTH,SOC,SocEconSoc,0,0,0,0,0,0,0,0,0,1,0,1,1,2,3,0,0,0,2,2,4
sp12,122,SIXTH,SOC,SocIntlStu,0,0,0,0,0,0,0,1,1,0,1,1,0,2,2,0,0,0,0,4,4
sp12,122,SIXTH,SOC,Sociology,0,0,0,0,1,1,0,2,2,4,11,15,5,7,12,0,0,0,9,21,30
sp12,122,SIXTH,SOC,SocLawSoc,0,0,0,0,0,0,0,0,0,0,3,3,0,3,3,0,0,0,0,6,6
sp12,122,SIXTH,SOC,SocSciMed,0,0,0,0,0,0,0,0,0,4,2,6,0,2,2,0,0,0,4,4,8
sp12,122,SIXTH,SOC,SocSolneq,0,0,0,0,0,0,0,1,1,0,1,1,0,0,0,0,0,0,0,2,2
sp12,122,SIXTH,THEA,Dance,0,0,0,0,0,0,0,0,0,0,0,0,0,1,1,0,0,0,0,1,1
sp12,122,SIXTH,THEA,Theatre,0,0,0,2,0,2,1,2,3,0,6,6,5,7,12,0,0,0,8,15,23
sp12,122,SIXTH,TWS,ThirdWldSt,0,0,0,0,0,0,0,1,1,0,0,0,0,1,1,0,0,0,0,2,2
sp12,122,SIXTH,UNAF,UndecHumAr,0,0,0,0,0,0,0,1,1,0,0,0,0,0,0,0,0,0,0,1,1
sp12,122,SIXTH,UNAF,Undeclared,0,0,0,7,13,20,10,19,29,0,1,1,0,0,0,0,0,0,17,33,50
sp12,122,SIXTH,UNAF,UndecPhysS,0,0,0,0,1,1,3,2,5,0,0,0,0,0,0,0,0,0,3,3,6
sp12,122,SIXTH,UNAF,UndecSocSc,0,0,0,0,1,1,0,0,0,0,0,0,0,0,0,0,0,0,0,1,1
sp12,122,SIXTH,USP,Urb Stu&Pl,0,0,0,1,1,2,0,2,2,5,3,8,4,7,11,0,0,0,10,13,23
sp12,122,SIXTH,VIS,Art Hst/Cr,0,0,0,0,0,0,0,3,3,1,2,3,1,9,10,0,0,0,2,14,16
sp12,122,SIXTH,VIS,Media,0,0,0,1,4,5,4,5,9,8,8,16,19,23,42,0,0,0,32,40,72
sp12,122,SIXTH,VIS,Studio VA,0,0,0,3,3,6,1,2,3,1,12,13,7,6,13,0,0,0,12,23,35
sp12,122,SIXTH,VIS,VA-CompArt,0,0,0,0,3,3,2,2,4,2,3,5,9,7,16,0,0,0,13,15,28
sp12,122,WARREN,ANTH,Anth-Arch,0,0,0,0,0,0,0,0,0,0,0,0,2,1,3,0,0,0,2,1,3
sp12,122,WARREN,ANTH,Anth-Biol,0,0,0,0,0,0,0,0,0,2,2,4,0,4,4,0,0,0,2,6,8
sp12,122,WARREN,ANTH,Anth-Soci,0,0,0,0,0,0,0,1,1,0,3,3,1,5,6,0,0,0,1,9,10
sp12,122,WARREN,BENG,Bioen:Binf,0,0,0,0,0,0,2,6,8,2,4,6,3,0,3,0,0,0,7,10,17
sp12,122,WARREN,BENG,Bioeng:PM,0,0,0,0,0,0,0,0,0,1,1,2,18,6,24,0,0,0,19,7,26
sp12,122,WARREN,BENG,BioengBiot,0,0,0,2,0,2,8,8,16,4,5,9,46,26,72,0,0,0,60,39,99
sp12,122,WARREN,BENG,Bioengin,0,0,0,1,0,1,12,4,16,8,4,12,28,11,39,0,0,0,49,19,68
sp12,122,WARREN,BIOL,Bioc/CellB,0,0,0,2,2,4,3,8,11,11,10,21,46,44,90,0,0,0,62,64,126
sp12,122,WARREN,BIOL,BiolBioinf,0,0,0,0,0,0,0,0,0,0,1,1,0,0,0,0,0,0,0,1,1
sp12,122,WARREN,BIOL,Ec/Beh/Evo,0,0,0,0,0,0,1,1,2,3,1,4,8,7,15,0,0,0,12,9,21
sp12,122,WARREN,BIOL,Genl Biol,0,0,0,0,0,0,3,5,8,15,13,28,33,59,92,0,0,0,51,77,128
sp12,122,WARREN,BIOL,Human Bio,0,0,0,2,7,9,11,14,25,16,21,37,45,68,113,0,0,0,74,110,184
sp12,122,WARREN,BIOL,Microbiol,0,0,0,1,0,1,0,0,0,5,2,7,3,6,9,0,0,0,9,8,17
sp12,122,WARREN,BIOL,Molec Biol,0,0,0,0,0,0,2,0,2,3,1,4,8,6,14,0,0,0,13,7,20
sp12,122,WARREN,BIOL,PhyslNeuro,0,0,0,2,3,5,2,9,11,4,8,12,35,24,59,0,0,0,43,44,87
sp12,122,WARREN,CENG,Chem Engin,0,0,0,2,2,4,12,10,22,23,8,31,39,12,51,0,0,0,76,32,108
sp12,122,WARREN,CGS,CritGendSt,0,0,0,1,0,1,0,0,0,0,0,0,0,1,1,0,0,0,1,1,2
sp12,122,WARREN,CHEM,Bioch/Chem,0,0,0,0,1,1,12,9,21,18,19,37,28,19,47,0,0,0,58,48,106
sp12,122,WARREN,CHEM,Chem Phys,0,0,0,0,0,0,0,1,1,0,1,1,0,0,0,0,0,0,0,2,2
sp12,122,WARREN,CHEM,Chemistry,0,0,0,0,2,2,1,5,6,6,6,12,10,7,17,0,0,0,17,20,37
sp12,122,WARREN,CHEM,MolecSynth,0,0,0,0,0,0,1,0,1,0,0,0,1,1,2,0,0,0,2,1,3
sp12,122,WARREN,CHEM,Pharm Chem,0,0,0,1,1,2,3,8,11,17,16,33,16,18,34,0,0,0,37,43,80
sp12,122,WARREN,CHIN,Chinese St,0,0,0,0,0,0,0,0,0,0,0,0,1,1,2,0,0,0,1,1,2
sp12,122,WARREN,COGS,Cog Sci,0,0,0,0,1,1,2,4,6,4,4,8,3,3,6,0,0,0,9,12,21
sp12,122,WARREN,COGS,CogSc/ClAs,0,0,0,0,1,1,0,0,0,1,0,1,0,4,4,0,0,0,1,5,6
sp12,122,WARREN,COGS,CogSc/Comp,0,0,0,0,0,0,0,1,1,0,0,0,3,0,3,0,0,0,3,1,4
sp12,122,WARREN,COGS,CogSc/HCI,0,0,0,0,1,1,2,0,2,2,3,5,6,6,12,0,0,0,10,10,20
sp12,122,WARREN,COGS,CogSc/HCog,0,0,0,0,0,0,0,1,1,0,0,0,2,6,8,0,0,0,2,7,9
sp12,122,WARREN,COGS,CogSc/Neur,0,0,0,0,0,0,1,7,8,6,11,17,8,15,23,0,0,0,15,33,48
sp12,122,WARREN,COMM,Communic,0,0,0,2,4,6,2,7,9,4,23,27,20,30,50,0,0,0,28,64,92
sp12,122,WARREN,CSE,Comp Sci,0,0,0,7,0,7,36,6,42,67,12,79,99,24,123,0,0,0,209,42,251
sp12,122,WARREN,CSE,CompEngCSE,0,0,0,6,0,6,13,3,16,18,4,22,29,4,33,0,0,0,66,11,77
sp12,122,WARREN,CSE,CompScBinf,0,0,0,0,0,0,1,0,1,4,2,6,3,3,6,0,0,0,8,5,13
sp12,122,WARREN,ECE,CompEngECE,0,0,0,2,1,3,5,2,7,6,0,6,4,0,4,0,0,0,17,3,20
sp12,122,WARREN,ECE,Electr Eng,0,0,0,7,2,9,25,2,27,42,3,45,55,10,65,0,0,0,129,17,146
sp12,122,WARREN,ECE,Engin Phys,0,0,0,0,0,0,1,0,1,0,0,0,4,0,4,0,0,0,5,0,5
sp12,122,WARREN,ECE,Pr-EngPhys,0,0,0,0,0,0,0,0,0,0,0,0,1,0,1,0,0,0,1,0,1
sp12,122,WARREN,ECON,Ec-Mth&Ecn,0,0,0,2,2,4,4,2,6,1,0,1,11,1,12,0,0,0,18,5,23
sp12,122,WARREN,ECON,Econ-MgtSc,0,0,0,4,4,8,7,8,15,26,16,42,36,18,54,0,0,0,73,46,119
sp12,122,WARREN,ECON,Economics,0,0,0,2,2,4,10,11,21,50,30,80,74,40,114,0,0,0,136,83,219
sp12,122,WARREN,ESYS,EnvSys(EB),0,0,0,0,0,0,0,2,2,2,9,11,2,10,12,0,0,0,4,21,25
sp12,122,WARREN,ESYS,EnvSys(EC),0,0,0,0,0,0,0,0,0,0,0,0,0,1,1,0,0,0,0,1,1
sp12,122,WARREN,ESYS,EnvSys(EP),0,0,0,0,0,0,1,1,2,0,1,1,1,1,2,0,0,0,2,3,5
sp12,122,WARREN,ESYS,EnvSys(ES),0,0,0,0,0,0,0,1,1,0,0,0,2,0,2,0,0,0,2,1,3
sp12,122,WARREN,ETHN,Ethnic St,0,0,0,1,0,1,0,0,0,0,1,1,1,5,6,0,0,0,2,6,8
sp12,122,WARREN,HDP,Human Dev,0,0,0,0,0,0,0,2,2,0,4,4,1,15,16,0,0,0,1,21,22
sp12,122,WARREN,HDP,Pr-HumnDev,0,0,0,1,1,2,0,6,6,0,5,5,1,2,3,0,0,0,2,14,16
sp12,122,WARREN,HIST,History,0,0,0,1,2,3,0,1,1,8,2,10,17,5,22,0,0,0,26,10,36
sp12,122,WARREN,INTD,Wa Ind St,0,0,0,0,0,0,0,0,0,0,0,0,0,1,1,0,0,0,0,1,1
sp12,122,WARREN,INTL,IntSt-Econ,0,0,0,0,0,0,0,4,4,2,6,8,11,5,16,0,0,0,13,15,28
sp12,122,WARREN,INTL,IntSt-Hist,0,0,0,0,0,0,0,1,1,1,2,3,2,1,3,0,0,0,3,4,7
sp12,122,WARREN,INTL,IntSt-Ling,0,0,0,0,0,0,0,1,1,1,1,2,0,1,1,0,0,0,1,3,4
sp12,122,WARREN,INTL,IntSt-Lit,0,0,0,0,0,0,0,0,0,0,0,0,0,1,1,0,0,0,0,1,1
sp12,122,WARREN,INTL,IntSt-PolS,0,0,0,1,0,1,0,0,0,2,1,3,4,13,17,0,0,0,7,14,21
sp12,122,WARREN,INTL,IntSt-Soc,0,0,0,1,0,1,0,0,0,0,1,1,0,2,2,0,0,0,1,3,4
sp12,122,WARREN,ITAL,Italian St,0,0,0,0,0,0,0,0,0,0,0,0,1,0,1,0,0,0,1,0,1
sp12,122,WARREN,JAPN,JapaneseSt,0,0,0,0,0,0,0,0,0,1,0,1,2,0,2,0,0,0,3,0,3
sp12,122,WARREN,LING,Lang Stu,0,0,0,0,0,0,0,0,0,0,0,0,0,1,1,0,0,0,0,1,1
sp12,122,WARREN,LING,Ling-CogLn,0,0,0,0,0,0,0,0,0,0,1,1,0,2,2,0,0,0,0,3,3
sp12,122,WARREN,LING,Ling-LSoc,0,0,0,0,0,0,0,0,0,0,0,0,1,1,2,0,0,0,1,1,2
sp12,122,WARREN,LING,Linguistcs,0,0,0,0,0,0,0,0,0,0,1,1,0,5,5,0,0,0,0,6,6
sp12,122,WARREN,LIT,Lit/Engl,0,0,0,0,2,2,0,0,0,0,2,2,2,7,9,0,0,0,2,11,13
sp12,122,WARREN,LIT,Lit/World,0,0,0,0,0,0,0,0,0,0,0,0,0,2,2,0,0,0,0,2,2
sp12,122,WARREN,LIT,Lit/Writng,0,0,0,0,1,1,0,2,2,0,3,3,7,7,14,0,0,0,7,13,20
sp12,122,WARREN,LIT,Pre-Lit/Wr,0,0,0,0,0,0,0,0,0,0,0,0,0,1,1,0,0,0,0,1,1
sp12,122,WARREN,LIT,Spanish Lt,0,0,0,0,0,0,1,0,1,1,0,1,0,1,1,0,0,0,2,1,3
sp12,122,WARREN,MAE,Aerosp Eng,0,0,0,2,1,3,6,6,12,13,0,13,30,6,36,0,0,0,51,13,64
sp12,122,WARREN,MAE,Engin Sci,0,0,0,2,0,2,5,2,7,3,2,5,6,0,6,0,0,0,16,4,20
sp12,122,WARREN,MAE,Envir Eng,0,0,0,3,1,4,4,1,5,9,9,18,15,9,24,0,0,0,31,20,51
sp12,122,WARREN,MAE,Mech Engin,0,0,0,6,1,7,11,5,16,23,4,27,94,11,105,0,0,0,134,21,155
sp12,122,WARREN,MATH,Appld Math,0,0,0,0,0,0,2,2,4,2,0,2,4,3,7,0,0,0,8,5,13
sp12,122,WARREN,MATH,Math/SecEd,0,0,0,0,0,0,0,1,1,0,2,2,1,2,3,0,0,0,1,5,6
sp12,122,WARREN,MATH,Mathematcs,0,0,0,0,2,2,1,2,3,2,3,5,8,3,11,0,0,0,11,10,21
sp12,122,WARREN,MATH,Mth-CompSc,0,0,0,0,0,0,0,1,1,2,1,3,3,1,4,0,0,0,5,3,8
sp12,122,WARREN,MATH,Mth-Mth&Ec,0,0,0,1,2,3,2,3,5,4,5,9,6,1,7,0,0,0,13,11,24
sp12,122,WARREN,MATH,Mth/ApldSc,0,0,0,0,0,0,0,0,0,0,1,1,0,1,1,0,0,0,0,2,2
sp12,122,WARREN,MATH,Prob&Stats,0,0,0,0,0,0,0,0,0,3,1,4,1,4,5,0,0,0,4,5,9
sp12,122,WARREN,MUS,Mu-CompArt,0,0,0,0,0,0,1,1,2,1,1,2,5,0,5,0,0,0,7,2,9
sp12,122,WARREN,MUS,Music,0,0,0,0,0,0,1,0,1,2,0,2,1,4,5,0,0,0,4,4,8
sp12,122,WARREN,MUS,Music Hum,0,0,0,0,0,0,0,0,0,1,0,1,0,0,0,0,0,0,1,0,1
sp12,122,WARREN,NENG,NanoEng,0,0,0,3,0,3,16,0,16,16,5,21,10,0,10,0,0,0,45,5,50
sp12,122,WARREN,PHIL,Philosophy,0,0,0,0,0,0,2,2,4,9,0,9,11,2,13,0,0,0,22,4,26
sp12,122,WARREN,PHYS,Biophysics,0,0,0,1,0,1,0,1,1,1,0,1,0,0,0,0,0,0,2,1,3
sp12,122,WARREN,PHYS,Phys/Astro,0,0,0,0,0,0,0,0,0,0,0,0,2,0,2,0,0,0,2,0,2
sp12,122,WARREN,PHYS,Phys/Comp,0,0,0,0,0,0,1,0,1,0,0,0,1,0,1,0,0,0,2,0,2
sp12,122,WARREN,PHYS,Physics,0,0,0,1,1,2,2,0,2,2,1,3,7,1,8,0,0,0,12,3,15
sp12,122,WARREN,POLI,Polit Sci,0,0,0,4,2,6,7,9,16,15,14,29,29,24,53,0,0,0,55,49,104
sp12,122,WARREN,POLI,PolSc-Amer,0,0,0,0,0,0,1,1,2,2,4,6,5,7,12,0,0,0,8,12,20
sp12,122,WARREN,POLI,PolSc-Comp,0,0,0,0,0,0,0,0,0,0,2,2,1,2,3,0,0,0,1,4,5
sp12,122,WARREN,POLI,PolSc-Intl,0,0,0,2,0,2,2,3,5,8,4,12,12,16,28,0,0,0,24,23,47
sp12,122,WARREN,POLI,PolSc-PLaw,0,0,0,0,1,1,2,7,9,4,10,14,7,7,14,0,0,0,13,25,38
sp12,122,WARREN,POLI,PolSc-PPol,0,0,0,0,0,0,1,0,1,1,3,4,2,2,4,0,0,0,4,5,9
sp12,122,WARREN,POLI,PolSc-Thry,0,0,0,0,0,0,1,0,1,2,0,2,1,3,4,0,0,0,4,3,7
sp12,122,WARREN,PSYC,Psychology,0,0,0,3,13,16,13,17,30,16,39,55,24,85,109,0,0,0,56,154,210
sp12,122,WARREN,RELI,Relig/Stu,0,0,0,0,0,0,1,0,1,0,1,1,2,1,3,0,0,0,3,2,5
sp12,122,WARREN,SE,Engin Sci,0,0,0,0,0,0,0,0,0,0,0,0,1,0,1,0,0,0,1,0,1
sp12,122,WARREN,SE,Struct Eng,0,0,0,6,5,11,19,9,28,37,7,44,62,25,87,0,0,0,124,46,170
sp12,122,WARREN,SIO,Earth Sci,0,0,0,1,0,1,1,0,1,2,2,4,3,2,5,0,0,0,7,4,11
sp12,122,WARREN,SOC,SocAmSt,0,0,0,0,0,0,0,0,0,0,0,0,0,1,1,0,0,0,0,1,1
sp12,122,WARREN,SOC,SocCulCom,0,0,0,0,0,0,0,2,2,1,1,2,0,0,0,0,0,0,1,3,4
sp12,122,WARREN,SOC,SocEconSoc,0,0,0,0,0,0,0,0,0,0,1,1,0,0,0,0,0,0,0,1,1
sp12,122,WARREN,SOC,SocIntlStu,0,0,0,0,0,0,0,0,0,0,1,1,2,0,2,0,0,0,2,1,3
sp12,122,WARREN,SOC,Sociology,0,0,0,0,0,0,0,4,4,3,9,12,5,12,17,0,0,0,8,25,33
sp12,122,WARREN,SOC,SocLawSoc,0,0,0,0,0,0,0,0,0,3,2,5,1,1,2,0,0,0,4,3,7
sp12,122,WARREN,SOC,SocSciMed,0,0,0,0,0,0,0,1,1,0,0,0,1,1,2,0,0,0,1,2,3
sp12,122,WARREN,SOC,SocSolneq,0,0,0,0,0,0,0,0,0,0,0,0,1,3,4,0,0,0,1,3,4
sp12,122,WARREN,THEA,Dance,0,0,0,0,0,0,0,0,0,0,0,0,1,1,2,0,0,0,1,1,2
sp12,122,WARREN,THEA,Theatre,0,0,0,1,1,2,1,0,1,2,0,2,1,3,4,0,0,0,5,4,9
sp12,122,WARREN,TWS,ThirdWldSt,0,0,0,0,0,0,0,0,0,0,0,0,0,1,1,0,0,0,0,1,1
sp12,122,WARREN,UNAF,IntcampVis,0,0,0,1,0,1,0,1,1,1,2,3,0,0,0,0,0,0,2,3,5
sp12,122,WARREN,UNAF,Limited St,0,0,0,0,0,0,0,0,0,0,0,0,0,0,0,1,2,3,1,2,3
sp12,122,WARREN,UNAF,Undeclared,0,0,0,7,11,18,13,16,29,0,3,3,0,0,0,0,0,0,20,30,50
sp12,122,WARREN,UNAF,UndecPhysS,0,0,0,0,1,1,2,2,4,0,0,0,0,0,0,0,0,0,2,3,5
sp12,122,WARREN,UNAF,UndecSocSc,0,0,0,1,0,1,1,0,1,0,0,0,0,0,0,0,0,0,2,0,2
sp12,122,WARREN,USP,Urb Stu&Pl,0,0,0,0,0,0,1,0,1,3,2,5,6,8,14,0,0,0,10,10,20
sp12,122,WARREN,VIS,Art Hst/Cr,0,0,0,0,0,0,1,0,1,0,0,0,2,1,3,0,0,0,3,1,4
sp12,122,WARREN,VIS,Media,0,0,0,0,0,0,0,0,0,2,4,6,9,6,15,0,0,0,11,10,21
sp12,122,WARREN,VIS,Studio VA,0,0,0,0,0,0,1,1,2,2,0,2,1,3,4,0,0,0,4,4,8
sp12,122,WARREN,VIS,VA-CompArt,0,0,0,0,0,0,1,0,1,2,0,2,1,0,1,0,0,0,4,0,4
fa11,113,MARSHALL,ANTH,Anth-Arch,0,1,1,0,0,0,1,0,1,1,1,2,2,2,4,0,0,0,4,4,8
fa11,113,MARSHALL,ANTH,Anth-Biol,0,2,2,0,0,0,0,2,2,4,4,8,3,4,7,0,0,0,7,12,19
fa11,113,MARSHALL,ANTH,Anth-Soci,0,3,3,0,0,0,0,1,1,0,3,3,1,5,6,0,0,0,1,12,13
fa11,113,MARSHALL,ANTH,Anthropol,0,0,0,0,0,0,0,0,0,0,0,0,0,1,1,0,0,0,0,1,1
fa11,113,MARSHALL,BENG,Bioen:Binf,3,0,3,0,0,0,1,0,1,1,1,2,3,2,5,0,0,0,8,3,11
fa11,113,MARSHALL,BENG,Bioeng:PM,0,0,0,0,0,0,0,1,1,0,0,0,8,4,12,0,0,0,8,5,13
fa11,113,MARSHALL,BENG,BioengBiot,1,2,3,0,0,0,0,2,2,6,3,9,17,8,25,0,0,0,24,15,39
fa11,113,MARSHALL,BENG,Bioengin,11,7,18,0,0,0,1,1,2,1,1,2,3,2,5,0,0,0,16,11,27
fa11,113,MARSHALL,BIOL,Bioc/CellB,8,18,26,0,0,0,3,4,7,12,24,36,41,39,80,0,0,0,64,85,149
fa11,113,MARSHALL,BIOL,BiolBioinf,1,0,1,0,0,0,0,0,0,1,0,1,0,0,0,0,0,0,2,0,2
fa11,113,MARSHALL,BIOL,Ec/Beh/Evo,0,0,0,0,0,0,1,3,4,1,0,1,6,8,14,0,0,0,8,11,19
fa11,113,MARSHALL,BIOL,Genl Biol,6,11,17,0,1,1,1,11,12,19,16,35,31,81,112,0,0,0,57,120,177
fa11,113,MARSHALL,BIOL,Human Bio,21,28,49,1,1,2,6,14,20,22,46,68,59,80,139,0,0,0,109,169,278
fa11,113,MARSHALL,BIOL,Microbiol,0,4,4,0,0,0,0,1,1,2,3,5,5,7,12,0,0,0,7,15,22
fa11,113,MARSHALL,BIOL,Molec Biol,0,3,3,0,0,0,0,0,0,2,1,3,4,7,11,0,0,0,6,11,17
fa11,113,MARSHALL,BIOL,PhyslNeuro,4,14,18,0,0,0,2,0,2,9,11,20,16,34,50,0,0,0,31,59,90
fa11,113,MARSHALL,CENG,Chem Engin,4,7,11,0,0,0,4,4,8,13,3,16,11,8,19,0,0,0,32,22,54
fa11,113,MARSHALL,CGS,CritGendSt,0,0,0,0,0,0,0,0,0,0,0,0,0,1,1,0,0,0,0,1,1
fa11,113,MARSHALL,CHEM,Bioch/Chem,2,6,8,0,0,0,8,14,22,12,22,34,20,23,43,0,0,0,42,65,107
fa11,113,MARSHALL,CHEM,Bioinform,0,0,0,0,0,0,0,0,0,1,0,1,0,0,0,0,0,0,1,0,1
fa11,113,MARSHALL,CHEM,Chem Phys,0,0,0,0,0,0,0,0,0,2,0,2,0,0,0,0,0,0,2,0,2
fa11,113,MARSHALL,CHEM,Chemistry,3,2,5,0,0,0,4,2,6,13,8,21,7,7,14,0,0,0,27,19,46
fa11,113,MARSHALL,CHEM,Envir Chem,0,0,0,0,0,0,0,1,1,0,1,1,2,0,2,0,0,0,2,2,4
fa11,113,MARSHALL,CHEM,Pharm Chem,1,10,11,1,0,1,4,8,12,6,16,22,13,15,28,0,0,0,25,49,74
fa11,113,MARSHALL,CLAS,Classic St,0,0,0,0,0,0,0,0,0,0,1,1,0,0,0,0,0,0,0,1,1
fa11,113,MARSHALL,COGS,Cog Sci,3,6,9,1,0,1,4,6,10,4,9,13,4,3,7,0,0,0,16,24,40
fa11,113,MARSHALL,COGS,CogSc/ClAs,0,0,0,0,0,0,0,1,1,0,2,2,0,4,4,0,0,0,0,7,7
fa11,113,MARSHALL,COGS,CogSc/Comp,0,0,0,0,0,0,0,0,0,0,0,0,1,1,2,0,0,0,1,1,2
fa11,113,MARSHALL,COGS,CogSc/HCI,0,0,0,0,0,0,0,1,1,1,1,2,5,0,5,0,0,0,6,2,8
fa11,113,MARSHALL,COGS,CogSc/HCog,0,0,0,0,0,0,0,1,1,1,1,2,1,0,1,0,0,0,2,2,4
fa11,113,MARSHALL,COGS,CogSc/Neur,1,0,1,0,1,1,2,7,9,5,4,9,4,11,15,0,0,0,12,23,35
fa11,113,MARSHALL,COMM,Communic,2,8,10,0,3,3,4,14,18,21,64,85,25,71,96,0,0,0,52,160,212
fa11,113,MARSHALL,CSE,Comp Sci,15,1,16,0,0,0,9,3,12,20,8,28,47,10,57,0,0,0,91,22,113
fa11,113,MARSHALL,CSE,CompEngCSE,3,3,6,0,0,0,4,0,4,8,1,9,9,2,11,0,0,0,24,6,30
fa11,113,MARSHALL,CSE,CompScBinf,0,0,0,0,0,0,0,1,1,3,0,3,2,2,4,0,0,0,5,3,8
fa11,113,MARSHALL,ECE,CompEngECE,1,0,1,1,0,1,0,0,0,0,0,0,2,0,2,0,0,0,4,0,4
fa11,113,MARSHALL,ECE,Electr Eng,7,2,9,0,0,0,6,1,7,21,5,26,34,4,38,0,0,0,68,12,80
fa11,113,MARSHALL,ECE,EleEng&Soc,0,0,0,0,0,0,0,0,0,0,0,0,1,0,1,0,0,0,1,0,1
fa11,113,MARSHALL,ECE,Engin Phys,1,0,1,0,0,0,0,0,0,0,0,0,1,0,1,0,0,0,2,0,2
fa11,113,MARSHALL,ECE,Pr-EngPhys,1,0,1,0,0,0,0,0,0,0,0,0,0,0,0,0,0,0,1,0,1
fa11,113,MARSHALL,ECON,Ec-Mth&Ecn,4,1,5,0,0,0,1,1,2,3,7,10,6,2,8,0,0,0,14,11,25
fa11,113,MARSHALL,ECON,Econ-MgtSc,6,5,11,1,2,3,10,13,23,31,22,53,58,46,104,0,0,0,106,88,194
fa11,113,MARSHALL,ECON,Economics,11,10,21,1,0,1,18,6,24,86,56,142,90,74,164,0,0,0,206,146,352
fa11,113,MARSHALL,ESYS,EnvSys(EB),1,0,1,0,1,1,1,2,3,3,8,11,4,7,11,0,0,0,9,18,27
fa11,113,MARSHALL,ESYS,EnvSys(EC),0,0,0,0,0,0,0,1,1,0,1,1,2,0,2,0,0,0,2,2,4
fa11,113,MARSHALL,ESYS,EnvSys(EP),1,0,1,0,0,0,0,1,1,0,1,1,0,3,3,0,0,0,1,5,6
fa11,113,MARSHALL,ESYS,EnvSys(ES),0,0,0,0,0,0,0,1,1,1,1,2,4,0,4,0,0,0,5,2,7
fa11,113,MARSHALL,ETHN,Ethnic St,0,1,1,0,0,0,1,3,4,2,2,4,4,7,11,0,0,0,7,13,20
fa11,113,MARSHALL,GMST,German Stu,0,0,0,0,0,0,0,0,0,0,0,0,1,0,1,0,0,0,1,0,1
fa11,113,MARSHALL,HDP,Human Dev,0,0,0,0,0,0,0,0,0,1,6,7,0,20,20,0,0,0,1,26,27
fa11,113,MARSHALL,HDP,Pr-HumnDev,0,5,5,0,1,1,2,7,9,4,28,32,1,8,9,0,0,0,7,49,56
fa11,113,MARSHALL,HIST,History,1,0,1,0,0,0,2,4,6,16,7,23,12,11,23,0,0,0,31,22,53
fa11,113,MARSHALL,INTL,Int-5yrEC,0,0,0,0,0,0,0,0,0,0,0,0,2,1,3,0,0,0,2,1,3
fa11,113,MARSHALL,INTL,IntSt-Anth,0,0,0,0,0,0,0,2,2,0,2,2,0,2,2,0,0,0,0,6,6
fa11,113,MARSHALL,INTL,IntSt-Econ,3,8,11,0,0,0,2,4,6,8,8,16,14,10,24,0,0,0,27,30,57
fa11,113,MARSHALL,INTL,IntSt-Hist,0,0,0,0,0,0,1,0,1,0,0,0,0,2,2,0,0,0,1,2,3
fa11,113,MARSHALL,INTL,IntSt-Ling,0,0,0,0,0,0,0,2,2,1,3,4,0,0,0,0,0,0,1,5,6
fa11,113,MARSHALL,INTL,IntSt-Lit,0,0,0,0,0,0,0,0,0,0,0,0,0,2,2,0,0,0,0,2,2
fa11,113,MARSHALL,INTL,IntSt-PolS,1,1,2,0,0,0,2,3,5,1,10,11,5,11,16,0,0,0,9,25,34
fa11,113,MARSHALL,INTL,IntSt-Soc,1,2,3,0,0,0,0,3,3,2,4,6,0,7,7,0,0,0,3,16,19
fa11,113,MARSHALL,ITAL,Italian St,0,0,0,1,0,1,0,0,0,0,0,0,0,0,0,0,0,0,1,0,1
fa11,113,MARSHALL,JAPN,JapaneseSt,0,1,1,0,0,0,0,0,0,0,0,0,0,0,0,0,0,0,0,1,1
fa11,113,MARSHALL,LATI,LatinAm St,0,1,1,0,0,0,0,0,0,0,0,0,0,2,2,0,0,0,0,3,3
fa11,113,MARSHALL,LING,Lang Stu,0,1,1,0,0,0,0,0,0,1,1,2,0,1,1,0,0,0,1,3,4
fa11,113,MARSHALL,LING,Ling-CogLn,0,0,0,0,0,0,0,0,0,0,2,2,1,0,1,0,0,0,1,2,3
fa11,113,MARSHALL,LING,Ling-LSoc,0,0,0,0,0,0,0,0,0,0,1,1,0,2,2,0,0,0,0,3,3
fa11,113,MARSHALL,LING,Linguistcs,0,2,2,0,0,0,0,0,0,3,1,4,2,4,6,0,0,0,5,7,12
fa11,113,MARSHALL,LIT,French Lit,0,1,1,0,0,0,0,0,0,0,0,0,0,0,0,0,0,0,0,1,1
fa11,113,MARSHALL,LIT,Lit/CultSt,0,0,0,0,0,0,0,0,0,0,0,0,0,2,2,0,0,0,0,2,2
fa11,113,MARSHALL,LIT,Lit/Engl,1,2,3,0,0,0,1,2,3,4,5,9,2,7,9,0,0,0,8,16,24
fa11,113,MARSHALL,LIT,Lit/World,0,0,0,0,0,0,0,0,0,0,0,0,0,6,6,0,0,0,0,6,6
fa11,113,MARSHALL,LIT,Lit/Writng,0,0,0,0,0,0,0,3,3,3,3,6,4,8,12,0,0,0,7,14,21
fa11,113,MARSHALL,LIT,Pre-Lit/Wr,0,0,0,0,0,0,0,0,0,0,1,1,2,0,2,0,0,0,2,1,3
fa11,113,MARSHALL,LIT,Spanish Lt,0,0,0,0,0,0,0,0,0,1,1,2,0,2,2,0,0,0,1,3,4
fa11,113,MARSHALL,MAE,Aerosp Eng,7,0,7,1,0,1,5,2,7,6,2,8,12,5,17,0,0,0,31,9,40
fa11,113,MARSHALL,MAE,Engin Sci,1,2,3,0,0,0,0,0,0,2,0,2,1,0,1,0,0,0,4,2,6
fa11,113,MARSHALL,MAE,Envir Eng,3,1,4,2,0,2,0,4,4,4,1,5,4,3,7,0,0,0,13,9,22
fa11,113,MARSHALL,MAE,Mech Engin,9,1,10,0,0,0,4,2,6,8,3,11,43,5,48,0,0,0,64,11,75
fa11,113,MARSHALL,MATH,Appld Math,4,3,7,1,0,1,0,1,1,2,1,3,1,2,3,0,0,0,8,7,15
fa11,113,MARSHALL,MATH,Math/SecEd,0,0,0,0,0,0,0,0,0,4,1,5,2,3,5,0,0,0,6,4,10
fa11,113,MARSHALL,MATH,Mathematcs,2,2,4,0,0,0,2,3,5,5,4,9,8,8,16,0,0,0,17,17,34
fa11,113,MARSHALL,MATH,Mth-CompSc,0,0,0,0,0,0,0,0,0,0,0,0,1,2,3,0,0,0,1,2,3
fa11,113,MARSHALL,MATH,Mth-Mth&Ec,0,0,0,0,0,0,2,0,2,3,5,8,5,1,6,0,0,0,10,6,16
fa11,113,MARSHALL,MATH,Mth/ApldSc,0,1,1,1,0,1,0,0,0,1,0,1,0,0,0,0,0,0,2,1,3
fa11,113,MARSHALL,MATH,Pr-Math CS,0,0,0,0,0,0,0,1,1,1,0,1,0,0,0,0,0,0,1,1,2
fa11,113,MARSHALL,MATH,Prob&Stats,0,1,1,0,0,0,0,2,2,0,1,1,1,2,3,0,0,0,1,6,7
fa11,113,MARSHALL,MUS,Mu-CompArt,0,0,0,0,0,0,0,0,0,1,0,1,3,2,5,0,0,0,4,2,6
fa11,113,MARSHALL,MUS,Music,0,0,0,1,0,1,1,1,2,2,2,4,3,1,4,0,0,0,7,4,11
fa11,113,MARSHALL,NENG,NanoEng,4,0,4,0,0,0,1,1,2,1,3,4,5,0,5,0,0,0,11,4,15
fa11,113,MARSHALL,PHIL,Philosophy,0,1,1,0,0,0,1,1,2,5,3,8,7,3,10,0,0,0,13,8,21
fa11,113,MARSHALL,PHYS,Biophysics,0,0,0,0,0,0,0,0,0,0,0,0,3,2,5,0,0,0,3,2,5
fa11,113,MARSHALL,PHYS,Gen Physcs,0,0,0,0,0,0,0,0,0,1,0,1,0,0,0,0,0,0,1,0,1
fa11,113,MARSHALL,PHYS,Phy/ErthSc,0,0,0,0,0,0,0,0,0,1,0,1,1,0,1,0,0,0,2,0,2
fa11,113,MARSHALL,PHYS,Phys/Astro,0,0,0,0,0,0,0,1,1,0,0,0,1,1,2,0,0,0,1,2,3
fa11,113,MARSHALL,PHYS,Phys/Comp,0,0,0,0,0,0,1,0,1,0,0,0,0,1,1,0,0,0,1,1,2
fa11,113,MARSHALL,PHYS,Physics,1,0,1,0,0,0,0,0,0,3,0,3,4,3,7,0,0,0,8,3,11
fa11,113,MARSHALL,POLI,Polit Sci,5,2,7,0,0,0,5,4,9,23,18,41,26,30,56,0,0,0,59,54,113
fa11,113,MARSHALL,POLI,PolSc-Amer,3,0,3,0,0,0,0,2,2,4,2,6,2,3,5,0,0,0,9,7,16
fa11,113,MARSHALL,POLI,PolSc-Comp,0,0,0,0,0,0,0,0,0,0,1,1,0,3,3,0,0,0,0,4,4
fa11,113,MARSHALL,POLI,PolSc-Intl,1,7,8,0,0,0,2,1,3,15,11,26,19,9,28,0,0,0,37,28,65
fa11,113,MARSHALL,POLI,PolSc-PLaw,2,5,7,1,0,1,2,4,6,9,4,13,7,3,10,0,0,0,21,16,37
fa11,113,MARSHALL,POLI,PolSc-PPol,0,2,2,0,0,0,0,0,0,0,1,1,4,2,6,0,0,0,4,5,9
fa11,113,MARSHALL,POLI,PolSc-Thry,0,1,1,0,0,0,1,0,1,2,1,3,2,2,4,0,0,0,5,4,9
fa11,113,MARSHALL,PSYC,Psychology,9,18,27,1,2,3,7,21,28,39,80,119,43,87,130,0,0,0,99,208,307
fa11,113,MARSHALL,RELI,Relig/Stu,1,0,1,0,0,0,0,0,0,0,0,0,0,1,1,0,0,0,1,1,2
fa11,113,MARSHALL,SE,Engin Sci,0,1,1,0,0,0,0,0,0,0,0,0,1,0,1,0,0,0,1,1,2
fa11,113,MARSHALL,SE,Struct Eng,7,3,10,0,1,1,10,6,16,22,5,27,29,14,43,0,0,0,68,29,97
fa11,113,MARSHALL,SIO,Earth Sci,0,0,0,0,0,0,2,1,3,1,1,2,2,1,3,0,0,0,5,3,8
fa11,113,MARSHALL,SOC,SocCulCom,0,0,0,0,0,0,0,0,0,0,0,0,0,1,1,0,0,0,0,1,1
fa11,113,MARSHALL,SOC,SocEconSoc,0,0,0,0,0,0,1,1,2,1,1,2,0,1,1,0,0,0,2,3,5
fa11,113,MARSHALL,SOC,SocIntlStu,0,0,0,0,0,0,0,1,1,0,0,0,0,2,2,0,0,0,0,3,3
fa11,113,MARSHALL,SOC,Sociology,1,1,2,0,0,0,3,4,7,12,42,54,9,22,31,0,0,0,25,69,94
fa11,113,MARSHALL,SOC,SocLawSoc,0,0,0,0,0,0,1,0,1,1,3,4,3,4,7,0,0,0,5,7,12
fa11,113,MARSHALL,SOC,SocSciMed,0,0,0,0,0,0,0,0,0,1,2,3,1,1,2,0,0,0,2,3,5
fa11,113,MARSHALL,SOC,SocSolneq,0,0,0,0,0,0,0,0,0,0,1,1,1,3,4,0,0,0,1,4,5
fa11,113,MARSHALL,THEA,Dance,1,0,1,0,0,0,0,0,0,0,1,1,0,2,2,0,0,0,1,3,4
fa11,113,MARSHALL,THEA,Theatre,0,1,1,0,0,0,1,1,2,1,0,1,3,5,8,0,0,0,5,7,12
fa11,113,MARSHALL,TWS,ThirdWldSt,0,1,1,0,0,0,0,0,0,0,0,0,0,0,0,0,0,0,0,1,1
fa11,113,MARSHALL,UNAF,UndecHumAr,0,6,6,0,0,0,0,2,2,0,0,0,0,0,0,0,0,0,0,8,8
fa11,113,MARSHALL,UNAF,Undeclared,25,37,62,1,2,3,4,9,13,14,8,22,1,0,1,0,0,0,45,56,101
fa11,113,MARSHALL,UNAF,UndecPhysS,4,6,10,1,0,1,2,1,3,0,0,0,0,0,0,0,0,0,7,7,14
fa11,113,MARSHALL,UNAF,UndecSocSc,2,10,12,0,0,0,1,1,2,0,0,0,0,0,0,0,0,0,3,11,14
fa11,113,MARSHALL,USP,Urb Stu&Pl,0,0,0,0,1,1,2,1,3,8,9,17,5,12,17,0,0,0,15,23,38
fa11,113,MARSHALL,VIS,Art Hst/Cr,0,1,1,0,0,0,0,0,0,0,0,0,0,6,6,0,0,0,0,7,7
fa11,113,MARSHALL,VIS,Media,0,0,0,1,0,1,2,1,3,7,3,10,10,6,16,0,0,0,20,10,30
fa11,113,MARSHALL,VIS,Studio VA,0,0,0,0,0,0,0,2,2,0,5,5,0,4,4,0,0,0,0,11,11
fa11,113,MARSHALL,VIS,VA-CompArt,0,0,0,0,0,0,0,0,0,2,1,3,1,1,2,0,0,0,3,2,5
fa11,113,MUIR,ANTH,Anth-Arch,0,2,2,1,0,1,0,3,3,1,3,4,0,2,2,0,0,0,2,10,12
fa11,113,MUIR,ANTH,Anth-Biol,1,1,2,0,0,0,0,2,2,0,2,2,1,5,6,0,0,0,2,10,12
fa11,113,MUIR,ANTH,Anth-Soci,0,3,3,0,0,0,0,1,1,2,6,8,4,9,13,0,0,0,6,19,25
fa11,113,MUIR,BENG,Bioen:Binf,0,0,0,1,0,1,1,0,1,1,1,2,1,0,1,0,0,0,4,1,5
fa11,113,MUIR,BENG,Bioeng:PM,0,0,0,0,0,0,0,0,0,0,0,0,5,3,8,0,0,0,5,3,8
fa11,113,MUIR,BENG,BioengBiot,3,2,5,0,0,0,2,1,3,5,2,7,10,10,20,0,0,0,20,15,35
fa11,113,MUIR,BENG,Bioengin,2,7,9,0,0,0,4,1,5,2,3,5,19,3,22,0,0,0,27,14,41
fa11,113,MUIR,BENG,Pr-BioenPM,0,0,0,1,0,1,0,0,0,1,1,2,1,0,1,0,0,0,3,1,4
fa11,113,MUIR,BIOL,Bioc/CellB,5,10,15,0,1,1,7,3,10,14,9,23,34,56,90,0,0,0,60,79,139
fa11,113,MUIR,BIOL,BiolBioinf,0,1,1,0,0,0,0,0,0,0,1,1,1,0,1,0,0,0,1,2,3
fa11,113,MUIR,BIOL,Ec/Beh/Evo,2,6,8,0,0,0,0,4,4,4,1,5,7,17,24,0,0,0,13,28,41
fa11,113,MUIR,BIOL,Genl Biol,6,17,23,2,1,3,5,14,19,8,28,36,34,66,100,0,0,0,55,126,181
fa11,113,MUIR,BIOL,Human Bio,11,32,43,2,4,6,13,27,40,23,30,53,50,72,122,0,0,0,99,165,264
fa11,113,MUIR,BIOL,Microbiol,1,1,2,0,1,1,1,0,1,3,2,5,7,3,10,0,0,0,12,7,19
fa11,113,MUIR,BIOL,Molec Biol,1,5,6,0,0,0,2,4,6,3,1,4,11,12,23,0,0,0,17,22,39
fa11,113,MUIR,BIOL,PhyslNeuro,6,13,19,0,0,0,9,8,17,13,10,23,29,29,58,0,0,0,57,60,117
fa11,113,MUIR,CENG,Chem Engin,5,2,7,0,0,0,5,3,8,10,5,15,14,11,25,0,0,0,34,21,55
fa11,113,MUIR,CGS,CritGendSt,0,1,1,0,0,0,0,0,0,0,0,0,1,1,2,0,0,0,1,2,3
fa11,113,MUIR,CHEM,Bioch/Chem,1,9,10,2,1,3,12,12,24,20,15,35,22,16,38,0,0,0,57,53,110
fa11,113,MUIR,CHEM,Chem Educ,0,0,0,0,0,0,0,0,0,0,0,0,0,1,1,0,0,0,0,1,1
fa11,113,MUIR,CHEM,Chem Phys,0,0,0,0,0,0,0,0,0,1,0,1,0,0,0,0,0,0,1,0,1
fa11,113,MUIR,CHEM,Chemistry,4,1,5,0,1,1,4,2,6,6,6,12,8,6,14,0,0,0,22,16,38
fa11,113,MUIR,CHEM,Envir Chem,0,0,0,0,0,0,0,0,0,1,1,2,1,0,1,0,0,0,2,1,3
fa11,113,MUIR,CHEM,MolecSynth,0,1,1,0,0,0,0,0,0,0,0,0,0,1,1,0,0,0,0,2,2
fa11,113,MUIR,CHEM,Pharm Chem,4,7,11,0,1,1,7,6,13,9,9,18,7,17,24,0,0,0,27,40,67
fa11,113,MUIR,CHIN,Chinese St,0,0,0,0,0,0,0,0,0,2,1,3,0,1,1,0,0,0,2,2,4
fa11,113,MUIR,CLAS,Classic St,0,0,0,0,0,0,0,0,0,0,1,1,0,1,1,0,0,0,0,2,2
fa11,113,MUIR,COGS,Cog Sci,4,4,8,0,0,0,1,6,7,9,7,16,7,10,17,0,0,0,21,27,48
fa11,113,MUIR,COGS,CogSc/ClAs,0,2,2,0,0,0,0,1,1,0,5,5,0,2,2,0,0,0,0,10,10
fa11,113,MUIR,COGS,CogSc/Comp,0,0,0,0,0,0,1,1,2,0,0,0,3,0,3,0,0,0,4,1,5
fa11,113,MUIR,COGS,CogSc/HCI,0,1,1,1,0,1,2,1,3,1,2,3,1,3,4,0,0,0,5,7,12
fa11,113,MUIR,COGS,CogSc/HCog,0,1,1,0,0,0,2,2,4,0,0,0,0,2,2,0,0,0,2,5,7
fa11,113,MUIR,COGS,CogSc/Neur,0,0,0,0,1,1,4,10,14,7,17,24,10,13,23,0,0,0,21,41,62
fa11,113,MUIR,COMM,Communic,0,9,9,1,1,2,4,12,16,18,28,46,18,54,72,0,0,0,41,104,145
fa11,113,MUIR,CSE,Comp Sci,5,5,10,2,0,2,14,4,18,33,8,41,39,13,52,0,0,0,93,30,123
fa11,113,MUIR,CSE,CompEngCSE,3,2,5,1,0,1,4,0,4,12,3,15,7,0,7,0,0,0,27,5,32
fa11,113,MUIR,CSE,CompScBinf,1,0,1,0,0,0,0,1,1,2,0,2,3,1,4,0,0,0,6,2,8
fa11,113,MUIR,ECE,CompEngECE,2,1,3,0,0,0,2,0,2,2,0,2,1,0,1,0,0,0,7,1,8
fa11,113,MUIR,ECE,Electr Eng,7,3,10,1,1,2,12,3,15,15,3,18,21,1,22,0,0,0,56,11,67
fa11,113,MUIR,ECE,Engin Phys,0,0,0,0,0,0,0,0,0,0,0,0,1,0,1,0,0,0,1,0,1
fa11,113,MUIR,ECE,Pr-EngPhys,0,0,0,0,0,0,0,0,0,1,0,1,0,0,0,0,0,0,1,0,1
fa11,113,MUIR,ECON,Ec-Mth&Ecn,3,2,5,0,0,0,4,2,6,3,4,7,5,2,7,0,0,0,15,10,25
fa11,113,MUIR,ECON,Econ-MgtSc,1,4,5,3,4,7,15,6,21,25,24,49,44,23,67,0,0,0,88,61,149
fa11,113,MUIR,ECON,Economics,12,13,25,2,1,3,19,15,34,52,34,86,64,43,107,0,0,0,149,106,255
fa11,113,MUIR,ESYS,EnvSys(EB),0,4,4,2,2,4,2,12,14,8,10,18,6,16,22,0,0,0,18,44,62
fa11,113,MUIR,ESYS,EnvSys(EC),0,0,0,0,0,0,0,0,0,0,1,1,0,1,1,0,0,0,0,2,2
fa11,113,MUIR,ESYS,EnvSys(EP),0,1,1,0,0,0,0,6,6,0,3,3,2,2,4,0,0,0,2,12,14
fa11,113,MUIR,ESYS,EnvSys(ES),0,0,0,0,0,0,4,0,4,0,2,2,1,2,3,0,0,0,5,4,9
fa11,113,MUIR,ETHN,Ethnic St,0,0,0,0,0,0,0,0,0,3,1,4,1,6,7,0,0,0,4,7,11
fa11,113,MUIR,HDP,Human Dev,0,0,0,0,0,0,0,0,0,3,5,8,1,19,20,0,0,0,4,24,28
fa11,113,MUIR,HDP,Pr-HumnDev,0,1,1,0,3,3,1,10,11,2,12,14,1,5,6,0,0,0,4,31,35
fa11,113,MUIR,HIST,History,1,0,1,0,0,0,1,4,5,9,7,16,14,15,29,0,0,0,25,26,51
fa11,113,MUIR,INTD,Muir Sp Pr,0,0,0,0,0,0,0,0,0,0,0,0,0,1,1,0,0,0,0,1,1
fa11,113,MUIR,INTL,IntSt-Anth,0,0,0,0,0,0,0,1,1,0,1,1,0,2,2,0,0,0,0,4,4
fa11,113,MUIR,INTL,IntSt-Econ,2,1,3,0,0,0,2,4,6,3,11,14,5,14,19,0,0,0,12,30,42
fa11,113,MUIR,INTL,IntSt-Hist,0,0,0,0,0,0,0,0,0,2,0,2,2,0,2,0,0,0,4,0,4
fa11,113,MUIR,INTL,IntSt-Lit,0,2,2,0,0,0,0,1,1,0,0,0,1,1,2,0,0,0,1,4,5
fa11,113,MUIR,INTL,IntSt-PolS,1,1,2,0,0,0,2,3,5,3,4,7,4,15,19,0,0,0,10,23,33
fa11,113,MUIR,INTL,IntSt-Soc,0,0,0,0,0,0,0,3,3,0,3,3,2,10,12,0,0,0,2,16,18
fa11,113,MUIR,JAPN,JapaneseSt,0,0,0,0,0,0,1,2,3,1,0,1,2,2,4,0,0,0,4,4,8
fa11,113,MUIR,LATI,LatinAm St,0,0,0,0,0,0,1,0,1,0,0,0,0,1,1,0,0,0,1,1,2
fa11,113,MUIR,LING,Lang Stu,0,0,0,0,0,0,0,1,1,1,2,3,0,0,0,0,0,0,1,3,4
fa11,113,MUIR,LING,Ling-CogLn,0,2,2,0,0,0,0,0,0,0,1,1,2,1,3,0,0,0,2,4,6
fa11,113,MUIR,LING,Ling-LSoc,0,0,0,0,0,0,0,0,0,1,3,4,0,0,0,0,0,0,1,3,4
fa11,113,MUIR,LING,Linguistcs,0,0,0,0,0,0,3,1,4,2,1,3,1,5,6,0,0,0,6,7,13
fa11,113,MUIR,LIT,Lit/Compos,0,0,0,0,0,0,0,0,0,0,1,1,0,0,0,0,0,0,0,1,1
fa11,113,MUIR,LIT,Lit/CultSt,0,0,0,0,1,1,0,0,0,0,0,0,0,1,1,0,0,0,0,2,2
fa11,113,MUIR,LIT,Lit/Engl,0,1,1,0,0,0,0,4,4,1,5,6,6,8,14,0,0,0,7,18,25
fa11,113,MUIR,LIT,Lit/World,0,0,0,0,0,0,0,0,0,0,2,2,0,4,4,0,0,0,0,6,6
fa11,113,MUIR,LIT,Lit/Writng,0,5,5,0,0,0,2,3,5,2,4,6,3,12,15,0,0,0,7,24,31
fa11,113,MUIR,LIT,Pre-Lit/Wr,0,0,0,0,0,0,0,1,1,1,0,1,1,1,2,0,0,0,2,2,4
fa11,113,MUIR,LIT,Spanish Lt,0,2,2,0,0,0,0,1,1,0,0,0,2,5,7,0,0,0,2,8,10
fa11,113,MUIR,MAE,Aerosp Eng,6,0,6,1,0,1,3,3,6,7,3,10,18,2,20,0,0,0,35,8,43
fa11,113,MUIR,MAE,Engin Sci,1,0,1,0,0,0,3,0,3,0,0,0,3,0,3,0,0,0,7,0,7
fa11,113,MUIR,MAE,Envir Eng,9,5,14,0,0,0,3,5,8,6,4,10,9,9,18,0,0,0,27,23,50
fa11,113,MUIR,MAE,Mech Engin,7,1,8,0,0,0,4,1,5,9,1,10,41,3,44,0,0,0,61,6,67
fa11,113,MUIR,MATH,Appld Math,2,1,3,1,0,1,0,0,0,0,2,2,3,3,6,0,0,0,6,6,12
fa11,113,MUIR,MATH,Math/SecEd,0,2,2,0,2,2,0,2,2,0,2,2,2,1,3,0,0,0,2,9,11
fa11,113,MUIR,MATH,Mathematcs,4,6,10,0,0,0,4,1,5,3,1,4,7,6,13,0,0,0,18,14,32
fa11,113,MUIR,MATH,Mth-CompSc,0,0,0,0,0,0,0,0,0,0,0,0,2,0,2,0,0,0,2,0,2
fa11,113,MUIR,MATH,Mth-Mth&Ec,3,5,8,0,0,0,1,1,2,10,2,12,2,4,6,0,0,0,16,12,28
fa11,113,MUIR,MATH,Mth-SciCom,1,0,1,0,0,0,0,0,0,0,0,0,0,0,0,0,0,0,1,0,1
fa11,113,MUIR,MATH,Mth/ApldSc,0,0,0,1,0,1,0,0,0,1,0,1,2,0,2,0,0,0,4,0,4
fa11,113,MUIR,MATH,Pr-Math CS,0,0,0,0,0,0,2,0,2,0,0,0,0,0,0,0,0,0,2,0,2
fa11,113,MUIR,MATH,Prob&Stats,0,0,0,0,0,0,1,0,1,0,0,0,5,0,5,0,0,0,6,0,6
fa11,113,MUIR,MUS,Mu-CompArt,1,1,2,0,0,0,1,0,1,3,0,3,7,0,7,0,0,0,12,1,13
fa11,113,MUIR,MUS,Music,1,1,2,1,1,2,2,0,2,2,1,3,2,2,4,0,0,0,8,5,13
fa11,113,MUIR,MUS,Music Hum,0,0,0,0,0,0,0,0,0,1,0,1,0,0,0,0,0,0,1,0,1
fa11,113,MUIR,NENG,NanoEng,3,0,3,0,0,0,6,0,6,5,2,7,1,0,1,0,0,0,15,2,17
fa11,113,MUIR,PHIL,Philosophy,1,1,2,1,0,1,3,0,3,8,7,15,3,1,4,0,0,0,16,9,25
fa11,113,MUIR,PHYS,Biophysics,0,0,0,1,0,1,1,0,1,0,0,0,4,1,5,0,0,0,6,1,7
fa11,113,MUIR,PHYS,Phy/ErthSc,0,0,0,0,0,0,0,0,0,0,0,0,0,1,1,0,0,0,0,1,1
fa11,113,MUIR,PHYS,Phys/Astro,0,0,0,0,0,0,0,0,0,3,0,3,4,1,5,0,0,0,7,1,8
fa11,113,MUIR,PHYS,Physics,2,0,2,0,0,0,2,1,3,4,0,4,9,1,10,0,0,0,17,2,19
fa11,113,MUIR,POLI,Polit Sci,1,2,3,1,1,2,10,10,20,20,11,31,21,21,42,0,0,0,53,45,98
fa11,113,MUIR,POLI,PolSc-Amer,0,0,0,0,0,0,3,1,4,1,3,4,3,0,3,0,0,0,7,4,11
fa11,113,MUIR,POLI,PolSc-Comp,0,0,0,0,0,0,0,0,0,0,0,0,0,1,1,0,0,0,0,1,1
fa11,113,MUIR,POLI,PolSc-Intl,1,4,5,0,0,0,1,3,4,9,8,17,12,9,21,0,0,0,23,24,47
fa11,113,MUIR,POLI,PolSc-PLaw,2,2,4,0,0,0,6,5,11,5,6,11,8,1,9,0,0,0,21,14,35
fa11,113,MUIR,POLI,PolSc-PPol,0,1,1,0,0,0,0,1,1,1,0,1,2,0,2,0,0,0,3,2,5
fa11,113,MUIR,POLI,PolSc-Thry,1,0,1,0,0,0,0,0,0,2,0,2,2,0,2,0,0,0,5,0,5
fa11,113,MUIR,PSYC,Psychology,9,41,50,1,5,6,14,33,47,26,82,108,39,102,141,0,0,0,89,263,352
fa11,113,MUIR,RELI,Relig/Stu,0,0,0,0,0,0,0,0,0,0,1,1,3,1,4,0,0,0,3,2,5
fa11,113,MUIR,RUSS,Russ&SovSt,0,0,0,0,0,0,0,1,1,0,0,0,1,0,1,0,0,0,1,1,2
fa11,113,MUIR,SE,Engin Sci,1,0,1,0,0,0,0,0,0,0,0,0,0,0,0,0,0,0,1,0,1
fa11,113,MUIR,SE,Struct Eng,10,5,15,0,2,2,9,6,15,14,5,19,26,9,35,0,0,0,59,27,86
fa11,113,MUIR,SIO,Earth Sci,0,2,2,0,0,0,0,1,1,2,3,5,3,0,3,0,0,0,5,6,11
fa11,113,MUIR,SIO,ErSc-Geol,0,0,0,0,0,0,0,0,0,0,0,0,2,0,2,0,0,0,2,0,2
fa11,113,MUIR,SOC,SocAmSt,0,0,0,0,0,0,0,1,1,0,0,0,0,0,0,0,0,0,0,1,1
fa11,113,MUIR,SOC,SocCulCom,0,0,0,0,0,0,0,0,0,1,4,5,1,2,3,0,0,0,2,6,8
fa11,113,MUIR,SOC,SocIntlStu,0,0,0,0,0,0,0,0,0,0,0,0,0,2,2,0,0,0,0,2,2
fa11,113,MUIR,SOC,Sociology,2,6,8,0,0,0,5,4,9,15,19,34,8,16,24,0,0,0,30,45,75
fa11,113,MUIR,SOC,SocLawSoc,0,0,0,0,2,2,0,3,3,2,3,5,2,3,5,0,0,0,4,11,15
fa11,113,MUIR,SOC,SocSciMed,0,0,0,0,0,0,0,0,0,1,2,3,0,5,5,0,0,0,1,7,8
fa11,113,MUIR,SOC,SocSolneq,0,0,0,0,0,0,0,1,1,0,1,1,0,2,2,0,0,0,0,4,4
fa11,113,MUIR,THEA,Dance,1,1,2,0,0,0,0,0,0,0,1,1,1,2,3,0,0,0,2,4,6
fa11,113,MUIR,THEA,Theatre,1,5,6,0,0,0,1,2,3,2,6,8,2,10,12,0,0,0,6,23,29
fa11,113,MUIR,UNAF,Limited St,0,0,0,0,0,0,0,0,0,0,0,0,0,0,0,0,1,1,0,1,1
fa11,113,MUIR,UNAF,UndecHumAr,2,5,7,0,1,1,1,1,2,0,0,0,0,0,0,0,0,0,3,7,10
fa11,113,MUIR,UNAF,Undeclared,37,50,87,5,7,12,17,24,41,3,6,9,0,0,0,0,0,0,62,87,149
fa11,113,MUIR,UNAF,UndecPhysS,5,3,8,0,0,0,3,2,5,0,1,1,0,0,0,0,0,0,8,6,14
fa11,113,MUIR,UNAF,UndecSocSc,3,8,11,2,0,2,0,3,3,0,0,0,0,0,0,0,0,0,5,11,16
fa11,113,MUIR,USP,Urb Stu&Pl,0,0,0,0,0,0,2,1,3,5,6,11,6,8,14,0,0,0,13,15,28
fa11,113,MUIR,VIS,Art Hst/Cr,1,0,1,0,0,0,0,1,1,0,4,4,1,3,4,0,0,0,2,8,10
fa11,113,MUIR,VIS,Media,0,0,0,1,0,1,4,7,11,7,7,14,8,13,21,0,0,0,20,27,47
fa11,113,MUIR,VIS,Studio VA,0,0,0,0,1,1,0,1,1,1,4,5,3,8,11,0,0,0,4,14,18
fa11,113,MUIR,VIS,VA-CompArt,0,1,1,0,0,0,1,0,1,1,4,5,5,3,8,0,0,0,7,8,15
fa11,113,REVELLE,ANTH,Anth-Arch,0,3,3,1,0,1,0,0,0,1,0,1,0,1,1,0,0,0,2,4,6
fa11,113,REVELLE,ANTH,Anth-Biol,0,1,1,0,0,0,0,1,1,2,2,4,1,6,7,0,0,0,3,10,13
fa11,113,REVELLE,ANTH,Anth-Soci,0,1,1,0,0,0,0,0,0,0,0,0,2,8,10,0,0,0,2,9,11
fa11,113,REVELLE,BENG,Bioen:Binf,6,3,9,1,0,1,2,1,3,3,1,4,2,2,4,0,0,0,14,7,21
fa11,113,REVELLE,BENG,Bioeng:PM,0,0,0,0,0,0,0,0,0,1,0,1,15,4,19,0,0,0,16,4,20
fa11,113,REVELLE,BENG,BioengBiot,7,2,9,0,0,0,4,2,6,7,4,11,23,11,34,0,0,0,41,19,60
fa11,113,REVELLE,BENG,Bioengin,8,11,19,0,1,1,2,3,5,3,4,7,17,6,23,0,0,0,30,25,55
fa11,113,REVELLE,BENG,Pr-BioenPM,0,0,0,0,0,0,0,0,0,1,0,1,1,0,1,0,0,0,2,0,2
fa11,113,REVELLE,BIOL,Bioc/CellB,8,23,31,0,1,1,5,8,13,19,13,32,74,57,131,0,0,0,106,102,208
fa11,113,REVELLE,BIOL,BiolBioinf,0,2,2,0,0,0,0,0,0,0,0,0,1,0,1,0,0,0,1,2,3
fa11,113,REVELLE,BIOL,Ec/Beh/Evo,2,1,3,0,0,0,0,2,2,3,2,5,3,8,11,0,0,0,8,13,21
fa11,113,REVELLE,BIOL,Genl Biol,2,14,16,1,0,1,8,14,22,15,24,39,45,95,140,0,0,0,71,147,218
fa11,113,REVELLE,BIOL,Human Bio,26,40,66,0,3,3,6,21,27,27,52,79,101,102,203,0,0,0,160,218,378
fa11,113,REVELLE,BIOL,Microbiol,4,2,6,0,0,0,1,1,2,3,4,7,10,8,18,0,0,0,18,15,33
fa11,113,REVELLE,BIOL,Molec Biol,1,1,2,0,0,0,0,2,2,4,3,7,10,10,20,0,0,0,15,16,31
fa11,113,REVELLE,BIOL,PhyslNeuro,6,12,18,0,1,1,6,6,12,10,19,29,32,37,69,0,0,0,54,75,129
fa11,113,REVELLE,CENG,Chem Engin,14,4,18,0,0,0,9,2,11,12,8,20,20,6,26,0,0,0,55,20,75
fa11,113,REVELLE,CGS,CritGendSt,0,0,0,0,0,0,0,0,0,0,0,0,0,1,1,0,0,0,0,1,1
fa11,113,REVELLE,CHEM,Bioch/Chem,6,12,18,1,1,2,8,16,24,18,19,37,22,21,43,0,0,0,55,69,124
fa11,113,REVELLE,CHEM,Bioinform,0,1,1,0,0,0,0,0,0,0,0,0,0,0,0,0,0,0,0,1,1
fa11,113,REVELLE,CHEM,Chem Phys,0,0,0,0,0,0,0,0,0,1,0,1,0,0,0,0,0,0,1,0,1
fa11,113,REVELLE,CHEM,Chemistry,7,6,13,0,0,0,2,3,5,10,13,23,8,12,20,0,0,0,27,34,61
fa11,113,REVELLE,CHEM,Envir Chem,0,1,1,0,0,0,0,1,1,0,1,1,1,1,2,0,0,0,1,4,5
fa11,113,REVELLE,CHEM,MolecSynth,1,0,1,0,0,0,0,0,0,1,0,1,3,0,3,0,0,0,5,0,5
fa11,113,REVELLE,CHEM,Pharm Chem,5,9,14,2,0,2,4,16,20,14,28,42,21,31,52,0,0,0,46,84,130
fa11,113,REVELLE,CLAS,Classic St,0,0,0,0,0,0,0,0,0,0,0,0,0,1,1,0,0,0,0,1,1
fa11,113,REVELLE,COGS,Cog Sci,1,3,4,1,1,2,8,6,14,5,3,8,4,1,5,0,0,0,19,14,33
fa11,113,REVELLE,COGS,CogSc/ClAs,0,0,0,0,0,0,0,0,0,0,3,3,1,3,4,0,0,0,1,6,7
fa11,113,REVELLE,COGS,CogSc/Comp,0,0,0,0,0,0,0,0,0,1,1,2,1,0,1,0,0,0,2,1,3
fa11,113,REVELLE,COGS,CogSc/HCI,0,0,0,0,0,0,0,1,1,1,0,1,0,0,0,0,0,0,1,1,2
fa11,113,REVELLE,COGS,CogSc/HCog,0,0,0,0,0,0,0,3,3,0,3,3,0,1,1,0,0,0,0,7,7
fa11,113,REVELLE,COGS,CogSc/Neur,2,1,3,0,1,1,3,10,13,3,19,22,3,8,11,0,0,0,11,39,50
fa11,113,REVELLE,COMM,Communic,1,4,5,1,0,1,3,3,6,9,16,25,6,12,18,0,0,0,20,35,55
fa11,113,REVELLE,CSE,Comp Sci,14,4,18,1,0,1,13,0,13,32,3,35,50,7,57,0,0,0,110,14,124
fa11,113,REVELLE,CSE,CompEngCSE,13,0,13,0,0,0,4,0,4,5,1,6,8,1,9,0,0,0,30,2,32
fa11,113,REVELLE,CSE,CompScBinf,0,2,2,0,0,0,1,0,1,2,0,2,2,3,5,0,0,0,5,5,10
fa11,113,REVELLE,ECE,CompEngECE,1,1,2,1,0,1,3,0,3,2,1,3,2,0,2,0,0,0,9,2,11
fa11,113,REVELLE,ECE,Electr Eng,17,2,19,0,0,0,2,0,2,30,2,32,25,7,32,0,0,0,74,11,85
fa11,113,REVELLE,ECE,Engin Phys,0,0,0,1,0,1,1,0,1,1,0,1,1,0,1,0,0,0,4,0,4
fa11,113,REVELLE,ECE,Pr-EngPhys,4,0,4,0,0,0,0,0,0,0,0,0,0,0,0,0,0,0,4,0,4
fa11,113,REVELLE,ECON,Ec-Mth&Ecn,4,3,7,0,0,0,1,2,3,5,2,7,7,2,9,0,0,0,17,9,26
fa11,113,REVELLE,ECON,Econ-MgtSc,5,4,9,0,1,1,5,4,9,17,8,25,32,5,37,0,0,0,59,22,81
fa11,113,REVELLE,ECON,Economics,15,5,20,1,1,2,6,4,10,41,24,65,43,27,70,0,0,0,106,61,167
fa11,113,REVELLE,ESYS,EnvSys(EB),2,0,2,0,0,0,1,4,5,1,12,13,3,0,3,0,0,0,7,16,23
fa11,113,REVELLE,ESYS,EnvSys(EC),0,0,0,0,0,0,0,0,0,0,1,1,0,0,0,0,0,0,0,1,1
fa11,113,REVELLE,ESYS,EnvSys(EP),0,1,1,0,0,0,0,0,0,1,1,2,0,2,2,0,0,0,1,4,5
fa11,113,REVELLE,ESYS,EnvSys(ES),0,2,2,0,0,0,0,0,0,2,0,2,1,1,2,0,0,0,3,3,6
fa11,113,REVELLE,ETHN,Ethnic St,0,0,0,0,0,0,0,0,0,2,2,4,0,3,3,0,0,0,2,5,7
fa11,113,REVELLE,HDP,Human Dev,0,0,0,0,0,0,0,0,0,0,0,0,1,15,16,0,0,0,1,15,16
fa11,113,REVELLE,HDP,Pr-HumnDev,1,2,3,0,0,0,2,8,10,0,7,7,0,1,1,0,0,0,3,18,21
fa11,113,REVELLE,HIST,History,1,2,3,0,0,0,1,0,1,8,4,12,5,9,14,0,0,0,15,15,30
fa11,113,REVELLE,INTD,Rev Ind Mj,0,0,0,0,0,0,0,0,0,0,0,0,1,1,2,0,0,0,1,1,2
fa11,113,REVELLE,INTL,Int-5yrPS,0,0,0,0,0,0,0,0,0,0,0,0,0,1,1,0,0,0,0,1,1
fa11,113,REVELLE,INTL,IntSt-Anth,0,0,0,0,0,0,0,0,0,1,0,1,1,0,1,0,0,0,2,0,2
fa11,113,REVELLE,INTL,IntSt-Econ,0,2,2,0,0,0,0,2,2,3,6,9,9,5,14,0,0,0,12,15,27
fa11,113,REVELLE,INTL,IntSt-Hist,0,0,0,0,0,0,0,0,0,0,1,1,0,2,2,0,0,0,0,3,3
fa11,113,REVELLE,INTL,IntSt-Ling,0,2,2,0,0,0,0,0,0,0,1,1,1,0,1,0,0,0,1,3,4
fa11,113,REVELLE,INTL,IntSt-PolS,0,2,2,0,0,0,0,1,1,0,2,2,5,3,8,0,0,0,5,8,13
fa11,113,REVELLE,INTL,IntSt-Soc,0,2,2,0,0,0,0,0,0,0,3,3,0,2,2,0,0,0,0,7,7
fa11,113,REVELLE,JAPN,JapaneseSt,0,0,0,0,0,0,0,0,0,1,0,1,1,1,2,0,0,0,2,1,3
fa11,113,REVELLE,JUDA,Judaic Stu,0,0,0,0,0,0,0,0,0,0,0,0,1,0,1,0,0,0,1,0,1
fa11,113,REVELLE,LING,Lang Stu,0,0,0,0,0,0,0,0,0,0,1,1,0,1,1,0,0,0,0,2,2
fa11,113,REVELLE,LING,Ling-CogLn,0,0,0,0,0,0,0,1,1,1,1,2,1,3,4,0,0,0,2,5,7
fa11,113,REVELLE,LING,Ling-LSoc,0,0,0,0,0,0,0,0,0,0,1,1,0,0,0,0,0,0,0,1,1
fa11,113,REVELLE,LING,Linguistcs,0,0,0,0,0,0,1,0,1,1,2,3,0,3,3,0,0,0,2,5,7
fa11,113,REVELLE,LIT,Lit/Compos,0,0,0,0,0,0,0,1,1,1,0,1,1,0,1,0,0,0,2,1,3
fa11,113,REVELLE,LIT,Lit/Engl,0,3,3,0,0,0,0,0,0,1,1,2,1,0,1,0,0,0,2,4,6
fa11,113,REVELLE,LIT,Lit/World,0,0,0,0,0,0,0,0,0,0,0,0,1,1,2,0,0,0,1,1,2
fa11,113,REVELLE,LIT,Lit/Writng,0,0,0,0,0,0,2,2,4,0,3,3,1,4,5,0,0,0,3,9,12
fa11,113,REVELLE,LIT,Pre-Lit/Wr,0,0,0,0,0,0,0,0,0,0,2,2,1,0,1,0,0,0,1,2,3
fa11,113,REVELLE,LIT,Spanish Lt,1,0,1,0,0,0,0,1,1,0,0,0,1,0,1,0,0,0,2,1,3
fa11,113,REVELLE,MAE,Aerosp Eng,4,4,8,0,0,0,4,0,4,7,2,9,15,4,19,0,0,0,30,10,40
fa11,113,REVELLE,MAE,Engin Sci,1,0,1,0,0,0,4,1,5,2,0,2,3,2,5,0,0,0,10,3,13
fa11,113,REVELLE,MAE,Envir Eng,6,9,15,1,0,1,6,0,6,6,1,7,6,2,8,0,0,0,25,12,37
fa11,113,REVELLE,MAE,Mech Engin,13,1,14,0,0,0,8,2,10,9,3,12,38,8,46,0,0,0,68,14,82
fa11,113,REVELLE,MATH,Appld Math,3,0,3,0,0,0,3,0,3,3,3,6,1,3,4,0,0,0,10,6,16
fa11,113,REVELLE,MATH,Math/SecEd,1,0,1,0,0,0,1,0,1,0,0,0,3,2,5,0,0,0,5,2,7
fa11,113,REVELLE,MATH,Mathematcs,8,3,11,0,0,0,1,2,3,5,4,9,4,4,8,0,0,0,18,13,31
fa11,113,REVELLE,MATH,Mth-CompSc,0,0,0,0,0,0,0,0,0,1,0,1,1,1,2,0,0,0,2,1,3
fa11,113,REVELLE,MATH,Mth-Mth&Ec,0,3,3,0,0,0,0,0,0,2,1,3,5,1,6,0,0,0,7,5,12
fa11,113,REVELLE,MATH,Mth-SciCom,0,0,0,0,0,0,0,1,1,0,0,0,0,1,1,0,0,0,0,2,2
fa11,113,REVELLE,MATH,Mth/ApldSc,0,0,0,0,0,0,1,0,1,1,0,1,0,1,1,0,0,0,2,1,3
fa11,113,REVELLE,MATH,Prob&Stats,0,0,0,0,0,0,1,1,2,2,1,3,3,0,3,0,0,0,6,2,8
fa11,113,REVELLE,MUS,Mu-CompArt,0,0,0,0,0,0,0,0,0,1,0,1,6,0,6,0,0,0,7,0,7
fa11,113,REVELLE,MUS,Music,1,0,1,0,0,0,1,0,1,2,1,3,3,1,4,0,0,0,7,2,9
fa11,113,REVELLE,NENG,NanoEng,8,3,11,0,0,0,5,2,7,16,3,19,4,3,7,0,0,0,33,11,44
fa11,113,REVELLE,PHIL,Philosophy,2,0,2,0,0,0,1,1,2,6,0,6,7,2,9,0,0,0,16,3,19
fa11,113,REVELLE,PHYS,Biophysics,0,0,0,0,0,0,1,0,1,1,3,4,0,1,1,0,0,0,2,4,6
fa11,113,REVELLE,PHYS,GenPys/SEd,0,0,0,0,0,0,1,0,1,0,0,0,0,0,0,0,0,0,1,0,1
fa11,113,REVELLE,PHYS,Phy/ErthSc,0,0,0,0,0,0,0,0,0,1,0,1,2,0,2,0,0,0,3,0,3
fa11,113,REVELLE,PHYS,Phys/Astro,1,2,3,0,0,0,0,0,0,3,0,3,3,1,4,0,0,0,7,3,10
fa11,113,REVELLE,PHYS,Phys/Comp,0,0,0,0,0,0,0,0,0,1,1,2,1,0,1,0,0,0,2,1,3
fa11,113,REVELLE,PHYS,Phys/Mtrls,1,0,1,0,0,0,1,1,2,0,0,0,1,0,1,0,0,0,3,1,4
fa11,113,REVELLE,PHYS,Physics,3,4,7,0,0,0,3,0,3,5,0,5,10,1,11,0,0,0,21,5,26
fa11,113,REVELLE,POLI,Polit Sci,2,3,5,0,0,0,0,3,3,4,7,11,16,10,26,0,0,0,22,23,45
fa11,113,REVELLE,POLI,PolSc-Amer,0,0,0,0,0,0,0,0,0,3,2,5,1,4,5,0,0,0,4,6,10
fa11,113,REVELLE,POLI,PolSc-Comp,0,0,0,0,0,0,0,0,0,0,0,0,0,1,1,0,0,0,0,1,1
fa11,113,REVELLE,POLI,PolSc-Intl,1,1,2,0,0,0,2,3,5,5,2,7,5,5,10,0,0,0,13,11,24
fa11,113,REVELLE,POLI,PolSc-PLaw,1,4,5,0,0,0,1,2,3,1,1,2,4,4,8,0,0,0,7,11,18
fa11,113,REVELLE,POLI,PolSc-PPol,0,0,0,0,0,0,1,1,2,0,1,1,0,0,0,0,0,0,1,2,3
fa11,113,REVELLE,POLI,PolSc-Thry,0,0,0,0,0,0,1,0,1,0,1,1,0,0,0,0,0,0,1,1,2
fa11,113,REVELLE,PSYC,Psychology,9,22,31,0,1,1,6,21,27,23,46,69,28,74,102,0,0,0,66,164,230
fa11,113,REVELLE,RELI,Relig/Stu,0,1,1,0,0,0,0,0,0,1,1,2,0,0,0,0,0,0,1,2,3
fa11,113,REVELLE,SE,Engin Sci,2,1,3,0,0,0,0,0,0,0,0,0,1,0,1,0,0,0,3,1,4
fa11,113,REVELLE,SE,Struct Eng,12,4,16,0,0,0,11,2,13,8,3,11,25,8,33,0,0,0,56,17,73
fa11,113,REVELLE,SIO,Earth Sci,0,1,1,0,0,0,0,1,1,1,1,2,2,1,3,0,0,0,3,4,7
fa11,113,REVELLE,SIO,ErSc-Geol,0,0,0,0,0,0,0,0,0,0,0,0,1,0,1,0,0,0,1,0,1
fa11,113,REVELLE,SOC,SocCulCom,0,0,0,0,0,0,0,0,0,0,0,0,0,2,2,0,0,0,0,2,2
fa11,113,REVELLE,SOC,SocEconSoc,0,0,0,0,0,0,0,0,0,0,1,1,1,2,3,0,0,0,1,3,4
fa11,113,REVELLE,SOC,Sociology,1,2,3,0,0,0,0,2,2,5,4,9,3,4,7,0,0,0,9,12,21
fa11,113,REVELLE,SOC,SocLawSoc,0,0,0,0,0,0,1,1,2,0,0,0,1,2,3,0,0,0,2,3,5
fa11,113,REVELLE,SOC,SocSciMed,0,1,1,0,1,1,0,2,2,0,0,0,0,3,3,0,0,0,0,7,7
fa11,113,REVELLE,THEA,Dance,0,0,0,0,0,0,0,0,0,0,1,1,0,1,1,0,0,0,0,2,2
fa11,113,REVELLE,THEA,Theatre,0,1,1,0,0,0,2,0,2,0,1,1,1,2,3,0,0,0,3,4,7
fa11,113,REVELLE,TWS,ThirdWldSt,0,0,0,0,0,0,0,0,0,0,1,1,0,1,1,0,0,0,0,2,2
fa11,113,REVELLE,UNAF,Limited St,0,0,0,0,0,0,0,0,0,0,0,0,0,0,0,5,9,14,5,9,14
fa11,113,REVELLE,UNAF,Spec-Emply,0,0,0,0,0,0,0,0,0,0,0,0,0,0,0,2,3,5,2,3,5
fa11,113,REVELLE,UNAF,UndecHumAr,2,3,5,0,0,0,0,2,2,0,1,1,0,0,0,0,0,0,2,6,8
fa11,113,REVELLE,UNAF,Undeclared,46,47,93,1,3,4,10,19,29,6,10,16,1,0,1,0,0,0,64,79,143
fa11,113,REVELLE,UNAF,UndecPhysS,4,4,8,0,0,0,0,2,2,1,0,1,0,0,0,0,0,0,5,6,11
fa11,113,REVELLE,UNAF,UndecSocSc,2,3,5,0,0,0,0,0,0,0,0,0,0,0,0,0,0,0,2,3,5
fa11,113,REVELLE,USP,Urb Stu&Pl,0,0,0,0,0,0,0,1,1,4,0,4,2,2,4,0,0,0,6,3,9
fa11,113,REVELLE,VIS,Art Hst/Cr,0,0,0,0,0,0,0,0,0,0,0,0,0,2,2,0,0,0,0,2,2
fa11,113,REVELLE,VIS,Media,0,0,0,0,0,0,0,0,0,2,3,5,3,4,7,0,0,0,5,7,12
fa11,113,REVELLE,VIS,Studio VA,0,2,2,0,0,0,0,0,0,0,1,1,3,3,6,0,0,0,3,6,9
fa11,113,REVELLE,VIS,VA-CompArt,1,0,1,0,0,0,0,0,0,3,2,5,4,2,6,0,0,0,8,4,12
fa11,113,ROOSEVELT,ANTH,Anth-Arch,0,0,0,0,0,0,1,3,4,0,2,2,1,5,6,0,0,0,2,10,12
fa11,113,ROOSEVELT,ANTH,Anth-Biol,0,2,2,0,0,0,0,0,0,0,4,4,0,5,5,0,0,0,0,11,11
fa11,113,ROOSEVELT,ANTH,Anth-Soci,0,1,1,0,0,0,0,1,1,5,8,13,0,3,3,0,0,0,5,13,18
fa11,113,ROOSEVELT,BENG,Bioen:Binf,2,4,6,0,0,0,0,1,1,4,0,4,0,2,2,0,0,0,6,7,13
fa11,113,ROOSEVELT,BENG,Bioeng:PM,0,0,0,0,0,0,0,0,0,2,0,2,8,4,12,0,0,0,10,4,14
fa11,113,ROOSEVELT,BENG,BioengBiot,4,1,5,0,0,0,0,1,1,4,2,6,12,5,17,0,0,0,20,9,29
fa11,113,ROOSEVELT,BENG,Bioengin,2,4,6,0,0,0,0,1,1,5,0,5,3,7,10,0,0,0,10,12,22
fa11,113,ROOSEVELT,BIOL,Bioc/CellB,10,8,18,0,0,0,2,2,4,6,9,15,19,27,46,0,0,0,37,46,83
fa11,113,ROOSEVELT,BIOL,BiolBioinf,1,0,1,0,0,0,0,0,0,0,0,0,0,0,0,0,0,0,1,0,1
fa11,113,ROOSEVELT,BIOL,Ec/Beh/Evo,0,4,4,0,0,0,0,0,0,3,1,4,2,8,10,0,0,0,5,13,18
fa11,113,ROOSEVELT,BIOL,Genl Biol,8,11,19,0,0,0,4,4,8,16,17,33,28,50,78,0,0,0,56,82,138
fa11,113,ROOSEVELT,BIOL,Human Bio,14,25,39,1,0,1,4,16,20,26,23,49,33,75,108,0,0,0,78,139,217
fa11,113,ROOSEVELT,BIOL,Microbiol,0,5,5,0,0,0,0,0,0,0,0,0,2,3,5,0,0,0,2,8,10
fa11,113,ROOSEVELT,BIOL,Molec Biol,3,2,5,0,0,0,1,2,3,0,2,2,4,5,9,0,0,0,8,11,19
fa11,113,ROOSEVELT,BIOL,PhyslNeuro,4,16,20,0,0,0,2,5,7,5,7,12,14,19,33,0,0,0,25,47,72
fa11,113,ROOSEVELT,CENG,Chem Engin,7,2,9,0,0,0,4,3,7,8,2,10,6,4,10,0,0,0,25,11,36
fa11,113,ROOSEVELT,CGS,CritGendSt,0,1,1,0,0,0,0,0,0,0,1,1,0,0,0,0,0,0,0,2,2
fa11,113,ROOSEVELT,CHEM,Bioch/Chem,1,4,5,0,1,1,8,10,18,12,18,30,10,13,23,0,0,0,31,46,77
fa11,113,ROOSEVELT,CHEM,Bioinform,0,0,0,0,1,1,0,0,0,0,0,0,0,0,0,0,0,0,0,1,1
fa11,113,ROOSEVELT,CHEM,Chem Educ,1,0,1,0,0,0,0,0,0,0,0,0,0,0,0,0,0,0,1,0,1
fa11,113,ROOSEVELT,CHEM,Chemistry,10,2,12,0,2,2,1,1,2,4,6,10,6,2,8,0,0,0,21,13,34
fa11,113,ROOSEVELT,CHEM,Envir Chem,0,0,0,0,0,0,1,0,1,1,0,1,2,1,3,0,0,0,4,1,5
fa11,113,ROOSEVELT,CHEM,Pharm Chem,8,8,16,0,0,0,5,3,8,5,8,13,12,12,24,0,0,0,30,31,61
fa11,113,ROOSEVELT,CHIN,Chinese St,0,1,1,0,0,0,0,3,3,1,2,3,0,0,0,0,0,0,1,6,7
fa11,113,ROOSEVELT,CLAS,Classic St,0,1,1,0,0,0,0,0,0,0,2,2,0,0,0,0,0,0,0,3,3
fa11,113,ROOSEVELT,COGS,Cog Sci,2,3,5,1,0,1,1,2,3,1,5,6,6,6,12,0,0,0,11,16,27
fa11,113,ROOSEVELT,COGS,CogSc/ClAs,0,2,2,0,0,0,0,2,2,0,2,2,0,0,0,0,0,0,0,6,6
fa11,113,ROOSEVELT,COGS,CogSc/Comp,0,0,0,0,0,0,0,0,0,0,0,0,0,1,1,0,0,0,0,1,1
fa11,113,ROOSEVELT,COGS,CogSc/HCI,0,0,0,0,0,0,0,2,2,0,0,0,5,2,7,0,0,0,5,4,9
fa11,113,ROOSEVELT,COGS,CogSc/HCog,0,0,0,1,0,1,2,0,2,1,2,3,0,1,1,0,0,0,4,3,7
fa11,113,ROOSEVELT,COGS,CogSc/Neur,0,2,2,0,0,0,1,12,13,4,7,11,3,12,15,0,0,0,8,33,41
fa11,113,ROOSEVELT,COMM,Communic,3,5,8,0,1,1,2,14,16,14,53,67,26,49,75,0,0,0,45,122,167
fa11,113,ROOSEVELT,CSE,Comp Sci,8,0,8,0,0,0,8,2,10,16,6,22,32,8,40,0,0,0,64,16,80
fa11,113,ROOSEVELT,CSE,CompEngCSE,5,0,5,1,0,1,2,0,2,4,1,5,3,0,3,0,0,0,15,1,16
fa11,113,ROOSEVELT,CSE,CompScBinf,0,0,0,0,0,0,0,0,0,0,0,0,1,1,2,0,0,0,1,1,2
fa11,113,ROOSEVELT,ECE,CompEngECE,2,2,4,0,0,0,0,0,0,2,0,2,2,0,2,0,0,0,6,2,8
fa11,113,ROOSEVELT,ECE,Electr Eng,11,0,11,1,1,2,5,1,6,12,6,18,15,3,18,0,0,0,44,11,55
fa11,113,ROOSEVELT,ECE,EleEng&Soc,1,0,1,0,0,0,0,0,0,0,0,0,0,0,0,0,0,0,1,0,1
fa11,113,ROOSEVELT,ECE,Engin Phys,1,0,1,0,0,0,0,0,0,1,0,1,0,0,0,0,0,0,2,0,2
fa11,113,ROOSEVELT,ECON,Ec-Mth&Ecn,0,3,3,0,1,1,3,3,6,4,2,6,6,2,8,0,0,0,13,11,24
fa11,113,ROOSEVELT,ECON,Econ-MgtSc,7,5,12,0,0,0,9,12,21,23,6,29,45,26,71,0,0,0,84,49,133
fa11,113,ROOSEVELT,ECON,Economics,6,7,13,1,2,3,8,11,19,54,38,92,56,40,96,0,0,0,125,98,223
fa11,113,ROOSEVELT,ESYS,EnvSys(EB),0,5,5,0,0,0,1,5,6,3,8,11,3,13,16,0,0,0,7,31,38
fa11,113,ROOSEVELT,ESYS,EnvSys(EC),0,0,0,0,0,0,0,1,1,1,2,3,1,2,3,0,0,0,2,5,7
fa11,113,ROOSEVELT,ESYS,EnvSys(EP),0,0,0,0,0,0,0,0,0,0,0,0,0,3,3,0,0,0,0,3,3
fa11,113,ROOSEVELT,ESYS,EnvSys(ES),0,1,1,0,0,0,1,0,1,0,3,3,1,3,4,0,0,0,2,7,9
fa11,113,ROOSEVELT,ETHN,Ethnic St,0,0,0,0,0,0,0,2,2,0,2,2,0,7,7,0,0,0,0,11,11
fa11,113,ROOSEVELT,HDP,Human Dev,0,0,0,0,0,0,0,0,0,2,8,10,3,14,17,0,0,0,5,22,27
fa11,113,ROOSEVELT,HDP,Pr-HumnDev,0,3,3,0,0,0,0,10,10,0,5,5,0,5,5,0,0,0,0,23,23
fa11,113,ROOSEVELT,HIST,History,2,2,4,1,0,1,3,3,6,14,17,31,10,19,29,0,0,0,30,41,71
fa11,113,ROOSEVELT,INTL,Int-5yrEC,0,0,0,0,0,0,0,0,0,0,0,0,0,1,1,0,0,0,0,1,1
fa11,113,ROOSEVELT,INTL,IntSt-Anth,0,2,2,0,0,0,0,1,1,0,1,1,2,9,11,0,0,0,2,13,15
fa11,113,ROOSEVELT,INTL,IntSt-Econ,4,5,9,1,0,1,5,13,18,5,8,13,13,25,38,0,0,0,28,51,79
fa11,113,ROOSEVELT,INTL,IntSt-Hist,0,1,1,1,0,1,0,2,2,3,2,5,4,10,14,0,0,0,8,15,23
fa11,113,ROOSEVELT,INTL,IntSt-Ling,1,1,2,0,1,1,0,2,2,1,5,6,0,3,3,0,0,0,2,12,14
fa11,113,ROOSEVELT,INTL,IntSt-Lit,0,1,1,0,0,0,0,2,2,0,1,1,0,0,0,0,0,0,0,4,4
fa11,113,ROOSEVELT,INTL,IntSt-PolS,4,9,13,0,0,0,8,13,21,8,22,30,15,47,62,0,0,0,35,91,126
fa11,113,ROOSEVELT,INTL,IntSt-Soc,1,5,6,0,0,0,4,9,13,2,11,13,1,21,22,0,0,0,8,46,54
fa11,113,ROOSEVELT,ITAL,Italian St,1,0,1,0,0,0,0,0,0,0,0,0,0,1,1,0,0,0,1,1,2
fa11,113,ROOSEVELT,JAPN,JapaneseSt,0,0,0,0,0,0,0,0,0,1,0,1,2,1,3,0,0,0,3,1,4
fa11,113,ROOSEVELT,LATI,LatinAm St,0,0,0,0,0,0,0,0,0,1,2,3,1,3,4,0,0,0,2,5,7
fa11,113,ROOSEVELT,LING,Lang Stu,1,2,3,0,0,0,0,1,1,0,1,1,0,1,1,0,0,0,1,5,6
fa11,113,ROOSEVELT,LING,Ling-CogLn,0,1,1,0,0,0,0,0,0,0,1,1,0,0,0,0,0,0,0,2,2
fa11,113,ROOSEVELT,LING,Ling-LSoc,0,0,0,0,0,0,1,0,1,0,4,4,0,2,2,0,0,0,1,6,7
fa11,113,ROOSEVELT,LING,Linguistcs,0,1,1,0,0,0,0,1,1,3,3,6,0,4,4,0,0,0,3,9,12
fa11,113,ROOSEVELT,LIT,Lit/Compos,0,0,0,0,0,0,0,0,0,0,0,0,1,0,1,0,0,0,1,0,1
fa11,113,ROOSEVELT,LIT,Lit/CultSt,0,0,0,0,0,0,0,0,0,1,0,1,0,1,1,0,0,0,1,1,2
fa11,113,ROOSEVELT,LIT,Lit/Engl,0,3,3,0,0,0,0,0,0,3,5,8,3,8,11,0,0,0,6,16,22
fa11,113,ROOSEVELT,LIT,Lit/World,0,3,3,0,0,0,0,1,1,0,0,0,3,4,7,0,0,0,3,8,11
fa11,113,ROOSEVELT,LIT,Lit/Writng,0,5,5,0,0,0,2,3,5,1,7,8,7,15,22,0,0,0,10,30,40
fa11,113,ROOSEVELT,LIT,Pre-Lit/Wr,0,0,0,0,0,0,0,0,0,0,1,1,2,2,4,0,0,0,2,3,5
fa11,113,ROOSEVELT,LIT,Spanish Lt,0,0,0,0,0,0,0,1,1,1,1,2,0,0,0,0,0,0,1,2,3
fa11,113,ROOSEVELT,MAE,Aerosp Eng,4,1,5,0,0,0,0,1,1,9,0,9,13,4,17,0,0,0,26,6,32
fa11,113,ROOSEVELT,MAE,Engin Sci,0,0,0,0,1,1,1,0,1,4,0,4,2,0,2,0,0,0,7,1,8
fa11,113,ROOSEVELT,MAE,Envir Eng,2,3,5,0,0,0,3,0,3,4,2,6,4,2,6,0,0,0,13,7,20
fa11,113,ROOSEVELT,MAE,Mech Engin,3,1,4,1,0,1,2,0,2,12,1,13,35,4,39,0,0,0,53,6,59
fa11,113,ROOSEVELT,MATH,Appld Math,1,0,1,0,0,0,0,3,3,0,0,0,0,1,1,0,0,0,1,4,5
fa11,113,ROOSEVELT,MATH,Math/SecEd,0,0,0,0,0,0,0,1,1,0,1,1,0,1,1,0,0,0,0,3,3
fa11,113,ROOSEVELT,MATH,Mathematcs,1,1,2,0,0,0,2,0,2,4,2,6,1,3,4,0,0,0,8,6,14
fa11,113,ROOSEVELT,MATH,Mth-CompSc,0,0,0,0,0,0,0,0,0,0,1,1,1,0,1,0,0,0,1,1,2
fa11,113,ROOSEVELT,MATH,Mth-Mth&Ec,0,5,5,0,1,1,1,3,4,4,2,6,5,1,6,0,0,0,10,12,22
fa11,113,ROOSEVELT,MATH,Mth/ApldSc,0,1,1,0,0,0,0,0,0,0,0,0,0,0,0,0,0,0,0,1,1
fa11,113,ROOSEVELT,MATH,Pr-Math CS,0,0,0,0,0,0,0,0,0,0,1,1,0,0,0,0,0,0,0,1,1
fa11,113,ROOSEVELT,MATH,Prob&Stats,0,1,1,0,0,0,0,0,0,0,1,1,0,1,1,0,0,0,0,3,3
fa11,113,ROOSEVELT,MUS,Mu-CompArt,0,0,0,0,0,0,0,1,1,1,0,1,0,0,0,0,0,0,1,1,2
fa11,113,ROOSEVELT,MUS,Music,0,0,0,0,0,0,0,0,0,1,2,3,2,2,4,0,0,0,3,4,7
fa11,113,ROOSEVELT,NENG,NanoEng,4,3,7,0,0,0,5,0,5,7,1,8,3,1,4,0,0,0,19,5,24
fa11,113,ROOSEVELT,PHIL,Philosophy,1,0,1,0,0,0,2,0,2,6,3,9,3,2,5,0,0,0,12,5,17
fa11,113,ROOSEVELT,PHYS,Biophysics,0,1,1,0,0,0,0,2,2,0,0,0,2,2,4,0,0,0,2,5,7
fa11,113,ROOSEVELT,PHYS,Gen Physcs,0,0,0,0,0,0,0,0,0,0,0,0,0,1,1,0,0,0,0,1,1
fa11,113,ROOSEVELT,PHYS,GenPys/SEd,0,0,0,0,0,0,0,0,0,0,0,0,0,1,1,0,0,0,0,1,1
fa11,113,ROOSEVELT,PHYS,Phy/ErthSc,0,0,0,0,0,0,0,0,0,0,0,0,0,1,1,0,0,0,0,1,1
fa11,113,ROOSEVELT,PHYS,Phys/Astro,0,0,0,0,0,0,0,1,1,0,0,0,1,0,1,0,0,0,1,1,2
fa11,113,ROOSEVELT,PHYS,Physics,2,0,2,0,0,0,0,1,1,1,1,2,3,2,5,0,0,0,6,4,10
fa11,113,ROOSEVELT,POLI,Polit Sci,7,7,14,0,0,0,5,9,14,22,12,34,30,26,56,0,0,0,64,54,118
fa11,113,ROOSEVELT,POLI,PolSc-Amer,1,0,1,0,0,0,0,1,1,3,3,6,7,3,10,0,0,0,11,7,18
fa11,113,ROOSEVELT,POLI,PolSc-Comp,0,0,0,0,0,0,0,0,0,0,1,1,4,2,6,0,0,0,4,3,7
fa11,113,ROOSEVELT,POLI,PolSc-Intl,0,3,3,0,1,1,3,9,12,24,24,48,19,21,40,0,0,0,46,58,104
fa11,113,ROOSEVELT,POLI,PolSc-PLaw,3,2,5,0,1,1,2,3,5,8,9,17,7,3,10,0,0,0,20,18,38
fa11,113,ROOSEVELT,POLI,PolSc-PPol,0,0,0,0,0,0,0,0,0,0,2,2,1,0,1,0,0,0,1,2,3
fa11,113,ROOSEVELT,POLI,PolSc-Thry,1,0,1,1,0,1,0,0,0,1,0,1,1,0,1,0,0,0,4,0,4
fa11,113,ROOSEVELT,PSYC,Psychology,11,19,30,0,3,3,11,28,39,27,65,92,39,91,130,0,0,0,88,206,294
fa11,113,ROOSEVELT,RELI,Relig/Stu,0,0,0,0,0,0,0,0,0,0,2,2,0,1,1,0,0,0,0,3,3
fa11,113,ROOSEVELT,SE,Engin Sci,0,1,1,0,0,0,0,0,0,1,0,1,0,0,0,0,0,0,1,1,2
fa11,113,ROOSEVELT,SE,Struct Eng,3,4,7,0,0,0,3,3,6,12,4,16,27,4,31,0,0,0,45,15,60
fa11,113,ROOSEVELT,SIO,Earth Sci,1,1,2,0,0,0,0,0,0,0,0,0,0,1,1,0,0,0,1,2,3
fa11,113,ROOSEVELT,SIO,ErSc-Geol,0,0,0,0,0,0,0,1,1,0,0,0,0,0,0,0,0,0,0,1,1
fa11,113,ROOSEVELT,SIO,ErSc-Geoph,0,0,0,0,0,0,0,0,0,1,0,1,0,0,0,0,0,0,1,0,1
fa11,113,ROOSEVELT,SOC,SocAmSt,0,0,0,0,0,0,0,0,0,0,1,1,0,1,1,0,0,0,0,2,2
fa11,113,ROOSEVELT,SOC,SocCulCom,0,0,0,0,0,0,0,0,0,1,0,1,2,1,3,0,0,0,3,1,4
fa11,113,ROOSEVELT,SOC,SocEconSoc,0,0,0,0,0,0,0,1,1,0,0,0,0,0,0,0,0,0,0,1,1
fa11,113,ROOSEVELT,SOC,SocIntlStu,0,0,0,0,0,0,0,0,0,0,1,1,2,2,4,0,0,0,2,3,5
fa11,113,ROOSEVELT,SOC,Sociology,2,7,9,0,0,0,0,3,3,9,21,30,4,21,25,0,0,0,15,52,67
fa11,113,ROOSEVELT,SOC,SocLawSoc,0,0,0,0,0,0,0,2,2,1,1,2,3,1,4,0,0,0,4,4,8
fa11,113,ROOSEVELT,SOC,SocSciMed,0,0,0,0,0,0,1,2,3,0,1,1,1,2,3,0,0,0,2,5,7
fa11,113,ROOSEVELT,SOC,SocSolneq,0,0,0,0,0,0,0,0,0,0,2,2,0,3,3,0,0,0,0,5,5
fa11,113,ROOSEVELT,THEA,Dance,0,0,0,0,0,0,0,0,0,0,0,0,0,1,1,0,0,0,0,1,1
fa11,113,ROOSEVELT,THEA,Theatre,1,1,2,0,0,0,0,3,3,3,6,9,2,10,12,0,0,0,6,20,26
fa11,113,ROOSEVELT,TWS,ThirdWldSt,1,0,1,0,0,0,0,1,1,0,0,0,0,1,1,0,0,0,1,2,3
fa11,113,ROOSEVELT,UNAF,UndecHumAr,2,7,9,0,0,0,0,2,2,1,0,1,0,0,0,0,0,0,3,9,12
fa11,113,ROOSEVELT,UNAF,Undeclared,36,53,89,1,3,4,11,23,34,3,11,14,0,1,1,0,0,0,51,91,142
fa11,113,ROOSEVELT,UNAF,UndecPhysS,4,4,8,1,0,1,1,2,3,0,0,0,0,0,0,0,0,0,6,6,12
fa11,113,ROOSEVELT,UNAF,UndecSocSc,3,13,16,0,1,1,0,3,3,0,0,0,0,0,0,0,0,0,3,17,20
fa11,113,ROOSEVELT,USP,Urb Stu&Pl,0,0,0,0,0,0,1,4,5,5,9,14,8,13,21,0,0,0,14,26,40
fa11,113,ROOSEVELT,VIS,Art Hst/Cr,0,0,0,0,0,0,0,0,0,1,2,3,2,3,5,0,0,0,3,5,8
fa11,113,ROOSEVELT,VIS,Media,0,2,2,1,0,1,2,2,4,2,5,7,8,13,21,0,0,0,13,22,35
fa11,113,ROOSEVELT,VIS,Studio VA,0,1,1,0,0,0,0,1,1,1,4,5,2,4,6,0,0,0,3,10,13
fa11,113,ROOSEVELT,VIS,VA-CompArt,0,0,0,0,0,0,2,0,2,1,3,4,1,3,4,0,0,0,4,6,10
fa11,113,SIXTH,ANTH,Anth-Arch,0,1,1,0,0,0,0,0,0,1,4,5,1,3,4,0,0,0,2,8,10
fa11,113,SIXTH,ANTH,Anth-Biol,1,2,3,0,0,0,0,0,0,2,7,9,2,4,6,0,0,0,5,13,18
fa11,113,SIXTH,ANTH,Anth-Soci,0,2,2,0,0,0,0,0,0,1,5,6,0,5,5,0,0,0,1,12,13
fa11,113,SIXTH,BENG,Bioen:Binf,4,2,6,0,0,0,1,0,1,4,1,5,2,1,3,0,0,0,11,4,15
fa11,113,SIXTH,BENG,Bioeng:PM,0,0,0,0,0,0,0,0,0,2,0,2,10,1,11,0,0,0,12,1,13
fa11,113,SIXTH,BENG,BioengBiot,8,2,10,0,0,0,4,2,6,2,2,4,14,4,18,0,0,0,28,10,38
fa11,113,SIXTH,BENG,Bioengin,4,2,6,0,0,0,2,2,4,6,0,6,4,3,7,0,0,0,16,7,23
fa11,113,SIXTH,BIOL,Bioc/CellB,12,20,32,0,0,0,1,1,2,7,15,22,30,28,58,0,0,0,50,64,114
fa11,113,SIXTH,BIOL,Ec/Beh/Evo,0,2,2,0,0,0,0,0,0,2,1,3,2,7,9,0,0,0,4,10,14
fa11,113,SIXTH,BIOL,Genl Biol,4,12,16,0,2,2,2,3,5,11,15,26,25,38,63,0,0,0,42,70,112
fa11,113,SIXTH,BIOL,Human Bio,10,19,29,0,0,0,11,8,19,23,16,39,42,49,91,0,0,0,86,92,178
fa11,113,SIXTH,BIOL,Microbiol,1,1,2,0,0,0,0,1,1,3,2,5,1,3,4,0,0,0,5,7,12
fa11,113,SIXTH,BIOL,Molec Biol,2,2,4,0,0,0,1,2,3,1,1,2,5,5,10,0,0,0,9,10,19
fa11,113,SIXTH,BIOL,PhyslNeuro,3,8,11,0,1,1,4,2,6,7,11,18,13,17,30,0,0,0,27,39,66
fa11,113,SIXTH,CENG,Chem Engin,6,3,9,0,0,0,5,2,7,9,4,13,17,0,17,0,0,0,37,9,46
fa11,113,SIXTH,CGS,CritGendSt,0,0,0,0,0,0,0,0,0,1,1,2,0,0,0,0,0,0,1,1,2
fa11,113,SIXTH,CHEM,Bioch/Chem,5,7,12,0,1,1,13,8,21,22,14,36,11,9,20,0,0,0,51,39,90
fa11,113,SIXTH,CHEM,Bioinform,1,0,1,0,0,0,0,0,0,0,0,0,0,0,0,0,0,0,1,0,1
fa11,113,SIXTH,CHEM,Chem Educ,0,0,0,0,0,0,0,0,0,0,0,0,1,0,1,0,0,0,1,0,1
fa11,113,SIXTH,CHEM,Chemistry,3,4,7,0,2,2,3,3,6,6,4,10,4,5,9,0,0,0,16,18,34
fa11,113,SIXTH,CHEM,Envir Chem,0,0,0,0,1,1,0,0,0,0,0,0,0,2,2,0,0,0,0,3,3
fa11,113,SIXTH,CHEM,MolecSynth,0,0,0,0,0,0,0,0,0,1,1,2,0,0,0,0,0,0,1,1,2
fa11,113,SIXTH,CHEM,Pharm Chem,11,13,24,1,0,1,10,10,20,9,11,20,7,13,20,0,0,0,38,47,85
fa11,113,SIXTH,CHIN,Chinese St,0,0,0,0,0,0,0,0,0,0,1,1,1,0,1,0,0,0,1,1,2
fa11,113,SIXTH,CLAS,Classic St,0,0,0,0,0,0,0,0,0,0,0,0,0,1,1,0,0,0,0,1,1
fa11,113,SIXTH,COGS,Cog Sci,1,6,7,0,0,0,0,0,0,8,6,14,5,1,6,0,0,0,14,13,27
fa11,113,SIXTH,COGS,CogSc/ClAs,0,0,0,0,0,0,0,3,3,0,2,2,0,3,3,0,0,0,0,8,8
fa11,113,SIXTH,COGS,CogSc/Comp,0,0,0,0,0,0,0,0,0,1,0,1,1,1,2,0,0,0,2,1,3
fa11,113,SIXTH,COGS,CogSc/HCI,0,0,0,0,0,0,1,1,2,1,1,2,5,2,7,0,0,0,7,4,11
fa11,113,SIXTH,COGS,CogSc/HCog,0,0,0,0,0,0,0,1,1,1,2,3,1,0,1,0,0,0,2,3,5
fa11,113,SIXTH,COGS,CogSc/Neur,1,0,1,0,0,0,2,5,7,9,7,16,3,11,14,0,0,0,15,23,38
fa11,113,SIXTH,COMM,Communic,3,9,12,2,1,3,3,30,33,23,46,69,19,44,63,0,0,0,50,130,180
fa11,113,SIXTH,CSE,Comp Sci,24,8,32,2,2,4,21,5,26,49,15,64,69,12,81,0,0,0,165,42,207
fa11,113,SIXTH,CSE,CompEngCSE,10,5,15,2,0,2,6,2,8,10,0,10,15,1,16,0,0,0,43,8,51
fa11,113,SIXTH,CSE,CompScBinf,2,2,4,0,0,0,0,0,0,4,0,4,3,0,3,0,0,0,9,2,11
fa11,113,SIXTH,ECE,CompEngECE,5,0,5,0,1,1,4,0,4,1,0,1,3,0,3,0,0,0,13,1,14
fa11,113,SIXTH,ECE,Electr Eng,18,4,22,1,0,1,13,0,13,23,2,25,43,3,46,0,0,0,98,9,107
fa11,113,SIXTH,ECE,Engin Phys,0,0,0,0,0,0,0,0,0,0,1,1,0,0,0,0,0,0,0,1,1
fa11,113,SIXTH,ECE,Pr-EngPhys,1,0,1,0,0,0,0,0,0,1,0,1,0,0,0,0,0,0,2,0,2
fa11,113,SIXTH,ECON,Ec-Mth&Ecn,0,0,0,0,0,0,0,1,1,6,1,7,5,4,9,0,0,0,11,6,17
fa11,113,SIXTH,ECON,Econ-MgtSc,2,8,10,1,1,2,21,11,32,18,25,43,42,29,71,0,0,0,84,74,158
fa11,113,SIXTH,ECON,Economics,10,4,14,0,0,0,12,8,20,50,27,77,66,29,95,0,0,0,138,68,206
fa11,113,SIXTH,ESYS,EnvSys(EB),0,2,2,0,0,0,0,8,8,4,10,14,3,10,13,0,0,0,7,30,37
fa11,113,SIXTH,ESYS,EnvSys(EC),0,1,1,0,0,0,1,1,2,2,0,2,0,0,0,0,0,0,3,2,5
fa11,113,SIXTH,ESYS,EnvSys(EP),0,3,3,0,0,0,1,1,2,2,3,5,0,3,3,0,0,0,3,10,13
fa11,113,SIXTH,ESYS,EnvSys(ES),0,0,0,0,0,0,1,1,2,1,1,2,1,1,2,0,0,0,3,3,6
fa11,113,SIXTH,ETHN,Ethnic St,0,0,0,0,0,0,1,1,2,2,3,5,2,3,5,0,0,0,5,7,12
fa11,113,SIXTH,HDP,Human Dev,0,0,0,0,0,0,0,1,1,0,7,7,1,16,17,0,0,0,1,24,25
fa11,113,SIXTH,HDP,Pr-HumnDev,0,1,1,0,1,1,0,9,9,3,8,11,0,3,3,0,0,0,3,22,25
fa11,113,SIXTH,HIST,History,3,3,6,0,0,0,2,1,3,8,3,11,5,4,9,0,0,0,18,11,29
fa11,113,SIXTH,INTL,Int-5yrEC,0,0,0,0,0,0,0,0,0,1,0,1,1,0,1,0,0,0,2,0,2
fa11,113,SIXTH,INTL,IntSt-Anth,1,1,2,0,0,0,0,0,0,0,1,1,1,2,3,0,0,0,2,4,6
fa11,113,SIXTH,INTL,IntSt-Econ,2,1,3,0,0,0,3,4,7,5,6,11,4,12,16,0,0,0,14,23,37
fa11,113,SIXTH,INTL,IntSt-Hist,1,1,2,0,0,0,0,0,0,0,1,1,1,2,3,0,0,0,2,4,6
fa11,113,SIXTH,INTL,IntSt-Ling,0,0,0,0,0,0,0,1,1,1,7,8,1,1,2,0,0,0,2,9,11
fa11,113,SIXTH,INTL,IntSt-PolS,0,1,1,0,0,0,0,4,4,7,6,13,4,14,18,0,0,0,11,25,36
fa11,113,SIXTH,INTL,IntSt-Soc,1,0,1,0,1,1,0,1,1,0,4,4,0,4,4,0,0,0,1,10,11
fa11,113,SIXTH,ITAL,Italian St,0,0,0,0,0,0,0,0,0,0,0,0,0,2,2,0,0,0,0,2,2
fa11,113,SIXTH,JAPN,JapaneseSt,0,0,0,0,0,0,0,1,1,1,0,1,0,0,0,0,0,0,1,1,2
fa11,113,SIXTH,LING,Lang Stu,0,0,0,0,0,0,0,1,1,1,1,2,0,0,0,0,0,0,1,2,3
fa11,113,SIXTH,LING,Ling-CogLn,0,0,0,0,0,0,0,0,0,1,0,1,0,0,0,0,0,0,1,0,1
fa11,113,SIXTH,LING,Ling-LSoc,0,0,0,0,0,0,0,1,1,0,0,0,0,1,1,0,0,0,0,2,2
fa11,113,SIXTH,LING,Linguistcs,0,0,0,0,0,0,0,0,0,2,1,3,2,4,6,0,0,0,4,5,9
fa11,113,SIXTH,LIT,French Lit,0,0,0,0,0,0,0,0,0,1,0,1,0,1,1,0,0,0,1,1,2
fa11,113,SIXTH,LIT,Lit/Compos,0,0,0,0,0,0,0,0,0,0,0,0,0,1,1,0,0,0,0,1,1
fa11,113,SIXTH,LIT,Lit/Engl,1,4,5,1,0,1,0,3,3,0,1,1,2,1,3,0,0,0,4,9,13
fa11,113,SIXTH,LIT,Lit/World,0,0,0,0,0,0,0,0,0,0,0,0,0,2,2,0,0,0,0,2,2
fa11,113,SIXTH,LIT,Lit/Writng,0,1,1,0,0,0,1,1,2,0,6,6,4,12,16,0,0,0,5,20,25
fa11,113,SIXTH,LIT,Pre-Lit/Wr,0,0,0,0,0,0,0,0,0,0,1,1,0,2,2,0,0,0,0,3,3
fa11,113,SIXTH,MAE,Aerosp Eng,9,2,11,1,1,2,5,1,6,11,2,13,28,4,32,0,0,0,54,10,64
fa11,113,SIXTH,MAE,Engin Sci,5,0,5,0,0,0,2,0,2,2,0,2,5,0,5,0,0,0,14,0,14
fa11,113,SIXTH,MAE,Envir Eng,5,5,10,0,1,1,8,3,11,4,4,8,6,5,11,0,0,0,23,18,41
fa11,113,SIXTH,MAE,Mech Engin,14,3,17,0,0,0,6,1,7,17,2,19,59,10,69,0,0,0,96,16,112
fa11,113,SIXTH,MATH,Appld Math,4,2,6,1,0,1,0,1,1,2,2,4,1,2,3,0,0,0,8,7,15
fa11,113,SIXTH,MATH,Math/SecEd,0,0,0,0,0,0,0,0,0,0,0,0,0,2,2,0,0,0,0,2,2
fa11,113,SIXTH,MATH,Mathematcs,2,2,4,0,0,0,2,2,4,6,2,8,7,4,11,0,0,0,17,10,27
fa11,113,SIXTH,MATH,Mth-CompSc,0,0,0,0,0,0,0,0,0,0,1,1,1,0,1,0,0,0,1,1,2
fa11,113,SIXTH,MATH,Mth-Mth&Ec,0,2,2,0,0,0,2,0,2,3,1,4,4,3,7,0,0,0,9,6,15
fa11,113,SIXTH,MATH,Mth-SciCom,0,0,0,0,0,0,0,0,0,1,0,1,0,1,1,0,0,0,1,1,2
fa11,113,SIXTH,MATH,Mth/ApldSc,1,0,1,0,0,0,0,1,1,1,0,1,0,0,0,0,0,0,2,1,3
fa11,113,SIXTH,MATH,Pr-Math CS,1,0,1,1,0,1,0,0,0,1,0,1,0,0,0,0,0,0,3,0,3
fa11,113,SIXTH,MATH,Prob&Stats,0,0,0,0,0,0,0,0,0,2,1,3,1,1,2,0,0,0,3,2,5
fa11,113,SIXTH,MUS,Mu-CompArt,1,0,1,0,0,0,2,0,2,9,2,11,11,1,12,0,0,0,23,3,26
fa11,113,SIXTH,MUS,Music,3,2,5,0,0,0,1,1,2,6,3,9,6,2,8,0,0,0,16,8,24
fa11,113,SIXTH,MUS,Music Hum,0,0,0,0,0,0,0,0,0,0,1,1,0,1,1,0,0,0,0,2,2
fa11,113,SIXTH,NENG,NanoEng,8,1,9,0,0,0,3,0,3,8,2,10,2,0,2,0,0,0,21,3,24
fa11,113,SIXTH,PHIL,Philosophy,0,0,0,0,0,0,0,0,0,2,2,4,6,0,6,0,0,0,8,2,10
fa11,113,SIXTH,PHYS,Biophysics,0,0,0,0,0,0,3,0,3,0,0,0,3,0,3,0,0,0,6,0,6
fa11,113,SIXTH,PHYS,Gen Physcs,1,0,1,0,0,0,0,0,0,0,0,0,0,0,0,0,0,0,1,0,1
fa11,113,SIXTH,PHYS,Phy/ErthSc,0,0,0,0,0,0,0,0,0,0,0,0,1,0,1,0,0,0,1,0,1
fa11,113,SIXTH,PHYS,Phys/Astro,0,1,1,0,0,0,1,0,1,1,0,1,1,0,1,0,0,0,3,1,4
fa11,113,SIXTH,PHYS,Phys/Mtrls,0,0,0,0,0,0,0,0,0,1,0,1,0,0,0,0,0,0,1,0,1
fa11,113,SIXTH,PHYS,Physics,0,0,0,2,0,2,0,0,0,7,1,8,7,0,7,0,0,0,16,1,17
fa11,113,SIXTH,POLI,Polit Sci,0,0,0,2,0,2,4,4,8,11,13,24,15,5,20,0,0,0,32,22,54
fa11,113,SIXTH,POLI,PolSc-Amer,0,1,1,1,0,1,0,1,1,1,0,1,2,2,4,0,0,0,4,4,8
fa11,113,SIXTH,POLI,PolSc-Comp,0,0,0,0,0,0,0,0,0,0,2,2,0,0,0,0,0,0,0,2,2
fa11,113,SIXTH,POLI,PolSc-Intl,1,1,2,1,0,1,2,3,5,7,5,12,10,3,13,0,0,0,21,12,33
fa11,113,SIXTH,POLI,PolSc-PLaw,3,2,5,0,1,1,2,2,4,5,4,9,2,2,4,0,0,0,12,11,23
fa11,113,SIXTH,POLI,PolSc-PPol,1,0,1,0,0,0,0,0,0,1,0,1,1,0,1,0,0,0,3,0,3
fa11,113,SIXTH,POLI,PolSc-Thry,0,0,0,0,0,0,0,0,0,1,0,1,2,1,3,0,0,0,3,1,4
fa11,113,SIXTH,PSYC,Psychology,5,18,23,1,2,3,17,20,37,24,30,54,34,43,77,0,0,0,81,113,194
fa11,113,SIXTH,RUSS,Russ&SovSt,0,0,0,0,0,0,0,0,0,0,0,0,0,1,1,0,0,0,0,1,1
fa11,113,SIXTH,SE,Engin Sci,0,1,1,0,0,0,0,1,1,1,0,1,0,0,0,0,0,0,1,2,3
fa11,113,SIXTH,SE,Struct Eng,6,5,11,1,1,2,10,2,12,28,2,30,26,12,38,0,0,0,71,22,93
fa11,113,SIXTH,SIO,Earth Sci,1,0,1,0,0,0,0,0,0,0,2,2,2,0,2,0,0,0,3,2,5
fa11,113,SIXTH,SIO,ErSc-Geoph,0,0,0,0,0,0,0,0,0,0,0,0,0,1,1,0,0,0,0,1,1
fa11,113,SIXTH,SOC,SocAmSt,0,0,0,0,0,0,0,0,0,0,1,1,0,0,0,0,0,0,0,1,1
fa11,113,SIXTH,SOC,SocCulCom,0,0,0,0,0,0,0,1,1,0,2,2,0,2,2,0,0,0,0,5,5
fa11,113,SIXTH,SOC,SocEconSoc,0,0,0,0,0,0,0,1,1,2,0,2,2,2,4,0,0,0,4,3,7
fa11,113,SIXTH,SOC,SocIntlStu,0,1,1,0,0,0,0,0,0,0,1,1,0,5,5,0,0,0,0,7,7
fa11,113,SIXTH,SOC,Sociology,0,3,3,0,0,0,0,2,2,8,10,18,4,6,10,0,0,0,12,21,33
fa11,113,SIXTH,SOC,SocLawSoc,0,0,0,0,0,0,0,0,0,1,3,4,0,2,2,0,0,0,1,5,6
fa11,113,SIXTH,SOC,SocSciMed,1,0,1,0,0,0,1,1,2,0,2,2,0,1,1,0,0,0,2,4,6
fa11,113,SIXTH,SOC,SocSolneq,0,0,0,0,0,0,0,0,0,0,1,1,0,0,0,0,0,0,0,1,1
fa11,113,SIXTH,THEA,Dance,0,0,0,0,0,0,1,0,1,0,0,0,0,1,1,0,0,0,1,1,2
fa11,113,SIXTH,THEA,Theatre,2,1,3,0,0,0,0,3,3,0,5,5,5,5,10,0,0,0,7,14,21
fa11,113,SIXTH,TWS,ThirdWldSt,0,1,1,0,0,0,0,0,0,0,1,1,0,0,0,0,0,0,0,2,2
fa11,113,SIXTH,UNAF,UndecHumAr,0,2,2,0,0,0,0,1,1,1,1,2,0,0,0,0,0,0,1,4,5
fa11,113,SIXTH,UNAF,Undeclared,30,42,72,0,2,2,9,17,26,9,11,20,0,0,0,0,0,0,48,72,120
fa11,113,SIXTH,UNAF,UndecPhysS,4,4,8,0,0,0,1,1,2,1,0,1,0,0,0,0,0,0,6,5,11
fa11,113,SIXTH,UNAF,UndecSocSc,1,2,3,1,0,1,1,0,1,0,1,1,0,0,0,0,0,0,3,3,6
fa11,113,SIXTH,USP,Urb Stu&Pl,0,0,0,0,1,1,1,3,4,6,3,9,5,2,7,0,0,0,12,9,21
fa11,113,SIXTH,VIS,Art Hst/Cr,0,3,3,0,0,0,0,0,0,1,4,5,1,7,8,0,0,0,2,14,16
fa11,113,SIXTH,VIS,Media,4,8,12,0,1,1,5,5,10,14,15,29,15,20,35,0,0,0,38,49,87
fa11,113,SIXTH,VIS,Studio VA,1,8,9,0,0,0,2,3,5,3,7,10,6,4,10,0,0,0,12,22,34
fa11,113,SIXTH,VIS,VA-CompArt,0,5,5,1,0,1,1,2,3,7,7,14,9,6,15,0,0,0,18,20,38
fa11,113,WARREN,ANTH,Anth-Arch,0,0,0,0,0,0,0,0,0,2,0,2,0,2,2,0,0,0,2,2,4
fa11,113,WARREN,ANTH,Anth-Biol,0,0,0,0,0,0,0,0,0,1,4,5,0,1,1,0,0,0,1,5,6
fa11,113,WARREN,ANTH,Anth-Soci,0,2,2,0,0,0,0,0,0,1,5,6,1,3,4,0,0,0,2,10,12
fa11,113,WARREN,BENG,Bioen:Binf,2,7,9,0,0,0,1,1,2,1,2,3,6,0,6,0,0,0,10,10,20
fa11,113,WARREN,BENG,Bioeng:PM,0,0,0,0,0,0,0,1,1,4,2,6,15,5,20,0,0,0,19,8,27
fa11,113,WARREN,BENG,BioengBiot,11,10,21,0,0,0,2,3,5,13,9,22,34,16,50,0,0,0,60,38,98
fa11,113,WARREN,BENG,Bioengin,17,5,22,0,0,0,2,2,4,11,5,16,24,10,34,0,0,0,54,22,76
fa11,113,WARREN,BENG,Pr-BioenPM,0,0,0,0,0,0,0,0,0,1,1,2,0,0,0,0,0,0,1,1,2
fa11,113,WARREN,BIOL,Bioc/CellB,5,9,14,0,0,0,4,3,7,16,15,31,37,43,80,0,0,0,62,70,132
fa11,113,WARREN,BIOL,BiolBioinf,0,0,0,0,0,0,0,1,1,0,0,0,0,0,0,0,0,0,0,1,1
fa11,113,WARREN,BIOL,Ec/Beh/Evo,1,0,1,0,0,0,2,1,3,1,1,2,9,7,16,0,0,0,13,9,22
fa11,113,WARREN,BIOL,Genl Biol,6,2,8,0,1,1,8,5,13,9,16,25,32,58,90,0,0,0,55,82,137
fa11,113,WARREN,BIOL,Human Bio,14,20,34,0,0,0,10,11,21,21,30,51,45,65,110,0,0,0,90,126,216
fa11,113,WARREN,BIOL,Microbiol,1,1,2,0,0,0,2,1,3,3,5,8,5,4,9,0,0,0,11,11,22
fa11,113,WARREN,BIOL,Molec Biol,3,0,3,0,0,0,1,1,2,4,2,6,6,5,11,0,0,0,14,8,22
fa11,113,WARREN,BIOL,PhyslNeuro,4,12,16,1,0,1,4,7,11,8,7,15,29,24,53,0,0,0,46,50,96
fa11,113,WARREN,CENG,Chem Engin,9,10,19,1,0,1,12,3,15,18,11,29,32,7,39,0,0,0,72,31,103
fa11,113,WARREN,CGS,CritGendSt,0,0,0,0,0,0,0,0,0,0,1,1,0,0,0,0,0,0,0,1,1
fa11,113,WARREN,CHEM,Bioch/Chem,3,7,10,6,1,7,13,11,24,25,16,41,17,14,31,0,0,0,64,49,113
fa11,113,WARREN,CHEM,Bioinform,0,0,0,0,0,0,0,0,0,0,0,0,0,1,1,0,0,0,0,1,1
fa11,113,WARREN,CHEM,Chemistry,1,4,5,0,1,1,3,1,4,7,10,17,8,5,13,0,0,0,19,21,40
fa11,113,WARREN,CHEM,Envir Chem,0,0,0,0,0,0,0,0,0,0,0,0,1,0,1,0,0,0,1,0,1
fa11,113,WARREN,CHEM,MolecSynth,0,0,0,0,0,0,1,0,1,0,0,0,2,1,3,0,0,0,3,1,4
fa11,113,WARREN,CHEM,Pharm Chem,2,7,9,1,1,2,6,13,19,14,17,31,11,14,25,0,0,0,34,52,86
fa11,113,WARREN,CHIN,Chinese St,0,0,0,0,0,0,0,0,0,0,0,0,1,2,3,0,0,0,1,2,3
fa11,113,WARREN,COGS,Cog Sci,1,3,4,0,0,0,2,4,6,3,6,9,2,5,7,0,0,0,8,18,26
fa11,113,WARREN,COGS,CogSc/ClAs,0,0,0,0,0,0,1,2,3,0,1,1,1,3,4,0,0,0,2,6,8
fa11,113,WARREN,COGS,CogSc/Comp,0,0,0,0,0,0,1,0,1,0,0,0,1,0,1,0,0,0,2,0,2
fa11,113,WARREN,COGS,CogSc/HCI,0,0,0,0,0,0,1,0,1,2,1,3,2,5,7,0,0,0,5,6,11
fa11,113,WARREN,COGS,CogSc/HCog,0,0,0,0,1,1,0,0,0,1,3,4,1,1,2,0,0,0,2,5,7
fa11,113,WARREN,COGS,CogSc/Neur,0,3,3,0,0,0,3,7,10,3,12,15,7,4,11,0,0,0,13,26,39
fa11,113,WARREN,COMM,Communic,2,8,10,0,2,2,2,7,9,7,34,41,17,24,41,0,0,0,28,75,103
fa11,113,WARREN,CSE,Comp Sci,33,4,37,1,0,1,27,8,35,72,13,85,76,15,91,0,0,0,209,40,249
fa11,113,WARREN,CSE,CompEngCSE,19,2,21,1,1,2,10,4,14,21,2,23,20,1,21,0,0,0,71,10,81
fa11,113,WARREN,CSE,CompScBinf,1,0,1,0,0,0,1,0,1,2,4,6,2,1,3,0,0,0,6,5,11
fa11,113,WARREN,ECE,CompEngECE,8,3,11,2,0,2,6,0,6,7,0,7,3,0,3,0,0,0,26,3,29
fa11,113,WARREN,ECE,Electr Eng,32,4,36,0,0,0,20,2,22,43,5,48,56,11,67,0,0,0,151,22,173
fa11,113,WARREN,ECE,Engin Phys,1,0,1,0,0,0,0,0,0,0,0,0,4,0,4,0,0,0,5,0,5
fa11,113,WARREN,ECE,Pr-EngPhys,0,0,0,0,0,0,0,0,0,0,0,0,1,0,1,0,0,0,1,0,1
fa11,113,WARREN,ECON,Ec-Mth&Ecn,2,4,6,0,0,0,1,2,3,5,2,7,11,2,13,0,0,0,19,10,29
fa11,113,WARREN,ECON,Econ-MgtSc,3,1,4,0,0,0,12,12,24,21,11,32,29,18,47,0,0,0,65,42,107
fa11,113,WARREN,ECON,Economics,5,8,13,0,0,0,11,6,17,66,33,99,63,31,94,0,0,0,145,78,223
fa11,113,WARREN,ESYS,EnvSys(EB),0,2,2,0,0,0,1,2,3,1,6,7,1,6,7,0,0,0,3,16,19
fa11,113,WARREN,ESYS,EnvSys(EC),0,0,0,0,0,0,0,0,0,0,1,1,0,0,0,0,0,0,0,1,1
fa11,113,WARREN,ESYS,EnvSys(EP),0,1,1,0,0,0,1,1,2,0,0,0,1,1,2,0,0,0,2,3,5
fa11,113,WARREN,ESYS,EnvSys(ES),0,0,0,0,1,1,1,0,1,1,0,1,2,0,2,0,0,0,4,1,5
fa11,113,WARREN,ETHN,Ethnic St,0,0,0,0,0,0,0,0,0,0,1,1,1,4,5,0,0,0,1,5,6
fa11,113,WARREN,HDP,Human Dev,0,0,0,0,0,0,0,1,1,0,5,5,0,10,10,0,0,0,0,16,16
fa11,113,WARREN,HDP,Pr-HumnDev,1,3,4,0,2,2,0,7,7,1,8,9,0,2,2,0,0,0,2,22,24
fa11,113,WARREN,HIST,History,2,1,3,0,0,0,0,1,1,10,5,15,15,2,17,0,0,0,27,9,36
fa11,113,WARREN,INTD,Wa Ind St,0,0,0,0,0,0,0,0,0,0,1,1,0,0,0,0,0,0,0,1,1
fa11,113,WARREN,INTL,IntSt-Econ,0,1,1,0,0,0,0,3,3,3,5,8,7,7,14,0,0,0,10,16,26
fa11,113,WARREN,INTL,IntSt-Hist,0,0,0,0,0,0,0,1,1,1,0,1,0,1,1,0,0,0,1,2,3
fa11,113,WARREN,INTL,IntSt-Ling,0,1,1,0,0,0,0,0,0,1,0,1,0,1,1,0,0,0,1,2,3
fa11,113,WARREN,INTL,IntSt-Lit,0,0,0,0,0,0,0,0,0,0,0,0,0,1,1,0,0,0,0,1,1
fa11,113,WARREN,INTL,IntSt-PolS,2,2,4,0,0,0,2,0,2,1,6,7,5,5,10,0,0,0,10,13,23
fa11,113,WARREN,INTL,IntSt-Soc,1,0,1,0,0,0,1,1,2,0,3,3,0,4,4,0,0,0,2,8,10
fa11,113,WARREN,ITAL,Italian St,0,0,0,0,0,0,0,0,0,0,0,0,1,0,1,0,0,0,1,0,1
fa11,113,WARREN,JAPN,JapaneseSt,0,0,0,0,0,0,0,0,0,1,0,1,2,0,2,0,0,0,3,0,3
fa11,113,WARREN,LATI,LatinAm St,0,0,0,0,0,0,0,0,0,0,0,0,0,1,1,0,0,0,0,1,1
fa11,113,WARREN,LING,Lang Stu,0,0,0,0,0,0,0,0,0,0,1,1,0,1,1,0,0,0,0,2,2
fa11,113,WARREN,LING,Ling-CogLn,0,0,0,0,0,0,0,0,0,0,1,1,0,2,2,0,0,0,0,3,3
fa11,113,WARREN,LING,Ling-LSoc,0,0,0,0,0,0,0,0,0,0,0,0,1,1,2,0,0,0,1,1,2
fa11,113,WARREN,LING,Linguistcs,0,0,0,0,0,0,0,0,0,0,2,2,0,2,2,0,0,0,0,4,4
fa11,113,WARREN,LIT,French Lit,0,0,0,0,0,0,0,0,0,0,0,0,1,0,1,0,0,0,1,0,1
fa11,113,WARREN,LIT,Lit/Compos,0,0,0,0,0,0,0,0,0,0,0,0,0,1,1,0,0,0,0,1,1
fa11,113,WARREN,LIT,Lit/Engl,1,2,3,0,0,0,0,2,2,0,1,1,2,7,9,0,0,0,3,12,15
fa11,113,WARREN,LIT,Lit/World,0,0,0,0,0,0,0,0,0,0,0,0,0,1,1,0,0,0,0,1,1
fa11,113,WARREN,LIT,Lit/Writng,0,1,1,0,1,1,0,1,1,2,3,5,4,9,13,0,0,0,6,15,21
fa11,113,WARREN,LIT,Pre-Lit/Wr,0,0,0,0,0,0,0,0,0,0,0,0,1,1,2,0,0,0,1,1,2
fa11,113,WARREN,MAE,Aerosp Eng,9,7,16,0,0,0,5,0,5,19,2,21,21,6,27,0,0,0,54,15,69
fa11,113,WARREN,MAE,Engin Sci,4,1,5,1,0,1,2,1,3,6,1,7,2,0,2,0,0,0,15,3,18
fa11,113,WARREN,MAE,Envir Eng,6,0,6,0,0,0,5,4,9,13,9,22,8,5,13,0,0,0,32,18,50
fa11,113,WARREN,MAE,Mech Engin,15,7,22,0,0,0,17,2,19,26,3,29,92,11,103,0,0,0,150,23,173
fa11,113,WARREN,MATH,Appld Math,1,0,1,1,0,1,1,0,1,4,0,4,2,1,3,0,0,0,9,1,10
fa11,113,WARREN,MATH,Math/SecEd,0,0,0,0,0,0,0,2,2,1,1,2,0,2,2,0,0,0,1,5,6
fa11,113,WARREN,MATH,Mathematcs,0,4,4,0,2,2,2,3,5,2,5,7,9,1,10,0,0,0,13,15,28
fa11,113,WARREN,MATH,Mth-CompSc,0,0,0,0,0,0,0,0,0,1,0,1,0,1,1,0,0,0,1,1,2
fa11,113,WARREN,MATH,Mth-Mth&Ec,2,3,5,0,0,0,2,2,4,4,5,9,3,3,6,0,0,0,11,13,24
fa11,113,WARREN,MATH,Mth/ApldSc,0,1,1,1,0,1,0,1,1,1,2,3,1,0,1,0,0,0,3,4,7
fa11,113,WARREN,MATH,Pr-Math CS,0,1,1,0,0,0,0,0,0,0,0,0,0,0,0,0,0,0,0,1,1
fa11,113,WARREN,MATH,Prob&Stats,1,0,1,0,0,0,2,0,2,5,0,5,0,3,3,0,0,0,8,3,11
fa11,113,WARREN,MUS,Mu-CompArt,0,0,0,1,0,1,1,0,1,1,0,1,5,0,5,0,0,0,8,0,8
fa11,113,WARREN,MUS,Music,0,0,0,0,0,0,2,0,2,3,3,6,1,4,5,0,0,0,6,7,13
fa11,113,WARREN,MUS,Music Hum,0,0,0,0,0,0,0,0,0,1,0,1,1,0,1,0,0,0,2,0,2
fa11,113,WARREN,NENG,NanoEng,11,0,11,0,0,0,13,2,15,15,2,17,3,0,3,0,0,0,42,4,46
fa11,113,WARREN,PHIL,Philosophy,2,1,3,0,0,0,0,0,0,9,2,11,11,4,15,0,0,0,22,7,29
fa11,113,WARREN,PHYS,Biophysics,0,1,1,0,0,0,0,0,0,1,0,1,0,0,0,0,0,0,1,1,2
fa11,113,WARREN,PHYS,Phys/Astro,1,0,1,0,0,0,0,0,0,0,0,0,3,0,3,0,0,0,4,0,4
fa11,113,WARREN,PHYS,Phys/Comp,1,0,1,0,0,0,0,0,0,0,0,0,1,0,1,0,0,0,2,0,2
fa11,113,WARREN,PHYS,Phys/Mtrls,0,0,0,0,0,0,1,0,1,0,0,0,0,0,0,0,0,0,1,0,1
fa11,113,WARREN,PHYS,Physics,2,1,3,1,0,1,1,1,2,2,0,2,7,1,8,0,0,0,13,3,16
fa11,113,WARREN,POLI,Polit Sci,5,4,9,0,0,0,10,11,21,17,17,34,26,22,48,0,0,0,58,54,112
fa11,113,WARREN,POLI,PolSc-Amer,1,0,1,0,0,0,1,3,4,2,1,3,5,5,10,0,0,0,9,9,18
fa11,113,WARREN,POLI,PolSc-Comp,0,0,0,0,0,0,0,1,1,0,1,1,1,2,3,0,0,0,1,4,5
fa11,113,WARREN,POLI,PolSc-Intl,1,1,2,1,0,1,3,4,7,8,6,14,16,11,27,0,0,0,29,22,51
fa11,113,WARREN,POLI,PolSc-PLaw,2,6,8,0,1,1,2,6,8,3,11,14,6,6,12,0,0,0,13,30,43
fa11,113,WARREN,POLI,PolSc-PPol,2,0,2,0,0,0,0,1,1,2,2,4,0,2,2,0,0,0,4,5,9
fa11,113,WARREN,POLI,PolSc-Thry,0,0,0,0,0,0,1,0,1,1,0,1,0,1,1,0,0,0,2,1,3
fa11,113,WARREN,PSYC,Psychology,10,24,34,1,3,4,8,18,26,14,51,65,26,69,95,0,0,0,59,165,224
fa11,113,WARREN,RELI,Relig/Stu,0,0,0,0,0,0,0,1,1,1,1,2,0,0,0,0,0,0,1,2,3
fa11,113,WARREN,SE,Engin Sci,0,0,0,0,0,0,1,1,2,0,0,0,0,0,0,0,0,0,1,1,2
fa11,113,WARREN,SE,Struct Eng,18,11,29,1,0,1,30,8,38,33,7,40,46,22,68,0,0,0,128,48,176
fa11,113,WARREN,SIO,Earth Sci,0,1,1,0,0,0,0,0,0,3,1,4,2,2,4,0,0,0,5,4,9
fa11,113,WARREN,SOC,SocCulCom,0,0,0,0,1,1,0,0,0,0,0,0,0,1,1,0,0,0,0,2,2
fa11,113,WARREN,SOC,SocEconSoc,0,0,0,0,0,0,0,0,0,0,1,1,0,0,0,0,0,0,0,1,1
fa11,113,WARREN,SOC,SocIntlStu,0,0,0,0,0,0,0,0,0,0,0,0,2,1,3,0,0,0,2,1,3
fa11,113,WARREN,SOC,Sociology,0,3,3,0,0,0,0,3,3,4,13,17,4,13,17,0,0,0,8,32,40
fa11,113,WARREN,SOC,SocLawSoc,0,1,1,0,0,0,1,2,3,2,0,2,1,3,4,0,0,0,4,6,10
fa11,113,WARREN,SOC,SocSciMed,0,0,0,0,0,0,0,1,1,2,0,2,0,1,1,0,0,0,2,2,4
fa11,113,WARREN,SOC,SocSolneq,0,0,0,0,0,0,0,0,0,0,0,0,1,1,2,0,0,0,1,1,2
fa11,113,WARREN,THEA,Dance,0,0,0,0,0,0,0,0,0,0,0,0,1,2,3,0,0,0,1,2,3
fa11,113,WARREN,THEA,Theatre,1,2,3,1,0,1,2,0,2,1,2,3,0,2,2,0,0,0,5,6,11
fa11,113,WARREN,TWS,ThirdWldSt,0,0,0,0,0,0,0,0,0,0,0,0,0,1,1,0,0,0,0,1,1
fa11,113,WARREN,UNAF,IntcampVis,0,0,0,2,0,2,0,1,1,0,1,1,1,0,1,0,0,0,3,2,5
fa11,113,WARREN,UNAF,Limited St,0,0,0,0,0,0,0,0,0,0,0,0,0,0,0,2,2,4,2,2,4
fa11,113,WARREN,UNAF,UndecHumAr,1,2,3,0,0,0,0,0,0,0,0,0,0,0,0,0,0,0,1,2,3
fa11,113,WARREN,UNAF,Undeclared,32,38,70,3,3,6,5,15,20,8,3,11,0,0,0,0,0,0,48,59,107
fa11,113,WARREN,UNAF,UndecPhysS,1,8,9,0,1,1,1,1,2,0,0,0,0,0,0,0,0,0,2,10,12
fa11,113,WARREN,UNAF,UndecSocSc,6,3,9,0,0,0,0,2,2,0,1,1,0,0,0,0,0,0,6,6,12
fa11,113,WARREN,USP,Urb Stu&Pl,0,0,0,0,0,0,1,1,2,3,3,6,5,7,12,0,0,0,9,11,20
fa11,113,WARREN,VIS,Art Hst/Cr,0,0,0,0,0,0,1,0,1,0,0,0,1,2,3,0,0,0,2,2,4
fa11,113,WARREN,VIS,Media,0,0,0,0,0,0,1,2,3,5,1,6,8,8,16,0,0,0,14,11,25
fa11,113,WARREN,VIS,Studio VA,0,0,0,1,0,1,1,1,2,1,0,1,1,3,4,0,0,0,4,4,8
fa11,113,WARREN,VIS,VA-CompArt,0,0,0,0,0,0,0,1,1,1,1,2,2,0,2,0,0,0,3,2,5
wi10,101,MARSHALL,ANTH,Anth-Arch,0,0,0,0,0,0,0,1,1,2,1,3,2,4,6,0,0,0,4,6,10
wi10,101,MARSHALL,ANTH,Anth-Biol,0,0,0,0,0,0,0,0,0,1,4,5,1,3,4,0,0,0,2,7,9
wi10,101,MARSHALL,ANTH,Anth-Soci,0,0,0,0,1,1,0,1,1,2,3,5,2,8,10,0,0,0,4,13,17
wi10,101,MARSHALL,ANTH,Anthropol,0,0,0,0,0,0,0,0,0,0,0,0,1,2,3,0,0,0,1,2,3
wi10,101,MARSHALL,BENG,Bioen:Binf,0,0,0,0,0,0,0,0,0,3,1,4,1,0,1,0,0,0,4,1,5
wi10,101,MARSHALL,BENG,Bioeng:PM,0,0,0,1,0,1,0,1,1,6,0,6,14,2,16,0,0,0,21,3,24
wi10,101,MARSHALL,BENG,BioengBiot,0,0,0,1,1,2,7,2,9,6,3,9,5,1,6,0,0,0,19,7,26
wi10,101,MARSHALL,BENG,Bioengin,0,0,0,1,1,2,1,1,2,3,2,5,2,4,6,0,0,0,7,8,15
wi10,101,MARSHALL,BENG,Pr-BioenPM,0,0,0,3,9,12,6,3,9,1,2,3,1,0,1,0,0,0,11,14,25
wi10,101,MARSHALL,BIOL,Anml Physl,0,0,0,0,0,0,0,0,0,0,0,0,1,0,1,0,0,0,1,0,1
wi10,101,MARSHALL,BIOL,Bioc/CellB,0,0,0,3,7,10,8,19,27,20,22,42,47,52,99,0,0,0,78,100,178
wi10,101,MARSHALL,BIOL,BiolBioinf,0,0,0,0,0,0,0,0,0,0,1,1,1,0,1,0,0,0,1,1,2
wi10,101,MARSHALL,BIOL,Ec/Beh/Evo,0,0,0,0,1,1,1,1,2,2,3,5,8,4,12,0,0,0,11,9,20
wi10,101,MARSHALL,BIOL,Genl Biol,0,0,0,2,13,15,7,26,33,19,30,49,41,59,100,0,0,0,69,128,197
wi10,101,MARSHALL,BIOL,Human Bio,0,0,0,6,13,19,35,70,105,39,69,108,52,78,130,0,0,0,132,230,362
wi10,101,MARSHALL,BIOL,Microbiol,0,0,0,1,2,3,1,0,1,1,7,8,4,4,8,0,0,0,7,13,20
wi10,101,MARSHALL,BIOL,Molec Biol,0,0,0,0,1,1,4,1,5,3,8,11,7,6,13,0,0,0,14,16,30
wi10,101,MARSHALL,BIOL,PhyslNeuro,0,0,0,0,3,3,5,16,21,14,25,39,13,24,37,0,0,0,32,68,100
wi10,101,MARSHALL,CENG,Chem Engin,0,0,0,1,1,2,6,3,9,8,4,12,11,6,17,0,0,0,26,14,40
wi10,101,MARSHALL,CGS,CritGendSt,0,0,0,0,0,0,0,0,0,1,2,3,0,3,3,0,0,0,1,5,6
wi10,101,MARSHALL,CHEM,Bioch/Chem,0,0,0,7,6,13,6,14,20,7,12,19,12,12,24,0,0,0,32,44,76
wi10,101,MARSHALL,CHEM,Bioinform,0,0,0,0,1,1,0,0,0,0,0,0,0,0,0,0,0,0,0,1,1
wi10,101,MARSHALL,CHEM,Chem Phys,0,0,0,0,0,0,0,0,0,1,0,1,0,0,0,0,0,0,1,0,1
wi10,101,MARSHALL,CHEM,Chemistry,0,0,0,1,3,4,3,4,7,2,1,3,6,7,13,0,0,0,12,15,27
wi10,101,MARSHALL,CHEM,Chm/ErthSc,0,0,0,0,0,0,0,0,0,1,0,1,0,0,0,0,0,0,1,0,1
wi10,101,MARSHALL,CHEM,Envir Chem,0,0,0,0,0,0,1,0,1,0,0,0,2,0,2,0,0,0,3,0,3
wi10,101,MARSHALL,CHEM,Pharm Chem,0,0,0,2,9,11,5,7,12,4,7,11,10,8,18,0,0,0,21,31,52
wi10,101,MARSHALL,CHIN,Chinese St,0,0,0,0,0,0,0,0,0,0,0,0,0,2,2,0,0,0,0,2,2
wi10,101,MARSHALL,CLAS,Classic St,0,0,0,0,1,1,0,0,0,0,0,0,0,1,1,0,0,0,0,2,2
wi10,101,MARSHALL,COGS,Cog Sci,0,0,0,0,2,2,1,1,2,3,5,8,3,2,5,0,0,0,7,10,17
wi10,101,MARSHALL,COGS,CogSc/ClAs,0,0,0,0,1,1,0,4,4,0,1,1,0,1,1,0,0,0,0,7,7
wi10,101,MARSHALL,COGS,CogSc/Comp,0,0,0,0,0,0,0,0,0,0,0,0,2,0,2,0,0,0,2,0,2
wi10,101,MARSHALL,COGS,CogSc/HCI,0,0,0,0,0,0,0,0,0,1,1,2,3,3,6,0,0,0,4,4,8
wi10,101,MARSHALL,COGS,CogSc/HCog,0,0,0,0,0,0,1,0,1,0,1,1,0,0,0,0,0,0,1,1,2
wi10,101,MARSHALL,COGS,CogSc/Neur,0,0,0,1,0,1,2,3,5,1,6,7,5,14,19,0,0,0,9,23,32
wi10,101,MARSHALL,COMM,Communic,0,1,1,1,7,8,6,28,34,29,48,77,23,48,71,0,0,0,59,132,191
wi10,101,MARSHALL,CSE,Comp Sci,0,0,0,4,2,6,8,7,15,21,1,22,37,5,42,0,0,0,70,15,85
wi10,101,MARSHALL,CSE,CompEngCSE,0,0,0,2,1,3,3,2,5,6,1,7,5,0,5,0,0,0,16,4,20
wi10,101,MARSHALL,CSE,CompScBinf,0,0,0,0,0,0,0,0,0,0,0,0,1,3,4,0,0,0,1,3,4
wi10,101,MARSHALL,ECE,CompEngECE,0,0,0,1,0,1,0,0,0,6,0,6,1,0,1,0,0,0,8,0,8
wi10,101,MARSHALL,ECE,Electr Eng,0,0,0,6,0,6,5,3,8,17,4,21,31,9,40,0,0,0,59,16,75
wi10,101,MARSHALL,ECE,EleEng&Soc,0,0,0,0,0,0,0,0,0,1,0,1,0,0,0,0,0,0,1,0,1
wi10,101,MARSHALL,ECE,Pr-EngPhys,0,0,0,0,0,0,0,0,0,1,0,1,0,0,0,0,0,0,1,0,1
wi10,101,MARSHALL,ECON,Ec-Mth&Ecn,0,0,0,1,3,4,5,0,5,6,2,8,6,3,9,0,0,0,18,8,26
wi10,101,MARSHALL,ECON,Econ-MgtSc,0,0,0,8,9,17,14,13,27,33,30,63,61,37,98,0,0,0,116,89,205
wi10,101,MARSHALL,ECON,Economics,1,0,1,12,7,19,21,18,39,85,41,126,96,54,150,0,0,0,215,120,335
wi10,101,MARSHALL,ESYS,EnvSys(EB),0,0,0,0,3,3,2,1,3,1,2,3,2,7,9,0,0,0,5,13,18
wi10,101,MARSHALL,ESYS,EnvSys(EC),0,0,0,0,0,0,0,0,0,1,0,1,0,1,1,0,0,0,1,1,2
wi10,101,MARSHALL,ESYS,EnvSys(EP),0,0,0,1,0,1,1,0,1,0,1,1,0,2,2,0,0,0,2,3,5
wi10,101,MARSHALL,ESYS,EnvSys(ES),0,0,0,0,1,1,1,0,1,0,0,0,0,2,2,0,0,0,1,3,4
wi10,101,MARSHALL,ETHN,Ethnic St,0,0,0,1,0,1,0,3,3,3,6,9,1,20,21,0,0,0,5,29,34
wi10,101,MARSHALL,HDP,Human Dev,0,0,0,0,0,0,0,0,0,1,9,10,0,34,34,0,0,0,1,43,44
wi10,101,MARSHALL,HDP,Pr-HumnDev,0,0,0,0,4,4,0,11,11,1,14,15,1,4,5,0,0,0,2,33,35
wi10,101,MARSHALL,HIST,History,0,0,0,1,3,4,2,2,4,14,11,25,17,11,28,0,0,0,34,27,61
wi10,101,MARSHALL,INTL,IntSt-Anth,0,0,0,0,1,1,0,0,0,0,1,1,1,3,4,0,0,0,1,5,6
wi10,101,MARSHALL,INTL,IntSt-Econ,0,0,0,0,1,1,9,9,18,8,9,17,8,5,13,0,0,0,25,24,49
wi10,101,MARSHALL,INTL,IntSt-Hist,0,0,0,0,0,0,0,0,0,1,1,2,1,5,6,0,0,0,2,6,8
wi10,101,MARSHALL,INTL,IntSt-Ling,0,0,0,0,1,1,0,0,0,0,3,3,0,1,1,0,0,0,0,5,5
wi10,101,MARSHALL,INTL,IntSt-Lit,0,0,0,0,1,1,0,1,1,0,0,0,0,0,0,0,0,0,0,2,2
wi10,101,MARSHALL,INTL,IntSt-PolS,0,0,0,1,3,4,1,7,8,2,9,11,9,18,27,0,0,0,13,37,50
wi10,101,MARSHALL,INTL,IntSt-Soc,0,0,0,0,2,2,0,1,1,2,6,8,2,8,10,0,0,0,4,17,21
wi10,101,MARSHALL,JAPN,JapaneseSt,0,0,0,0,0,0,0,0,0,0,0,0,1,0,1,0,0,0,1,0,1
wi10,101,MARSHALL,JUDA,Judaic Stu,0,0,0,0,0,0,0,0,0,0,0,0,1,0,1,0,0,0,1,0,1
wi10,101,MARSHALL,LATI,LatinAm St,0,0,0,0,0,0,0,0,0,0,0,0,1,1,2,0,0,0,1,1,2
wi10,101,MARSHALL,LING,Lang Stu,0,0,0,0,0,0,1,1,2,0,2,2,0,1,1,0,0,0,1,4,5
wi10,101,MARSHALL,LING,Ling-CogLn,0,0,0,0,0,0,0,0,0,1,0,1,0,0,0,0,0,0,1,0,1
wi10,101,MARSHALL,LING,Ling-LSoc,0,0,0,0,0,0,0,0,0,0,1,1,0,0,0,0,0,0,0,1,1
wi10,101,MARSHALL,LING,Linguistcs,0,0,0,0,0,0,1,2,3,0,2,2,1,1,2,0,0,0,2,5,7
wi10,101,MARSHALL,LIT,Lit/Compos,0,0,0,1,0,1,0,0,0,0,0,0,0,0,0,0,0,0,1,0,1
wi10,101,MARSHALL,LIT,Lit/CultSt,0,0,0,0,0,0,0,2,2,0,0,0,0,0,0,0,0,0,0,2,2
wi10,101,MARSHALL,LIT,Lit/Engl,0,0,0,1,3,4,0,3,3,1,3,4,3,2,5,0,0,0,5,11,16
wi10,101,MARSHALL,LIT,Lit/World,0,0,0,0,0,0,0,0,0,0,1,1,1,5,6,0,0,0,1,6,7
wi10,101,MARSHALL,LIT,Lit/Writng,0,0,0,0,0,0,0,0,0,0,4,4,8,6,14,0,0,0,8,10,18
wi10,101,MARSHALL,LIT,Pre-Lit/Wr,0,0,0,0,1,1,1,1,2,5,6,11,3,1,4,0,0,0,9,9,18
wi10,101,MARSHALL,LIT,Spanish Lt,0,0,0,0,0,0,0,1,1,0,2,2,0,3,3,0,0,0,0,6,6
wi10,101,MARSHALL,MAE,Aerosp Eng,0,0,0,5,0,5,5,0,5,8,3,11,16,4,20,0,0,0,34,7,41
wi10,101,MARSHALL,MAE,Engin Sci,0,0,0,0,1,1,0,0,0,0,0,0,1,0,1,0,0,0,1,1,2
wi10,101,MARSHALL,MAE,Envir Eng,0,0,0,1,1,2,0,1,1,1,1,2,0,2,2,0,0,0,2,5,7
wi10,101,MARSHALL,MAE,Mech Engin,0,0,0,4,1,5,15,2,17,19,2,21,56,4,60,0,0,0,94,9,103
wi10,101,MARSHALL,MATH,Appld Math,0,0,0,0,0,0,2,0,2,1,1,2,2,1,3,0,0,0,5,2,7
wi10,101,MARSHALL,MATH,Math/SecEd,0,0,0,3,1,4,0,1,1,0,2,2,2,0,2,0,0,0,5,4,9
wi10,101,MARSHALL,MATH,Mathematcs,0,0,0,0,3,3,1,2,3,6,6,12,5,0,5,0,0,0,12,11,23
wi10,101,MARSHALL,MATH,Mth-CompSc,0,0,0,0,0,0,0,0,0,1,1,2,0,2,2,0,0,0,1,3,4
wi10,101,MARSHALL,MATH,Mth-Mth&Ec,0,0,0,0,0,0,0,2,2,8,3,11,5,2,7,0,0,0,13,7,20
wi10,101,MARSHALL,MATH,Mth-SciCom,0,0,0,0,0,0,1,0,1,0,0,0,0,1,1,0,0,0,1,1,2
wi10,101,MARSHALL,MATH,Mth/ApldSc,0,0,0,0,0,0,0,1,1,0,0,0,0,0,0,0,0,0,0,1,1
wi10,101,MARSHALL,MATH,Pr-Math CS,0,0,0,0,0,0,0,0,0,0,1,1,0,0,0,0,0,0,0,1,1
wi10,101,MARSHALL,MATH,Prob&Stats,0,0,0,0,0,0,0,0,0,1,0,1,3,1,4,0,0,0,4,1,5
wi10,101,MARSHALL,MUS,Mu-CompArt,0,0,0,1,0,1,0,0,0,3,0,3,1,1,2,0,0,0,5,1,6
wi10,101,MARSHALL,MUS,Music,0,0,0,1,0,1,1,2,3,2,3,5,2,4,6,0,0,0,6,9,15
wi10,101,MARSHALL,MUS,Music Hum,0,0,0,0,0,0,0,0,0,0,0,0,0,1,1,0,0,0,0,1,1
wi10,101,MARSHALL,PHIL,Philosophy,0,0,0,0,1,1,1,0,1,5,1,6,6,3,9,0,0,0,12,5,17
wi10,101,MARSHALL,PHYS,Biophysics,0,0,0,0,0,0,3,0,3,1,0,1,0,1,1,0,0,0,4,1,5
wi10,101,MARSHALL,PHYS,Phy/ErthSc,0,0,0,0,0,0,0,0,0,1,0,1,0,1,1,0,0,0,1,1,2
wi10,101,MARSHALL,PHYS,Phys/Astro,0,0,0,1,1,2,0,0,0,0,1,1,0,1,1,0,0,0,1,3,4
wi10,101,MARSHALL,PHYS,Phys/Mtrls,0,0,0,0,0,0,0,0,0,0,0,0,0,1,1,0,0,0,0,1,1
wi10,101,MARSHALL,PHYS,Physics,0,0,0,2,1,3,3,1,4,3,0,3,2,1,3,0,0,0,10,3,13
wi10,101,MARSHALL,POLI,Polit Sci,0,0,0,0,1,1,8,13,21,24,18,42,31,26,57,0,0,0,63,58,121
wi10,101,MARSHALL,POLI,PolSc-Amer,0,0,0,0,0,0,0,2,2,2,1,3,4,2,6,0,0,0,6,5,11
wi10,101,MARSHALL,POLI,PolSc-Comp,0,0,0,0,0,0,0,1,1,1,0,1,1,1,2,0,0,0,2,2,4
wi10,101,MARSHALL,POLI,PolSc-Intl,0,0,0,0,2,2,3,6,9,12,17,29,26,14,40,0,0,0,41,39,80
wi10,101,MARSHALL,POLI,PolSc-PLaw,0,0,0,2,4,6,3,4,7,13,1,14,8,9,17,0,0,0,26,18,44
wi10,101,MARSHALL,POLI,PolSc-PPol,0,0,0,0,0,0,0,0,0,2,0,2,0,3,3,0,0,0,2,3,5
wi10,101,MARSHALL,POLI,PolSc-Thry,0,0,0,0,0,0,0,1,1,0,2,2,1,0,1,0,0,0,1,3,4
wi10,101,MARSHALL,PSYC,Psychology,0,0,0,7,27,34,7,29,36,21,57,78,34,92,126,0,0,0,69,205,274
wi10,101,MARSHALL,RELI,Relig/Stu,0,0,0,0,0,0,0,0,0,0,2,2,2,1,3,0,0,0,2,3,5
wi10,101,MARSHALL,SE,Engin Sci,0,0,0,0,0,0,0,0,0,1,0,1,0,0,0,0,0,0,1,0,1
wi10,101,MARSHALL,SE,Struct Eng,0,0,0,4,2,6,7,6,13,9,5,14,14,13,27,0,0,0,34,26,60
wi10,101,MARSHALL,SOC,SocAmSt,0,0,0,0,0,0,0,1,1,0,0,0,0,0,0,0,0,0,0,1,1
wi10,101,MARSHALL,SOC,SocCulCom,0,0,0,0,0,0,0,0,0,1,3,4,0,2,2,0,0,0,1,5,6
wi10,101,MARSHALL,SOC,SocEconSoc,0,0,0,0,0,0,0,0,0,0,2,2,1,0,1,0,0,0,1,2,3
wi10,101,MARSHALL,SOC,SocIntlStu,0,0,0,0,0,0,0,0,0,0,2,2,0,1,1,0,0,0,0,3,3
wi10,101,MARSHALL,SOC,Sociology,0,0,0,1,3,4,2,5,7,8,17,25,9,27,36,0,0,0,20,52,72
wi10,101,MARSHALL,SOC,SocLawSoc,0,0,0,0,1,1,2,0,2,1,3,4,2,3,5,0,0,0,5,7,12
wi10,101,MARSHALL,SOC,SocSciMed,0,0,0,0,0,0,1,0,1,0,0,0,0,0,0,0,0,0,1,0,1
wi10,101,MARSHALL,SOC,SocSolneq,0,0,0,0,0,0,0,0,0,0,1,1,2,1,3,0,0,0,2,2,4
wi10,101,MARSHALL,THEA,Dance,0,0,0,0,0,0,0,0,0,0,0,0,0,1,1,0,0,0,0,1,1
wi10,101,MARSHALL,THEA,Theatre,0,0,0,0,1,1,0,1,1,2,4,6,5,4,9,0,0,0,7,10,17
wi10,101,MARSHALL,UNAF,UndecBiolS,0,0,0,0,0,0,0,0,0,1,0,1,0,0,0,0,0,0,1,0,1
wi10,101,MARSHALL,UNAF,UndecHumAr,0,0,0,0,4,4,0,0,0,0,0,0,0,0,0,0,0,0,0,4,4
wi10,101,MARSHALL,UNAF,Undeclared,0,0,0,23,51,74,16,28,44,0,1,1,0,0,0,0,0,0,39,80,119
wi10,101,MARSHALL,UNAF,UndecPhysS,0,0,0,3,3,6,0,2,2,0,0,0,0,0,0,0,0,0,3,5,8
wi10,101,MARSHALL,UNAF,UndecSocSc,0,0,0,1,3,4,1,5,6,0,0,0,0,0,0,0,0,0,2,8,10
wi10,101,MARSHALL,USP,Urb Stu&Pl,0,0,0,0,1,1,2,1,3,4,7,11,5,9,14,0,0,0,11,18,29
wi10,101,MARSHALL,VIS,Art Hst/Cr,0,0,0,0,0,0,0,2,2,0,5,5,0,7,7,0,0,0,0,14,14
wi10,101,MARSHALL,VIS,Media,0,0,0,0,2,2,2,3,5,8,5,13,9,7,16,0,0,0,19,17,36
wi10,101,MARSHALL,VIS,Studio VA,0,0,0,0,1,1,0,1,1,2,4,6,5,4,9,0,0,0,7,10,17
wi10,101,MARSHALL,VIS,VA-CompArt,0,0,0,0,0,0,0,0,0,1,2,3,3,0,3,0,0,0,4,2,6
wi10,101,MUIR,ANTH,Anth-Arch,0,0,0,0,0,0,0,1,1,1,2,3,4,2,6,0,0,0,5,5,10
wi10,101,MUIR,ANTH,Anth-Biol,0,0,0,0,1,1,0,1,1,2,5,7,3,11,14,0,0,0,5,18,23
wi10,101,MUIR,ANTH,Anth-Soci,0,0,0,0,1,1,1,3,4,1,5,6,1,3,4,0,0,0,3,12,15
wi10,101,MUIR,BENG,Bioen:Binf,0,0,0,0,0,0,1,0,1,0,0,0,0,0,0,0,0,0,1,0,1
wi10,101,MUIR,BENG,Bioeng:PM,0,0,0,0,0,0,0,0,0,0,0,0,12,4,16,0,0,0,12,4,16
wi10,101,MUIR,BENG,BioengBiot,0,0,0,0,1,1,3,6,9,5,5,10,7,4,11,0,0,0,15,16,31
wi10,101,MUIR,BENG,Bioengin,0,0,0,2,1,3,9,3,12,15,3,18,11,6,17,0,0,0,37,13,50
wi10,101,MUIR,BENG,Pr-BioenPM,0,0,0,4,2,6,5,4,9,4,0,4,0,0,0,0,0,0,13,6,19
wi10,101,MUIR,BIOL,Anml Physl,0,0,0,0,0,0,0,0,0,0,0,0,0,1,1,0,0,0,0,1,1
wi10,101,MUIR,BIOL,Bioc/CellB,0,0,0,2,3,5,11,16,27,32,29,61,62,55,117,0,0,0,107,103,210
wi10,101,MUIR,BIOL,BiolBioinf,0,0,0,0,0,0,0,0,0,1,0,1,0,0,0,0,0,0,1,0,1
wi10,101,MUIR,BIOL,Ec/Beh/Evo,0,0,0,1,1,2,1,3,4,3,13,16,5,17,22,0,0,0,10,34,44
wi10,101,MUIR,BIOL,Genl Biol,0,0,0,3,7,10,6,34,40,17,39,56,51,77,128,0,0,0,77,157,234
wi10,101,MUIR,BIOL,Human Bio,0,0,0,5,24,29,31,52,83,41,65,106,72,98,170,0,0,0,149,239,388
wi10,101,MUIR,BIOL,Microbiol,0,0,0,1,2,3,2,1,3,1,5,6,6,6,12,0,0,0,10,14,24
wi10,101,MUIR,BIOL,Molec Biol,0,0,0,0,1,1,8,1,9,6,7,13,11,10,21,0,0,0,25,19,44
wi10,101,MUIR,BIOL,PhyslNeuro,0,0,0,3,2,5,11,15,26,12,24,36,34,35,69,0,0,0,60,76,136
wi10,101,MUIR,CENG,Chem Engin,0,0,0,1,0,1,5,1,6,4,5,9,16,8,24,0,0,0,26,14,40
wi10,101,MUIR,CGS,CritGendSt,0,0,0,0,0,0,0,0,0,0,3,3,0,6,6,0,0,0,0,9,9
wi10,101,MUIR,CHEM,Bioch/Chem,0,0,0,3,5,8,12,13,25,10,12,22,12,18,30,0,0,0,37,48,85
wi10,101,MUIR,CHEM,Bioinform,0,0,0,0,0,0,1,0,1,0,0,0,0,0,0,0,0,0,1,0,1
wi10,101,MUIR,CHEM,Chem Educ,0,0,0,0,0,0,0,1,1,0,0,0,0,0,0,0,0,0,0,1,1
wi10,101,MUIR,CHEM,Chemistry,0,0,0,1,3,4,1,3,4,8,4,12,9,3,12,0,0,0,19,13,32
wi10,101,MUIR,CHEM,Envir Chem,0,0,0,0,1,1,0,0,0,0,1,1,2,1,3,0,0,0,2,3,5
wi10,101,MUIR,CHEM,MolecSynth,0,0,0,0,0,0,0,0,0,0,0,0,2,0,2,0,0,0,2,0,2
wi10,101,MUIR,CHEM,Pharm Chem,0,0,0,4,2,6,2,8,10,11,9,20,11,14,25,0,0,0,28,33,61
wi10,101,MUIR,CHIN,Chinese St,0,0,0,0,0,0,0,0,0,0,0,0,1,1,2,0,0,0,1,1,2
wi10,101,MUIR,CLAS,Classic St,0,0,0,0,0,0,0,1,1,0,0,0,0,2,2,0,0,0,0,3,3
wi10,101,MUIR,COGS,Cog Sci,0,0,0,3,2,5,2,4,6,9,11,20,14,9,23,0,0,0,28,26,54
wi10,101,MUIR,COGS,CogSc/ClAs,0,0,0,0,0,0,0,1,1,0,2,2,2,4,6,0,0,0,2,7,9
wi10,101,MUIR,COGS,CogSc/Comp,0,0,0,0,0,0,0,0,0,2,0,2,2,0,2,0,0,0,4,0,4
wi10,101,MUIR,COGS,CogSc/HCI,0,0,0,1,1,2,2,3,5,2,2,4,5,2,7,0,0,0,10,8,18
wi10,101,MUIR,COGS,CogSc/HCog,0,0,0,0,0,0,1,1,2,1,3,4,2,1,3,0,0,0,4,5,9
wi10,101,MUIR,COGS,CogSc/Neur,0,0,0,3,2,5,3,2,5,4,5,9,8,10,18,0,0,0,18,19,37
wi10,101,MUIR,COMM,Communic,0,0,0,1,5,6,3,25,28,12,40,52,15,71,86,0,0,0,31,141,172
wi10,101,MUIR,CSE,Comp Sci,0,0,0,10,1,11,8,3,11,13,5,18,37,6,43,0,0,0,68,15,83
wi10,101,MUIR,CSE,CompEngCSE,0,0,0,3,1,4,5,1,6,4,3,7,8,0,8,0,0,0,20,5,25
wi10,101,MUIR,CSE,CompScBinf,0,0,0,1,0,1,2,0,2,0,1,1,2,1,3,0,0,0,5,2,7
wi10,101,MUIR,CSE,Pr-Comp Sc,0,0,0,0,0,0,0,0,0,1,0,1,0,0,0,0,0,0,1,0,1
wi10,101,MUIR,ECE,CompEngECE,0,0,0,2,1,3,2,0,2,0,1,1,2,0,2,0,0,0,6,2,8
wi10,101,MUIR,ECE,Electr Eng,0,0,0,2,1,3,9,0,9,11,1,12,16,4,20,0,0,0,38,6,44
wi10,101,MUIR,ECE,Engin Phys,0,0,0,0,0,0,1,0,1,0,0,0,0,0,0,0,0,0,1,0,1
wi10,101,MUIR,ECON,Ec-Mth&Ecn,0,0,0,1,4,5,3,0,3,2,2,4,5,1,6,0,0,0,11,7,18
wi10,101,MUIR,ECON,Econ-MgtSc,0,0,0,4,5,9,17,12,29,37,11,48,46,33,79,0,0,0,104,61,165
wi10,101,MUIR,ECON,Economics,0,0,0,6,6,12,13,10,23,53,40,93,81,50,131,0,0,0,153,106,259
wi10,101,MUIR,ERTH,Earth Scis,0,0,0,0,0,0,0,0,0,0,0,0,1,0,1,0,0,0,1,0,1
wi10,101,MUIR,ESYS,EnvSys(EB),0,0,0,2,3,5,2,6,8,7,8,15,2,8,10,0,0,0,13,25,38
wi10,101,MUIR,ESYS,EnvSys(EC),0,0,0,0,0,0,0,0,0,0,0,0,0,1,1,0,0,0,0,1,1
wi10,101,MUIR,ESYS,EnvSys(EP),0,0,0,0,1,1,1,1,2,1,1,2,1,2,3,0,0,0,3,5,8
wi10,101,MUIR,ESYS,EnvSys(ES),0,0,0,0,1,1,0,3,3,0,0,0,3,0,3,0,0,0,3,4,7
wi10,101,MUIR,ETHN,Ethnic St,0,0,0,1,2,3,0,5,5,0,4,4,2,10,12,0,0,0,3,21,24
wi10,101,MUIR,GMST,German Stu,0,0,0,0,0,0,0,0,0,0,0,0,0,1,1,0,0,0,0,1,1
wi10,101,MUIR,HDP,Human Dev,0,0,0,0,0,0,0,0,0,0,0,0,1,22,23,0,0,0,1,22,23
wi10,101,MUIR,HDP,Pr-HumnDev,0,0,0,0,4,4,2,16,18,0,10,10,0,3,3,0,0,0,2,33,35
wi10,101,MUIR,HIST,History,0,0,0,1,0,1,2,5,7,14,8,22,11,15,26,0,0,0,28,28,56
wi10,101,MUIR,INTD,Muir Sp Pr,0,0,0,0,0,0,0,0,0,0,0,0,0,1,1,0,0,0,0,1,1
wi10,101,MUIR,INTL,IntSt-Anth,0,0,0,0,0,0,0,0,0,0,0,0,3,1,4,0,0,0,3,1,4
wi10,101,MUIR,INTL,IntSt-Econ,0,0,0,0,2,2,1,9,10,5,8,13,12,13,25,0,0,0,18,32,50
wi10,101,MUIR,INTL,IntSt-Hist,0,0,0,0,0,0,0,1,1,1,1,2,2,4,6,0,0,0,3,6,9
wi10,101,MUIR,INTL,IntSt-Ling,0,0,0,0,1,1,0,0,0,0,1,1,1,3,4,0,0,0,1,5,6
wi10,101,MUIR,INTL,IntSt-Lit,0,0,0,0,0,0,0,0,0,0,3,3,1,0,1,0,0,0,1,3,4
wi10,101,MUIR,INTL,IntSt-PolS,0,0,0,0,2,2,0,3,3,2,10,12,8,16,24,0,0,0,10,31,41
wi10,101,MUIR,INTL,IntSt-Soc,0,0,0,0,0,0,0,3,3,5,4,9,1,7,8,0,0,0,6,14,20
wi10,101,MUIR,ITAL,Italian St,0,0,0,0,0,0,1,0,1,0,0,0,0,0,0,0,0,0,1,0,1
wi10,101,MUIR,JAPN,JapaneseSt,0,0,0,0,0,0,0,1,1,0,2,2,4,5,9,0,0,0,4,8,12
wi10,101,MUIR,JUDA,Judaic Stu,0,0,0,0,0,0,0,1,1,0,0,0,0,0,0,0,0,0,0,1,1
wi10,101,MUIR,LATI,LatinAm St,0,0,0,1,0,1,0,0,0,0,0,0,1,1,2,0,0,0,2,1,3
wi10,101,MUIR,LING,Lang Stu,0,0,0,0,0,0,0,1,1,0,0,0,2,2,4,0,0,0,2,3,5
wi10,101,MUIR,LING,Ling-CogLn,0,0,0,0,0,0,1,0,1,1,0,1,0,3,3,0,0,0,2,3,5
wi10,101,MUIR,LING,Ling-LSoc,0,0,0,0,1,1,0,1,1,0,1,1,0,1,1,0,0,0,0,4,4
wi10,101,MUIR,LING,Linguistcs,0,0,0,0,0,0,1,1,2,4,6,10,0,8,8,0,0,0,5,15,20
wi10,101,MUIR,LIT,French Lit,0,0,0,0,0,0,0,0,0,0,0,0,0,1,1,0,0,0,0,1,1
wi10,101,MUIR,LIT,Lit/CultSt,0,0,0,0,0,0,0,0,0,0,0,0,0,2,2,0,0,0,0,2,2
wi10,101,MUIR,LIT,Lit/Engl,0,0,0,1,2,3,0,1,1,5,7,12,4,10,14,0,0,0,10,20,30
wi10,101,MUIR,LIT,Lit/World,0,0,0,0,0,0,0,0,0,0,4,4,2,4,6,0,0,0,2,8,10
wi10,101,MUIR,LIT,Lit/Writng,0,0,0,0,0,0,0,0,0,0,0,0,3,10,13,0,0,0,3,10,13
wi10,101,MUIR,LIT,Pre-Lit/Wr,0,0,0,0,2,2,2,7,9,2,5,7,7,5,12,0,0,0,11,19,30
wi10,101,MUIR,LIT,Spanish Lt,0,0,0,0,0,0,0,0,0,0,0,0,2,4,6,0,0,0,2,4,6
wi10,101,MUIR,MAE,Aerosp Eng,0,0,0,5,0,5,11,3,14,8,1,9,13,5,18,0,0,0,37,9,46
wi10,101,MUIR,MAE,Envir Eng,0,0,0,3,2,5,4,0,4,3,5,8,2,2,4,0,0,0,12,9,21
wi10,101,MUIR,MAE,Mech Engin,0,0,0,3,1,4,10,1,11,25,2,27,46,6,52,0,0,0,84,10,94
wi10,101,MUIR,MATH,Appld Math,0,0,0,0,0,0,0,1,1,1,1,2,4,2,6,0,0,0,5,4,9
wi10,101,MUIR,MATH,Math/SecEd,0,0,0,0,1,1,0,2,2,2,3,5,2,3,5,0,0,0,4,9,13
wi10,101,MUIR,MATH,Mathematcs,0,0,0,1,2,3,3,2,5,2,2,4,7,6,13,0,0,0,13,12,25
wi10,101,MUIR,MATH,Mth-CompSc,0,0,0,0,0,0,0,0,0,2,0,2,0,1,1,0,0,0,2,1,3
wi10,101,MUIR,MATH,Mth-Mth&Ec,0,0,0,1,0,1,1,0,1,4,1,5,4,3,7,0,0,0,10,4,14
wi10,101,MUIR,MATH,Mth-SciCom,0,0,0,0,0,0,0,0,0,0,0,0,1,0,1,0,0,0,1,0,1
wi10,101,MUIR,MATH,Mth/ApldSc,0,0,0,0,0,0,0,0,0,0,0,0,1,1,2,0,0,0,1,1,2
wi10,101,MUIR,MATH,Prob&Stats,0,0,0,0,0,0,2,0,2,1,2,3,1,0,1,0,0,0,4,2,6
wi10,101,MUIR,MUS,Mu-CompArt,0,0,0,1,0,1,0,0,0,7,0,7,6,1,7,0,0,0,14,1,15
wi10,101,MUIR,MUS,Music,0,0,0,2,1,3,1,0,1,2,5,7,6,8,14,0,0,0,11,14,25
wi10,101,MUIR,MUS,Music Hum,0,0,0,0,0,0,1,0,1,0,2,2,0,0,0,0,0,0,1,2,3
wi10,101,MUIR,PHIL,Philosophy,0,0,0,0,0,0,2,0,2,2,0,2,6,4,10,0,0,0,10,4,14
wi10,101,MUIR,PHYS,Biophysics,0,0,0,0,0,0,0,0,0,1,0,1,0,0,0,0,0,0,1,0,1
wi10,101,MUIR,PHYS,Phy/ErthSc,0,0,0,0,0,0,0,0,0,0,1,1,0,0,0,0,0,0,0,1,1
wi10,101,MUIR,PHYS,Phys/Astro,0,0,0,0,0,0,0,0,0,2,1,3,3,1,4,0,0,0,5,2,7
wi10,101,MUIR,PHYS,Phys/Comp,0,0,0,0,0,0,0,0,0,1,0,1,2,0,2,0,0,0,3,0,3
wi10,101,MUIR,PHYS,Phys/Mtrls,0,0,0,0,0,0,1,0,1,0,0,0,0,0,0,0,0,0,1,0,1
wi10,101,MUIR,PHYS,Physics,0,0,0,0,0,0,3,0,3,1,2,3,2,0,2,0,0,0,6,2,8
wi10,101,MUIR,POLI,Polit Sci,0,0,0,1,0,1,7,11,18,14,21,35,27,17,44,0,0,0,49,49,98
wi10,101,MUIR,POLI,PolSc-Amer,0,0,0,1,1,2,2,0,2,2,4,6,5,4,9,0,0,0,10,9,19
wi10,101,MUIR,POLI,PolSc-Comp,0,0,0,0,0,0,0,0,0,1,1,2,2,0,2,0,0,0,3,1,4
wi10,101,MUIR,POLI,PolSc-Intl,0,0,0,2,2,4,5,5,10,13,9,22,8,6,14,0,0,0,28,22,50
wi10,101,MUIR,POLI,PolSc-PLaw,0,0,0,0,3,3,0,1,1,6,5,11,9,5,14,0,0,0,15,14,29
wi10,101,MUIR,POLI,PolSc-PPol,0,0,0,0,0,0,1,0,1,2,0,2,2,2,4,0,0,0,5,2,7
wi10,101,MUIR,POLI,PolSc-Thry,0,0,0,0,0,0,0,0,0,3,0,3,4,2,6,0,0,0,7,2,9
wi10,101,MUIR,PSYC,Psychology,0,1,1,8,28,36,12,28,40,26,61,87,38,104,142,0,0,0,84,222,306
wi10,101,MUIR,RELI,Relig/Stu,0,0,0,0,0,0,0,0,0,1,1,2,5,1,6,0,0,0,6,2,8
wi10,101,MUIR,SE,Struct Eng,0,0,0,4,3,7,10,4,14,13,2,15,25,12,37,0,0,0,52,21,73
wi10,101,MUIR,SIO,ErSc-Geol,0,0,0,0,0,0,1,0,1,1,0,1,2,0,2,0,0,0,4,0,4
wi10,101,MUIR,SOC,SocAmSt,0,0,0,0,0,0,0,0,0,0,1,1,0,0,0,0,0,0,0,1,1
wi10,101,MUIR,SOC,SocCulCom,0,0,0,0,1,1,0,0,0,0,0,0,0,1,1,0,0,0,0,2,2
wi10,101,MUIR,SOC,SocIntlStu,0,0,0,0,0,0,0,0,0,1,1,2,0,1,1,0,0,0,1,2,3
wi10,101,MUIR,SOC,Sociology,0,0,0,2,7,9,1,6,7,7,14,21,2,23,25,0,0,0,12,50,62
wi10,101,MUIR,SOC,SocLawSoc,0,0,0,0,0,0,1,0,1,1,0,1,0,1,1,0,0,0,2,1,3
wi10,101,MUIR,SOC,SocSciMed,0,0,0,0,1,1,0,1,1,2,1,3,0,1,1,0,0,0,2,4,6
wi10,101,MUIR,SOC,SocSolneq,0,0,0,0,0,0,0,0,0,0,2,2,0,0,0,0,0,0,0,2,2
wi10,101,MUIR,THEA,Dance,0,0,0,0,0,0,0,0,0,0,1,1,2,3,5,0,0,0,2,4,6
wi10,101,MUIR,THEA,Theatre,0,0,0,1,2,3,2,4,6,1,6,7,5,7,12,0,0,0,9,19,28
wi10,101,MUIR,TWS,ThirdWldSt,0,0,0,0,1,1,0,0,0,0,0,0,0,0,0,0,0,0,0,1,1
wi10,101,MUIR,UNAF,Limited St,0,0,0,0,0,0,0,0,0,0,0,0,0,0,0,1,0,1,1,0,1
wi10,101,MUIR,UNAF,UndecBiolS,0,0,0,0,1,1,0,0,0,0,0,0,0,0,0,0,0,0,0,1,1
wi10,101,MUIR,UNAF,UndecHumAr,0,0,0,2,4,6,0,0,0,0,0,0,0,0,0,0,0,0,2,4,6
wi10,101,MUIR,UNAF,Undeclared,0,0,0,28,33,61,28,21,49,0,2,2,0,0,0,0,0,0,56,56,112
wi10,101,MUIR,UNAF,UndecPhysS,0,0,0,4,3,7,3,1,4,0,0,0,0,0,0,0,0,0,7,4,11
wi10,101,MUIR,UNAF,UndecSocSc,0,0,0,2,2,4,0,4,4,0,0,0,0,0,0,0,0,0,2,6,8
wi10,101,MUIR,USP,Urb Stu&Pl,0,0,0,1,1,2,2,0,2,7,6,13,8,5,13,0,0,0,18,12,30
wi10,101,MUIR,VIS,Art Hst/Cr,0,0,0,0,0,0,0,0,0,0,7,7,0,7,7,0,0,0,0,14,14
wi10,101,MUIR,VIS,Media,0,0,0,0,4,4,1,6,7,14,2,16,12,13,25,0,0,0,27,25,52
wi10,101,MUIR,VIS,Studio VA,0,1,1,0,0,0,0,1,1,1,2,3,1,7,8,0,0,0,2,11,13
wi10,101,MUIR,VIS,VA-CompArt,0,0,0,0,2,2,2,2,4,4,0,4,4,4,8,0,0,0,10,8,18
wi10,101,REVELLE,ANTH,Anth-Arch,0,0,0,0,0,0,1,1,2,0,2,2,0,1,1,0,0,0,1,4,5
wi10,101,REVELLE,ANTH,Anth-Biol,0,0,0,0,1,1,0,1,1,0,3,3,3,1,4,0,0,0,3,6,9
wi10,101,REVELLE,ANTH,Anth-Soci,1,0,1,0,0,0,0,3,3,1,5,6,1,6,7,0,0,0,3,14,17
wi10,101,REVELLE,BENG,Bioen:Binf,0,0,0,0,0,0,1,0,1,1,0,1,2,1,3,0,0,0,4,1,5
wi10,101,REVELLE,BENG,Bioeng:PM,0,0,0,0,0,0,1,0,1,6,2,8,29,13,42,0,0,0,36,15,51
wi10,101,REVELLE,BENG,BioengBiot,0,0,0,3,1,4,6,3,9,5,4,9,14,8,22,0,0,0,28,16,44
wi10,101,REVELLE,BENG,Bioengin,0,0,0,3,3,6,4,2,6,10,7,17,7,11,18,0,0,0,24,23,47
wi10,101,REVELLE,BENG,Pr-Bioeng,0,0,0,0,0,0,0,0,0,1,0,1,0,0,0,0,0,0,1,0,1
wi10,101,REVELLE,BENG,Pr-BioenPM,0,0,0,4,4,8,11,6,17,4,3,7,0,0,0,0,0,0,19,13,32
wi10,101,REVELLE,BIOL,Bioc/CellB,0,0,0,4,4,8,13,20,33,57,43,100,78,93,171,0,0,0,152,160,312
wi10,101,REVELLE,BIOL,BiolBioinf,0,0,0,1,0,1,1,1,2,0,0,0,1,0,1,0,0,0,3,1,4
wi10,101,REVELLE,BIOL,Ec/Beh/Evo,0,0,0,1,1,2,3,0,3,4,8,12,5,6,11,0,0,0,13,15,28
wi10,101,REVELLE,BIOL,Genl Biol,0,0,0,8,11,19,12,22,34,27,42,69,41,76,117,0,0,0,88,151,239
wi10,101,REVELLE,BIOL,Human Bio,0,0,0,13,29,42,38,65,103,67,98,165,97,124,221,0,0,0,215,316,531
wi10,101,REVELLE,BIOL,Microbiol,0,0,0,1,0,1,2,3,5,6,5,11,7,15,22,0,0,0,16,23,39
wi10,101,REVELLE,BIOL,Molec Biol,0,0,0,1,1,2,3,1,4,10,9,19,26,15,41,0,0,0,40,26,66
wi10,101,REVELLE,BIOL,PhyslNeuro,0,1,1,3,6,9,10,13,23,21,30,51,39,44,83,0,0,0,73,94,167
wi10,101,REVELLE,CENG,Chem Engin,0,0,0,4,2,6,10,1,11,16,4,20,16,9,25,0,0,0,46,16,62
wi10,101,REVELLE,CHEM,Bioch/Chem,0,0,0,8,19,27,13,12,25,7,10,17,26,31,57,0,0,0,54,72,126
wi10,101,REVELLE,CHEM,Chem Phys,0,0,0,0,1,1,0,0,0,0,0,0,1,0,1,0,0,0,1,1,2
wi10,101,REVELLE,CHEM,Chemistry,0,0,0,3,3,6,5,6,11,5,2,7,9,8,17,0,0,0,22,19,41
wi10,101,REVELLE,CHEM,Envir Chem,0,0,0,0,0,0,1,0,1,1,0,1,1,0,1,0,0,0,3,0,3
wi10,101,REVELLE,CHEM,MolecSynth,0,0,0,0,1,1,0,0,0,0,1,1,2,1,3,0,0,0,2,3,5
wi10,101,REVELLE,CHEM,Pharm Chem,0,0,0,5,12,17,9,10,19,10,14,24,16,24,40,0,0,0,40,60,100
wi10,101,REVELLE,CHIN,Chinese St,0,0,0,0,0,0,0,0,0,0,0,0,2,0,2,0,0,0,2,0,2
wi10,101,REVELLE,CLAS,Classic St,0,0,0,0,0,0,0,2,2,0,0,0,1,0,1,0,0,0,1,2,3
wi10,101,REVELLE,COGS,Cog Sci,0,0,0,0,1,1,1,4,5,3,1,4,2,3,5,0,0,0,6,9,15
wi10,101,REVELLE,COGS,CogSc/ClAs,0,0,0,0,1,1,0,1,1,0,2,2,1,0,1,0,0,0,1,4,5
wi10,101,REVELLE,COGS,CogSc/Comp,0,0,0,0,0,0,0,0,0,2,0,2,1,0,1,0,0,0,3,0,3
wi10,101,REVELLE,COGS,CogSc/HCI,0,0,0,0,0,0,0,0,0,0,0,0,3,3,6,0,0,0,3,3,6
wi10,101,REVELLE,COGS,CogSc/HCog,0,0,0,0,0,0,0,2,2,1,0,1,1,0,1,0,0,0,2,2,4
wi10,101,REVELLE,COGS,CogSc/Neur,0,0,0,0,4,4,2,2,4,2,4,6,4,7,11,0,0,0,8,17,25
wi10,101,REVELLE,COMM,Communic,0,0,0,0,4,4,1,10,11,7,23,30,15,21,36,0,0,0,23,58,81
wi10,101,REVELLE,CSE,Comp Sci,0,0,0,9,0,9,10,1,11,19,5,24,27,3,30,0,0,0,65,9,74
wi10,101,REVELLE,CSE,CompEngCSE,0,0,0,8,0,8,2,2,4,10,0,10,3,0,3,0,0,0,23,2,25
wi10,101,REVELLE,CSE,CompScBinf,0,0,0,0,0,0,0,0,0,1,0,1,1,0,1,0,0,0,2,0,2
wi10,101,REVELLE,ECE,CompEngECE,0,0,0,0,0,0,3,0,3,2,0,2,1,0,1,0,0,0,6,0,6
wi10,101,REVELLE,ECE,Electr Eng,0,0,0,5,0,5,6,2,8,11,1,12,27,3,30,0,0,0,49,6,55
wi10,101,REVELLE,ECE,Engin Phys,0,0,0,0,0,0,0,0,0,0,0,0,1,0,1,0,0,0,1,0,1
wi10,101,REVELLE,ECON,Ec-Mth&Ecn,0,0,0,1,0,1,1,0,1,3,0,3,3,1,4,0,0,0,8,1,9
wi10,101,REVELLE,ECON,Econ-MgtSc,0,0,0,4,3,7,10,3,13,23,6,29,26,23,49,0,0,0,63,35,98
wi10,101,REVELLE,ECON,Economics,0,0,0,5,4,9,9,5,14,33,23,56,43,25,68,0,0,0,90,57,147
wi10,101,REVELLE,ERTH,ErthSc-Phy,0,0,0,0,0,0,0,0,0,0,0,0,1,0,1,0,0,0,1,0,1
wi10,101,REVELLE,ESYS,EnvSys(EB),0,0,0,2,4,6,1,0,1,1,2,3,3,5,8,0,0,0,7,11,18
wi10,101,REVELLE,ESYS,EnvSys(EC),0,0,0,0,1,1,0,0,0,1,0,1,1,0,1,0,0,0,2,1,3
wi10,101,REVELLE,ESYS,EnvSys(EP),0,0,0,0,0,0,0,0,0,0,1,1,0,0,0,0,0,0,0,1,1
wi10,101,REVELLE,ESYS,EnvSys(ES),0,0,0,0,1,1,0,0,0,1,1,2,0,2,2,0,0,0,1,4,5
wi10,101,REVELLE,ETHN,Ethnic St,0,0,0,0,1,1,1,1,2,2,3,5,0,2,2,0,0,0,3,7,10
wi10,101,REVELLE,HDP,Human Dev,0,0,0,0,0,0,0,0,0,0,4,4,3,14,17,0,0,0,3,18,21
wi10,101,REVELLE,HDP,Pr-HumnDev,0,0,0,0,2,2,0,6,6,0,5,5,0,1,1,0,0,0,0,14,14
wi10,101,REVELLE,HIST,History,0,0,0,1,1,2,2,1,3,5,7,12,4,6,10,0,0,0,12,15,27
wi10,101,REVELLE,INTL,IntSt-Econ,0,0,0,2,1,3,4,2,6,2,5,7,4,3,7,0,0,0,12,11,23
wi10,101,REVELLE,INTL,IntSt-Hist,0,0,0,0,0,0,0,1,1,0,2,2,0,2,2,0,0,0,0,5,5
wi10,101,REVELLE,INTL,IntSt-Ling,0,0,0,0,0,0,1,0,1,0,3,3,0,1,1,0,0,0,1,4,5
wi10,101,REVELLE,INTL,IntSt-Lit,0,0,0,0,0,0,0,0,0,0,1,1,0,1,1,0,0,0,0,2,2
wi10,101,REVELLE,INTL,IntSt-PolS,0,0,0,0,2,2,1,1,2,1,5,6,3,7,10,0,0,0,5,15,20
wi10,101,REVELLE,INTL,IntSt-Soc,0,0,0,0,0,0,0,2,2,2,5,7,0,1,1,0,0,0,2,8,10
wi10,101,REVELLE,ITAL,Italian St,0,0,0,0,0,0,0,0,0,0,0,0,0,1,1,0,0,0,0,1,1
wi10,101,REVELLE,JAPN,JapaneseSt,0,0,0,1,1,2,0,0,0,1,0,1,1,0,1,0,0,0,3,1,4
wi10,101,REVELLE,JUDA,Judaic Stu,0,0,0,0,0,0,1,0,1,0,1,1,0,0,0,0,0,0,1,1,2
wi10,101,REVELLE,LATI,LatinAm St,0,0,0,0,0,0,0,0,0,1,0,1,0,0,0,0,0,0,1,0,1
wi10,101,REVELLE,LING,Lang Stu,0,0,0,0,0,0,0,0,0,0,0,0,0,1,1,0,0,0,0,1,1
wi10,101,REVELLE,LING,Ling-CogLn,0,0,0,0,0,0,0,4,4,0,0,0,0,1,1,0,0,0,0,5,5
wi10,101,REVELLE,LING,Ling-LSoc,0,0,0,0,0,0,0,0,0,0,0,0,0,1,1,0,0,0,0,1,1
wi10,101,REVELLE,LING,Linguistcs,0,0,0,0,2,2,0,1,1,0,1,1,2,3,5,0,0,0,2,7,9
wi10,101,REVELLE,LIT,Ital Lit,0,0,0,0,0,0,0,0,0,0,0,0,0,1,1,0,0,0,0,1,1
wi10,101,REVELLE,LIT,Lit/Compos,0,0,0,0,0,0,1,1,2,1,0,1,0,0,0,0,0,0,2,1,3
wi10,101,REVELLE,LIT,Lit/Engl,0,0,0,0,2,2,2,0,2,0,4,4,1,7,8,0,0,0,3,13,16
wi10,101,REVELLE,LIT,Lit/World,0,0,0,0,0,0,0,0,0,4,2,6,1,5,6,0,0,0,5,7,12
wi10,101,REVELLE,LIT,Lit/Writng,0,0,0,0,0,0,0,0,0,1,0,1,1,6,7,0,0,0,2,6,8
wi10,101,REVELLE,LIT,Pre-Lit/Wr,0,0,0,0,1,1,1,2,3,2,2,4,3,2,5,0,0,0,6,7,13
wi10,101,REVELLE,LIT,Spanish Lt,0,0,0,0,0,0,0,1,1,0,0,0,0,2,2,0,0,0,0,3,3
wi10,101,REVELLE,MAE,Aerosp Eng,0,0,0,3,0,3,9,2,11,11,3,14,19,5,24,0,0,0,42,10,52
wi10,101,REVELLE,MAE,Engin Sci,0,0,0,1,0,1,1,0,1,1,0,1,0,0,0,0,0,0,3,0,3
wi10,101,REVELLE,MAE,Envir Eng,0,0,0,1,0,1,2,1,3,1,1,2,2,1,3,0,0,0,6,3,9
wi10,101,REVELLE,MAE,Mech Engin,0,0,0,3,2,5,10,2,12,23,6,29,50,11,61,0,0,0,86,21,107
wi10,101,REVELLE,MATH,Appld Math,0,0,0,0,0,0,0,0,0,2,2,4,2,2,4,0,0,0,4,4,8
wi10,101,REVELLE,MATH,Math/SecEd,0,0,0,0,0,0,0,1,1,0,2,2,0,0,0,0,0,0,0,3,3
wi10,101,REVELLE,MATH,Mathematcs,0,0,0,1,1,2,3,1,4,2,7,9,9,7,16,0,0,0,15,16,31
wi10,101,REVELLE,MATH,Mth-CompSc,0,0,0,0,0,0,0,0,0,1,0,1,3,0,3,0,0,0,4,0,4
wi10,101,REVELLE,MATH,Mth-Mth&Ec,0,0,0,0,1,1,1,0,1,3,1,4,6,0,6,0,0,0,10,2,12
wi10,101,REVELLE,MATH,Mth-SciCom,0,0,0,0,0,0,0,0,0,0,1,1,1,1,2,0,0,0,1,2,3
wi10,101,REVELLE,MATH,Mth/ApldSc,0,0,0,0,1,1,1,0,1,2,0,2,1,0,1,0,0,0,4,1,5
wi10,101,REVELLE,MATH,Prob&Stats,0,0,0,1,0,1,0,0,0,3,0,3,1,1,2,0,0,0,5,1,6
wi10,101,REVELLE,MUS,Mu-CompArt,0,0,0,0,0,0,0,0,0,2,0,2,2,0,2,0,0,0,4,0,4
wi10,101,REVELLE,MUS,Music,0,0,0,0,0,0,2,0,2,4,1,5,3,1,4,0,0,0,9,2,11
wi10,101,REVELLE,MUS,Music Hum,0,0,0,0,0,0,0,0,0,1,0,1,0,0,0,0,0,0,1,0,1
wi10,101,REVELLE,PHIL,Philosophy,0,0,0,0,0,0,1,0,1,5,3,8,3,2,5,0,0,0,9,5,14
wi10,101,REVELLE,PHYS,Biophysics,0,0,0,1,0,1,0,0,0,0,1,1,1,0,1,0,0,0,2,1,3
wi10,101,REVELLE,PHYS,Phy/ErthSc,0,0,0,0,0,0,0,0,0,0,0,0,1,0,1,0,0,0,1,0,1
wi10,101,REVELLE,PHYS,Phys/Astro,0,0,0,0,0,0,0,0,0,5,1,6,1,3,4,0,0,0,6,4,10
wi10,101,REVELLE,PHYS,Phys/Comp,0,0,0,1,1,2,1,0,1,0,0,0,0,0,0,0,0,0,2,1,3
wi10,101,REVELLE,PHYS,Phys/Mtrls,0,0,0,0,0,0,1,0,1,0,0,0,0,0,0,0,0,0,1,0,1
wi10,101,REVELLE,PHYS,Physics,0,0,0,1,0,1,3,0,3,4,1,5,5,2,7,0,0,0,13,3,16
wi10,101,REVELLE,POLI,Polit Sci,1,0,1,4,5,9,3,5,8,10,4,14,9,7,16,0,0,0,27,21,48
wi10,101,REVELLE,POLI,PolSc-Amer,0,0,0,0,1,1,2,3,5,0,0,0,1,2,3,0,0,0,3,6,9
wi10,101,REVELLE,POLI,PolSc-Intl,0,0,0,0,1,1,0,3,3,9,5,14,5,5,10,0,0,0,14,14,28
wi10,101,REVELLE,POLI,PolSc-PLaw,0,0,0,0,0,0,3,1,4,5,6,11,2,4,6,0,0,0,10,11,21
wi10,101,REVELLE,POLI,PolSc-PPol,0,0,0,0,0,0,0,0,0,1,3,4,0,1,1,0,0,0,1,4,5
wi10,101,REVELLE,POLI,PolSc-Thry,0,0,0,0,0,0,1,0,1,0,0,0,0,1,1,0,0,0,1,1,2
wi10,101,REVELLE,PSYC,Psychology,0,0,0,2,19,21,10,22,32,24,56,80,33,67,100,0,0,0,69,164,233
wi10,101,REVELLE,RELI,Relig/Stu,0,0,0,0,0,0,0,0,0,1,0,1,1,0,1,0,0,0,2,0,2
wi10,101,REVELLE,SE,Struct Eng,0,0,0,3,1,4,7,2,9,14,4,18,24,12,36,0,0,0,48,19,67
wi10,101,REVELLE,SIO,ErSc-Geoch,0,0,0,0,0,0,0,0,0,0,1,1,0,0,0,0,0,0,0,1,1
wi10,101,REVELLE,SIO,ErSc-Geol,0,0,0,0,0,0,0,0,0,2,1,3,2,0,2,0,0,0,4,1,5
wi10,101,REVELLE,SOC,SocCulCom,0,0,0,0,0,0,0,0,0,0,1,1,1,0,1,0,0,0,1,1,2
wi10,101,REVELLE,SOC,Sociology,0,0,0,0,1,1,0,3,3,4,10,14,1,5,6,0,0,0,5,19,24
wi10,101,REVELLE,SOC,SocLawSoc,0,0,0,0,0,0,0,0,0,0,1,1,1,1,2,0,0,0,1,2,3
wi10,101,REVELLE,SOC,SocSciMed,0,0,0,0,0,0,0,0,0,1,1,2,0,1,1,0,0,0,1,2,3
wi10,101,REVELLE,SOC,SocSolneq,0,0,0,0,0,0,0,0,0,0,1,1,0,0,0,0,0,0,0,1,1
wi10,101,REVELLE,THEA,Dance,0,0,0,0,0,0,0,0,0,0,1,1,1,1,2,0,0,0,1,2,3
wi10,101,REVELLE,THEA,Theatre,0,0,0,0,0,0,0,0,0,0,1,1,2,4,6,0,0,0,2,5,7
wi10,101,REVELLE,TWS,ThirdWldSt,0,0,0,0,0,0,0,1,1,0,0,0,0,0,0,0,0,0,0,1,1
wi10,101,REVELLE,UNAF,Limited St,0,0,0,0,0,0,0,0,0,0,0,0,0,0,0,7,7,14,7,7,14
wi10,101,REVELLE,UNAF,Spec-Emply,0,0,0,0,0,0,0,0,0,0,0,0,0,0,0,3,1,4,3,1,4
wi10,101,REVELLE,UNAF,UndecHumAr,0,0,0,0,5,5,0,2,2,0,2,2,0,0,0,0,0,0,0,9,9
wi10,101,REVELLE,UNAF,Undeclared,0,1,1,17,42,59,10,20,30,2,0,2,0,0,0,0,0,0,29,63,92
wi10,101,REVELLE,UNAF,UndecPhysS,0,0,0,1,8,9,6,3,9,0,0,0,0,0,0,0,0,0,7,11,18
wi10,101,REVELLE,UNAF,UndecSocSc,0,0,0,1,4,5,4,2,6,1,0,1,0,0,0,0,0,0,6,6,12
wi10,101,REVELLE,USP,Urb Stu&Pl,0,0,0,1,1,2,0,2,2,1,2,3,3,2,5,0,0,0,5,7,12
wi10,101,REVELLE,VIS,Art Hst/Cr,0,0,0,0,1,1,0,0,0,0,3,3,1,2,3,0,0,0,1,6,7
wi10,101,REVELLE,VIS,Media,0,0,0,0,0,0,3,0,3,0,3,3,4,6,10,0,0,0,7,9,16
wi10,101,REVELLE,VIS,Studio VA,0,0,0,0,0,0,0,0,0,1,4,5,0,1,1,0,0,0,1,5,6
wi10,101,REVELLE,VIS,VA-CompArt,0,0,0,0,0,0,0,0,0,6,2,8,1,0,1,0,0,0,7,2,9
wi10,101,ROOSEVELT,ANTH,Anth-Arch,0,0,0,0,1,1,0,2,2,1,5,6,3,3,6,0,0,0,4,11,15
wi10,101,ROOSEVELT,ANTH,Anth-Biol,0,0,0,0,0,0,0,4,4,1,5,6,0,4,4,0,0,0,1,13,14
wi10,101,ROOSEVELT,ANTH,Anth-Soci,0,0,0,1,1,2,0,3,3,2,4,6,1,4,5,0,0,0,4,12,16
wi10,101,ROOSEVELT,ANTH,Anthropol,0,0,0,0,0,0,0,0,0,0,0,0,0,1,1,0,0,0,0,1,1
wi10,101,ROOSEVELT,BENG,Bioen:Binf,0,0,0,0,0,0,0,0,0,0,1,1,0,0,0,0,0,0,0,1,1
wi10,101,ROOSEVELT,BENG,Bioeng:PM,0,0,0,0,0,0,1,1,2,4,2,6,8,6,14,0,0,0,13,9,22
wi10,101,ROOSEVELT,BENG,BioengBiot,0,0,0,2,1,3,5,0,5,3,5,8,3,1,4,0,0,0,13,7,20
wi10,101,ROOSEVELT,BENG,Bioengin,0,0,0,1,1,2,2,0,2,3,6,9,2,3,5,0,0,0,8,10,18
wi10,101,ROOSEVELT,BENG,Pr-BioenPM,0,0,0,3,2,5,12,3,15,0,2,2,1,0,1,0,0,0,16,7,23
wi10,101,ROOSEVELT,BIOL,Bioc/CellB,0,0,0,1,3,4,7,4,11,14,18,32,25,37,62,0,0,0,47,62,109
wi10,101,ROOSEVELT,BIOL,Ec/Beh/Evo,0,0,0,2,1,3,0,3,3,1,3,4,3,9,12,0,0,0,6,16,22
wi10,101,ROOSEVELT,BIOL,Genl Biol,0,0,0,1,4,5,7,10,17,13,35,48,27,56,83,0,0,0,48,105,153
wi10,101,ROOSEVELT,BIOL,Human Bio,0,0,0,7,13,20,18,41,59,34,63,97,30,59,89,0,0,0,89,176,265
wi10,101,ROOSEVELT,BIOL,Microbiol,0,0,0,0,1,1,2,1,3,3,0,3,4,4,8,0,0,0,9,6,15
wi10,101,ROOSEVELT,BIOL,Molec Biol,0,0,0,1,0,1,0,2,2,5,3,8,7,9,16,0,0,0,13,14,27
wi10,101,ROOSEVELT,BIOL,PhyslNeuro,0,0,0,1,2,3,4,6,10,12,13,25,12,18,30,0,0,0,29,39,68
wi10,101,ROOSEVELT,CENG,Chem Engin,0,0,0,4,0,4,2,0,2,1,4,5,3,4,7,0,0,0,10,8,18
wi10,101,ROOSEVELT,CGS,CritGendSt,0,0,0,0,0,0,0,0,0,0,0,0,0,1,1,0,0,0,0,1,1
wi10,101,ROOSEVELT,CHEM,Bioch/Chem,0,0,0,10,9,19,7,6,13,7,5,12,8,5,13,0,0,0,32,25,57
wi10,101,ROOSEVELT,CHEM,Chemistry,0,0,0,2,3,5,0,1,1,2,3,5,3,0,3,0,0,0,7,7,14
wi10,101,ROOSEVELT,CHEM,Envir Chem,0,0,0,1,1,2,1,0,1,1,0,1,0,2,2,0,0,0,3,3,6
wi10,101,ROOSEVELT,CHEM,Pharm Chem,0,0,0,0,10,10,4,8,12,5,6,11,3,2,5,0,0,0,12,26,38
wi10,101,ROOSEVELT,CHIN,Chinese St,0,0,0,1,3,4,0,0,0,1,1,2,2,1,3,0,0,0,4,5,9
wi10,101,ROOSEVELT,CLAS,Classic St,0,0,0,0,0,0,0,1,1,0,0,0,2,0,2,0,0,0,2,1,3
wi10,101,ROOSEVELT,COGS,Cog Sci,0,0,0,1,2,3,2,6,8,4,5,9,3,3,6,0,0,0,10,16,26
wi10,101,ROOSEVELT,COGS,CogSc/ClAs,0,0,0,0,0,0,0,0,0,0,0,0,1,0,1,0,0,0,1,0,1
wi10,101,ROOSEVELT,COGS,CogSc/HCI,0,0,0,0,0,0,1,1,2,1,1,2,3,4,7,0,0,0,5,6,11
wi10,101,ROOSEVELT,COGS,CogSc/HCog,0,0,0,0,1,1,0,0,0,0,1,1,0,0,0,0,0,0,0,2,2
wi10,101,ROOSEVELT,COGS,CogSc/Neur,0,0,0,1,0,1,1,4,5,1,5,6,3,13,16,0,0,0,6,22,28
wi10,101,ROOSEVELT,COMM,Communic,1,1,2,1,13,14,8,21,29,16,54,70,23,66,89,0,0,0,49,155,204
wi10,101,ROOSEVELT,CSE,Comp Sci,0,0,0,4,2,6,12,2,14,16,3,19,18,3,21,0,0,0,50,10,60
wi10,101,ROOSEVELT,CSE,CompEngCSE,0,0,0,2,1,3,2,0,2,4,1,5,3,0,3,0,0,0,11,2,13
wi10,101,ROOSEVELT,CSE,Pr-Comp Sc,0,0,0,0,0,0,0,0,0,0,1,1,0,0,0,0,0,0,0,1,1
wi10,101,ROOSEVELT,ECE,CompEngECE,0,0,0,1,0,1,2,0,2,2,0,2,1,0,1,0,0,0,6,0,6
wi10,101,ROOSEVELT,ECE,Electr Eng,0,0,0,4,0,4,3,2,5,6,2,8,15,5,20,0,0,0,28,9,37
wi10,101,ROOSEVELT,ECE,Pr-EngPhys,0,0,0,0,0,0,1,0,1,1,0,1,0,0,0,0,0,0,2,0,2
wi10,101,ROOSEVELT,ECON,Ec-Mth&Ecn,0,0,0,1,1,2,0,1,1,7,0,7,6,4,10,0,0,0,14,6,20
wi10,101,ROOSEVELT,ECON,Econ-MgtSc,0,0,0,8,5,13,11,17,28,34,16,50,51,28,79,0,0,0,104,66,170
wi10,101,ROOSEVELT,ECON,Economics,0,0,0,7,10,17,20,16,36,52,29,81,71,38,109,0,0,0,150,93,243
wi10,101,ROOSEVELT,ERTH,ErSc-Geol,0,0,0,0,0,0,0,0,0,0,0,0,0,1,1,0,0,0,0,1,1
wi10,101,ROOSEVELT,ESYS,EnvSys(EB),0,0,0,1,1,2,0,3,3,0,2,2,1,4,5,0,0,0,2,10,12
wi10,101,ROOSEVELT,ESYS,EnvSys(EC),0,0,0,0,0,0,0,0,0,0,0,0,1,2,3,0,0,0,1,2,3
wi10,101,ROOSEVELT,ESYS,EnvSys(EP),0,0,0,0,0,0,0,1,1,1,3,4,4,3,7,0,0,0,5,7,12
wi10,101,ROOSEVELT,ESYS,EnvSys(ES),0,0,0,0,1,1,0,1,1,0,2,2,2,1,3,0,0,0,2,5,7
wi10,101,ROOSEVELT,ETHN,Ethnic St,0,0,0,1,1,2,0,1,1,0,4,4,0,11,11,0,0,0,1,17,18
wi10,101,ROOSEVELT,HDP,Human Dev,0,0,0,0,0,0,0,0,0,0,6,6,3,18,21,0,0,0,3,24,27
wi10,101,ROOSEVELT,HDP,Pr-HumnDev,0,0,0,1,5,6,2,11,13,0,6,6,0,5,5,0,0,0,3,27,30
wi10,101,ROOSEVELT,HIST,History,0,0,0,2,2,4,2,6,8,10,17,27,20,27,47,0,0,0,34,52,86
wi10,101,ROOSEVELT,INTD,Roos IndSt,0,0,0,0,0,0,0,0,0,0,0,0,1,0,1,0,0,0,1,0,1
wi10,101,ROOSEVELT,INTL,Int-5yrEC,0,0,0,0,0,0,0,0,0,0,0,0,0,1,1,0,0,0,0,1,1
wi10,101,ROOSEVELT,INTL,IntSt-Anth,0,0,0,0,1,1,0,2,2,1,4,5,1,5,6,0,0,0,2,12,14
wi10,101,ROOSEVELT,INTL,IntSt-Econ,0,0,0,2,7,9,8,9,17,16,25,41,16,27,43,0,0,0,42,68,110
wi10,101,ROOSEVELT,INTL,IntSt-Hist,0,0,0,1,0,1,1,3,4,2,8,10,4,6,10,0,0,0,8,17,25
wi10,101,ROOSEVELT,INTL,IntSt-Ling,0,0,0,0,2,2,1,3,4,0,4,4,2,4,6,0,0,0,3,13,16
wi10,101,ROOSEVELT,INTL,IntSt-Lit,0,0,0,0,0,0,0,1,1,0,1,1,0,2,2,0,0,0,0,4,4
wi10,101,ROOSEVELT,INTL,IntSt-PolS,0,0,0,2,6,8,4,15,19,4,37,41,22,34,56,0,0,0,32,92,124
wi10,101,ROOSEVELT,INTL,IntSt-Soc,0,0,0,0,4,4,0,9,9,1,17,18,0,24,24,0,0,0,1,54,55
wi10,101,ROOSEVELT,ITAL,Italian St,0,0,0,0,0,0,0,0,0,1,1,2,0,0,0,0,0,0,1,1,2
wi10,101,ROOSEVELT,JAPN,JapaneseSt,0,0,0,1,1,2,0,1,1,0,2,2,1,3,4,0,0,0,2,7,9
wi10,101,ROOSEVELT,JUDA,Judaic Stu,0,0,0,0,0,0,0,0,0,1,0,1,0,1,1,0,0,0,1,1,2
wi10,101,ROOSEVELT,LATI,LatinAm St,0,0,0,0,1,1,0,1,1,0,1,1,2,1,3,0,0,0,2,4,6
wi10,101,ROOSEVELT,LING,Lang Stu,0,0,0,0,1,1,0,0,0,0,2,2,0,4,4,0,0,0,0,7,7
wi10,101,ROOSEVELT,LING,Ling-CogLn,0,0,0,0,0,0,0,1,1,0,0,0,0,1,1,0,0,0,0,2,2
wi10,101,ROOSEVELT,LING,Ling-LSoc,0,0,0,0,0,0,0,1,1,0,0,0,1,2,3,0,0,0,1,3,4
wi10,101,ROOSEVELT,LING,Linguistcs,0,0,0,1,1,2,0,3,3,1,6,7,1,1,2,0,0,0,3,11,14
wi10,101,ROOSEVELT,LIT,French Lit,0,0,0,0,0,0,0,0,0,1,1,2,0,1,1,0,0,0,1,2,3
wi10,101,ROOSEVELT,LIT,Lit/Compos,0,0,0,1,0,1,0,0,0,0,1,1,0,1,1,0,0,0,1,2,3
wi10,101,ROOSEVELT,LIT,Lit/CultSt,0,0,0,0,0,0,0,1,1,0,1,1,0,0,0,0,0,0,0,2,2
wi10,101,ROOSEVELT,LIT,Lit/Engl,0,0,0,0,2,2,1,4,5,5,8,13,3,4,7,0,0,0,9,18,27
wi10,101,ROOSEVELT,LIT,Lit/World,0,0,0,0,0,0,0,1,1,0,1,1,1,1,2,0,0,0,1,3,4
wi10,101,ROOSEVELT,LIT,Lit/Writng,0,0,0,0,0,0,0,0,0,0,3,3,3,13,16,0,0,0,3,16,19
wi10,101,ROOSEVELT,LIT,Pre-Lit/Wr,0,0,0,0,4,4,1,2,3,8,9,17,1,4,5,0,0,0,10,19,29
wi10,101,ROOSEVELT,LIT,Spanish Lt,0,0,0,0,0,0,0,0,0,1,0,1,0,2,2,0,0,0,1,2,3
wi10,101,ROOSEVELT,MAE,Aerosp Eng,0,0,0,8,0,8,5,1,6,6,2,8,11,3,14,0,0,0,30,6,36
wi10,101,ROOSEVELT,MAE,Engin Sci,0,0,0,0,1,1,0,0,0,1,0,1,1,0,1,0,0,0,2,1,3
wi10,101,ROOSEVELT,MAE,Envir Eng,0,0,0,1,2,3,2,0,2,2,1,3,2,2,4,0,0,0,7,5,12
wi10,101,ROOSEVELT,MAE,Mech Engin,0,0,0,4,2,6,10,1,11,14,3,17,21,9,30,0,0,0,49,15,64
wi10,101,ROOSEVELT,MATH,Appld Math,0,0,0,0,0,0,0,0,0,0,1,1,2,2,4,0,0,0,2,3,5
wi10,101,ROOSEVELT,MATH,Math/SecEd,0,0,0,1,1,2,0,1,1,1,0,1,2,0,2,0,0,0,4,2,6
wi10,101,ROOSEVELT,MATH,Mathematcs,0,0,0,0,1,1,1,2,3,2,0,2,1,4,5,0,0,0,4,7,11
wi10,101,ROOSEVELT,MATH,Mth-CompSc,0,0,0,0,0,0,0,0,0,0,0,0,2,0,2,0,0,0,2,0,2
wi10,101,ROOSEVELT,MATH,Mth-Mth&Ec,0,0,0,1,1,2,1,0,1,3,0,3,2,1,3,0,0,0,7,2,9
wi10,101,ROOSEVELT,MATH,Mth-SciCom,0,0,0,1,0,1,0,0,0,0,0,0,0,0,0,0,0,0,1,0,1
wi10,101,ROOSEVELT,MATH,Mth/ApldSc,0,0,0,1,0,1,0,0,0,0,0,0,2,0,2,0,0,0,3,0,3
wi10,101,ROOSEVELT,MATH,Pr-Math CS,0,0,0,0,1,1,1,0,1,1,0,1,0,0,0,0,0,0,2,1,3
wi10,101,ROOSEVELT,MATH,Prob&Stats,0,0,0,0,0,0,1,0,1,1,0,1,0,0,0,0,0,0,2,0,2
wi10,101,ROOSEVELT,MUS,Mu-CompArt,0,0,0,0,0,0,0,0,0,1,1,2,2,1,3,0,0,0,3,2,5
wi10,101,ROOSEVELT,MUS,Music,0,0,0,1,0,1,1,2,3,2,2,4,5,2,7,0,0,0,9,6,15
wi10,101,ROOSEVELT,PHIL,Philosophy,0,0,0,0,0,0,3,0,3,2,3,5,2,2,4,0,0,0,7,5,12
wi10,101,ROOSEVELT,PHYS,Biophysics,0,0,0,0,0,0,0,0,0,0,0,0,1,0,1,0,0,0,1,0,1
wi10,101,ROOSEVELT,PHYS,GenPys/SEd,0,0,0,0,0,0,0,0,0,1,1,2,0,0,0,0,0,0,1,1,2
wi10,101,ROOSEVELT,PHYS,Phys/Astro,0,0,0,0,0,0,0,0,0,2,0,2,0,1,1,0,0,0,2,1,3
wi10,101,ROOSEVELT,PHYS,Phys/Comp,0,0,0,0,0,0,0,0,0,0,0,0,0,1,1,0,0,0,0,1,1
wi10,101,ROOSEVELT,PHYS,Phys/Mtrls,0,0,0,0,0,0,1,0,1,0,0,0,0,0,0,0,0,0,1,0,1
wi10,101,ROOSEVELT,PHYS,Physics,0,0,0,0,0,0,0,1,1,1,0,1,4,3,7,0,0,0,5,4,9
wi10,101,ROOSEVELT,POLI,Polit Sci,1,0,1,4,5,9,7,8,15,19,24,43,27,35,62,0,0,0,58,72,130
wi10,101,ROOSEVELT,POLI,PolSc-Amer,0,0,0,0,4,4,2,0,2,2,3,5,3,4,7,0,0,0,7,11,18
wi10,101,ROOSEVELT,POLI,PolSc-Comp,0,0,0,0,0,0,0,1,1,0,3,3,0,1,1,0,0,0,0,5,5
wi10,101,ROOSEVELT,POLI,PolSc-Intl,0,0,0,5,11,16,10,9,19,15,13,28,14,26,40,0,0,0,44,59,103
wi10,101,ROOSEVELT,POLI,PolSc-PLaw,0,0,0,0,2,2,5,4,9,7,11,18,6,11,17,0,0,0,18,28,46
wi10,101,ROOSEVELT,POLI,PolSc-PPol,0,0,0,1,1,2,0,0,0,3,2,5,2,0,2,0,0,0,6,3,9
wi10,101,ROOSEVELT,POLI,PolSc-Thry,0,0,0,0,0,0,1,0,1,1,2,3,0,3,3,0,0,0,2,5,7
wi10,101,ROOSEVELT,PSYC,Psychology,0,0,0,10,24,34,10,34,44,26,74,100,21,73,94,0,0,0,67,205,272
wi10,101,ROOSEVELT,RELI,Relig/Stu,0,0,0,0,0,0,0,1,1,0,1,1,0,1,1,0,0,0,0,3,3
wi10,101,ROOSEVELT,RUSS,Russ&SovSt,0,0,0,0,0,0,1,0,1,0,0,0,0,0,0,0,0,0,1,0,1
wi10,101,ROOSEVELT,SE,Engin Sci,0,0,0,1,1,2,0,1,1,0,0,0,0,0,0,0,0,0,1,2,3
wi10,101,ROOSEVELT,SE,Struct Eng,0,0,0,2,4,6,13,2,15,9,1,10,19,7,26,0,0,0,43,14,57
wi10,101,ROOSEVELT,SIO,ErSc-Geol,0,0,0,0,0,0,0,2,2,1,2,3,0,0,0,0,0,0,1,4,5
wi10,101,ROOSEVELT,SOC,SocCulCom,0,0,0,0,0,0,0,1,1,1,0,1,2,3,5,0,0,0,3,4,7
wi10,101,ROOSEVELT,SOC,SocEconSoc,0,0,0,0,0,0,0,0,0,0,0,0,0,1,1,0,0,0,0,1,1
wi10,101,ROOSEVELT,SOC,SocIntlStu,0,0,0,0,0,0,0,0,0,2,1,3,0,1,1,0,0,0,2,2,4
wi10,101,ROOSEVELT,SOC,Sociology,0,0,0,1,4,5,0,5,5,7,18,25,6,21,27,0,0,0,14,48,62
wi10,101,ROOSEVELT,SOC,SocLawSoc,0,0,0,0,0,0,1,0,1,0,2,2,1,1,2,0,0,0,2,3,5
wi10,101,ROOSEVELT,SOC,SocSciMed,0,0,0,0,0,0,0,1,1,1,0,1,0,1,1,0,0,0,1,2,3
wi10,101,ROOSEVELT,SOC,SocSolneq,0,0,0,0,0,0,0,0,0,0,3,3,1,1,2,0,0,0,1,4,5
wi10,101,ROOSEVELT,THEA,Dance,0,0,0,0,0,0,0,1,1,0,0,0,0,0,0,0,0,0,0,1,1
wi10,101,ROOSEVELT,THEA,Theatre,0,0,0,0,2,2,1,4,5,2,7,9,3,5,8,0,0,0,6,18,24
wi10,101,ROOSEVELT,TWS,ThirdWldSt,0,0,0,0,0,0,0,0,0,1,2,3,0,4,4,0,0,0,1,6,7
wi10,101,ROOSEVELT,UNAF,UndecHumAr,0,0,0,0,1,1,1,3,4,0,0,0,0,0,0,0,0,0,1,4,5
wi10,101,ROOSEVELT,UNAF,Undeclared,0,0,0,9,32,41,13,23,36,1,0,1,0,0,0,0,0,0,23,55,78
wi10,101,ROOSEVELT,UNAF,UndecPhysS,0,0,0,3,5,8,1,1,2,0,0,0,0,0,0,0,0,0,4,6,10
wi10,101,ROOSEVELT,UNAF,UndecSocSc,0,0,0,0,4,4,1,2,3,0,1,1,0,0,0,0,0,0,1,7,8
wi10,101,ROOSEVELT,USP,Urb Stu&Pl,0,0,0,0,1,1,3,4,7,5,11,16,5,11,16,0,0,0,13,27,40
wi10,101,ROOSEVELT,VIS,Art Hst/Cr,0,0,0,0,0,0,0,0,0,0,1,1,2,10,12,0,0,0,2,11,13
wi10,101,ROOSEVELT,VIS,Media,0,0,0,0,0,0,0,5,5,3,7,10,8,13,21,0,0,0,11,25,36
wi10,101,ROOSEVELT,VIS,Studio VA,0,0,0,0,0,0,0,3,3,1,6,7,2,4,6,0,0,0,3,13,16
wi10,101,ROOSEVELT,VIS,VA-CompArt,0,0,0,0,0,0,0,3,3,0,2,2,3,0,3,0,0,0,3,5,8
wi10,101,SIXTH,ANTH,Anth-Arch,0,0,0,0,0,0,0,0,0,0,1,1,4,2,6,0,0,0,4,3,7
wi10,101,SIXTH,ANTH,Anth-Biol,0,0,0,0,0,0,0,3,3,1,2,3,1,3,4,0,0,0,2,8,10
wi10,101,SIXTH,ANTH,Anth-Soci,0,0,0,0,2,2,0,1,1,0,8,8,1,4,5,0,0,0,1,15,16
wi10,101,SIXTH,BENG,Bioen:Binf,0,0,0,1,0,1,0,0,0,1,0,1,3,0,3,0,0,0,5,0,5
wi10,101,SIXTH,BENG,Bioeng:PM,0,0,0,0,0,0,0,0,0,0,0,0,13,5,18,0,0,0,13,5,18
wi10,101,SIXTH,BENG,BioengBiot,0,0,0,0,2,2,6,3,9,6,3,9,5,2,7,0,0,0,17,10,27
wi10,101,SIXTH,BENG,Bioengin,0,0,0,1,2,3,2,2,4,2,1,3,6,1,7,0,0,0,11,6,17
wi10,101,SIXTH,BENG,Pr-BioenPM,0,0,0,6,1,7,5,3,8,5,0,5,1,0,1,0,0,0,17,4,21
wi10,101,SIXTH,BIOL,Bioc/CellB,0,0,0,1,1,2,10,13,23,9,14,23,41,39,80,0,0,0,61,67,128
wi10,101,SIXTH,BIOL,BiolBioinf,0,0,0,0,0,0,0,0,0,0,0,0,0,1,1,0,0,0,0,1,1
wi10,101,SIXTH,BIOL,Ec/Beh/Evo,0,0,0,0,0,0,0,0,0,2,6,8,2,9,11,0,0,0,4,15,19
wi10,101,SIXTH,BIOL,Genl Biol,0,0,0,2,2,4,6,11,17,17,25,42,37,38,75,0,0,0,62,76,138
wi10,101,SIXTH,BIOL,Human Bio,0,0,0,6,3,9,22,30,52,26,41,67,42,54,96,0,0,0,96,128,224
wi10,101,SIXTH,BIOL,Microbiol,0,0,0,2,1,3,2,1,3,5,5,10,4,3,7,0,0,0,13,10,23
wi10,101,SIXTH,BIOL,Molec Biol,0,0,0,0,0,0,0,0,0,6,3,9,7,7,14,0,0,0,13,10,23
wi10,101,SIXTH,BIOL,PhyslNeuro,0,0,0,0,1,1,6,6,12,8,9,17,22,15,37,0,0,0,36,31,67
wi10,101,SIXTH,CENG,Chem Engin,0,0,0,5,0,5,6,0,6,12,1,13,12,5,17,0,0,0,35,6,41
wi10,101,SIXTH,CHEM,Bioch/Chem,0,0,0,6,8,14,10,5,15,5,2,7,8,11,19,0,0,0,29,26,55
wi10,101,SIXTH,CHEM,Chem Educ,0,0,0,0,0,0,0,1,1,1,0,1,0,0,0,0,0,0,1,1,2
wi10,101,SIXTH,CHEM,Chemistry,0,0,0,4,2,6,1,2,3,2,2,4,10,3,13,0,0,0,17,9,26
wi10,101,SIXTH,CHEM,Envir Chem,0,0,0,1,0,1,0,1,1,0,0,0,2,1,3,0,0,0,3,2,5
wi10,101,SIXTH,CHEM,MolecSynth,0,0,0,0,0,0,0,0,0,0,0,0,1,1,2,0,0,0,1,1,2
wi10,101,SIXTH,CHEM,Pharm Chem,0,0,0,4,4,8,4,12,16,3,9,12,10,10,20,0,0,0,21,35,56
wi10,101,SIXTH,CHIN,Chinese St,0,0,0,0,1,1,0,0,0,1,0,1,0,0,0,0,0,0,1,1,2
wi10,101,SIXTH,CLAS,Classic St,0,0,0,0,0,0,0,1,1,0,0,0,1,0,1,0,0,0,1,1,2
wi10,101,SIXTH,COGS,Cog Sci,0,0,0,4,1,5,2,5,7,8,3,11,4,4,8,0,0,0,18,13,31
wi10,101,SIXTH,COGS,CogSc/ClAs,0,0,0,0,0,0,0,1,1,0,0,0,0,1,1,0,0,0,0,2,2
wi10,101,SIXTH,COGS,CogSc/HCI,0,0,0,0,0,0,0,0,0,1,1,2,8,3,11,0,0,0,9,4,13
wi10,101,SIXTH,COGS,CogSc/HCog,0,0,0,0,0,0,2,0,2,1,0,1,0,0,0,0,0,0,3,0,3
wi10,101,SIXTH,COGS,CogSc/Neur,0,0,0,0,1,1,4,4,8,0,3,3,2,3,5,0,0,0,6,11,17
wi10,101,SIXTH,COMM,Communic,0,0,0,2,14,16,5,15,20,19,42,61,22,46,68,0,0,0,48,117,165
wi10,101,SIXTH,CSE,Comp Sci,0,0,0,17,8,25,20,4,24,30,7,37,49,13,62,0,0,0,116,32,148
wi10,101,SIXTH,CSE,CompEngCSE,0,0,0,4,1,5,9,2,11,16,0,16,13,3,16,0,0,0,42,6,48
wi10,101,SIXTH,CSE,CompScBinf,0,0,0,1,1,2,3,1,4,0,0,0,1,1,2,0,0,0,5,3,8
wi10,101,SIXTH,ECE,CompEngECE,0,0,0,2,0,2,1,0,1,2,0,2,6,0,6,0,0,0,11,0,11
wi10,101,SIXTH,ECE,Electr Eng,0,0,0,11,0,11,8,1,9,25,2,27,38,5,43,0,0,0,82,8,90
wi10,101,SIXTH,ECE,Pr-EngPhys,0,0,0,3,0,3,0,1,1,0,0,0,1,0,1,0,0,0,4,1,5
wi10,101,SIXTH,ECON,Ec-Mth&Ecn,0,0,0,2,2,4,1,2,3,5,1,6,5,1,6,0,0,0,13,6,19
wi10,101,SIXTH,ECON,Econ-MgtSc,0,0,0,5,1,6,9,6,15,30,21,51,57,26,83,0,0,0,101,54,155
wi10,101,SIXTH,ECON,Economics,0,0,0,7,2,9,20,4,24,57,34,91,57,34,91,0,0,0,141,74,215
wi10,101,SIXTH,ESYS,EnvSys(EB),0,0,0,0,2,2,0,3,3,2,5,7,4,6,10,0,0,0,6,16,22
wi10,101,SIXTH,ESYS,EnvSys(EC),0,0,0,0,0,0,0,0,0,0,0,0,2,0,2,0,0,0,2,0,2
wi10,101,SIXTH,ESYS,EnvSys(EP),0,0,0,1,0,1,0,2,2,2,0,2,0,1,1,0,0,0,3,3,6
wi10,101,SIXTH,ESYS,EnvSys(ES),0,0,0,0,2,2,1,1,2,0,1,1,2,1,3,0,0,0,3,5,8
wi10,101,SIXTH,ETHN,Ethnic St,0,0,0,1,0,1,1,0,1,0,1,1,4,4,8,0,0,0,6,5,11
wi10,101,SIXTH,HDP,Human Dev,0,0,0,0,0,0,0,0,0,0,6,6,2,11,13,0,0,0,2,17,19
wi10,101,SIXTH,HDP,Pr-HumnDev,0,0,0,0,3,3,0,11,11,1,2,3,0,2,2,0,0,0,1,18,19
wi10,101,SIXTH,HIST,History,0,0,0,0,1,1,1,1,2,5,6,11,9,5,14,0,0,0,15,13,28
wi10,101,SIXTH,INTL,IntSt-Anth,0,0,0,0,0,0,0,0,0,1,4,5,0,0,0,0,0,0,1,4,5
wi10,101,SIXTH,INTL,IntSt-Econ,0,0,0,0,1,1,3,5,8,2,6,8,11,13,24,0,0,0,16,25,41
wi10,101,SIXTH,INTL,IntSt-Hist,0,0,0,0,1,1,0,0,0,0,4,4,2,3,5,0,0,0,2,8,10
wi10,101,SIXTH,INTL,IntSt-Ling,0,0,0,0,1,1,0,0,0,0,0,0,2,0,2,0,0,0,2,1,3
wi10,101,SIXTH,INTL,IntSt-Lit,0,0,0,0,0,0,0,0,0,0,0,0,0,1,1,0,0,0,0,1,1
wi10,101,SIXTH,INTL,IntSt-PolS,0,0,0,6,2,8,1,3,4,4,10,14,9,10,19,0,0,0,20,25,45
wi10,101,SIXTH,INTL,IntSt-Soc,0,0,0,0,2,2,0,0,0,1,7,8,4,2,6,0,0,0,5,11,16
wi10,101,SIXTH,ITAL,Italian St,0,0,0,0,0,0,0,0,0,0,2,2,0,0,0,0,0,0,0,2,2
wi10,101,SIXTH,JAPN,JapaneseSt,0,0,0,0,0,0,1,0,1,1,1,2,3,1,4,0,0,0,5,2,7
wi10,101,SIXTH,LATI,LatinAm St,0,0,0,0,1,1,0,0,0,0,1,1,0,0,0,0,0,0,0,2,2
wi10,101,SIXTH,LING,Lang Stu,0,0,0,1,0,1,0,0,0,0,1,1,0,0,0,0,0,0,1,1,2
wi10,101,SIXTH,LING,Ling-CogLn,0,0,0,0,0,0,0,0,0,0,1,1,1,4,5,0,0,0,1,5,6
wi10,101,SIXTH,LING,Ling-LSoc,0,0,0,0,0,0,0,1,1,1,0,1,1,1,2,0,0,0,2,2,4
wi10,101,SIXTH,LING,Linguistcs,0,0,0,0,2,2,0,1,1,1,1,2,1,2,3,0,0,0,2,6,8
wi10,101,SIXTH,LIT,French Lit,0,0,0,0,0,0,0,0,0,0,0,0,0,1,1,0,0,0,0,1,1
wi10,101,SIXTH,LIT,Lit/Compos,0,0,0,1,0,1,0,0,0,0,0,0,0,1,1,0,0,0,1,1,2
wi10,101,SIXTH,LIT,Lit/CultSt,0,0,0,0,0,0,0,0,0,0,1,1,0,2,2,0,0,0,0,3,3
wi10,101,SIXTH,LIT,Lit/Engl,0,0,0,0,0,0,0,0,0,1,2,3,1,2,3,0,0,0,2,4,6
wi10,101,SIXTH,LIT,Lit/World,0,0,0,0,0,0,0,0,0,0,1,1,1,1,2,0,0,0,1,2,3
wi10,101,SIXTH,LIT,Lit/Writng,0,0,0,0,0,0,0,0,0,2,0,2,5,7,12,0,0,0,7,7,14
wi10,101,SIXTH,LIT,Pre-Lit/Wr,0,0,0,1,1,2,1,10,11,1,4,5,1,1,2,0,0,0,4,16,20
wi10,101,SIXTH,MAE,Aerosp Eng,0,0,0,11,2,13,12,0,12,16,1,17,28,5,33,0,0,0,67,8,75
wi10,101,SIXTH,MAE,Engin Sci,0,0,0,1,0,1,0,0,0,2,0,2,0,1,1,0,0,0,3,1,4
wi10,101,SIXTH,MAE,Envir Eng,0,0,0,4,0,4,2,3,5,2,2,4,1,3,4,0,0,0,9,8,17
wi10,101,SIXTH,MAE,Mech Engin,0,0,0,12,2,14,19,4,23,32,2,34,60,13,73,0,0,0,123,21,144
wi10,101,SIXTH,MATH,Appld Math,0,0,0,1,0,1,0,0,0,2,2,4,2,1,3,0,0,0,5,3,8
wi10,101,SIXTH,MATH,Math/SecEd,0,0,0,1,4,5,1,0,1,1,2,3,0,1,1,0,0,0,3,7,10
wi10,101,SIXTH,MATH,Mathematcs,0,0,0,0,0,0,2,1,3,5,0,5,5,3,8,0,0,0,12,4,16
wi10,101,SIXTH,MATH,Mth-CompSc,0,0,0,0,0,0,0,0,0,0,0,0,1,0,1,0,0,0,1,0,1
wi10,101,SIXTH,MATH,Mth-Mth&Ec,0,0,0,0,1,1,2,1,3,1,1,2,5,2,7,0,0,0,8,5,13
wi10,101,SIXTH,MATH,Mth/ApldSc,0,0,0,0,0,0,1,0,1,0,0,0,1,0,1,0,0,0,2,0,2
wi10,101,SIXTH,MATH,Pr-Math CS,0,0,0,0,0,0,0,0,0,2,0,2,0,0,0,0,0,0,2,0,2
wi10,101,SIXTH,MATH,Prob&Stats,0,0,0,0,1,1,0,0,0,1,0,1,0,0,0,0,0,0,1,1,2
wi10,101,SIXTH,MUS,Mu-CompArt,1,0,1,4,0,4,2,2,4,9,2,11,10,1,11,0,0,0,26,5,31
wi10,101,SIXTH,MUS,Music,0,0,0,1,2,3,0,2,2,5,1,6,6,3,9,0,0,0,12,8,20
wi10,101,SIXTH,MUS,Music Hum,0,0,0,0,0,0,0,0,0,0,1,1,1,0,1,0,0,0,1,1,2
wi10,101,SIXTH,PHIL,Philosophy,0,0,0,0,1,1,1,0,1,2,1,3,2,2,4,0,0,0,5,4,9
wi10,101,SIXTH,PHYS,Biophysics,0,0,0,1,0,1,1,0,1,1,0,1,1,0,1,0,0,0,4,0,4
wi10,101,SIXTH,PHYS,Phy/ErthSc,0,0,0,0,0,0,1,0,1,0,0,0,0,0,0,0,0,0,1,0,1
wi10,101,SIXTH,PHYS,Phys/Astro,0,0,0,0,0,0,0,0,0,2,0,2,0,0,0,0,0,0,2,0,2
wi10,101,SIXTH,PHYS,Phys/Comp,0,0,0,1,0,1,0,0,0,1,0,1,0,0,0,0,0,0,2,0,2
wi10,101,SIXTH,PHYS,Physics,0,0,0,4,0,4,2,0,2,1,0,1,8,0,8,0,0,0,15,0,15
wi10,101,SIXTH,POLI,Polit Sci,0,0,0,3,4,7,5,1,6,20,9,29,18,9,27,0,0,0,46,23,69
wi10,101,SIXTH,POLI,PolSc-Amer,0,0,0,0,0,0,1,0,1,1,2,3,4,5,9,0,0,0,6,7,13
wi10,101,SIXTH,POLI,PolSc-Comp,0,0,0,0,0,0,0,0,0,0,0,0,0,1,1,0,0,0,0,1,1
wi10,101,SIXTH,POLI,PolSc-Intl,0,0,0,3,3,6,2,1,3,10,4,14,9,7,16,0,0,0,24,15,39
wi10,101,SIXTH,POLI,PolSc-PLaw,0,0,0,1,4,5,1,4,5,7,1,8,5,5,10,0,0,0,14,14,28
wi10,101,SIXTH,POLI,PolSc-PPol,0,0,0,0,0,0,0,0,0,1,0,1,0,0,0,0,0,0,1,0,1
wi10,101,SIXTH,POLI,PolSc-Thry,0,0,0,0,0,0,1,0,1,1,1,2,1,0,1,0,0,0,3,1,4
wi10,101,SIXTH,PSYC,Psychology,0,0,0,9,14,23,7,18,25,17,46,63,29,59,88,0,0,0,62,137,199
wi10,101,SIXTH,RELI,Relig/Stu,0,0,0,1,0,1,0,0,0,0,0,0,0,0,0,0,0,0,1,0,1
wi10,101,SIXTH,SE,Engin Sci,0,0,0,1,0,1,0,0,0,0,0,0,0,0,0,0,0,0,1,0,1
wi10,101,SIXTH,SE,Struct Eng,0,0,0,7,3,10,11,2,13,16,9,25,23,13,36,0,0,0,57,27,84
wi10,101,SIXTH,SIO,ErSc-Geoch,0,0,0,0,0,0,1,1,2,0,0,0,0,0,0,0,0,0,1,1,2
wi10,101,SIXTH,SIO,ErSc-Geol,0,0,0,0,0,0,0,1,1,0,1,1,1,0,1,0,0,0,1,2,3
wi10,101,SIXTH,SIO,ErSc-Geoph,0,0,0,0,0,0,0,1,1,0,0,0,0,0,0,0,0,0,0,1,1
wi10,101,SIXTH,SOC,SocCulCom,0,0,0,0,0,0,0,1,1,1,2,3,0,1,1,0,0,0,1,4,5
wi10,101,SIXTH,SOC,SocEconSoc,0,0,0,0,1,1,0,0,0,0,1,1,0,1,1,0,0,0,0,3,3
wi10,101,SIXTH,SOC,SocIntlStu,0,0,0,0,0,0,0,0,0,0,1,1,0,1,1,0,0,0,0,2,2
wi10,101,SIXTH,SOC,Sociology,0,0,0,0,0,0,1,0,1,2,14,16,6,18,24,0,0,0,9,32,41
wi10,101,SIXTH,SOC,SocLawSoc,0,0,0,0,0,0,0,0,0,1,2,3,0,3,3,0,0,0,1,5,6
wi10,101,SIXTH,SOC,SocSciMed,0,0,0,0,0,0,0,0,0,0,2,2,0,0,0,0,0,0,0,2,2
wi10,101,SIXTH,SOC,SocSolneq,0,0,0,0,0,0,0,0,0,0,2,2,0,1,1,0,0,0,0,3,3
wi10,101,SIXTH,THEA,Dance,0,0,0,1,0,1,0,0,0,0,1,1,0,3,3,0,0,0,1,4,5
wi10,101,SIXTH,THEA,Theatre,1,0,1,1,2,3,1,1,2,1,2,3,1,6,7,0,0,0,5,11,16
wi10,101,SIXTH,TWS,ThirdWldSt,0,0,0,0,1,1,0,0,0,0,0,0,0,1,1,0,0,0,0,2,2
wi10,101,SIXTH,UNAF,Limited St,0,0,0,0,0,0,0,0,0,0,0,0,0,0,0,1,0,1,1,0,1
wi10,101,SIXTH,UNAF,UndecBiolS,0,0,0,0,0,0,0,1,1,0,0,0,0,0,0,0,0,0,0,1,1
wi10,101,SIXTH,UNAF,UndecHumAr,0,0,0,0,5,5,1,1,2,0,0,0,0,0,0,0,0,0,1,6,7
wi10,101,SIXTH,UNAF,Undeclared,0,0,0,24,37,61,12,15,27,0,0,0,0,0,0,0,0,0,36,52,88
wi10,101,SIXTH,UNAF,UndecPhysS,0,0,0,0,0,0,0,1,1,0,0,0,0,0,0,0,0,0,0,1,1
wi10,101,SIXTH,UNAF,UndecSocSc,0,0,0,4,1,5,3,2,5,0,0,0,0,0,0,0,0,0,7,3,10
wi10,101,SIXTH,USP,Urb Stu&Pl,0,0,0,1,0,1,1,1,2,3,7,10,8,3,11,0,0,0,13,11,24
wi10,101,SIXTH,VIS,Art Hst/Cr,0,0,0,0,0,0,0,1,1,0,9,9,0,13,13,0,0,0,0,23,23
wi10,101,SIXTH,VIS,Media,0,0,0,1,6,7,9,12,21,14,9,23,13,17,30,0,0,0,37,44,81
wi10,101,SIXTH,VIS,Studio VA,0,0,0,1,0,1,1,4,5,6,10,16,8,9,17,0,0,0,16,23,39
wi10,101,SIXTH,VIS,VA-CompArt,0,0,0,1,2,3,3,2,5,5,4,9,7,6,13,0,0,0,16,14,30
wi10,101,WARREN,ANTH,Anth-Arch,0,0,0,0,0,0,0,0,0,1,4,5,1,2,3,0,0,0,2,6,8
wi10,101,WARREN,ANTH,Anth-Biol,0,0,0,0,1,1,0,3,3,0,2,2,2,5,7,0,0,0,2,11,13
wi10,101,WARREN,ANTH,Anth-Soci,0,0,0,0,0,0,0,0,0,0,3,3,0,3,3,0,0,0,0,6,6
wi10,101,WARREN,BENG,Bioen:Binf,0,0,0,1,0,1,0,0,0,4,0,4,6,1,7,0,0,0,11,1,12
wi10,101,WARREN,BENG,Bioeng:PM,0,0,0,0,0,0,2,0,2,4,1,5,32,14,46,0,0,0,38,15,53
wi10,101,WARREN,BENG,BioengBiot,0,0,0,4,4,8,14,2,16,17,7,24,29,7,36,0,0,0,64,20,84
wi10,101,WARREN,BENG,Bioengin,0,0,0,4,2,6,8,3,11,10,5,15,19,8,27,0,0,0,41,18,59
wi10,101,WARREN,BENG,Pr-BioenPM,0,0,0,6,6,12,18,7,25,4,2,6,2,0,2,0,0,0,30,15,45
wi10,101,WARREN,BIOL,Anml Physl,0,0,0,0,0,0,0,0,0,0,1,1,0,0,0,0,0,0,0,1,1
wi10,101,WARREN,BIOL,Bioc/CellB,1,0,1,4,4,8,12,7,19,22,25,47,76,80,156,0,0,0,115,116,231
wi10,101,WARREN,BIOL,BiolBioinf,0,0,0,0,0,0,0,0,0,1,0,1,1,0,1,0,0,0,2,0,2
wi10,101,WARREN,BIOL,Ec/Beh/Evo,0,0,0,0,0,0,1,1,2,5,6,11,5,9,14,0,0,0,11,16,27
wi10,101,WARREN,BIOL,Genl Biol,0,0,0,6,3,9,8,24,32,18,32,50,45,57,102,0,0,0,77,116,193
wi10,101,WARREN,BIOL,Human Bio,0,0,0,8,19,27,23,33,56,31,68,99,52,83,135,0,0,0,114,203,317
wi10,101,WARREN,BIOL,Microbiol,0,0,0,0,0,0,1,2,3,1,5,6,10,6,16,0,0,0,12,13,25
wi10,101,WARREN,BIOL,Molec Biol,0,0,0,0,0,0,4,3,7,1,6,7,13,13,26,0,0,0,18,22,40
wi10,101,WARREN,BIOL,PhyslNeuro,0,0,0,4,3,7,8,7,15,15,20,35,23,27,50,0,0,0,50,57,107
wi10,101,WARREN,CENG,Chem Engin,0,0,0,5,3,8,10,7,17,17,4,21,26,14,40,0,0,0,58,28,86
wi10,101,WARREN,CGS,CritGendSt,0,0,0,0,0,0,0,0,0,0,1,1,0,2,2,0,0,0,0,3,3
wi10,101,WARREN,CHEM,Bioch/Chem,0,0,0,10,8,18,7,7,14,7,10,17,17,17,34,0,0,0,41,42,83
wi10,101,WARREN,CHEM,Bioinform,0,0,0,0,1,1,0,0,0,0,0,0,0,0,0,0,0,0,0,1,1
wi10,101,WARREN,CHEM,Chem Phys,0,0,0,0,0,0,0,0,0,0,0,0,2,0,2,0,0,0,2,0,2
wi10,101,WARREN,CHEM,Chemistry,0,0,0,1,6,7,4,1,5,6,4,10,6,5,11,0,0,0,17,16,33
wi10,101,WARREN,CHEM,Envir Chem,0,0,0,0,0,0,1,1,2,0,0,0,0,0,0,0,0,0,1,1,2
wi10,101,WARREN,CHEM,MolecSynth,0,0,0,0,0,0,0,0,0,3,0,3,3,1,4,0,0,0,6,1,7
wi10,101,WARREN,CHEM,Pharm Chem,0,0,0,5,5,10,2,7,9,3,9,12,11,13,24,0,0,0,21,34,55
wi10,101,WARREN,CHIN,Chinese St,0,0,0,0,0,0,0,0,0,1,0,1,0,6,6,0,0,0,1,6,7
wi10,101,WARREN,CLAS,Classic St,0,0,0,0,1,1,0,0,0,0,0,0,0,0,0,0,0,0,0,1,1
wi10,101,WARREN,COGS,Cog Sci,0,0,0,0,1,1,0,3,3,2,3,5,6,6,12,0,0,0,8,13,21
wi10,101,WARREN,COGS,CogSc/ClAs,0,0,0,0,1,1,0,2,2,0,1,1,1,1,2,0,0,0,1,5,6
wi10,101,WARREN,COGS,CogSc/Clin,0,0,0,0,0,0,0,0,0,0,0,0,0,1,1,0,0,0,0,1,1
wi10,101,WARREN,COGS,CogSc/Comp,0,0,0,0,0,0,0,0,0,2,0,2,0,0,0,0,0,0,2,0,2
wi10,101,WARREN,COGS,CogSc/HCI,0,0,0,0,0,0,1,3,4,1,1,2,3,0,3,0,0,0,5,4,9
wi10,101,WARREN,COGS,CogSc/HCog,0,0,0,0,1,1,0,0,0,0,1,1,1,1,2,0,0,0,1,3,4
wi10,101,WARREN,COGS,CogSc/Neur,0,0,0,0,3,3,2,2,4,3,3,6,5,4,9,0,0,0,10,12,22
wi10,101,WARREN,COMM,Communic,0,0,0,2,3,5,5,12,17,15,38,53,17,33,50,0,0,0,39,86,125
wi10,101,WARREN,CSE,Comp Sci,0,0,0,13,4,17,21,6,27,39,8,47,55,13,68,0,0,0,128,31,159
wi10,101,WARREN,CSE,CompEngCSE,0,0,0,9,3,12,15,3,18,13,1,14,12,0,12,0,0,0,49,7,56
wi10,101,WARREN,CSE,CompScBinf,0,0,0,0,1,1,2,1,3,1,1,2,1,0,1,0,0,0,4,3,7
wi10,101,WARREN,ECE,CompEngECE,0,0,0,6,1,7,4,1,5,3,1,4,6,0,6,0,0,0,19,3,22
wi10,101,WARREN,ECE,Electr Eng,0,0,0,11,2,13,18,3,21,27,5,32,79,14,93,0,0,0,135,24,159
wi10,101,WARREN,ECE,EleEng&Soc,0,0,0,0,0,0,1,0,1,0,0,0,0,0,0,0,0,0,1,0,1
wi10,101,WARREN,ECE,Engin Phys,0,0,0,0,0,0,0,0,0,1,0,1,1,0,1,0,0,0,2,0,2
wi10,101,WARREN,ECE,Pr-EngPhys,0,0,0,0,0,0,4,0,4,2,0,2,2,0,2,0,0,0,8,0,8
wi10,101,WARREN,ECON,Ec-Mth&Ecn,0,0,0,1,1,2,3,0,3,5,5,10,8,4,12,0,0,0,17,10,27
wi10,101,WARREN,ECON,Econ-MgtSc,0,0,0,1,1,2,3,10,13,25,20,45,48,39,87,0,0,0,77,70,147
wi10,101,WARREN,ECON,Econ-QEDS,0,0,0,0,0,0,0,0,0,0,0,0,0,1,1,0,0,0,0,1,1
wi10,101,WARREN,ECON,Economics,0,0,0,7,7,14,12,6,18,54,34,88,61,28,89,0,0,0,134,75,209
wi10,101,WARREN,ESYS,EnvSys(EB),0,0,0,0,3,3,1,1,2,1,1,2,2,3,5,0,0,0,4,8,12
wi10,101,WARREN,ESYS,EnvSys(EC),0,0,0,0,1,1,0,0,0,1,1,2,1,1,2,0,0,0,2,3,5
wi10,101,WARREN,ESYS,EnvSys(EP),0,0,0,0,0,0,1,0,1,0,1,1,2,1,3,0,0,0,3,2,5
wi10,101,WARREN,ESYS,EnvSys(ES),0,0,0,1,0,1,0,0,0,1,0,1,1,0,1,0,0,0,3,0,3
wi10,101,WARREN,ETHN,Ethnic St,0,0,0,0,0,0,0,3,3,0,2,2,2,2,4,0,0,0,2,7,9
wi10,101,WARREN,GMST,German Stu,0,0,0,0,0,0,0,0,0,0,0,0,1,0,1,0,0,0,1,0,1
wi10,101,WARREN,HDP,Human Dev,0,0,0,0,0,0,0,0,0,2,3,5,1,16,17,0,0,0,3,19,22
wi10,101,WARREN,HDP,Pr-HumnDev,0,0,0,0,3,3,0,2,2,0,3,3,0,1,1,0,0,0,0,9,9
wi10,101,WARREN,HIST,History,0,0,0,2,1,3,4,2,6,10,5,15,19,16,35,0,0,0,35,24,59
wi10,101,WARREN,INTL,Int-5yrEC,0,0,0,0,0,0,0,0,0,0,0,0,0,1,1,0,0,0,0,1,1
wi10,101,WARREN,INTL,IntSt-Anth,0,0,0,0,0,0,0,0,0,0,2,2,0,1,1,0,0,0,0,3,3
wi10,101,WARREN,INTL,IntSt-Econ,0,0,0,0,1,1,3,5,8,9,2,11,5,10,15,0,0,0,17,18,35
wi10,101,WARREN,INTL,IntSt-Hist,0,0,0,0,0,0,1,0,1,0,1,1,1,2,3,0,0,0,2,3,5
wi10,101,WARREN,INTL,IntSt-Ling,0,0,0,0,0,0,0,2,2,0,2,2,0,1,1,0,0,0,0,5,5
wi10,101,WARREN,INTL,IntSt-Lit,0,0,0,0,0,0,0,1,1,0,0,0,0,1,1,0,0,0,0,2,2
wi10,101,WARREN,INTL,IntSt-PolS,0,0,0,1,0,1,0,5,5,8,5,13,6,13,19,0,0,0,15,23,38
wi10,101,WARREN,INTL,IntSt-Soc,0,0,0,1,1,2,0,2,2,1,5,6,1,4,5,0,0,0,3,12,15
wi10,101,WARREN,ITAL,Italian St,0,0,0,0,0,0,0,0,0,0,0,0,1,0,1,0,0,0,1,0,1
wi10,101,WARREN,JAPN,JapaneseSt,0,0,0,0,0,0,0,0,0,1,0,1,1,0,1,0,0,0,2,0,2
wi10,101,WARREN,LATI,LatinAm St,0,0,0,0,0,0,0,0,0,1,0,1,0,0,0,0,0,0,1,0,1
wi10,101,WARREN,LING,Lang Stu,0,0,0,0,0,0,0,0,0,0,1,1,0,1,1,0,0,0,0,2,2
wi10,101,WARREN,LING,Ling-CogLn,0,0,0,0,0,0,0,0,0,0,0,0,2,0,2,0,0,0,2,0,2
wi10,101,WARREN,LING,Linguistcs,0,0,0,0,0,0,0,0,0,0,3,3,1,2,3,0,0,0,1,5,6
wi10,101,WARREN,LIT,French Lit,0,0,0,0,0,0,0,0,0,0,0,0,1,0,1,0,0,0,1,0,1
wi10,101,WARREN,LIT,Hn-Span Lt,0,0,0,0,0,0,0,0,0,0,1,1,0,0,0,0,0,0,0,1,1
wi10,101,WARREN,LIT,Lit/CultSt,0,0,0,0,0,0,0,0,0,0,1,1,0,1,1,0,0,0,0,2,2
wi10,101,WARREN,LIT,Lit/Engl,0,0,0,1,1,2,1,2,3,0,4,4,1,3,4,0,0,0,3,10,13
wi10,101,WARREN,LIT,Lit/World,0,0,0,0,0,0,0,0,0,0,1,1,0,0,0,0,0,0,0,1,1
wi10,101,WARREN,LIT,Lit/Writng,0,0,0,0,0,0,0,0,0,0,0,0,1,10,11,0,0,0,1,10,11
wi10,101,WARREN,LIT,Pre-Lit/Wr,0,0,0,1,0,1,1,2,3,4,7,11,0,2,2,0,0,0,6,11,17
wi10,101,WARREN,LIT,Spanish Lt,0,0,0,0,1,1,0,0,0,0,0,0,1,4,5,0,0,0,1,5,6
wi10,101,WARREN,MAE,Aerosp Eng,0,0,0,12,1,13,14,4,18,10,1,11,36,4,40,0,0,0,72,10,82
wi10,101,WARREN,MAE,Engin Sci,0,0,0,1,0,1,0,0,0,0,0,0,1,0,1,0,0,0,2,0,2
wi10,101,WARREN,MAE,Envir Eng,0,0,0,0,4,4,5,3,8,1,1,2,3,4,7,0,0,0,9,12,21
wi10,101,WARREN,MAE,Mech Engin,0,0,0,16,5,21,29,3,32,47,8,55,97,10,107,0,0,0,189,26,215
wi10,101,WARREN,MATH,Appld Math,0,0,0,0,0,0,0,1,1,3,2,5,4,4,8,0,0,0,7,7,14
wi10,101,WARREN,MATH,Math/SecEd,0,0,0,0,0,0,1,0,1,0,0,0,1,1,2,0,0,0,2,1,3
wi10,101,WARREN,MATH,Mathematcs,0,0,0,1,1,2,3,1,4,6,3,9,11,5,16,0,0,0,21,10,31
wi10,101,WARREN,MATH,Mth-CompSc,0,0,0,1,0,1,0,0,0,0,0,0,4,2,6,0,0,0,5,2,7
wi10,101,WARREN,MATH,Mth-Mth&Ec,0,0,0,0,0,0,1,2,3,1,1,2,3,3,6,0,0,0,5,6,11
wi10,101,WARREN,MATH,Mth-SciCom,0,0,0,0,0,0,0,0,0,0,0,0,2,0,2,0,0,0,2,0,2
wi10,101,WARREN,MATH,Mth/ApldSc,0,0,0,0,0,0,1,0,1,0,0,0,2,0,2,0,0,0,3,0,3
wi10,101,WARREN,MATH,Prob&Stats,0,0,0,1,2,3,0,1,1,2,1,3,2,4,6,0,0,0,5,8,13
wi10,101,WARREN,MUS,Mu-CompArt,0,0,0,1,0,1,1,0,1,4,0,4,9,2,11,0,0,0,15,2,17
wi10,101,WARREN,MUS,Music,0,0,0,2,0,2,0,0,0,3,2,5,8,1,9,0,0,0,13,3,16
wi10,101,WARREN,MUS,Music Hum,0,0,0,0,0,0,0,0,0,0,0,0,0,1,1,0,0,0,0,1,1
wi10,101,WARREN,PHIL,Philosophy,0,0,0,1,0,1,2,1,3,7,2,9,10,3,13,0,0,0,20,6,26
wi10,101,WARREN,PHYS,Biophysics,0,0,0,1,0,1,2,1,3,1,0,1,3,1,4,0,0,0,7,2,9
wi10,101,WARREN,PHYS,Gen Physcs,0,0,0,0,0,0,0,0,0,0,0,0,1,0,1,0,0,0,1,0,1
wi10,101,WARREN,PHYS,Phys/Astro,0,0,0,1,0,1,1,0,1,1,0,1,3,0,3,0,0,0,6,0,6
wi10,101,WARREN,PHYS,Phys/Mtrls,0,0,0,0,0,0,0,0,0,0,0,0,1,0,1,0,0,0,1,0,1
wi10,101,WARREN,PHYS,Physics,0,0,0,1,0,1,1,0,1,2,0,2,9,1,10,0,0,0,13,1,14
wi10,101,WARREN,POLI,Polit Sci,0,0,0,5,5,10,8,5,13,27,14,41,23,23,46,0,0,0,63,47,110
wi10,101,WARREN,POLI,PolSc-Amer,0,0,0,1,3,4,2,1,3,2,3,5,4,5,9,0,0,0,9,12,21
wi10,101,WARREN,POLI,PolSc-Comp,0,0,0,0,0,0,0,0,0,1,0,1,1,0,1,0,0,0,2,0,2
wi10,101,WARREN,POLI,PolSc-Intl,0,0,0,2,2,4,6,5,11,7,7,14,17,12,29,0,0,0,32,26,58
wi10,101,WARREN,POLI,PolSc-PLaw,0,0,0,0,3,3,4,7,11,6,7,13,6,6,12,0,0,0,16,23,39
wi10,101,WARREN,POLI,PolSc-PPol,0,0,0,0,0,0,0,0,0,2,2,4,1,2,3,0,0,0,3,4,7
wi10,101,WARREN,POLI,PolSc-Thry,0,0,0,0,0,0,1,0,1,1,1,2,3,2,5,0,0,0,5,3,8
wi10,101,WARREN,PSYC,Psychology,0,0,0,4,20,24,12,26,38,21,39,60,24,74,98,0,0,0,61,159,220
wi10,101,WARREN,RELI,Relig/Stu,0,0,0,0,0,0,0,0,0,0,1,1,0,1,1,0,0,0,0,2,2
wi10,101,WARREN,SE,Engin Sci,0,0,0,0,0,0,0,0,0,1,0,1,0,0,0,0,0,0,1,0,1
wi10,101,WARREN,SE,Struct Eng,0,0,0,23,5,28,17,11,28,29,10,39,43,23,66,0,0,0,112,49,161
wi10,101,WARREN,SIO,ErSc-Geoch,0,0,0,0,0,0,0,0,0,1,1,2,0,1,1,0,0,0,1,2,3
wi10,101,WARREN,SOC,SocIntlStu,0,0,0,0,0,0,0,0,0,1,0,1,0,0,0,0,0,0,1,0,1
wi10,101,WARREN,SOC,Sociology,0,0,0,2,2,4,1,1,2,2,12,14,7,15,22,0,0,0,12,30,42
wi10,101,WARREN,SOC,SocLawSoc,0,0,0,0,1,1,0,1,1,0,2,2,1,1,2,0,0,0,1,5,6
wi10,101,WARREN,SOC,SocSciMed,0,0,0,0,0,0,0,1,1,0,0,0,0,0,0,0,0,0,0,1,1
wi10,101,WARREN,SOC,SocSolneq,0,0,0,0,0,0,0,0,0,1,0,1,0,1,1,0,0,0,1,1,2
wi10,101,WARREN,THEA,Dance,0,0,0,0,0,0,0,0,0,1,0,1,0,1,1,0,0,0,1,1,2
wi10,101,WARREN,THEA,Theatre,0,0,0,0,0,0,1,1,2,0,0,0,1,7,8,0,0,0,2,8,10
wi10,101,WARREN,TWS,ThirdWldSt,0,0,0,0,0,0,0,1,1,0,0,0,0,0,0,0,0,0,0,1,1
wi10,101,WARREN,UNAF,IntcampVis,0,0,0,0,0,0,1,0,1,0,2,2,0,3,3,0,0,0,1,5,6
wi10,101,WARREN,UNAF,Limited St,0,0,0,0,0,0,0,0,0,0,0,0,0,0,0,2,1,3,2,1,3
wi10,101,WARREN,UNAF,UndecHumAr,0,0,0,1,1,2,2,1,3,0,0,0,0,0,0,0,0,0,3,2,5
wi10,101,WARREN,UNAF,Undeclared,0,0,0,17,24,41,12,9,21,0,1,1,0,0,0,0,0,0,29,34,63
wi10,101,WARREN,UNAF,UndecPhysS,0,0,0,2,0,2,1,2,3,0,0,0,0,0,0,0,0,0,3,2,5
wi10,101,WARREN,UNAF,UndecSocSc,0,0,0,1,2,3,0,2,2,0,0,0,0,0,0,0,0,0,1,4,5
wi10,101,WARREN,USP,Urb Stu&Pl,0,0,0,0,0,0,4,3,7,4,3,7,3,1,4,0,0,0,11,7,18
wi10,101,WARREN,VIS,Art Hst/Cr,0,0,0,0,1,1,0,1,1,0,1,1,1,5,6,0,0,0,1,8,9
wi10,101,WARREN,VIS,Media,0,0,0,1,0,1,1,1,2,3,5,8,12,6,18,0,0,0,17,12,29
wi10,101,WARREN,VIS,Studio VA,0,0,0,0,0,0,1,2,3,0,1,1,3,5,8,0,0,0,4,8,12
wi10,101,WARREN,VIS,VA-CompArt,0,0,0,0,1,1,0,1,1,0,1,1,3,0,3,0,0,0,3,3,6
fa07,73,MARSHALL,ANTH,Anth-Arch,0,2,2,1,0,1,0,1,1,1,0,1,1,1,2,0,0,0,3,4,7
fa07,73,MARSHALL,ANTH,Anth-Biol,0,0,0,0,0,0,0,1,1,1,2,3,2,5,7,0,0,0,3,8,11
fa07,73,MARSHALL,ANTH,Anth-Soci,0,2,2,0,0,0,0,0,0,2,2,4,0,1,1,0,0,0,2,5,7
fa07,73,MARSHALL,ANTH,Anthropol,0,0,0,0,0,0,1,1,2,0,2,2,1,5,6,0,0,0,2,8,10
fa07,73,MARSHALL,BENG,Bioen:Binf,0,0,0,0,0,0,0,0,0,0,0,0,1,1,2,0,0,0,1,1,2
fa07,73,MARSHALL,BENG,Bioeng:PM,0,0,0,0,0,0,3,0,3,5,0,5,11,9,20,0,0,0,19,9,28
fa07,73,MARSHALL,BENG,BioengBiot,2,1,3,0,0,0,0,0,0,5,3,8,8,5,13,0,0,0,15,9,24
fa07,73,MARSHALL,BENG,Bioengin,1,2,3,0,0,0,0,2,2,0,1,1,4,3,7,0,0,0,5,8,13
fa07,73,MARSHALL,BENG,Pr-BioenPM,11,2,13,1,1,2,11,6,17,6,0,6,1,2,3,0,0,0,30,11,41
fa07,73,MARSHALL,BIOL,Anml Physl,0,0,0,0,0,0,0,0,0,1,0,1,11,14,25,0,0,0,12,14,26
fa07,73,MARSHALL,BIOL,Bioc/CellB,6,10,16,0,1,1,9,15,24,15,16,31,40,29,69,0,0,0,70,71,141
fa07,73,MARSHALL,BIOL,BiolBioinf,0,0,0,0,0,0,0,0,0,0,0,0,1,0,1,0,0,0,1,0,1
fa07,73,MARSHALL,BIOL,Ec/Beh/Evo,1,2,3,0,0,0,1,1,2,1,5,6,1,3,4,0,0,0,4,11,15
fa07,73,MARSHALL,BIOL,Genl Biol,11,24,35,1,2,3,11,17,28,30,25,55,23,37,60,0,0,0,76,105,181
fa07,73,MARSHALL,BIOL,Human Bio,18,35,53,3,6,9,25,39,64,26,43,69,44,58,102,0,0,0,116,181,297
fa07,73,MARSHALL,BIOL,Microbiol,1,3,4,0,0,0,1,0,1,0,3,3,3,2,5,0,0,0,5,8,13
fa07,73,MARSHALL,BIOL,Molec Biol,4,5,9,0,0,0,2,2,4,4,2,6,5,7,12,0,0,0,15,16,31
fa07,73,MARSHALL,BIOL,PhyslNeuro,6,14,20,0,0,0,4,4,8,8,11,19,7,4,11,0,0,0,25,33,58
fa07,73,MARSHALL,CENG,Chem Engin,3,1,4,0,0,0,3,4,7,6,3,9,6,4,10,0,0,0,18,12,30
fa07,73,MARSHALL,CGS,CritGendSt,0,1,1,0,0,0,0,0,0,0,2,2,0,4,4,0,0,0,0,7,7
fa07,73,MARSHALL,CHEM,Bioch/Chem,8,8,16,1,0,1,3,10,13,9,11,20,9,7,16,0,0,0,30,36,66
fa07,73,MARSHALL,CHEM,Chem Educ,0,0,0,0,0,0,0,0,0,0,0,0,0,1,1,0,0,0,0,1,1
fa07,73,MARSHALL,CHEM,Chemistry,3,7,10,0,1,1,3,2,5,6,4,10,0,3,3,0,0,0,12,17,29
fa07,73,MARSHALL,CHEM,Envir Chem,0,0,0,0,0,0,0,1,1,0,0,0,0,0,0,0,0,0,0,1,1
fa07,73,MARSHALL,CHEM,MolecSynth,0,0,0,0,0,0,0,0,0,0,0,0,0,1,1,0,0,0,0,1,1
fa07,73,MARSHALL,CHEM,Pharm Chem,2,11,13,0,1,1,2,8,10,10,14,24,6,12,18,0,0,0,20,46,66
fa07,73,MARSHALL,CHIN,Chinese St,0,1,1,0,0,0,1,0,1,0,0,0,1,2,3,0,0,0,2,3,5
fa07,73,MARSHALL,CLAS,Classic St,0,0,0,0,0,0,0,0,0,1,1,2,0,0,0,0,0,0,1,1,2
fa07,73,MARSHALL,COGS,Cog Sci,1,4,5,1,0,1,1,2,3,7,5,12,5,4,9,0,0,0,15,15,30
fa07,73,MARSHALL,COGS,CogSc/ClAs,0,0,0,0,0,0,0,1,1,0,1,1,0,1,1,0,0,0,0,3,3
fa07,73,MARSHALL,COGS,CogSc/Comp,0,0,0,0,0,0,1,0,1,0,0,0,0,0,0,0,0,0,1,0,1
fa07,73,MARSHALL,COGS,CogSc/HCI,0,0,0,0,0,0,0,0,0,2,0,2,2,1,3,0,0,0,4,1,5
fa07,73,MARSHALL,COGS,CogSc/HCog,0,0,0,0,0,0,0,0,0,1,1,2,1,0,1,0,0,0,2,1,3
fa07,73,MARSHALL,COGS,CogSc/Neur,1,0,1,0,0,0,3,1,4,2,2,4,3,1,4,0,0,0,9,4,13
fa07,73,MARSHALL,COMM,Communic,6,12,18,0,4,4,4,15,19,17,46,63,15,35,50,0,0,0,42,112,154
fa07,73,MARSHALL,CSE,Comp Sci,9,1,10,0,0,0,4,1,5,7,0,7,18,4,22,0,0,0,38,6,44
fa07,73,MARSHALL,CSE,CompEngCSE,4,1,5,0,0,0,8,0,8,4,0,4,9,1,10,0,0,0,25,2,27
fa07,73,MARSHALL,CSE,CompScBinf,0,0,0,0,0,0,0,0,0,0,0,0,0,1,1,0,0,0,0,1,1
fa07,73,MARSHALL,ECE,CompEngECE,0,0,0,0,0,0,2,0,2,0,0,0,0,0,0,0,0,0,2,0,2
fa07,73,MARSHALL,ECE,Electr Eng,5,1,6,0,0,0,8,1,9,13,4,17,19,5,24,0,0,0,45,11,56
fa07,73,MARSHALL,ECE,Engin Phys,0,0,0,0,0,0,0,0,0,0,0,0,2,0,2,0,0,0,2,0,2
fa07,73,MARSHALL,ECE,Pr-ElecEng,0,0,0,0,0,0,0,0,0,2,0,2,0,0,0,0,0,0,2,0,2
fa07,73,MARSHALL,ECON,Ec-Mth&Ecn,2,0,2,1,1,2,1,2,3,6,4,10,2,2,4,0,0,0,12,9,21
fa07,73,MARSHALL,ECON,Econ-MgtSc,3,4,7,5,1,6,20,13,33,36,22,58,34,29,63,0,0,0,98,69,167
fa07,73,MARSHALL,ECON,Economics,22,6,28,2,1,3,23,19,42,70,32,102,61,34,95,0,0,0,178,92,270
fa07,73,MARSHALL,ERTH,Earth Scis,0,0,0,1,0,1,0,0,0,1,0,1,0,1,1,0,0,0,2,1,3
fa07,73,MARSHALL,ESYS,EnvSys(EB),0,1,1,0,0,0,1,3,4,2,2,4,3,4,7,0,0,0,6,10,16
fa07,73,MARSHALL,ESYS,EnvSys(EC),0,0,0,0,0,0,0,0,0,1,0,1,0,0,0,0,0,0,1,0,1
fa07,73,MARSHALL,ESYS,EnvSys(EP),1,2,3,0,0,0,0,0,0,0,2,2,0,0,0,0,0,0,1,4,5
fa07,73,MARSHALL,ESYS,EnvSys(ES),0,0,0,0,0,0,0,0,0,2,0,2,1,1,2,0,0,0,3,1,4
fa07,73,MARSHALL,ETHN,Ethnic St,0,1,1,0,0,0,0,2,2,0,15,15,1,8,9,0,0,0,1,26,27
fa07,73,MARSHALL,HDP,Human Dev,0,0,0,0,0,0,0,0,0,0,7,7,1,25,26,0,0,0,1,32,33
fa07,73,MARSHALL,HDP,Pr-HumnDev,1,0,1,0,2,2,0,10,10,1,16,17,1,3,4,0,0,0,3,31,34
fa07,73,MARSHALL,HIST,History,2,3,5,1,0,1,3,5,8,10,8,18,14,18,32,0,0,0,30,34,64
fa07,73,MARSHALL,INTL,IntSt-Anth,0,0,0,0,0,0,0,0,0,0,2,2,0,1,1,0,0,0,0,3,3
fa07,73,MARSHALL,INTL,IntSt-Econ,2,8,10,0,0,0,2,6,8,8,9,17,4,15,19,0,0,0,16,38,54
fa07,73,MARSHALL,INTL,IntSt-Hist,0,0,0,0,0,0,0,2,2,1,1,2,1,0,1,0,0,0,2,3,5
fa07,73,MARSHALL,INTL,IntSt-Ling,1,2,3,0,1,1,0,1,1,0,2,2,1,0,1,0,0,0,2,6,8
fa07,73,MARSHALL,INTL,IntSt-Lit,0,0,0,0,0,0,0,1,1,0,0,0,0,0,0,0,0,0,0,1,1
fa07,73,MARSHALL,INTL,IntSt-PolS,3,2,5,0,0,0,3,3,6,3,8,11,1,9,10,0,0,0,10,22,32
fa07,73,MARSHALL,INTL,IntSt-Soc,0,2,2,0,0,0,0,3,3,2,9,11,0,7,7,0,0,0,2,21,23
fa07,73,MARSHALL,JAPN,JapaneseSt,1,1,2,0,0,0,1,0,1,0,1,1,0,2,2,0,0,0,2,4,6
fa07,73,MARSHALL,JUDA,Judaic Stu,1,1,2,0,0,0,0,0,0,0,0,0,0,1,1,0,0,0,1,2,3
fa07,73,MARSHALL,LATI,LatinAm St,0,1,1,0,0,0,0,3,3,1,0,1,1,1,2,0,0,0,2,5,7
fa07,73,MARSHALL,LING,Lang Stu,0,0,0,0,0,0,0,0,0,0,0,0,0,3,3,0,0,0,0,3,3
fa07,73,MARSHALL,LING,Ling-CogLn,0,0,0,0,0,0,0,0,0,0,1,1,0,0,0,0,0,0,0,1,1
fa07,73,MARSHALL,LING,Linguistcs,0,2,2,0,0,0,0,0,0,1,0,1,2,2,4,0,0,0,3,4,7
fa07,73,MARSHALL,LIT,Lit/Compos,0,0,0,0,0,0,0,1,1,0,0,0,0,0,0,0,0,0,0,1,1
fa07,73,MARSHALL,LIT,Lit/Engl,2,2,4,0,1,1,2,2,4,1,4,5,2,8,10,0,0,0,7,17,24
fa07,73,MARSHALL,LIT,Lit/World,0,0,0,0,1,1,0,1,1,2,0,2,0,0,0,0,0,0,2,2,4
fa07,73,MARSHALL,LIT,Lit/Writng,0,0,0,0,0,0,0,0,0,1,0,1,4,2,6,0,0,0,5,2,7
fa07,73,MARSHALL,LIT,Pre-Lit/Wr,1,3,4,0,0,0,1,3,4,1,5,6,0,2,2,0,0,0,3,13,16
fa07,73,MARSHALL,LIT,Russian Lt,0,0,0,0,0,0,0,0,0,0,0,0,0,1,1,0,0,0,0,1,1
fa07,73,MARSHALL,LIT,Spanish Lt,0,0,0,0,0,0,0,1,1,0,2,2,0,3,3,0,0,0,0,6,6
fa07,73,MARSHALL,MAE,Aerosp Eng,4,2,6,0,0,0,6,0,6,11,1,12,17,1,18,0,0,0,38,4,42
fa07,73,MARSHALL,MAE,Engin Sci,1,0,1,0,0,0,1,0,1,0,1,1,1,0,1,0,0,0,3,1,4
fa07,73,MARSHALL,MAE,Envir Eng,1,2,3,1,0,1,0,0,0,0,0,0,1,1,2,0,0,0,3,3,6
fa07,73,MARSHALL,MAE,Mech Engin,15,6,21,1,0,1,14,1,15,23,1,24,43,4,47,0,0,0,96,12,108
fa07,73,MARSHALL,MATH,Appld Math,1,1,2,1,0,1,1,0,1,2,2,4,4,1,5,0,0,0,9,4,13
fa07,73,MARSHALL,MATH,Math/SecEd,1,0,1,0,0,0,0,0,0,1,3,4,2,1,3,0,0,0,4,4,8
fa07,73,MARSHALL,MATH,Mathematcs,5,4,9,0,0,0,0,2,2,3,1,4,3,1,4,0,0,0,11,8,19
fa07,73,MARSHALL,MATH,Mth-CompSc,0,0,0,0,0,0,0,0,0,0,0,0,1,0,1,0,0,0,1,0,1
fa07,73,MARSHALL,MATH,Mth-Mth&Ec,0,1,1,0,0,0,1,1,2,2,2,4,2,2,4,0,0,0,5,6,11
fa07,73,MARSHALL,MATH,Mth-SciCom,0,0,0,0,0,0,0,1,1,0,0,0,0,0,0,0,0,0,0,1,1
fa07,73,MARSHALL,MATH,Mth/ApldSc,0,2,2,0,0,0,0,1,1,2,0,2,1,0,1,0,0,0,3,3,6
fa07,73,MARSHALL,MATH,Pr-Math CS,1,1,2,0,0,0,1,0,1,0,2,2,1,0,1,0,0,0,3,3,6
fa07,73,MARSHALL,MUS,Mu-CompArt,0,0,0,0,0,0,0,2,2,3,0,3,0,0,0,0,0,0,3,2,5
fa07,73,MARSHALL,MUS,Music,1,1,2,0,0,0,2,2,4,2,4,6,2,0,2,0,0,0,7,7,14
fa07,73,MARSHALL,MUS,Music Hum,0,0,0,0,0,0,0,1,1,0,1,1,0,0,0,0,0,0,0,2,2
fa07,73,MARSHALL,PHIL,Philosophy,1,1,2,0,0,0,1,1,2,1,4,5,9,3,12,0,0,0,12,9,21
fa07,73,MARSHALL,PHYS,Biophysics,0,0,0,0,0,0,0,0,0,0,1,1,0,1,1,0,0,0,0,2,2
fa07,73,MARSHALL,PHYS,Gen Physcs,0,0,0,0,0,0,0,0,0,1,0,1,0,0,0,0,0,0,1,0,1
fa07,73,MARSHALL,PHYS,Phys/Astro,2,2,4,0,0,0,1,0,1,1,1,2,3,3,6,0,0,0,7,6,13
fa07,73,MARSHALL,PHYS,Physics,2,0,2,0,0,0,1,0,1,2,1,3,4,0,4,0,0,0,9,1,10
fa07,73,MARSHALL,POLI,Polit Sci,10,11,21,0,2,2,9,6,15,24,15,39,22,28,50,0,0,0,65,62,127
fa07,73,MARSHALL,POLI,PolSc-Amer,1,2,3,1,0,1,2,1,3,5,1,6,2,5,7,0,0,0,11,9,20
fa07,73,MARSHALL,POLI,PolSc-Comp,0,0,0,0,0,0,0,0,0,0,0,0,0,1,1,0,0,0,0,1,1
fa07,73,MARSHALL,POLI,PolSc-Intl,3,7,10,0,2,2,4,5,9,8,11,19,7,8,15,0,0,0,22,33,55
fa07,73,MARSHALL,POLI,PolSc-PLaw,7,5,12,0,1,1,8,5,13,8,4,12,4,5,9,0,0,0,27,20,47
fa07,73,MARSHALL,POLI,PolSc-PPol,0,0,0,0,0,0,0,1,1,0,2,2,4,0,4,0,0,0,4,3,7
fa07,73,MARSHALL,POLI,PolSc-Thry,0,0,0,0,0,0,0,1,1,0,0,0,0,2,2,0,0,0,0,3,3
fa07,73,MARSHALL,PSYC,Psychology,8,26,34,1,4,5,10,32,42,24,48,72,29,59,88,0,0,0,72,169,241
fa07,73,MARSHALL,RELI,Relig/Stu,0,0,0,0,0,0,0,0,0,2,1,3,1,1,2,0,0,0,3,2,5
fa07,73,MARSHALL,SE,Struct Eng,6,1,7,2,0,2,2,5,7,8,2,10,20,7,27,0,0,0,38,15,53
fa07,73,MARSHALL,SOC,Sociology,1,7,8,0,0,0,0,13,13,15,22,37,7,22,29,0,0,0,23,64,87
fa07,73,MARSHALL,THEA,Dance,0,0,0,0,0,0,0,0,0,0,1,1,0,1,1,0,0,0,0,2,2
fa07,73,MARSHALL,THEA,Theatre,0,1,1,0,1,1,0,1,1,2,5,7,3,2,5,0,0,0,5,10,15
fa07,73,MARSHALL,TWS,ThirdWldSt,0,1,1,0,0,0,0,0,0,0,1,1,1,0,1,0,0,0,1,2,3
fa07,73,MARSHALL,UNAF,UndecBiolS,13,30,43,1,5,6,8,17,25,1,2,3,0,0,0,0,0,0,23,54,77
fa07,73,MARSHALL,UNAF,UndecHumAr,1,17,18,0,1,1,2,4,6,0,2,2,0,0,0,0,0,0,3,24,27
fa07,73,MARSHALL,UNAF,Undeclared,42,66,108,4,11,15,20,40,60,6,5,11,0,0,0,0,0,0,72,122,194
fa07,73,MARSHALL,UNAF,UndecPhysS,7,6,13,0,0,0,5,1,6,1,0,1,0,0,0,0,0,0,13,7,20
fa07,73,MARSHALL,UNAF,UndecSocSc,5,18,23,0,1,1,4,7,11,2,1,3,0,0,0,0,0,0,11,27,38
fa07,73,MARSHALL,USP,Urb Stu&Pl,0,3,3,0,0,0,2,4,6,2,6,8,11,14,25,0,0,0,15,27,42
fa07,73,MARSHALL,VIS,Art Hst/Cr,0,1,1,0,1,1,0,2,2,0,4,4,1,2,3,0,0,0,1,10,11
fa07,73,MARSHALL,VIS,Media,1,1,2,1,1,2,0,1,1,5,3,8,10,1,11,0,0,0,17,7,24
fa07,73,MARSHALL,VIS,Studio VA,1,0,1,0,0,0,2,1,3,1,2,3,1,6,7,0,0,0,5,9,14
fa07,73,MARSHALL,VIS,VA-CompArt,0,0,0,0,0,0,0,1,1,1,1,2,2,0,2,0,0,0,3,2,5
fa07,73,MUIR,ANTH,Anth-Arch,0,0,0,0,0,0,1,2,3,1,2,3,2,2,4,0,0,0,4,6,10
fa07,73,MUIR,ANTH,Anth-Biol,0,0,0,1,0,1,0,2,2,4,4,8,1,8,9,0,0,0,6,14,20
fa07,73,MUIR,ANTH,Anth-Soci,1,0,1,0,0,0,0,2,2,0,3,3,1,0,1,0,0,0,2,5,7
fa07,73,MUIR,ANTH,Anthropol,0,0,0,0,0,0,0,1,1,0,4,4,0,5,5,0,0,0,0,10,10
fa07,73,MUIR,BENG,Bioen:Binf,0,0,0,0,0,0,0,0,0,0,0,0,1,0,1,0,0,0,1,0,1
fa07,73,MUIR,BENG,Bioeng:PM,0,0,0,0,0,0,3,0,3,4,3,7,10,5,15,0,0,0,17,8,25
fa07,73,MUIR,BENG,BioengBiot,3,2,5,0,0,0,3,0,3,6,2,8,9,8,17,0,0,0,21,12,33
fa07,73,MUIR,BENG,Bioengin,8,2,10,0,1,1,3,3,6,3,3,6,9,4,13,0,0,0,23,13,36
fa07,73,MUIR,BENG,Pr-BioenBf,0,0,0,0,0,0,0,0,0,0,1,1,0,0,0,0,0,0,0,1,1
fa07,73,MUIR,BENG,Pr-BioenPM,8,11,19,4,0,4,4,6,10,8,3,11,2,0,2,0,0,0,26,20,46
fa07,73,MUIR,BIOL,Anml Physl,0,0,0,0,0,0,0,0,0,0,0,0,5,16,21,0,0,0,5,16,21
fa07,73,MUIR,BIOL,Bioc/CellB,9,11,20,1,1,2,17,17,34,21,29,50,25,40,65,0,0,0,73,98,171
fa07,73,MUIR,BIOL,BiolBioinf,0,0,0,0,0,0,0,0,0,0,0,0,1,0,1,0,0,0,1,0,1
fa07,73,MUIR,BIOL,Ec/Beh/Evo,1,0,1,1,1,2,2,1,3,1,9,10,3,12,15,0,0,0,8,23,31
fa07,73,MUIR,BIOL,Genl Biol,8,25,33,1,3,4,17,22,39,18,35,53,26,38,64,0,0,0,70,123,193
fa07,73,MUIR,BIOL,Human Bio,24,38,62,1,4,5,33,46,79,41,54,95,44,61,105,0,0,0,143,203,346
fa07,73,MUIR,BIOL,Microbiol,0,1,1,0,0,0,3,0,3,2,2,4,5,8,13,0,0,0,10,11,21
fa07,73,MUIR,BIOL,Molec Biol,6,5,11,0,1,1,6,10,16,3,2,5,8,13,21,0,0,0,23,31,54
fa07,73,MUIR,BIOL,PhyslNeuro,5,7,12,0,0,0,6,12,18,11,13,24,5,7,12,0,0,0,27,39,66
fa07,73,MUIR,BIOL,Pr-BioBinf,0,0,0,0,0,0,0,0,0,0,1,1,0,0,0,0,0,0,0,1,1
fa07,73,MUIR,CENG,Chem Engin,1,5,6,0,0,0,3,1,4,9,1,10,8,2,10,0,0,0,21,9,30
fa07,73,MUIR,CGS,CritGendSt,0,1,1,0,0,0,0,0,0,0,1,1,1,4,5,0,0,0,1,6,7
fa07,73,MUIR,CHEM,Bioch/Chem,14,9,23,1,0,1,6,10,16,18,13,31,21,6,27,0,0,0,60,38,98
fa07,73,MUIR,CHEM,Chem Educ,0,0,0,0,0,0,0,0,0,0,0,0,1,1,2,0,0,0,1,1,2
fa07,73,MUIR,CHEM,Chem Phys,0,0,0,0,0,0,0,0,0,1,0,1,0,1,1,0,0,0,1,1,2
fa07,73,MUIR,CHEM,Chemistry,5,3,8,0,1,1,5,4,9,6,3,9,4,7,11,0,0,0,20,18,38
fa07,73,MUIR,CHEM,Envir Chem,0,0,0,0,0,0,0,0,0,0,1,1,0,1,1,0,0,0,0,2,2
fa07,73,MUIR,CHEM,MolecSynth,0,0,0,0,0,0,0,0,0,1,1,2,0,0,0,0,0,0,1,1,2
fa07,73,MUIR,CHEM,Pharm Chem,9,4,13,2,1,3,8,7,15,7,10,17,5,13,18,0,0,0,31,35,66
fa07,73,MUIR,CHIN,Chinese St,1,0,1,0,0,0,0,0,0,1,2,3,0,0,0,0,0,0,2,2,4
fa07,73,MUIR,CLAS,Classic St,0,0,0,0,0,0,0,1,1,2,1,3,1,1,2,0,0,0,3,3,6
fa07,73,MUIR,COGS,Cog Sci,3,5,8,0,0,0,5,4,9,9,9,18,5,8,13,0,0,0,22,26,48
fa07,73,MUIR,COGS,CogSc/ClAs,0,0,0,0,0,0,0,1,1,1,0,1,1,1,2,0,0,0,2,2,4
fa07,73,MUIR,COGS,CogSc/HCI,0,0,0,0,0,0,1,1,2,2,0,2,5,1,6,0,0,0,8,2,10
fa07,73,MUIR,COGS,CogSc/HCog,0,0,0,0,0,0,0,0,0,2,0,2,1,0,1,0,0,0,3,0,3
fa07,73,MUIR,COGS,CogSc/Neur,0,0,0,0,0,0,0,2,2,3,3,6,4,3,7,0,0,0,7,8,15
fa07,73,MUIR,COMM,Communic,1,9,10,1,7,8,7,21,28,28,45,73,14,45,59,0,0,0,51,127,178
fa07,73,MUIR,CSE,Comp Sci,9,1,10,0,0,0,7,1,8,11,0,11,24,3,27,0,0,0,51,5,56
fa07,73,MUIR,CSE,CompEngCSE,3,0,3,0,0,0,4,0,4,6,0,6,5,0,5,0,0,0,18,0,18
fa07,73,MUIR,CSE,CompScBinf,0,0,0,0,0,0,0,0,0,0,0,0,1,0,1,0,0,0,1,0,1
fa07,73,MUIR,ECE,CompEngECE,3,2,5,0,0,0,2,0,2,4,0,4,3,0,3,0,0,0,12,2,14
fa07,73,MUIR,ECE,Electr Eng,1,0,1,1,0,1,4,1,5,7,4,11,14,2,16,0,0,0,27,7,34
fa07,73,MUIR,ECE,Engin Phys,0,0,0,0,0,0,1,0,1,0,0,0,0,0,0,0,0,0,1,0,1
fa07,73,MUIR,ECE,Pr-EngPhys,0,0,0,0,0,0,1,0,1,0,0,0,0,0,0,0,0,0,1,0,1
fa07,73,MUIR,ECON,Ec-Mth&Ecn,4,2,6,0,0,0,5,1,6,2,1,3,1,2,3,0,0,0,12,6,18
fa07,73,MUIR,ECON,Econ-MgtSc,2,2,4,1,1,2,12,8,20,16,13,29,37,22,59,0,0,0,68,46,114
fa07,73,MUIR,ECON,Economics,13,7,20,7,1,8,18,17,35,50,36,86,67,29,96,0,0,0,155,90,245
fa07,73,MUIR,ERTH,Earth Scis,0,0,0,0,0,0,0,0,0,0,0,0,2,0,2,0,0,0,2,0,2
fa07,73,MUIR,ERTH,ErSc-GeoCh,0,0,0,0,0,0,0,1,1,0,0,0,1,0,1,0,0,0,1,1,2
fa07,73,MUIR,ERTH,ErSc-Geol,0,0,0,0,0,0,0,1,1,0,0,0,0,0,0,0,0,0,0,1,1
fa07,73,MUIR,ESYS,EnvSys(EB),0,2,2,0,0,0,0,3,3,0,5,5,4,7,11,0,0,0,4,17,21
fa07,73,MUIR,ESYS,EnvSys(EC),0,0,0,0,0,0,0,0,0,0,0,0,3,0,3,0,0,0,3,0,3
fa07,73,MUIR,ESYS,EnvSys(EP),0,1,1,0,1,1,0,3,3,2,1,3,1,2,3,0,0,0,3,8,11
fa07,73,MUIR,ESYS,EnvSys(ES),2,1,3,0,0,0,2,0,2,1,0,1,0,1,1,0,0,0,5,2,7
fa07,73,MUIR,ETHN,Ethnic St,0,1,1,0,0,0,1,2,3,0,3,3,6,6,12,0,0,0,7,12,19
fa07,73,MUIR,HDP,Human Dev,0,0,0,0,0,0,0,0,0,1,2,3,1,21,22,0,0,0,2,23,25
fa07,73,MUIR,HDP,Pr-HumnDev,0,2,2,0,1,1,0,11,11,0,10,10,0,7,7,0,0,0,0,31,31
fa07,73,MUIR,HIST,History,4,2,6,0,0,0,4,5,9,8,8,16,23,18,41,0,0,0,39,33,72
fa07,73,MUIR,INTL,IntSt-Anth,0,0,0,0,0,0,0,2,2,1,5,6,2,4,6,0,0,0,3,11,14
fa07,73,MUIR,INTL,IntSt-Econ,0,9,9,0,1,1,2,8,10,10,11,21,6,10,16,0,0,0,18,39,57
fa07,73,MUIR,INTL,IntSt-Hist,0,0,0,0,0,0,1,2,3,1,0,1,0,3,3,0,0,0,2,5,7
fa07,73,MUIR,INTL,IntSt-Ling,0,1,1,0,0,0,0,0,0,1,1,2,0,0,0,0,0,0,1,2,3
fa07,73,MUIR,INTL,IntSt-Lit,0,0,0,0,0,0,0,0,0,0,1,1,0,2,2,0,0,0,0,3,3
fa07,73,MUIR,INTL,IntSt-PolS,1,3,4,0,0,0,1,2,3,5,7,12,4,19,23,0,0,0,11,31,42
fa07,73,MUIR,INTL,IntSt-Soc,0,0,0,0,0,0,0,5,5,3,8,11,0,11,11,0,0,0,3,24,27
fa07,73,MUIR,JAPN,JapaneseSt,1,0,1,0,0,0,1,0,1,0,0,0,1,1,2,0,0,0,3,1,4
fa07,73,MUIR,JUDA,Judaic Stu,0,0,0,0,0,0,0,1,1,0,0,0,0,0,0,0,0,0,0,1,1
fa07,73,MUIR,LATI,LatinAm St,0,0,0,0,0,0,0,0,0,0,0,0,1,3,4,0,0,0,1,3,4
fa07,73,MUIR,LING,Lang Stu,1,1,2,0,0,0,0,0,0,0,2,2,1,2,3,0,0,0,2,5,7
fa07,73,MUIR,LING,Ling-CogLn,0,0,0,0,0,0,0,1,1,0,0,0,0,4,4,0,0,0,0,5,5
fa07,73,MUIR,LING,Ling-LSoc,0,0,0,0,0,0,0,1,1,0,1,1,0,1,1,0,0,0,0,3,3
fa07,73,MUIR,LING,Linguistcs,0,0,0,0,0,0,0,1,1,0,4,4,0,2,2,0,0,0,0,7,7
fa07,73,MUIR,LIT,French Lit,0,0,0,0,0,0,0,0,0,0,1,1,0,0,0,0,0,0,0,1,1
fa07,73,MUIR,LIT,German Lit,0,0,0,0,0,0,0,0,0,0,1,1,0,0,0,0,0,0,0,1,1
fa07,73,MUIR,LIT,Lit/Compos,0,0,0,0,0,0,0,1,1,0,1,1,2,1,3,0,0,0,2,3,5
fa07,73,MUIR,LIT,Lit/Engl,1,2,3,0,1,1,0,5,5,4,8,12,7,8,15,0,0,0,12,24,36
fa07,73,MUIR,LIT,Lit/World,0,1,1,0,0,0,0,0,0,2,4,6,2,4,6,0,0,0,4,9,13
fa07,73,MUIR,LIT,Lit/Writng,0,0,0,0,0,0,0,0,0,1,1,2,5,16,21,0,0,0,6,17,23
fa07,73,MUIR,LIT,Pre-Lit/Wr,1,4,5,1,1,2,3,11,14,9,10,19,1,7,8,0,0,0,15,33,48
fa07,73,MUIR,LIT,Spanish Lt,0,1,1,0,0,0,0,0,0,3,3,6,0,1,1,0,0,0,3,5,8
fa07,73,MUIR,MAE,Aerosp Eng,7,0,7,4,1,5,3,0,3,9,2,11,12,5,17,0,0,0,35,8,43
fa07,73,MUIR,MAE,Engin Sci,0,0,0,0,0,0,1,0,1,0,0,0,0,0,0,0,0,0,1,0,1
fa07,73,MUIR,MAE,Envir Eng,1,1,2,0,0,0,0,2,2,1,3,4,1,3,4,0,0,0,3,9,12
fa07,73,MUIR,MAE,Mech Engin,16,2,18,3,0,3,14,3,17,13,2,15,37,2,39,0,0,0,83,9,92
fa07,73,MUIR,MATH,Appld Math,5,1,6,0,0,0,2,0,2,2,1,3,3,2,5,0,0,0,12,4,16
fa07,73,MUIR,MATH,Math/SecEd,0,0,0,1,0,1,0,0,0,2,1,3,4,1,5,0,0,0,7,2,9
fa07,73,MUIR,MATH,Mathematcs,2,4,6,0,1,1,7,3,10,11,10,21,10,1,11,0,0,0,30,19,49
fa07,73,MUIR,MATH,Mth-CompSc,0,0,0,0,0,0,0,0,0,1,0,1,1,1,2,0,0,0,2,1,3
fa07,73,MUIR,MATH,Mth-Mth&Ec,0,2,2,0,1,1,0,3,3,3,3,6,3,2,5,0,0,0,6,11,17
fa07,73,MUIR,MATH,Mth/ApldSc,0,0,0,0,0,0,0,2,2,1,1,2,0,1,1,0,0,0,1,4,5
fa07,73,MUIR,MATH,Pr-Math CS,0,0,0,0,0,0,0,0,0,1,0,1,0,0,0,0,0,0,1,0,1
fa07,73,MUIR,MUS,Mu-CompArt,0,0,0,2,0,2,2,1,3,6,3,9,3,0,3,0,0,0,13,4,17
fa07,73,MUIR,MUS,Music,1,2,3,0,1,1,3,0,3,2,3,5,5,2,7,0,0,0,11,8,19
fa07,73,MUIR,MUS,Music Hum,1,0,1,0,0,0,0,0,0,0,0,0,0,0,0,0,0,0,1,0,1
fa07,73,MUIR,PHIL,Philosophy,1,0,1,0,0,0,3,1,4,4,4,8,6,5,11,0,0,0,14,10,24
fa07,73,MUIR,PHYS,Biophysics,1,0,1,0,0,0,1,0,1,2,0,2,6,1,7,0,0,0,10,1,11
fa07,73,MUIR,PHYS,Gen Physcs,0,1,1,0,0,0,0,0,0,0,0,0,0,1,1,0,0,0,0,2,2
fa07,73,MUIR,PHYS,Phy/ErthSc,0,0,0,0,0,0,1,0,1,0,0,0,0,0,0,0,0,0,1,0,1
fa07,73,MUIR,PHYS,Phys/Astro,0,1,1,0,0,0,1,1,2,0,0,0,1,2,3,0,0,0,2,4,6
fa07,73,MUIR,PHYS,Phys/Mtrls,0,0,0,0,0,0,0,0,0,0,0,0,1,0,1,0,0,0,1,0,1
fa07,73,MUIR,PHYS,Physics,2,0,2,0,0,0,0,1,1,1,0,1,7,0,7,0,0,0,10,1,11
fa07,73,MUIR,POLI,Polit Sci,2,2,4,0,1,1,6,10,16,17,18,35,24,6,30,0,0,0,49,37,86
fa07,73,MUIR,POLI,PolSc-Amer,1,1,2,0,0,0,1,2,3,0,2,2,1,3,4,0,0,0,3,8,11
fa07,73,MUIR,POLI,PolSc-Comp,0,0,0,0,0,0,1,0,1,0,0,0,1,2,3,0,0,0,2,2,4
fa07,73,MUIR,POLI,PolSc-Intl,3,0,3,0,0,0,3,6,9,7,9,16,11,10,21,0,0,0,24,25,49
fa07,73,MUIR,POLI,PolSc-PLaw,3,4,7,1,3,4,0,0,0,8,3,11,4,3,7,0,0,0,16,13,29
fa07,73,MUIR,POLI,PolSc-PPol,1,0,1,0,0,0,0,0,0,0,0,0,0,0,0,0,0,0,1,0,1
fa07,73,MUIR,POLI,PolSc-Thry,0,0,0,0,0,0,1,1,2,1,1,2,1,0,1,0,0,0,3,2,5
fa07,73,MUIR,PSYC,Psychology,7,32,39,2,9,11,13,37,50,23,58,81,35,84,119,0,0,0,80,220,300
fa07,73,MUIR,RELI,Relig/Stu,0,0,0,1,0,1,1,1,2,1,2,3,1,1,2,0,0,0,4,4,8
fa07,73,MUIR,RUSS,Russ&SovSt,0,0,0,0,0,0,0,0,0,0,0,0,0,1,1,0,0,0,0,1,1
fa07,73,MUIR,SE,Engin Sci,1,0,1,0,0,0,1,0,1,0,0,0,0,0,0,0,0,0,2,0,2
fa07,73,MUIR,SE,Struct Eng,4,1,5,3,0,3,7,7,14,10,6,16,28,3,31,0,0,0,52,17,69
fa07,73,MUIR,SIO,ErSc-Geoch,1,0,1,0,0,0,0,0,0,0,0,0,0,0,0,0,0,0,1,0,1
fa07,73,MUIR,SOC,Sociology,0,1,1,1,1,2,1,8,9,6,21,27,9,19,28,0,0,0,17,50,67
fa07,73,MUIR,THEA,Dance,0,0,0,0,0,0,0,0,0,0,3,3,0,3,3,0,0,0,0,6,6
fa07,73,MUIR,THEA,Theatre,2,3,5,0,0,0,3,7,10,6,8,14,8,9,17,0,0,0,19,27,46
fa07,73,MUIR,TWS,ThirdWldSt,0,1,1,0,0,0,0,1,1,0,0,0,0,1,1,0,0,0,0,3,3
fa07,73,MUIR,UNAF,Limited St,0,0,0,0,0,0,0,0,0,0,0,0,0,0,0,1,1,2,1,1,2
fa07,73,MUIR,UNAF,UndecBiolS,12,20,32,3,1,4,12,18,30,1,4,5,0,0,0,0,0,0,28,43,71
fa07,73,MUIR,UNAF,UndecHumAr,2,11,13,1,1,2,3,10,13,0,1,1,0,0,0,0,0,0,6,23,29
fa07,73,MUIR,UNAF,Undeclared,42,58,100,9,11,20,40,58,98,13,10,23,0,0,0,0,0,0,104,137,241
fa07,73,MUIR,UNAF,UndecPhysS,4,4,8,1,2,3,5,5,10,1,0,1,0,0,0,0,0,0,11,11,22
fa07,73,MUIR,UNAF,UndecSocSc,10,13,23,1,2,3,7,11,18,1,1,2,0,0,0,0,0,0,19,27,46
fa07,73,MUIR,USP,Urb Stu&Pl,1,0,1,0,1,1,1,2,3,9,4,13,6,3,9,0,0,0,17,10,27
fa07,73,MUIR,VIS,Art Hst/Cr,0,0,0,0,0,0,0,2,2,0,2,2,1,10,11,0,0,0,1,14,15
fa07,73,MUIR,VIS,Media,2,5,7,0,0,0,9,7,16,10,9,19,9,4,13,0,0,0,30,25,55
fa07,73,MUIR,VIS,Studio VA,1,1,2,0,2,2,0,2,2,1,9,10,2,5,7,0,0,0,4,19,23
fa07,73,MUIR,VIS,VA-CompArt,1,0,1,0,0,0,4,2,6,1,0,1,1,1,2,0,0,0,7,3,10
fa07,73,REVELLE,ANTH,Anth-Arch,0,0,0,0,0,0,0,0,0,0,1,1,0,2,2,0,0,0,0,3,3
fa07,73,REVELLE,ANTH,Anth-Biol,0,1,1,0,0,0,0,0,0,0,4,4,0,3,3,0,0,0,0,8,8
fa07,73,REVELLE,ANTH,Anth-Soci,1,2,3,0,0,0,0,0,0,1,0,1,0,0,0,0,0,0,2,2,4
fa07,73,REVELLE,ANTH,Anthropol,0,0,0,0,0,0,0,0,0,0,1,1,0,4,4,0,0,0,0,5,5
fa07,73,REVELLE,BENG,Bioen:Binf,0,0,0,0,0,0,0,0,0,0,0,0,2,0,2,0,0,0,2,0,2
fa07,73,REVELLE,BENG,Bioeng:PM,0,0,0,0,0,0,1,1,2,7,4,11,26,14,40,0,0,0,34,19,53
fa07,73,REVELLE,BENG,BioengBiot,4,4,8,0,0,0,2,2,4,4,1,5,18,3,21,0,0,0,28,10,38
fa07,73,REVELLE,BENG,Bioengin,7,6,13,0,0,0,2,4,6,6,5,11,10,8,18,0,0,0,25,23,48
fa07,73,REVELLE,BENG,Pr-BioenBf,0,0,0,0,0,0,0,0,0,1,0,1,0,0,0,0,0,0,1,0,1
fa07,73,REVELLE,BENG,Pr-BioenPM,29,22,51,0,0,0,10,2,12,8,5,13,1,0,1,0,0,0,48,29,77
fa07,73,REVELLE,BIOL,Anml Physl,0,0,0,0,0,0,0,0,0,0,1,1,7,10,17,0,0,0,7,11,18
fa07,73,REVELLE,BIOL,Bioc/CellB,21,19,40,1,2,3,7,22,29,41,38,79,64,62,126,0,0,0,134,143,277
fa07,73,REVELLE,BIOL,BiolBioinf,0,0,0,0,0,0,0,0,0,0,0,0,2,0,2,0,0,0,2,0,2
fa07,73,REVELLE,BIOL,Ec/Beh/Evo,2,0,2,0,0,0,0,1,1,4,3,7,7,4,11,0,0,0,13,8,21
fa07,73,REVELLE,BIOL,Genl Biol,23,40,63,1,7,8,9,27,36,32,32,64,27,71,98,0,0,0,92,177,269
fa07,73,REVELLE,BIOL,Human Bio,37,65,102,3,10,13,38,65,103,47,63,110,63,97,160,0,1,1,188,301,489
fa07,73,REVELLE,BIOL,Microbiol,5,1,6,0,0,0,1,5,6,2,6,8,9,8,17,0,0,0,17,20,37
fa07,73,REVELLE,BIOL,Molec Biol,7,6,13,0,0,0,2,4,6,6,5,11,15,18,33,0,0,0,30,33,63
fa07,73,REVELLE,BIOL,PhyslNeuro,7,13,20,0,2,2,7,8,15,13,21,34,6,14,20,0,0,0,33,58,91
fa07,73,REVELLE,CENG,Chem Engin,7,6,13,0,0,0,7,3,10,6,3,9,7,5,12,0,0,0,27,17,44
fa07,73,REVELLE,CGS,CritGendSt,0,0,0,0,0,0,0,2,2,0,2,2,0,1,1,0,0,0,0,5,5
fa07,73,REVELLE,CHEM,Bioch/Chem,21,31,52,1,3,4,4,10,14,10,17,27,23,21,44,0,0,0,59,82,141
fa07,73,REVELLE,CHEM,Chem Phys,1,0,1,0,0,0,0,0,0,1,0,1,3,0,3,0,0,0,5,0,5
fa07,73,REVELLE,CHEM,Chemistry,7,7,14,1,0,1,7,6,13,2,3,5,8,9,17,0,0,0,25,25,50
fa07,73,REVELLE,CHEM,Envir Chem,1,0,1,0,0,0,1,1,2,1,0,1,0,2,2,0,0,0,3,3,6
fa07,73,REVELLE,CHEM,MolecSynth,0,0,0,1,0,1,0,0,0,1,0,1,1,0,1,0,0,0,3,0,3
fa07,73,REVELLE,CHEM,Pharm Chem,9,14,23,0,2,2,8,18,26,12,22,34,17,16,33,0,0,0,46,72,118
fa07,73,REVELLE,CHIN,Chinese St,0,1,1,0,0,0,0,0,0,0,0,0,1,2,3,0,0,0,1,3,4
fa07,73,REVELLE,COGS,Cog Sci,1,3,4,0,0,0,4,3,7,1,5,6,4,4,8,0,0,0,10,15,25
fa07,73,REVELLE,COGS,CogSc/ClAs,0,0,0,0,0,0,0,0,0,0,0,0,1,1,2,0,0,0,1,1,2
fa07,73,REVELLE,COGS,CogSc/Clin,0,0,0,0,0,0,0,1,1,0,0,0,0,0,0,0,0,0,0,1,1
fa07,73,REVELLE,COGS,CogSc/Comp,0,0,0,0,0,0,0,0,0,0,0,0,1,0,1,0,0,0,1,0,1
fa07,73,REVELLE,COGS,CogSc/HCI,0,0,0,0,0,0,0,1,1,2,0,2,6,2,8,0,0,0,8,3,11
fa07,73,REVELLE,COGS,CogSc/HCog,0,0,0,0,0,0,0,0,0,0,1,1,0,0,0,0,0,0,0,1,1
fa07,73,REVELLE,COGS,CogSc/Neur,0,0,0,0,0,0,1,0,1,1,5,6,5,3,8,0,0,0,7,8,15
fa07,73,REVELLE,COMM,Communic,1,8,9,0,1,1,2,13,15,3,14,17,3,10,13,0,0,0,9,46,55
fa07,73,REVELLE,CSE,Comp Sci,10,0,10,1,0,1,5,1,6,10,0,10,22,2,24,0,0,0,48,3,51
fa07,73,REVELLE,CSE,CompEngCSE,8,1,9,1,0,1,6,2,8,1,1,2,7,0,7,0,0,0,23,4,27
fa07,73,REVELLE,CSE,CompScBinf,0,0,0,0,0,0,0,0,0,0,0,0,5,0,5,0,0,0,5,0,5
fa07,73,REVELLE,ECE,CompEngECE,1,0,1,0,0,0,1,0,1,1,0,1,2,0,2,0,0,0,5,0,5
fa07,73,REVELLE,ECE,Electr Eng,3,1,4,1,0,1,6,0,6,12,2,14,25,3,28,0,0,0,47,6,53
fa07,73,REVELLE,ECE,Engin Phys,0,0,0,0,0,0,1,0,1,0,0,0,2,0,2,0,0,0,3,0,3
fa07,73,REVELLE,ECE,Pr-ElecEng,0,0,0,0,0,0,0,0,0,1,0,1,0,0,0,0,0,0,1,0,1
fa07,73,REVELLE,ECE,Pr-EngPhys,2,0,2,0,0,0,0,0,0,1,0,1,0,0,0,0,0,0,3,0,3
fa07,73,REVELLE,ECON,Ec-Mth&Ecn,3,1,4,0,0,0,1,2,3,1,2,3,1,1,2,0,0,0,6,6,12
fa07,73,REVELLE,ECON,Econ-MgtSc,1,0,1,1,4,5,2,4,6,20,21,41,27,19,46,0,0,0,51,48,99
fa07,73,REVELLE,ECON,Economics,4,4,8,4,0,4,8,6,14,28,19,47,42,20,62,0,0,0,86,49,135
fa07,73,REVELLE,ERTH,ErSc-Geol,0,0,0,0,0,0,0,0,0,0,0,0,0,1,1,0,0,0,0,1,1
fa07,73,REVELLE,ERTH,ErSc-GeoPh,0,0,0,0,0,0,0,0,0,0,0,0,1,0,1,0,0,0,1,0,1
fa07,73,REVELLE,ERTH,ErthSc-Chm,0,0,0,0,0,0,0,0,0,0,0,0,0,1,1,0,0,0,0,1,1
fa07,73,REVELLE,ERTH,ErthSc-Phy,0,0,0,0,0,0,0,0,0,1,0,1,0,0,0,0,0,0,1,0,1
fa07,73,REVELLE,ESYS,EnvSys(EB),1,1,2,0,0,0,0,2,2,2,4,6,3,2,5,0,0,0,6,9,15
fa07,73,REVELLE,ESYS,EnvSys(EC),0,0,0,0,0,0,0,1,1,0,0,0,0,1,1,0,0,0,0,2,2
fa07,73,REVELLE,ESYS,EnvSys(EP),0,0,0,0,0,0,1,0,1,0,1,1,1,1,2,0,0,0,2,2,4
fa07,73,REVELLE,ESYS,EnvSys(ES),0,0,0,0,0,0,0,0,0,3,1,4,1,0,1,0,0,0,4,1,5
fa07,73,REVELLE,ETHN,Ethnic St,0,0,0,0,0,0,0,1,1,0,1,1,0,1,1,0,0,0,0,3,3
fa07,73,REVELLE,HDP,Human Dev,0,0,0,0,0,0,0,0,0,0,3,3,1,14,15,0,0,0,1,17,18
fa07,73,REVELLE,HDP,Pr-HumnDev,1,3,4,0,0,0,0,5,5,0,9,9,0,2,2,0,0,0,1,19,20
fa07,73,REVELLE,HIST,History,3,2,5,1,0,1,2,3,5,8,6,14,8,2,10,0,0,0,22,13,35
fa07,73,REVELLE,INTL,IntSt-Anth,0,0,0,0,0,0,0,0,0,1,1,2,0,2,2,0,0,0,1,3,4
fa07,73,REVELLE,INTL,IntSt-Econ,0,2,2,0,0,0,1,3,4,1,4,5,7,6,13,0,0,0,9,15,24
fa07,73,REVELLE,INTL,IntSt-Hist,0,0,0,0,0,0,0,1,1,0,1,1,0,2,2,0,0,0,0,4,4
fa07,73,REVELLE,INTL,IntSt-Ling,0,1,1,0,0,0,0,0,0,0,3,3,0,1,1,0,0,0,0,5,5
fa07,73,REVELLE,INTL,IntSt-Lit,0,0,0,0,0,0,0,0,0,0,3,3,0,0,0,0,0,0,0,3,3
fa07,73,REVELLE,INTL,IntSt-PolS,0,2,2,0,0,0,1,4,5,1,3,4,2,8,10,0,0,0,4,17,21
fa07,73,REVELLE,INTL,IntSt-Soc,0,3,3,0,0,0,1,1,2,0,1,1,0,1,1,0,0,0,1,6,7
fa07,73,REVELLE,ITAL,Italian St,0,0,0,0,0,0,0,0,0,0,0,0,0,1,1,0,0,0,0,1,1
fa07,73,REVELLE,JAPN,JapaneseSt,0,1,1,0,0,0,0,0,0,1,0,1,0,0,0,0,0,0,1,1,2
fa07,73,REVELLE,LING,Lang Stu,0,0,0,0,0,0,0,0,0,0,0,0,0,1,1,0,0,0,0,1,1
fa07,73,REVELLE,LING,Ling-CogLn,0,0,0,0,0,0,1,1,2,0,0,0,0,0,0,0,0,0,1,1,2
fa07,73,REVELLE,LING,Linguistcs,0,0,0,0,0,0,0,0,0,0,0,0,2,1,3,0,0,0,2,1,3
fa07,73,REVELLE,LIT,Ital Lit,0,0,0,0,0,0,0,0,0,0,1,1,0,0,0,0,0,0,0,1,1
fa07,73,REVELLE,LIT,Lit/Compos,1,1,2,0,0,0,0,0,0,1,0,1,0,0,0,0,0,0,2,1,3
fa07,73,REVELLE,LIT,Lit/Engl,2,1,3,0,0,0,0,6,6,0,4,4,3,6,9,0,0,0,5,17,22
fa07,73,REVELLE,LIT,Lit/World,0,0,0,0,0,0,0,1,1,0,0,0,0,3,3,0,0,0,0,4,4
fa07,73,REVELLE,LIT,Lit/Writng,0,0,0,0,0,0,0,0,0,1,2,3,6,4,10,0,0,0,7,6,13
fa07,73,REVELLE,LIT,Pre-Lit/Wr,2,2,4,2,0,2,2,3,5,2,3,5,2,1,3,0,0,0,10,9,19
fa07,73,REVELLE,LIT,Spanish Lt,0,1,1,0,0,0,0,1,1,0,0,0,0,1,1,0,0,0,0,3,3
fa07,73,REVELLE,MAE,Aerosp Eng,8,1,9,1,0,1,9,3,12,10,3,13,24,6,30,0,0,0,52,13,65
fa07,73,REVELLE,MAE,Engin Sci,1,0,1,0,0,0,0,0,0,1,0,1,0,0,0,0,0,0,2,0,2
fa07,73,REVELLE,MAE,Envir Eng,0,1,1,0,0,0,0,0,0,0,1,1,1,1,2,0,0,0,1,3,4
fa07,73,REVELLE,MAE,Mech Engin,10,3,13,1,0,1,13,1,14,18,5,23,42,8,50,0,0,0,84,17,101
fa07,73,REVELLE,MATH,Appld Math,1,1,2,0,0,0,2,0,2,2,1,3,1,1,2,0,0,0,6,3,9
fa07,73,REVELLE,MATH,Math/SecEd,0,1,1,0,0,0,0,2,2,0,2,2,1,2,3,0,0,0,1,7,8
fa07,73,REVELLE,MATH,Mathematcs,8,7,15,1,0,1,5,7,12,5,5,10,10,2,12,0,0,0,29,21,50
fa07,73,REVELLE,MATH,Mth-CompSc,0,0,0,0,0,0,0,0,0,1,0,1,5,1,6,0,0,0,6,1,7
fa07,73,REVELLE,MATH,Mth-Mth&Ec,2,1,3,0,0,0,1,2,3,2,0,2,2,3,5,0,0,0,7,6,13
fa07,73,REVELLE,MATH,Mth-SciCom,0,0,0,0,0,0,0,0,0,1,0,1,0,0,0,0,0,0,1,0,1
fa07,73,REVELLE,MATH,Mth/ApldSc,1,1,2,0,0,0,0,1,1,0,1,1,0,1,1,0,0,0,1,4,5
fa07,73,REVELLE,MATH,Pr-Math CS,0,0,0,0,0,0,0,0,0,1,0,1,0,0,0,0,0,0,1,0,1
fa07,73,REVELLE,MUS,Mu-CompArt,0,0,0,0,0,0,1,0,1,3,1,4,2,0,2,0,0,0,6,1,7
fa07,73,REVELLE,MUS,Music,0,0,0,0,0,0,1,1,2,1,2,3,3,2,5,0,0,0,5,5,10
fa07,73,REVELLE,PHIL,Philosophy,1,1,2,0,0,0,1,2,3,3,1,4,1,4,5,0,0,0,6,8,14
fa07,73,REVELLE,PHYS,Biophysics,0,2,2,0,0,0,1,1,2,0,2,2,1,0,1,0,0,0,2,5,7
fa07,73,REVELLE,PHYS,Gen Physcs,0,0,0,0,0,0,0,0,0,1,0,1,0,0,0,0,0,0,1,0,1
fa07,73,REVELLE,PHYS,Phy/ErthSc,0,1,1,0,0,0,0,0,0,0,0,0,0,0,0,0,0,0,0,1,1
fa07,73,REVELLE,PHYS,Phys/Astro,2,1,3,0,0,0,0,0,0,3,0,3,2,3,5,0,0,0,7,4,11
fa07,73,REVELLE,PHYS,Phys/Comp,0,0,0,0,0,0,0,0,0,1,0,1,0,0,0,0,0,0,1,0,1
fa07,73,REVELLE,PHYS,Phys/Mtrls,0,0,0,0,0,0,0,0,0,1,0,1,2,0,2,0,0,0,3,0,3
fa07,73,REVELLE,PHYS,Physics,3,2,5,0,0,0,1,0,1,4,1,5,11,2,13,0,0,0,19,5,24
fa07,73,REVELLE,POLI,Polit Sci,4,3,7,1,1,2,3,4,7,6,6,12,7,14,21,0,0,0,21,28,49
fa07,73,REVELLE,POLI,PolSc-Amer,0,1,1,0,0,0,0,2,2,1,1,2,1,1,2,0,0,0,2,5,7
fa07,73,REVELLE,POLI,PolSc-Comp,0,0,0,0,0,0,0,0,0,0,0,0,1,0,1,0,0,0,1,0,1
fa07,73,REVELLE,POLI,PolSc-Intl,0,2,2,0,0,0,1,1,2,5,1,6,6,4,10,0,0,0,12,8,20
fa07,73,REVELLE,POLI,PolSc-PLaw,2,0,2,0,1,1,0,1,1,3,3,6,1,0,1,0,0,0,6,5,11
fa07,73,REVELLE,POLI,PolSc-PPol,0,1,1,0,0,0,0,0,0,1,0,1,0,0,0,0,0,0,1,1,2
fa07,73,REVELLE,PSYC,Psychology,6,14,20,2,2,4,4,27,31,16,45,61,27,83,110,0,0,0,55,171,226
fa07,73,REVELLE,SE,Struct Eng,6,3,9,1,1,2,11,4,15,9,3,12,18,5,23,0,0,0,45,16,61
fa07,73,REVELLE,SIO,ErSc-Geol,0,0,0,0,0,0,0,0,0,0,1,1,0,0,0,0,0,0,0,1,1
fa07,73,REVELLE,SIO,ErSc-Geoph,0,0,0,0,0,0,0,0,0,1,0,1,0,0,0,0,0,0,1,0,1
fa07,73,REVELLE,SOC,Sociology,0,0,0,0,0,0,1,2,3,0,8,8,0,7,7,0,0,0,1,17,18
fa07,73,REVELLE,THEA,Dance,0,0,0,0,0,0,1,0,1,0,0,0,0,0,0,0,0,0,1,0,1
fa07,73,REVELLE,THEA,Theatre,1,0,1,0,0,0,2,4,6,1,1,2,0,3,3,0,0,0,4,8,12
fa07,73,REVELLE,UNAF,Limited St,0,0,0,0,0,0,0,0,0,0,0,0,0,0,0,5,12,17,5,12,17
fa07,73,REVELLE,UNAF,Spec-Emply,0,0,0,0,0,0,0,0,0,0,0,0,0,0,0,2,4,6,2,4,6
fa07,73,REVELLE,UNAF,UndecBiolS,27,32,59,1,2,3,12,17,29,3,1,4,0,0,0,0,0,0,43,52,95
fa07,73,REVELLE,UNAF,UndecHumAr,1,12,13,0,1,1,2,4,6,2,0,2,0,0,0,0,0,0,5,17,22
fa07,73,REVELLE,UNAF,Undeclared,26,53,79,4,6,10,32,29,61,8,9,17,0,0,0,0,0,0,70,97,167
fa07,73,REVELLE,UNAF,UndecPhysS,12,6,18,0,0,0,1,3,4,0,0,0,0,0,0,0,0,0,13,9,22
fa07,73,REVELLE,UNAF,UndecSocSc,6,9,15,0,0,0,4,5,9,0,1,1,0,0,0,0,0,0,10,15,25
fa07,73,REVELLE,USP,Urb Stu&Pl,0,1,1,0,0,0,0,1,1,3,2,5,2,3,5,0,0,0,5,7,12
fa07,73,REVELLE,VIS,Art Hst/Cr,0,0,0,0,0,0,0,1,1,0,0,0,0,8,8,0,0,0,0,9,9
fa07,73,REVELLE,VIS,Media,1,0,1,1,0,1,0,1,1,3,1,4,4,2,6,0,0,0,9,4,13
fa07,73,REVELLE,VIS,Studio VA,0,0,0,0,0,0,0,1,1,2,1,3,1,4,5,0,0,0,3,6,9
fa07,73,REVELLE,VIS,VA-CompArt,0,0,0,0,0,0,0,1,1,1,0,1,0,3,3,0,0,0,1,4,5
fa07,73,ROOSEVELT,ANTH,Anth-Arch,1,0,1,0,1,1,3,2,5,0,5,5,0,2,2,0,0,0,4,10,14
fa07,73,ROOSEVELT,ANTH,Anth-Biol,0,0,0,0,0,0,0,4,4,0,7,7,2,2,4,0,0,0,2,13,15
fa07,73,ROOSEVELT,ANTH,Anth-Soci,1,1,2,0,0,0,0,0,0,0,2,2,0,0,0,0,0,0,1,3,4
fa07,73,ROOSEVELT,ANTH,Anthropol,0,0,0,0,0,0,0,4,4,0,3,3,2,3,5,0,0,0,2,10,12
fa07,73,ROOSEVELT,BENG,Bioen:Binf,0,0,0,0,0,0,0,0,0,0,0,0,1,0,1,0,0,0,1,0,1
fa07,73,ROOSEVELT,BENG,Bioeng:PM,0,0,0,0,0,0,0,0,0,1,3,4,6,3,9,0,0,0,7,6,13
fa07,73,ROOSEVELT,BENG,BioengBiot,2,0,2,0,0,0,0,0,0,3,1,4,2,4,6,0,0,0,7,5,12
fa07,73,ROOSEVELT,BENG,Bioengin,2,1,3,0,0,0,0,0,0,4,1,5,4,1,5,0,0,0,10,3,13
fa07,73,ROOSEVELT,BENG,Pr-BioenPM,9,6,15,0,1,1,5,4,9,5,3,8,1,1,2,0,0,0,20,15,35
fa07,73,ROOSEVELT,BIOL,Anml Physl,0,0,0,0,0,0,0,0,0,0,0,0,5,7,12,0,0,0,5,7,12
fa07,73,ROOSEVELT,BIOL,Bioc/CellB,4,12,16,1,0,1,4,11,15,9,19,28,25,31,56,0,0,0,43,73,116
fa07,73,ROOSEVELT,BIOL,BiolBioinf,0,0,0,0,0,0,0,0,0,0,0,0,1,0,1,0,0,0,1,0,1
fa07,73,ROOSEVELT,BIOL,Ec/Beh/Evo,1,2,3,0,0,0,0,0,0,1,2,3,5,3,8,0,0,0,7,7,14
fa07,73,ROOSEVELT,BIOL,Genl Biol,6,14,20,0,0,0,5,6,11,11,26,37,25,31,56,0,0,0,47,77,124
fa07,73,ROOSEVELT,BIOL,Human Bio,8,31,39,1,1,2,8,31,39,14,40,54,21,38,59,0,0,0,52,141,193
fa07,73,ROOSEVELT,BIOL,Microbiol,2,0,2,0,0,0,1,0,1,1,6,7,2,3,5,0,0,0,6,9,15
fa07,73,ROOSEVELT,BIOL,Molec Biol,2,2,4,0,0,0,1,5,6,4,2,6,5,7,12,0,0,0,12,16,28
fa07,73,ROOSEVELT,BIOL,PhyslNeuro,1,5,6,0,0,0,1,8,9,6,5,11,6,7,13,0,0,0,14,25,39
fa07,73,ROOSEVELT,CENG,Chem Engin,1,1,2,0,0,0,2,2,4,1,5,6,2,3,5,0,0,0,6,11,17
fa07,73,ROOSEVELT,CGS,CritGendSt,0,0,0,0,0,0,0,0,0,0,2,2,0,2,2,0,0,0,0,4,4
fa07,73,ROOSEVELT,CHEM,Bioch/Chem,3,14,17,0,1,1,2,6,8,6,7,13,6,5,11,0,0,0,17,33,50
fa07,73,ROOSEVELT,CHEM,Chem Phys,0,0,0,0,0,0,0,0,0,0,0,0,1,0,1,0,0,0,1,0,1
fa07,73,ROOSEVELT,CHEM,Chemistry,3,2,5,0,1,1,2,0,2,1,5,6,3,1,4,0,0,0,9,9,18
fa07,73,ROOSEVELT,CHEM,Chm/ErthSc,0,0,0,0,1,1,0,0,0,0,0,0,0,0,0,0,0,0,0,1,1
fa07,73,ROOSEVELT,CHEM,Envir Chem,0,0,0,0,0,0,0,0,0,0,0,0,1,0,1,0,0,0,1,0,1
fa07,73,ROOSEVELT,CHEM,MolecSynth,0,0,0,0,0,0,0,0,0,1,0,1,0,0,0,0,0,0,1,0,1
fa07,73,ROOSEVELT,CHEM,Pharm Chem,1,4,5,0,0,0,1,4,5,12,1,13,9,8,17,0,0,0,23,17,40
fa07,73,ROOSEVELT,CHIN,Chinese St,0,0,0,1,0,1,1,1,2,0,1,1,2,0,2,0,0,0,4,2,6
fa07,73,ROOSEVELT,CLAS,Classic St,1,1,2,0,0,0,0,0,0,0,0,0,0,0,0,0,0,0,1,1,2
fa07,73,ROOSEVELT,COGS,Cog Sci,1,4,5,0,1,1,0,0,0,4,6,10,3,7,10,0,0,0,8,18,26
fa07,73,ROOSEVELT,COGS,CogSc/ClAs,0,0,0,0,0,0,0,0,0,0,1,1,1,0,1,0,0,0,1,1,2
fa07,73,ROOSEVELT,COGS,CogSc/Comp,0,0,0,0,0,0,0,0,0,0,0,0,1,0,1,0,0,0,1,0,1
fa07,73,ROOSEVELT,COGS,CogSc/HCI,0,0,0,0,0,0,0,1,1,0,0,0,2,1,3,0,0,0,2,2,4
fa07,73,ROOSEVELT,COGS,CogSc/HCog,0,0,0,0,0,0,0,0,0,0,1,1,1,1,2,0,0,0,1,2,3
fa07,73,ROOSEVELT,COGS,CogSc/Neur,0,0,0,0,0,0,0,1,1,2,4,6,4,4,8,0,0,0,6,9,15
fa07,73,ROOSEVELT,COMM,Communic,4,18,22,1,3,4,2,20,22,13,45,58,11,36,47,0,0,0,31,122,153
fa07,73,ROOSEVELT,CSE,Comp Sci,5,0,5,0,0,0,2,1,3,6,1,7,25,3,28,0,0,0,38,5,43
fa07,73,ROOSEVELT,CSE,CompEngCSE,3,0,3,0,0,0,3,0,3,1,2,3,7,0,7,0,0,0,14,2,16
fa07,73,ROOSEVELT,ECE,CompEngECE,1,0,1,0,0,0,0,0,0,0,0,0,2,1,3,0,0,0,3,1,4
fa07,73,ROOSEVELT,ECE,Electr Eng,4,2,6,0,0,0,4,1,5,15,1,16,18,6,24,0,0,0,41,10,51
fa07,73,ROOSEVELT,ECON,Ec-Mth&Ecn,2,2,4,0,0,0,1,0,1,2,2,4,5,2,7,0,0,0,10,6,16
fa07,73,ROOSEVELT,ECON,Econ-MgtSc,6,7,13,1,0,1,11,8,19,25,21,46,30,27,57,0,0,0,73,63,136
fa07,73,ROOSEVELT,ECON,Economics,8,14,22,2,2,4,18,12,30,61,31,92,41,34,75,0,0,0,130,93,223
fa07,73,ROOSEVELT,ERTH,Earth Scis,0,0,0,0,0,0,0,0,0,0,0,0,1,0,1,0,0,0,1,0,1
fa07,73,ROOSEVELT,ERTH,ErSc-Geol,0,0,0,0,0,0,0,1,1,0,0,0,1,0,1,0,0,0,1,1,2
fa07,73,ROOSEVELT,ERTH,ErthSc-Phy,0,0,0,0,0,0,0,1,1,0,0,0,0,0,0,0,0,0,0,1,1
fa07,73,ROOSEVELT,ESYS,EnvSys(EB),1,0,1,0,0,0,0,1,1,2,2,4,2,10,12,0,0,0,5,13,18
fa07,73,ROOSEVELT,ESYS,EnvSys(EC),0,0,0,0,0,0,0,1,1,2,2,4,0,0,0,0,0,0,2,3,5
fa07,73,ROOSEVELT,ESYS,EnvSys(EP),0,0,0,0,0,0,0,1,1,0,0,0,1,2,3,0,0,0,1,3,4
fa07,73,ROOSEVELT,ESYS,EnvSys(ES),0,0,0,0,0,0,0,2,2,1,0,1,1,0,1,0,0,0,2,2,4
fa07,73,ROOSEVELT,ETHN,Ethnic St,0,0,0,0,2,2,1,1,2,0,6,6,4,5,9,0,0,0,5,14,19
fa07,73,ROOSEVELT,GMST,German Stu,0,1,1,0,0,0,0,0,0,0,0,0,1,0,1,0,0,0,1,1,2
fa07,73,ROOSEVELT,HDP,Human Dev,0,0,0,0,0,0,0,0,0,0,4,4,1,17,18,0,0,0,1,21,22
fa07,73,ROOSEVELT,HDP,Pr-HumnDev,0,1,1,0,1,1,1,10,11,0,4,4,0,4,4,0,0,0,1,20,21
fa07,73,ROOSEVELT,HIST,History,4,5,9,0,0,0,5,7,12,13,16,29,17,28,45,0,0,0,39,56,95
fa07,73,ROOSEVELT,INTL,IntSt-Anth,0,0,0,0,0,0,0,2,2,1,4,5,0,5,5,0,0,0,1,11,12
fa07,73,ROOSEVELT,INTL,IntSt-Econ,6,21,27,1,1,2,8,15,23,11,21,32,5,17,22,0,0,0,31,75,106
fa07,73,ROOSEVELT,INTL,IntSt-Hist,2,2,4,0,0,0,0,2,2,1,3,4,2,11,13,0,0,0,5,18,23
fa07,73,ROOSEVELT,INTL,IntSt-Ling,1,2,3,0,0,0,0,9,9,1,4,5,1,2,3,0,0,0,3,17,20
fa07,73,ROOSEVELT,INTL,IntSt-Lit,0,2,2,0,0,0,0,2,2,0,3,3,0,2,2,0,0,0,0,9,9
fa07,73,ROOSEVELT,INTL,IntSt-PolS,4,18,22,1,0,1,5,18,23,11,20,31,12,17,29,0,0,0,33,73,106
fa07,73,ROOSEVELT,INTL,IntSt-Soc,1,6,7,0,1,1,1,14,15,2,10,12,1,19,20,0,0,0,5,50,55
fa07,73,ROOSEVELT,ITAL,Italian St,0,0,0,0,0,0,0,0,0,0,0,0,0,1,1,0,0,0,0,1,1
fa07,73,ROOSEVELT,JAPN,JapaneseSt,0,1,1,0,0,0,1,1,2,0,1,1,1,4,5,0,0,0,2,7,9
fa07,73,ROOSEVELT,JUDA,Judaic Stu,0,0,0,0,0,0,0,1,1,0,0,0,0,1,1,0,0,0,0,2,2
fa07,73,ROOSEVELT,LATI,LatinAm St,1,1,2,0,0,0,1,1,2,0,0,0,0,2,2,0,0,0,2,4,6
fa07,73,ROOSEVELT,LING,Lang Stu,0,3,3,0,0,0,0,0,0,3,0,3,1,0,1,0,0,0,4,3,7
fa07,73,ROOSEVELT,LING,Ling-LSoc,0,1,1,0,0,0,1,1,2,1,1,2,2,1,3,0,0,0,4,4,8
fa07,73,ROOSEVELT,LING,Linguistcs,0,1,1,0,0,0,0,1,1,1,3,4,0,4,4,0,0,0,1,9,10
fa07,73,ROOSEVELT,LIT,French Lit,0,0,0,0,0,0,0,0,0,0,1,1,0,0,0,0,0,0,0,1,1
fa07,73,ROOSEVELT,LIT,Lit/Compos,1,1,2,0,0,0,0,0,0,0,0,0,0,0,0,0,0,0,1,1,2
fa07,73,ROOSEVELT,LIT,Lit/Engl,0,6,6,0,0,0,1,2,3,1,5,6,2,8,10,0,0,0,4,21,25
fa07,73,ROOSEVELT,LIT,Lit/World,0,1,1,0,0,0,0,0,0,0,3,3,1,5,6,0,0,0,1,9,10
fa07,73,ROOSEVELT,LIT,Lit/Writng,0,0,0,0,0,0,0,0,0,1,1,2,5,8,13,0,0,0,6,9,15
fa07,73,ROOSEVELT,LIT,Pre-Lit/Wr,0,5,5,0,1,1,2,4,6,2,4,6,3,3,6,0,0,0,7,17,24
fa07,73,ROOSEVELT,LIT,Spanish Lt,0,1,1,0,1,1,0,0,0,2,1,3,1,5,6,0,0,0,3,8,11
fa07,73,ROOSEVELT,MAE,Aerosp Eng,6,1,7,2,0,2,2,1,3,2,4,6,14,2,16,0,0,0,26,8,34
fa07,73,ROOSEVELT,MAE,Engin Sci,0,1,1,0,0,0,0,1,1,0,0,0,0,0,0,0,0,0,0,2,2
fa07,73,ROOSEVELT,MAE,Envir Eng,0,1,1,0,0,0,0,0,0,0,1,1,0,0,0,0,0,0,0,2,2
fa07,73,ROOSEVELT,MAE,Mech Engin,4,0,4,0,0,0,5,2,7,10,5,15,26,5,31,0,0,0,45,12,57
fa07,73,ROOSEVELT,MATH,Appld Math,1,2,3,0,0,0,0,0,0,0,0,0,1,2,3,0,0,0,2,4,6
fa07,73,ROOSEVELT,MATH,Math/SecEd,0,2,2,0,0,0,0,2,2,0,2,2,0,0,0,0,0,0,0,6,6
fa07,73,ROOSEVELT,MATH,Mathematcs,4,1,5,0,0,0,2,4,6,6,2,8,4,1,5,0,0,0,16,8,24
fa07,73,ROOSEVELT,MATH,Mth-CompSc,0,0,0,0,0,0,0,0,0,0,1,1,1,0,1,0,0,0,1,1,2
fa07,73,ROOSEVELT,MATH,Mth-Mth&Ec,2,1,3,0,1,1,2,0,2,3,3,6,1,1,2,0,0,0,8,6,14
fa07,73,ROOSEVELT,MATH,Mth-SciCom,0,1,1,0,0,0,0,0,0,0,0,0,0,0,0,0,0,0,0,1,1
fa07,73,ROOSEVELT,MATH,Mth/ApldSc,0,0,0,0,0,0,1,0,1,1,0,1,1,0,1,0,0,0,3,0,3
fa07,73,ROOSEVELT,MATH,Pr-Math CS,0,0,0,0,0,0,0,1,1,0,1,1,0,0,0,0,0,0,0,2,2
fa07,73,ROOSEVELT,MATH,Prob&Stats,0,0,0,0,0,0,0,0,0,0,1,1,0,0,0,0,0,0,0,1,1
fa07,73,ROOSEVELT,MUS,Mu-CompArt,0,0,0,1,0,1,1,0,1,3,0,3,2,0,2,0,0,0,7,0,7
fa07,73,ROOSEVELT,MUS,Music,0,1,1,0,0,0,0,0,0,1,1,2,1,3,4,0,0,0,2,5,7
fa07,73,ROOSEVELT,PHIL,Philosophy,1,2,3,0,0,0,1,3,4,1,3,4,3,1,4,0,0,0,6,9,15
fa07,73,ROOSEVELT,PHYS,Biophysics,0,1,1,0,0,0,1,0,1,0,1,1,1,0,1,0,0,0,2,2,4
fa07,73,ROOSEVELT,PHYS,Phys/Astro,0,0,0,0,0,0,3,1,4,1,0,1,3,0,3,0,0,0,7,1,8
fa07,73,ROOSEVELT,PHYS,Phys/Comp,0,0,0,0,0,0,0,0,0,1,0,1,1,0,1,0,0,0,2,0,2
fa07,73,ROOSEVELT,PHYS,Physics,0,1,1,1,0,1,0,0,0,3,0,3,1,0,1,0,0,0,5,1,6
fa07,73,ROOSEVELT,POLI,Polit Sci,5,10,15,0,2,2,11,8,19,22,19,41,15,19,34,0,0,0,53,58,111
fa07,73,ROOSEVELT,POLI,PolSc-Amer,1,1,2,0,0,0,0,3,3,1,3,4,3,2,5,0,0,0,5,9,14
fa07,73,ROOSEVELT,POLI,PolSc-Comp,0,0,0,0,0,0,0,0,0,2,2,4,1,4,5,0,0,0,3,6,9
fa07,73,ROOSEVELT,POLI,PolSc-Intl,5,20,25,1,3,4,3,14,17,15,20,35,11,22,33,0,0,0,35,79,114
fa07,73,ROOSEVELT,POLI,PolSc-PLaw,4,6,10,0,1,1,4,11,15,5,11,16,3,7,10,0,0,0,16,36,52
fa07,73,ROOSEVELT,POLI,PolSc-PPol,0,0,0,0,0,0,0,2,2,2,0,2,0,0,0,0,0,0,2,2,4
fa07,73,ROOSEVELT,POLI,PolSc-Thry,0,0,0,0,0,0,0,0,0,0,0,0,3,1,4,0,0,0,3,1,4
fa07,73,ROOSEVELT,PSYC,Psychology,9,24,33,0,2,2,8,29,37,11,38,49,19,59,78,0,0,0,47,152,199
fa07,73,ROOSEVELT,RELI,Relig/Stu,0,0,0,0,0,0,0,1,1,1,0,1,0,1,1,0,0,0,1,2,3
fa07,73,ROOSEVELT,RUSS,Russ&SovSt,0,0,0,0,0,0,0,0,0,0,1,1,0,0,0,0,0,0,0,1,1
fa07,73,ROOSEVELT,SE,Struct Eng,8,1,9,2,1,3,2,2,4,10,1,11,15,10,25,0,0,0,37,15,52
fa07,73,ROOSEVELT,SOC,Sociology,0,3,3,0,1,1,1,9,10,4,17,21,6,25,31,0,0,0,11,55,66
fa07,73,ROOSEVELT,THEA,Dance,1,0,1,0,0,0,0,0,0,0,1,1,0,0,0,0,0,0,1,1,2
fa07,73,ROOSEVELT,THEA,Theatre,0,1,1,0,0,0,0,2,2,2,7,9,1,1,2,0,0,0,3,11,14
fa07,73,ROOSEVELT,TWS,ThirdWldSt,1,0,1,0,0,0,0,0,0,0,0,0,1,1,2,0,0,0,2,1,3
fa07,73,ROOSEVELT,UNAF,UndecBiolS,7,21,28,1,3,4,3,7,10,0,2,2,0,0,0,0,0,0,11,33,44
fa07,73,ROOSEVELT,UNAF,UndecHumAr,3,21,24,0,0,0,3,17,20,0,2,2,0,0,0,0,0,0,6,40,46
fa07,73,ROOSEVELT,UNAF,Undeclared,40,67,107,4,8,12,22,30,52,2,5,7,0,0,0,0,0,0,68,110,178
fa07,73,ROOSEVELT,UNAF,UndecPhysS,3,2,5,0,0,0,2,2,4,0,2,2,0,0,0,0,0,0,5,6,11
fa07,73,ROOSEVELT,UNAF,UndecSocSc,11,17,28,1,1,2,6,7,13,3,2,5,0,0,0,0,0,0,21,27,48
fa07,73,ROOSEVELT,USP,Urb Stu&Pl,1,1,2,0,0,0,2,2,4,3,3,6,4,6,10,0,0,0,10,12,22
fa07,73,ROOSEVELT,VIS,Art Hst/Cr,0,3,3,0,0,0,1,3,4,1,5,6,0,2,2,0,0,0,2,13,15
fa07,73,ROOSEVELT,VIS,Media,1,5,6,1,1,2,1,3,4,10,4,14,1,11,12,0,0,0,14,24,38
fa07,73,ROOSEVELT,VIS,Studio VA,0,3,3,1,0,1,0,4,4,0,1,1,2,1,3,0,0,0,3,9,12
fa07,73,ROOSEVELT,VIS,VA-CompArt,0,0,0,0,1,1,1,1,2,0,0,0,1,2,3,0,0,0,2,4,6
fa07,73,SIXTH,ANTH,Anth-Arch,0,1,1,0,0,0,0,0,0,0,0,0,0,1,1,0,0,0,0,2,2
fa07,73,SIXTH,ANTH,Anth-Biol,1,2,3,0,0,0,0,1,1,1,3,4,0,2,2,0,0,0,2,8,10
fa07,73,SIXTH,ANTH,Anth-Soci,0,1,1,0,0,0,0,0,0,1,2,3,1,0,1,0,0,0,2,3,5
fa07,73,SIXTH,ANTH,Anthropol,0,0,0,0,0,0,2,0,2,0,3,3,0,1,1,0,0,0,2,4,6
fa07,73,SIXTH,BENG,Bioen:Binf,0,0,0,0,0,0,0,0,0,0,0,0,3,0,3,0,0,0,3,0,3
fa07,73,SIXTH,BENG,Bioeng:PM,0,0,0,0,0,0,0,0,0,2,2,4,5,4,9,0,0,0,7,6,13
fa07,73,SIXTH,BENG,BioengBiot,2,2,4,0,0,0,1,0,1,4,1,5,8,3,11,0,0,0,15,6,21
fa07,73,SIXTH,BENG,Bioengin,5,1,6,0,0,0,1,1,2,4,1,5,6,4,10,0,0,0,16,7,23
fa07,73,SIXTH,BENG,Pr-BioenPM,15,5,20,0,0,0,3,4,7,5,3,8,0,0,0,0,0,0,23,12,35
fa07,73,SIXTH,BIOL,Anml Physl,0,0,0,0,0,0,0,0,0,1,0,1,7,2,9,0,0,0,8,2,10
fa07,73,SIXTH,BIOL,Bioc/CellB,10,8,18,0,0,0,5,7,12,10,11,21,14,17,31,0,0,0,39,43,82
fa07,73,SIXTH,BIOL,BiolBioinf,0,0,0,0,0,0,0,0,0,0,0,0,0,1,1,0,0,0,0,1,1
fa07,73,SIXTH,BIOL,Ec/Beh/Evo,1,0,1,0,0,0,0,3,3,1,2,3,2,4,6,0,0,0,4,9,13
fa07,73,SIXTH,BIOL,Genl Biol,10,21,31,3,0,3,8,12,20,11,6,17,9,18,27,0,0,0,41,57,98
fa07,73,SIXTH,BIOL,Human Bio,12,22,34,2,1,3,19,22,41,16,27,43,22,18,40,0,0,0,71,90,161
fa07,73,SIXTH,BIOL,Microbiol,1,4,5,0,0,0,0,1,1,0,1,1,3,1,4,0,0,0,4,7,11
fa07,73,SIXTH,BIOL,Molec Biol,5,2,7,0,0,0,1,1,2,5,0,5,4,3,7,0,0,0,15,6,21
fa07,73,SIXTH,BIOL,PhyslNeuro,6,3,9,0,0,0,7,5,12,6,3,9,2,1,3,0,0,0,21,12,33
fa07,73,SIXTH,BIOL,Pr-BioBinf,0,0,0,0,0,0,0,0,0,0,0,0,1,0,1,0,0,0,1,0,1
fa07,73,SIXTH,CENG,Chem Engin,4,0,4,0,0,0,5,2,7,7,2,9,2,1,3,0,0,0,18,5,23
fa07,73,SIXTH,CGS,CritGendSt,0,0,0,0,0,0,0,0,0,0,1,1,0,1,1,0,0,0,0,2,2
fa07,73,SIXTH,CHEM,Bioch/Chem,4,10,14,0,0,0,5,6,11,3,5,8,6,7,13,0,0,0,18,28,46
fa07,73,SIXTH,CHEM,Chem Educ,1,0,1,0,0,0,0,0,0,0,0,0,1,0,1,0,0,0,2,0,2
fa07,73,SIXTH,CHEM,Chem Phys,0,0,0,0,0,0,0,0,0,1,0,1,1,0,1,0,0,0,2,0,2
fa07,73,SIXTH,CHEM,Chemistry,5,6,11,0,0,0,4,4,8,1,2,3,4,3,7,0,0,0,14,15,29
fa07,73,SIXTH,CHEM,Envir Chem,0,0,0,0,0,0,0,0,0,0,0,0,1,1,2,0,0,0,1,1,2
fa07,73,SIXTH,CHEM,MolecSynth,0,0,0,0,0,0,1,0,1,0,0,0,1,0,1,0,0,0,2,0,2
fa07,73,SIXTH,CHEM,Pharm Chem,4,11,15,1,1,2,2,8,10,4,3,7,5,7,12,0,0,0,16,30,46
fa07,73,SIXTH,CHIN,Chinese St,1,0,1,0,0,0,0,0,0,0,0,0,0,1,1,0,0,0,1,1,2
fa07,73,SIXTH,CLAS,Classic St,1,0,1,0,0,0,0,0,0,0,0,0,0,1,1,0,0,0,1,1,2
fa07,73,SIXTH,COGS,Cog Sci,4,1,5,0,0,0,2,1,3,8,2,10,7,1,8,0,0,0,21,5,26
fa07,73,SIXTH,COGS,CogSc/ClAs,0,0,0,0,0,0,0,0,0,0,0,0,1,2,3,0,0,0,1,2,3
fa07,73,SIXTH,COGS,CogSc/Comp,0,0,0,0,0,0,1,0,1,0,0,0,2,0,2,0,0,0,3,0,3
fa07,73,SIXTH,COGS,CogSc/HCI,0,0,0,1,0,1,2,0,2,0,1,1,4,1,5,0,0,0,7,2,9
fa07,73,SIXTH,COGS,CogSc/HCog,0,0,0,0,0,0,0,0,0,0,0,0,2,1,3,0,0,0,2,1,3
fa07,73,SIXTH,COGS,CogSc/Neur,0,1,1,0,0,0,0,2,2,0,1,1,4,1,5,0,0,0,4,5,9
fa07,73,SIXTH,COMM,Communic,3,14,17,1,3,4,4,23,27,11,21,32,15,25,40,0,0,0,34,86,120
fa07,73,SIXTH,CSE,Comp Sci,15,3,18,2,2,4,12,4,16,15,4,19,25,4,29,0,0,0,69,17,86
fa07,73,SIXTH,CSE,CompEngCSE,15,2,17,2,0,2,8,0,8,6,4,10,16,0,16,0,0,0,47,6,53
fa07,73,SIXTH,CSE,CompScBinf,0,0,0,0,0,0,0,0,0,0,0,0,0,1,1,0,0,0,0,1,1
fa07,73,SIXTH,ECE,CompEngECE,11,0,11,1,0,1,2,0,2,3,1,4,3,0,3,0,0,0,20,1,21
fa07,73,SIXTH,ECE,Electr Eng,16,0,16,2,0,2,8,1,9,19,4,23,20,1,21,0,0,0,65,6,71
fa07,73,SIXTH,ECE,Engin Phys,0,0,0,0,0,0,0,0,0,0,0,0,2,0,2,0,0,0,2,0,2
fa07,73,SIXTH,ECE,Pr-ElecEng,0,0,0,0,0,0,0,0,0,1,0,1,0,0,0,0,0,0,1,0,1
fa07,73,SIXTH,ECE,Pr-EngPhys,0,0,0,0,0,0,1,1,2,2,0,2,1,0,1,0,0,0,4,1,5
fa07,73,SIXTH,ECON,Ec-Mth&Ecn,3,0,3,1,0,1,0,2,2,6,1,7,4,1,5,0,0,0,14,4,18
fa07,73,SIXTH,ECON,Econ-MgtSc,9,4,13,1,0,1,16,7,23,20,8,28,31,19,50,0,0,0,77,38,115
fa07,73,SIXTH,ECON,Economics,17,7,24,3,2,5,21,7,28,47,21,68,24,19,43,0,0,0,112,56,168
fa07,73,SIXTH,ERTH,Earth Scis,0,0,0,0,0,0,0,0,0,0,0,0,1,0,1,0,0,0,1,0,1
fa07,73,SIXTH,ERTH,ErSc-GeoPh,0,0,0,0,1,1,0,0,0,0,0,0,0,0,0,0,0,0,0,1,1
fa07,73,SIXTH,ESYS,EnvSys(EB),1,5,6,0,0,0,1,2,3,2,1,3,0,2,2,0,0,0,4,10,14
fa07,73,SIXTH,ESYS,EnvSys(EC),0,0,0,0,0,0,0,0,0,0,0,0,1,0,1,0,0,0,1,0,1
fa07,73,SIXTH,ESYS,EnvSys(EP),1,1,2,0,0,0,0,2,2,0,0,0,2,1,3,0,0,0,3,4,7
fa07,73,SIXTH,ESYS,EnvSys(ES),1,1,2,0,0,0,0,1,1,0,1,1,1,0,1,0,0,0,2,3,5
fa07,73,SIXTH,ETHN,Ethnic St,1,0,1,0,0,0,1,1,2,1,4,5,1,2,3,0,0,0,4,7,11
fa07,73,SIXTH,GMST,German Stu,0,0,0,0,0,0,0,0,0,0,0,0,0,1,1,0,0,0,0,1,1
fa07,73,SIXTH,HDP,Human Dev,0,0,0,0,0,0,0,0,0,0,2,2,0,5,5,0,0,0,0,7,7
fa07,73,SIXTH,HDP,Pr-HumnDev,0,0,0,0,1,1,2,6,8,0,3,3,0,1,1,0,0,0,2,11,13
fa07,73,SIXTH,HIST,History,2,0,2,0,0,0,2,2,4,4,1,5,9,1,10,0,0,0,17,4,21
fa07,73,SIXTH,INTL,IntSt-Anth,0,1,1,0,0,0,0,0,0,2,0,2,1,2,3,0,0,0,3,3,6
fa07,73,SIXTH,INTL,IntSt-Econ,2,5,7,1,1,2,6,3,9,4,6,10,4,9,13,0,0,0,17,24,41
fa07,73,SIXTH,INTL,IntSt-Hist,0,1,1,0,0,0,0,0,0,0,0,0,1,0,1,0,0,0,1,1,2
fa07,73,SIXTH,INTL,IntSt-Ling,0,0,0,0,0,0,1,0,1,1,2,3,0,1,1,0,0,0,2,3,5
fa07,73,SIXTH,INTL,IntSt-Lit,0,1,1,0,0,0,0,1,1,0,1,1,0,0,0,0,0,0,0,3,3
fa07,73,SIXTH,INTL,IntSt-PolS,1,3,4,0,1,1,4,2,6,2,2,4,2,6,8,0,0,0,9,14,23
fa07,73,SIXTH,INTL,IntSt-Soc,1,2,3,0,1,1,0,0,0,3,1,4,0,4,4,0,0,0,4,8,12
fa07,73,SIXTH,JAPN,JapaneseSt,0,1,1,0,0,0,2,0,2,0,0,0,2,0,2,0,0,0,4,1,5
fa07,73,SIXTH,LING,Lang Stu,0,0,0,0,0,0,0,1,1,0,0,0,0,1,1,0,0,0,0,2,2
fa07,73,SIXTH,LING,Ling-CogLn,0,0,0,0,0,0,0,0,0,0,0,0,0,1,1,0,0,0,0,1,1
fa07,73,SIXTH,LING,Ling-LSoc,0,0,0,0,0,0,0,0,0,1,1,2,0,1,1,0,0,0,1,2,3
fa07,73,SIXTH,LING,Linguistcs,0,1,1,0,0,0,0,0,0,0,1,1,1,3,4,0,0,0,1,5,6
fa07,73,SIXTH,LIT,Lit/Compos,0,0,0,0,0,0,0,0,0,1,0,1,0,0,0,0,0,0,1,0,1
fa07,73,SIXTH,LIT,Lit/Engl,2,3,5,0,0,0,2,0,2,1,1,2,0,3,3,0,0,0,5,7,12
fa07,73,SIXTH,LIT,Lit/World,1,0,1,0,0,0,0,0,0,0,0,0,0,0,0,0,0,0,1,0,1
fa07,73,SIXTH,LIT,Lit/Writng,0,0,0,0,0,0,0,0,0,0,1,1,0,8,8,0,0,0,0,9,9
fa07,73,SIXTH,LIT,Pre-Lit/Wr,0,4,4,0,1,1,2,3,5,3,7,10,0,1,1,0,0,0,5,16,21
fa07,73,SIXTH,LIT,Spanish Lt,0,0,0,0,0,0,0,0,0,1,0,1,0,1,1,0,0,0,1,1,2
fa07,73,SIXTH,MAE,Aerosp Eng,12,1,13,2,0,2,8,2,10,14,1,15,12,3,15,0,0,0,48,7,55
fa07,73,SIXTH,MAE,Engin Sci,0,1,1,0,0,0,0,0,0,0,0,0,0,0,0,0,0,0,0,1,1
fa07,73,SIXTH,MAE,Envir Eng,3,0,3,0,0,0,0,1,1,0,1,1,1,1,2,0,0,0,4,3,7
fa07,73,SIXTH,MAE,Mech Engin,20,4,24,3,0,3,22,5,27,22,2,24,35,3,38,0,0,0,102,14,116
fa07,73,SIXTH,MATH,Appld Math,3,1,4,0,0,0,0,0,0,1,0,1,1,1,2,0,0,0,5,2,7
fa07,73,SIXTH,MATH,Math/SecEd,2,1,3,0,0,0,2,0,2,0,1,1,0,1,1,0,0,0,4,3,7
fa07,73,SIXTH,MATH,Mathematcs,1,9,10,1,0,1,2,1,3,1,2,3,3,2,5,0,0,0,8,14,22
fa07,73,SIXTH,MATH,Mth-CompSc,0,0,0,0,0,0,0,0,0,1,0,1,0,0,0,0,0,0,1,0,1
fa07,73,SIXTH,MATH,Mth-Mth&Ec,2,0,2,0,0,0,2,3,5,0,0,0,1,0,1,0,0,0,5,3,8
fa07,73,SIXTH,MATH,Mth-SciCom,0,0,0,0,0,0,1,0,1,0,0,0,1,0,1,0,0,0,2,0,2
fa07,73,SIXTH,MATH,Mth/ApldSc,1,1,2,0,0,0,0,0,0,0,0,0,1,0,1,0,0,0,2,1,3
fa07,73,SIXTH,MATH,Pr-Math CS,0,0,0,0,0,0,1,0,1,1,0,1,0,0,0,0,0,0,2,0,2
fa07,73,SIXTH,MATH,Prob&Stats,0,0,0,0,0,0,0,0,0,1,0,1,0,0,0,0,0,0,1,0,1
fa07,73,SIXTH,MUS,Mu-CompArt,0,0,0,0,1,1,4,1,5,2,1,3,4,1,5,0,0,0,10,4,14
fa07,73,SIXTH,MUS,Music,1,0,1,1,0,1,0,1,1,2,4,6,3,1,4,0,0,0,7,6,13
fa07,73,SIXTH,PHIL,Philosophy,2,0,2,0,0,0,0,1,1,3,2,5,2,2,4,0,0,0,7,5,12
fa07,73,SIXTH,PHYS,Biophysics,1,1,2,0,0,0,1,1,2,0,0,0,1,1,2,0,0,0,3,3,6
fa07,73,SIXTH,PHYS,Gen Physcs,1,0,1,0,0,0,0,0,0,0,0,0,0,0,0,0,0,0,1,0,1
fa07,73,SIXTH,PHYS,Phy/ErthSc,0,0,0,0,0,0,0,0,0,0,0,0,1,0,1,0,0,0,1,0,1
fa07,73,SIXTH,PHYS,Phys/Astro,4,1,5,0,0,0,1,0,1,0,0,0,3,1,4,0,0,0,8,2,10
fa07,73,SIXTH,PHYS,Phys/Mtrls,1,0,1,0,0,0,0,0,0,2,0,2,0,0,0,0,0,0,3,0,3
fa07,73,SIXTH,PHYS,Physics,5,0,5,0,0,0,3,0,3,4,1,5,7,1,8,0,0,0,19,2,21
fa07,73,SIXTH,POLI,Polit Sci,1,3,4,0,0,0,6,4,10,2,8,10,2,7,9,0,0,0,11,22,33
fa07,73,SIXTH,POLI,PolSc-Amer,1,2,3,0,0,0,1,3,4,2,0,2,0,1,1,0,0,0,4,6,10
fa07,73,SIXTH,POLI,PolSc-Comp,0,0,0,0,0,0,0,0,0,0,0,0,0,1,1,0,0,0,0,1,1
fa07,73,SIXTH,POLI,PolSc-Intl,7,5,12,0,0,0,3,2,5,7,6,13,5,3,8,0,0,0,22,16,38
fa07,73,SIXTH,POLI,PolSc-PLaw,1,2,3,1,0,1,3,5,8,2,3,5,2,0,2,0,0,0,9,10,19
fa07,73,SIXTH,POLI,PolSc-PPol,2,0,2,0,0,0,0,0,0,1,1,2,0,0,0,0,0,0,3,1,4
fa07,73,SIXTH,POLI,PolSc-Thry,0,0,0,0,0,0,1,0,1,0,0,0,0,0,0,0,0,0,1,0,1
fa07,73,SIXTH,PSYC,Psychology,5,16,21,1,3,4,7,20,27,10,25,35,12,21,33,0,0,0,35,85,120
fa07,73,SIXTH,RELI,Relig/Stu,0,0,0,0,0,0,0,0,0,0,0,0,2,0,2,0,0,0,2,0,2
fa07,73,SIXTH,SE,Engin Sci,2,0,2,0,0,0,2,1,3,0,0,0,0,0,0,0,0,0,4,1,5
fa07,73,SIXTH,SE,Struct Eng,5,7,12,2,0,2,11,7,18,10,7,17,18,6,24,0,0,0,46,27,73
fa07,73,SIXTH,SOC,Sociology,1,4,5,0,0,0,2,7,9,4,11,15,1,9,10,0,0,0,8,31,39
fa07,73,SIXTH,THEA,Dance,0,0,0,0,0,0,0,2,2,0,3,3,0,2,2,0,0,0,0,7,7
fa07,73,SIXTH,THEA,Theatre,3,0,3,0,1,1,0,4,4,1,2,3,3,9,12,0,0,0,7,16,23
fa07,73,SIXTH,TWS,ThirdWldSt,0,2,2,0,0,0,0,1,1,0,1,1,0,1,1,0,0,0,0,5,5
fa07,73,SIXTH,UNAF,UndecBiolS,7,18,25,0,1,1,6,7,13,0,3,3,0,0,0,0,0,0,13,29,42
fa07,73,SIXTH,UNAF,UndecHumAr,8,5,13,0,1,1,1,8,9,0,0,0,0,0,0,0,0,0,9,14,23
fa07,73,SIXTH,UNAF,Undeclared,43,47,90,8,5,13,27,26,53,5,4,9,0,0,0,0,0,0,83,82,165
fa07,73,SIXTH,UNAF,UndecPhysS,8,5,13,0,0,0,3,2,5,1,0,1,0,0,0,0,0,0,12,7,19
fa07,73,SIXTH,UNAF,UndecSocSc,2,9,11,0,0,0,6,1,7,0,1,1,0,0,0,0,0,0,8,11,19
fa07,73,SIXTH,USP,Urb Stu&Pl,0,0,0,0,0,0,1,1,2,3,2,5,1,5,6,0,0,0,5,8,13
fa07,73,SIXTH,VIS,Art Hst/Cr,0,2,2,0,0,0,0,2,2,0,3,3,2,6,8,0,0,0,2,13,15
fa07,73,SIXTH,VIS,Media,3,6,9,2,1,3,8,7,15,14,8,22,23,11,34,0,0,0,50,33,83
fa07,73,SIXTH,VIS,Studio VA,2,0,2,0,0,0,0,2,2,2,7,9,4,4,8,0,0,0,8,13,21
fa07,73,SIXTH,VIS,VA-CompArt,3,5,8,0,0,0,3,3,6,3,5,8,8,2,10,0,0,0,17,15,32
fa07,73,WARREN,ANTH,Anth-Arch,1,0,1,0,0,0,0,0,0,0,4,4,3,4,7,0,0,0,4,8,12
fa07,73,WARREN,ANTH,Anth-Biol,0,0,0,0,0,0,1,0,1,0,7,7,1,2,3,0,0,0,2,9,11
fa07,73,WARREN,ANTH,Anth-Soci,0,1,1,0,0,0,0,0,0,0,0,0,0,0,0,0,0,0,0,1,1
fa07,73,WARREN,ANTH,Anthropol,0,0,0,0,0,0,0,0,0,0,5,5,3,2,5,0,0,0,3,7,10
fa07,73,WARREN,BENG,Bioen:Binf,0,0,0,0,0,0,0,0,0,0,0,0,2,1,3,0,0,0,2,1,3
fa07,73,WARREN,BENG,Bioeng:PM,0,0,0,0,0,0,4,2,6,7,2,9,11,9,20,0,0,0,22,13,35
fa07,73,WARREN,BENG,BioengBiot,9,4,13,0,0,0,10,2,12,6,4,10,20,15,35,0,0,0,45,25,70
fa07,73,WARREN,BENG,Bioengin,10,6,16,0,0,0,3,3,6,13,8,21,7,5,12,0,0,0,33,22,55
fa07,73,WARREN,BENG,Pr-BioenPM,20,13,33,1,1,2,13,6,19,10,8,18,5,0,5,0,0,0,49,28,77
fa07,73,WARREN,BIOL,Anml Physl,0,0,0,0,0,0,0,0,0,1,1,2,5,9,14,0,0,0,6,10,16
fa07,73,WARREN,BIOL,Bioc/CellB,9,15,24,0,3,3,11,10,21,23,23,46,41,61,102,0,0,0,84,112,196
fa07,73,WARREN,BIOL,Ec/Beh/Evo,0,3,3,0,0,0,0,1,1,1,3,4,1,5,6,0,0,0,2,12,14
fa07,73,WARREN,BIOL,Genl Biol,8,12,20,0,1,1,8,8,16,27,33,60,36,56,92,0,0,0,79,110,189
fa07,73,WARREN,BIOL,Human Bio,17,40,57,3,3,6,21,29,50,30,58,88,61,64,125,0,0,0,132,194,326
fa07,73,WARREN,BIOL,Microbiol,2,3,5,0,0,0,1,2,3,2,3,5,5,6,11,0,0,0,10,14,24
fa07,73,WARREN,BIOL,Molec Biol,4,6,10,0,0,0,3,4,7,6,5,11,5,11,16,0,0,0,18,26,44
fa07,73,WARREN,BIOL,PhyslNeuro,0,11,11,1,0,1,7,4,11,6,13,19,10,6,16,0,0,0,24,34,58
fa07,73,WARREN,BIOL,Pr-BiochCB,0,0,0,0,0,0,0,0,0,1,0,1,0,0,0,0,0,0,1,0,1
fa07,73,WARREN,CENG,Chem Engin,7,2,9,0,0,0,7,5,12,6,6,12,12,5,17,0,0,0,32,18,50
fa07,73,WARREN,CGS,CritGendSt,0,0,0,0,0,0,0,1,1,0,0,0,0,0,0,0,0,0,0,1,1
fa07,73,WARREN,CHEM,Bioch/Chem,12,8,20,1,1,2,6,5,11,11,21,32,22,21,43,0,0,0,52,56,108
fa07,73,WARREN,CHEM,Chem Educ,0,0,0,0,0,0,0,0,0,1,0,1,0,1,1,0,0,0,1,1,2
fa07,73,WARREN,CHEM,Chem Phys,1,0,1,0,0,0,0,0,0,0,0,0,0,1,1,0,0,0,1,1,2
fa07,73,WARREN,CHEM,Chemistry,4,5,9,0,0,0,3,1,4,5,4,9,7,4,11,0,0,0,19,14,33
fa07,73,WARREN,CHEM,Envir Chem,0,0,0,0,0,0,0,0,0,1,0,1,2,1,3,0,0,0,3,1,4
fa07,73,WARREN,CHEM,MolecSynth,0,0,0,0,0,0,0,0,0,1,0,1,0,1,1,0,0,0,1,1,2
fa07,73,WARREN,CHEM,Pharm Chem,4,10,14,0,1,1,8,5,13,9,13,22,15,25,40,0,0,0,36,54,90
fa07,73,WARREN,CHIN,Chinese St,0,0,0,0,0,0,0,0,0,0,2,2,1,4,5,0,0,0,1,6,7
fa07,73,WARREN,COGS,Cog Sci,1,4,5,0,0,0,2,4,6,3,4,7,2,1,3,0,0,0,8,13,21
fa07,73,WARREN,COGS,CogSc/ClAs,0,0,0,0,0,0,0,1,1,0,0,0,0,0,0,0,0,0,0,1,1
fa07,73,WARREN,COGS,CogSc/HCI,0,0,0,0,0,0,0,1,1,0,0,0,5,1,6,0,0,0,5,2,7
fa07,73,WARREN,COGS,CogSc/HCog,0,0,0,0,0,0,0,0,0,0,0,0,1,3,4,0,0,0,1,3,4
fa07,73,WARREN,COGS,CogSc/Neur,0,0,0,0,0,0,0,0,0,0,1,1,4,5,9,0,0,0,4,6,10
fa07,73,WARREN,COMM,Communic,1,6,7,2,4,6,6,14,20,15,32,47,12,31,43,0,0,0,36,87,123
fa07,73,WARREN,CSE,Comp Sci,13,2,15,3,0,3,20,6,26,21,2,23,41,8,49,0,0,0,98,18,116
fa07,73,WARREN,CSE,CompEngCSE,9,4,13,3,0,3,8,2,10,8,1,9,11,3,14,0,0,0,39,10,49
fa07,73,WARREN,CSE,CompScBinf,0,0,0,0,0,0,0,0,0,0,0,0,4,0,4,0,0,0,4,0,4
fa07,73,WARREN,ECE,CompEngECE,7,0,7,0,0,0,2,0,2,5,0,5,8,2,10,0,0,0,22,2,24
fa07,73,WARREN,ECE,Electr Eng,12,1,13,1,1,2,18,1,19,23,3,26,71,8,79,0,0,0,125,14,139
fa07,73,WARREN,ECE,Engin Phys,0,0,0,0,0,0,0,0,0,0,0,0,2,1,3,0,0,0,2,1,3
fa07,73,WARREN,ECE,Pr-CmEnECE,0,0,0,0,0,0,0,0,0,1,0,1,0,0,0,0,0,0,1,0,1
fa07,73,WARREN,ECE,Pr-ElecEng,0,0,0,0,0,0,0,0,0,2,0,2,0,0,0,0,0,0,2,0,2
fa07,73,WARREN,ECE,Pr-EngPhys,2,0,2,0,0,0,1,0,1,3,1,4,0,0,0,0,0,0,6,1,7
fa07,73,WARREN,ECON,Ec-Mth&Ecn,4,0,4,0,0,0,1,3,4,1,2,3,4,1,5,0,0,0,10,6,16
fa07,73,WARREN,ECON,Econ-MgtSc,4,0,4,0,2,2,15,12,27,26,20,46,33,29,62,0,0,0,78,63,141
fa07,73,WARREN,ECON,Economics,14,12,26,1,0,1,27,9,36,59,35,94,62,22,84,0,0,0,163,78,241
fa07,73,WARREN,ERTH,ErthSc-Phy,0,0,0,0,0,0,0,0,0,0,0,0,1,0,1,0,0,0,1,0,1
fa07,73,WARREN,ESYS,EnvSys(EB),0,0,0,0,0,0,0,1,1,1,1,2,0,3,3,0,0,0,1,5,6
fa07,73,WARREN,ESYS,EnvSys(EC),0,0,0,0,0,0,0,1,1,0,0,0,0,2,2,0,0,0,0,3,3
fa07,73,WARREN,ESYS,EnvSys(EP),0,0,0,0,0,0,0,1,1,0,0,0,0,1,1,0,0,0,0,2,2
fa07,73,WARREN,ESYS,EnvSys(ES),0,2,2,0,0,0,0,0,0,0,0,0,1,4,5,0,0,0,1,6,7
fa07,73,WARREN,ETHN,Ethnic St,0,1,1,0,0,0,0,0,0,0,1,1,2,2,4,0,0,0,2,4,6
fa07,73,WARREN,HDP,Human Dev,0,0,0,0,0,0,0,1,1,0,2,2,1,12,13,0,0,0,1,15,16
fa07,73,WARREN,HDP,Pr-HumnDev,0,0,0,0,1,1,1,7,8,2,10,12,1,4,5,0,0,0,4,22,26
fa07,73,WARREN,HIST,History,6,6,12,1,0,1,3,2,5,8,7,15,19,17,36,0,0,0,37,32,69
fa07,73,WARREN,INTD,Wa Ind St,0,0,0,0,0,0,0,0,0,0,0,0,1,3,4,0,0,0,1,3,4
fa07,73,WARREN,INTL,IntSt-Anth,0,1,1,0,0,0,0,1,1,1,0,1,0,0,0,0,0,0,1,2,3
fa07,73,WARREN,INTL,IntSt-Econ,2,3,5,0,2,2,1,4,5,6,10,16,4,5,9,0,0,0,13,24,37
fa07,73,WARREN,INTL,IntSt-Hist,0,2,2,0,0,0,1,0,1,1,1,2,2,4,6,0,0,0,4,7,11
fa07,73,WARREN,INTL,IntSt-Ling,0,0,0,0,0,0,0,0,0,2,1,3,0,1,1,0,0,0,2,2,4
fa07,73,WARREN,INTL,IntSt-PolS,1,2,3,0,2,2,0,2,2,2,8,10,4,4,8,0,0,0,7,18,25
fa07,73,WARREN,INTL,IntSt-Soc,0,0,0,0,0,0,1,2,3,2,3,5,0,1,1,0,0,0,3,6,9
fa07,73,WARREN,ITAL,Italian St,0,0,0,0,0,0,0,0,0,1,0,1,0,1,1,0,0,0,1,1,2
fa07,73,WARREN,JAPN,JapaneseSt,0,0,0,0,0,0,0,0,0,1,1,2,1,1,2,0,0,0,2,2,4
fa07,73,WARREN,LING,Lang Stu,0,0,0,0,1,1,0,0,0,0,1,1,0,1,1,0,0,0,0,3,3
fa07,73,WARREN,LING,Ling-CogLn,0,1,1,0,0,0,0,0,0,0,0,0,1,0,1,0,0,0,1,1,2
fa07,73,WARREN,LING,Ling-LSoc,0,0,0,0,0,0,0,0,0,0,1,1,0,0,0,0,0,0,0,1,1
fa07,73,WARREN,LING,Linguistcs,0,0,0,0,0,0,0,0,0,1,2,3,1,0,1,0,0,0,2,2,4
fa07,73,WARREN,LIT,Lit/Engl,0,4,4,0,0,0,1,1,2,2,2,4,0,5,5,0,0,0,3,12,15
fa07,73,WARREN,LIT,Lit/World,0,0,0,0,0,0,0,1,1,0,2,2,2,3,5,0,0,0,2,6,8
fa07,73,WARREN,LIT,Lit/Writng,0,0,0,0,0,0,0,0,0,0,0,0,3,5,8,0,0,0,3,5,8
fa07,73,WARREN,LIT,Pre-Lit/Wr,2,4,6,0,0,0,1,0,1,0,3,3,0,1,1,0,0,0,3,8,11
fa07,73,WARREN,LIT,Spanish Lt,0,0,0,0,0,0,0,0,0,1,1,2,1,3,4,0,0,0,2,4,6
fa07,73,WARREN,MAE,Aerosp Eng,13,3,16,0,0,0,11,2,13,20,1,21,41,5,46,0,0,0,85,11,96
fa07,73,WARREN,MAE,Engin Sci,0,1,1,0,0,0,0,0,0,1,0,1,2,0,2,0,0,0,3,1,4
fa07,73,WARREN,MAE,Envir Eng,0,0,0,0,0,0,1,1,2,0,2,2,3,0,3,0,0,0,4,3,7
fa07,73,WARREN,MAE,Mech Engin,21,6,27,1,1,2,27,2,29,32,4,36,89,12,101,0,0,0,170,25,195
fa07,73,WARREN,MATH,Appld Math,3,3,6,0,0,0,1,2,3,1,3,4,2,1,3,0,0,0,7,9,16
fa07,73,WARREN,MATH,Math/SecEd,1,0,1,0,0,0,1,1,2,0,4,4,0,0,0,0,0,0,2,5,7
fa07,73,WARREN,MATH,Mathematcs,3,3,6,0,1,1,1,0,1,9,0,9,7,5,12,0,0,0,20,9,29
fa07,73,WARREN,MATH,Mth-CompSc,0,0,0,0,0,0,0,0,0,1,0,1,5,0,5,0,0,0,6,0,6
fa07,73,WARREN,MATH,Mth-Mth&Ec,2,0,2,0,0,0,1,2,3,1,2,3,4,2,6,0,0,0,8,6,14
fa07,73,WARREN,MATH,Mth-SciCom,1,0,1,0,0,0,1,0,1,0,1,1,1,2,3,0,0,0,3,3,6
fa07,73,WARREN,MATH,Mth/ApldSc,0,2,2,0,1,1,0,0,0,0,0,0,2,1,3,0,0,0,2,4,6
fa07,73,WARREN,MATH,Pr-Math CS,0,1,1,0,0,0,2,0,2,1,1,2,0,0,0,0,0,0,3,2,5
fa07,73,WARREN,MATH,Prob&Stats,0,0,0,0,0,0,0,0,0,1,1,2,2,0,2,0,0,0,3,1,4
fa07,73,WARREN,MUS,Mu-CompArt,1,0,1,0,0,0,1,2,3,2,1,3,3,1,4,0,0,0,7,4,11
fa07,73,WARREN,MUS,Music,0,0,0,0,0,0,0,0,0,3,1,4,8,0,8,0,0,0,11,1,12
fa07,73,WARREN,PHIL,Philosophy,1,0,1,1,0,1,2,1,3,3,8,11,7,4,11,0,0,0,14,13,27
fa07,73,WARREN,PHYS,Biophysics,0,0,0,0,0,0,0,1,1,4,0,4,0,0,0,0,0,0,4,1,5
fa07,73,WARREN,PHYS,Gen Physcs,0,0,0,0,0,0,0,0,0,1,0,1,1,0,1,0,0,0,2,0,2
fa07,73,WARREN,PHYS,GenPys/SEd,0,0,0,0,0,0,0,0,0,0,0,0,1,0,1,0,0,0,1,0,1
fa07,73,WARREN,PHYS,Phys/Astro,1,0,1,1,0,1,2,0,2,0,1,1,3,1,4,0,0,0,7,2,9
fa07,73,WARREN,PHYS,Phys/Comp,0,0,0,0,0,0,0,0,0,2,0,2,2,0,2,0,0,0,4,0,4
fa07,73,WARREN,PHYS,Physics,3,0,3,1,0,1,3,2,5,5,0,5,8,4,12,0,0,0,20,6,26
fa07,73,WARREN,POLI,Polit Sci,6,6,12,2,1,3,4,7,11,24,20,44,17,19,36,0,0,0,53,53,106
fa07,73,WARREN,POLI,PolSc-Amer,1,1,2,0,0,0,5,1,6,1,3,4,0,3,3,0,0,0,7,8,15
fa07,73,WARREN,POLI,PolSc-Comp,1,0,1,0,0,0,0,0,0,0,0,0,0,0,0,0,0,0,1,0,1
fa07,73,WARREN,POLI,PolSc-Intl,5,6,11,0,1,1,5,6,11,7,10,17,13,6,19,0,0,0,30,29,59
fa07,73,WARREN,POLI,PolSc-PLaw,2,6,8,1,1,2,1,4,5,3,11,14,6,6,12,0,0,0,13,28,41
fa07,73,WARREN,POLI,PolSc-PPol,1,2,3,0,0,0,0,0,0,1,2,3,0,1,1,0,0,0,2,5,7
fa07,73,WARREN,POLI,PolSc-Thry,0,0,0,0,0,0,1,0,1,1,0,1,2,1,3,0,0,0,4,1,5
fa07,73,WARREN,PSYC,Psychology,5,24,29,1,4,5,8,20,28,17,37,54,20,66,86,0,0,0,51,151,202
fa07,73,WARREN,RELI,Relig/Stu,0,0,0,0,0,0,0,0,0,1,0,1,2,0,2,0,0,0,3,0,3
fa07,73,WARREN,RUSS,Russ&SovSt,1,0,1,0,0,0,0,0,0,0,0,0,0,0,0,0,0,0,1,0,1
fa07,73,WARREN,SE,Engin Sci,1,0,1,0,0,0,1,1,2,0,0,0,0,0,0,0,0,0,2,1,3
fa07,73,WARREN,SE,Struct Eng,21,6,27,4,3,7,11,9,20,28,8,36,49,26,75,0,0,0,113,52,165
fa07,73,WARREN,SIO,ErSc-Geol,0,0,0,0,0,0,0,0,0,0,1,1,0,0,0,0,0,0,0,1,1
fa07,73,WARREN,SOC,Sociology,1,1,2,0,1,1,0,4,4,6,15,21,5,10,15,0,0,0,12,31,43
fa07,73,WARREN,THEA,Dance,0,0,0,0,0,0,0,0,0,0,0,0,0,1,1,0,0,0,0,1,1
fa07,73,WARREN,THEA,Theatre,0,1,1,0,0,0,0,1,1,3,4,7,3,6,9,0,0,0,6,12,18
fa07,73,WARREN,UNAF,IntcampVis,0,0,0,0,0,0,0,1,1,1,1,2,1,1,2,0,0,0,2,3,5
fa07,73,WARREN,UNAF,Limited St,0,0,0,0,0,0,0,0,0,0,0,0,0,0,0,2,0,2,2,0,2
fa07,73,WARREN,UNAF,UndecBiolS,9,14,23,1,2,3,4,11,15,2,3,5,0,0,0,0,0,0,16,30,46
fa07,73,WARREN,UNAF,UndecHumAr,1,5,6,0,1,1,1,4,5,0,1,1,0,0,0,0,0,0,2,11,13
fa07,73,WARREN,UNAF,Undeclared,26,39,65,7,6,13,27,18,45,4,11,15,0,0,0,0,0,0,64,74,138
fa07,73,WARREN,UNAF,UndecPhysS,1,2,3,1,1,2,1,0,1,0,1,1,0,0,0,0,0,0,3,4,7
fa07,73,WARREN,UNAF,UndecSocSc,5,5,10,0,1,1,4,6,10,0,1,1,0,0,0,0,0,0,9,13,22
fa07,73,WARREN,USP,Urb Stu&Pl,0,0,0,0,0,0,0,1,1,4,5,9,5,6,11,0,0,0,9,12,21
fa07,73,WARREN,VIS,Art Hst/Cr,0,1,1,0,0,0,0,1,1,0,5,5,1,4,5,0,0,0,1,11,12
fa07,73,WARREN,VIS,Media,1,2,3,0,0,0,3,2,5,4,4,8,7,8,15,0,0,0,15,16,31
fa07,73,WARREN,VIS,Studio VA,1,0,1,0,1,1,0,0,0,2,6,8,6,4,10,0,0,0,9,11,20
fa07,73,WARREN,VIS,VA-CompArt,0,1,1,0,0,0,1,1,2,0,2,2,0,4,4,0,0,0,1,8,9
fa09,93,MARSHALL,ANTH,Anth-Arch,0,1,1,0,0,0,1,0,1,0,2,2,2,2,4,0,0,0,3,5,8
fa09,93,MARSHALL,ANTH,Anth-Biol,0,0,0,0,0,0,0,0,0,1,5,6,1,2,3,0,0,0,2,7,9
fa09,93,MARSHALL,ANTH,Anth-Soci,0,2,2,0,0,0,0,1,1,2,3,5,1,7,8,0,0,0,3,13,16
fa09,93,MARSHALL,ANTH,Anthropol,0,0,0,0,0,0,0,0,0,0,0,0,1,2,3,0,0,0,1,2,3
fa09,93,MARSHALL,BENG,Bioen:Binf,0,0,0,0,0,0,0,0,0,3,1,4,1,0,1,0,0,0,4,1,5
fa09,93,MARSHALL,BENG,Bioeng:PM,1,1,2,0,0,0,1,0,1,5,0,5,13,2,15,0,0,0,20,3,23
fa09,93,MARSHALL,BENG,BioengBiot,3,2,5,0,0,0,3,1,4,3,2,5,5,1,6,0,0,0,14,6,20
fa09,93,MARSHALL,BENG,Bioengin,0,1,1,0,0,0,1,0,1,2,2,4,1,4,5,0,0,0,4,7,11
fa09,93,MARSHALL,BENG,Pr-BioenPM,9,11,20,0,0,0,1,3,4,4,2,6,0,0,0,0,0,0,14,16,30
fa09,93,MARSHALL,BIOL,Anml Physl,0,0,0,0,0,0,0,0,0,0,0,0,2,0,2,0,0,0,2,0,2
fa09,93,MARSHALL,BIOL,Bioc/CellB,8,14,22,1,3,4,12,18,30,18,22,40,39,52,91,0,0,0,78,109,187
fa09,93,MARSHALL,BIOL,BiolBioinf,0,0,0,0,0,0,0,0,0,0,1,1,1,1,2,0,0,0,1,2,3
fa09,93,MARSHALL,BIOL,Ec/Beh/Evo,1,0,1,0,1,1,1,2,3,2,3,5,6,4,10,0,0,0,10,10,20
fa09,93,MARSHALL,BIOL,Genl Biol,6,24,30,0,2,2,8,19,27,15,34,49,43,45,88,0,0,0,72,124,196
fa09,93,MARSHALL,BIOL,Human Bio,20,24,44,3,9,12,25,68,93,41,82,123,49,60,109,0,0,0,138,243,381
fa09,93,MARSHALL,BIOL,Microbiol,1,2,3,0,0,0,2,2,4,2,5,7,3,4,7,0,0,0,8,13,21
fa09,93,MARSHALL,BIOL,Molec Biol,1,2,3,0,0,0,3,5,8,3,6,9,7,6,13,0,0,0,14,19,33
fa09,93,MARSHALL,BIOL,PhyslNeuro,2,6,8,0,1,1,7,16,23,11,22,33,15,18,33,0,0,0,35,63,98
fa09,93,MARSHALL,BIOL,Pr-GenBiol,0,0,0,0,0,0,0,0,0,1,0,1,0,0,0,0,0,0,1,0,1
fa09,93,MARSHALL,CENG,Chem Engin,3,3,6,0,0,0,5,2,7,7,2,9,10,5,15,0,0,0,25,12,37
fa09,93,MARSHALL,CGS,CritGendSt,0,0,0,0,0,0,0,0,0,0,0,0,0,4,4,0,0,0,0,4,4
fa09,93,MARSHALL,CHEM,Bioch/Chem,10,11,21,0,0,0,1,7,8,7,8,15,11,11,22,0,0,0,29,37,66
fa09,93,MARSHALL,CHEM,Bioinform,0,1,1,0,0,0,0,0,0,0,0,0,0,0,0,0,0,0,0,1,1
fa09,93,MARSHALL,CHEM,Chem Educ,1,0,1,0,0,0,0,0,0,0,0,0,0,0,0,0,0,0,1,0,1
fa09,93,MARSHALL,CHEM,Chemistry,4,7,11,0,0,0,2,0,2,4,3,7,4,5,9,0,0,0,14,15,29
fa09,93,MARSHALL,CHEM,Chm/ErthSc,0,0,0,0,0,0,0,0,0,1,0,1,0,1,1,0,0,0,1,1,2
fa09,93,MARSHALL,CHEM,Envir Chem,0,0,0,0,0,0,0,0,0,0,0,0,1,0,1,0,0,0,1,0,1
fa09,93,MARSHALL,CHEM,MolecSynth,0,0,0,0,0,0,0,0,0,0,0,0,1,0,1,0,0,0,1,0,1
fa09,93,MARSHALL,CHEM,Pharm Chem,4,11,15,0,0,0,1,6,7,3,7,10,9,10,19,0,0,0,17,34,51
fa09,93,MARSHALL,CHIN,Chinese St,0,0,0,0,0,0,0,0,0,0,0,0,0,2,2,0,0,0,0,2,2
fa09,93,MARSHALL,CLAS,Classic St,0,1,1,0,0,0,0,0,0,0,0,0,0,1,1,0,0,0,0,2,2
fa09,93,MARSHALL,COGS,Cog Sci,1,3,4,0,0,0,2,3,5,4,6,10,3,1,4,0,0,0,10,13,23
fa09,93,MARSHALL,COGS,CogSc/ClAs,0,0,0,0,0,0,0,4,4,0,1,1,0,1,1,0,0,0,0,6,6
fa09,93,MARSHALL,COGS,CogSc/Comp,0,0,0,0,0,0,0,0,0,0,0,0,2,0,2,0,0,0,2,0,2
fa09,93,MARSHALL,COGS,CogSc/HCI,0,0,0,0,0,0,0,0,0,1,1,2,3,3,6,0,0,0,4,4,8
fa09,93,MARSHALL,COGS,CogSc/HCog,0,1,1,0,0,0,1,1,2,0,0,0,0,0,0,0,0,0,1,2,3
fa09,93,MARSHALL,COGS,CogSc/Neur,1,1,2,0,0,0,0,3,3,3,5,8,3,13,16,0,0,0,7,22,29
fa09,93,MARSHALL,COMM,Communic,1,11,12,2,1,3,4,28,32,26,38,64,21,42,63,0,0,0,54,120,174
fa09,93,MARSHALL,CSE,Comp Sci,7,3,10,1,0,1,7,4,11,20,1,21,29,5,34,0,0,0,64,13,77
fa09,93,MARSHALL,CSE,CompEngCSE,4,3,7,0,0,0,3,2,5,6,0,6,7,0,7,0,0,0,20,5,25
fa09,93,MARSHALL,CSE,CompScBinf,0,0,0,0,0,0,0,0,0,0,0,0,2,1,3,0,0,0,2,1,3
fa09,93,MARSHALL,ECE,CompEngECE,1,0,1,0,0,0,1,0,1,6,0,6,0,0,0,0,0,0,8,0,8
fa09,93,MARSHALL,ECE,Electr Eng,7,2,9,0,0,0,7,4,11,18,2,20,28,9,37,0,0,0,60,17,77
fa09,93,MARSHALL,ECE,Pr-EngPhys,0,0,0,0,0,0,2,0,2,0,0,0,0,0,0,0,0,0,2,0,2
fa09,93,MARSHALL,ECON,Ec-Mth&Ecn,3,2,5,0,0,0,2,1,3,9,4,13,3,2,5,0,0,0,17,9,26
fa09,93,MARSHALL,ECON,Econ-MgtSc,9,8,17,1,0,1,15,23,38,31,19,50,56,35,91,0,0,0,112,85,197
fa09,93,MARSHALL,ECON,Economics,15,14,29,2,1,3,23,16,39,88,42,130,92,51,143,0,0,0,220,124,344
fa09,93,MARSHALL,ESYS,EnvSys(EB),0,1,1,0,0,0,1,1,2,1,2,3,2,7,9,0,0,0,4,11,15
fa09,93,MARSHALL,ESYS,EnvSys(EC),1,0,1,0,0,0,0,0,0,0,0,0,1,1,2,0,0,0,2,1,3
fa09,93,MARSHALL,ESYS,EnvSys(EP),2,1,3,0,0,0,2,1,3,0,0,0,0,1,1,0,0,0,4,3,7
fa09,93,MARSHALL,ESYS,EnvSys(ES),1,2,3,0,0,0,1,0,1,1,0,1,0,2,2,0,0,0,3,4,7
fa09,93,MARSHALL,ETHN,Ethnic St,1,2,3,0,0,0,0,3,3,3,7,10,1,20,21,0,0,0,5,32,37
fa09,93,MARSHALL,HDP,Human Dev,0,0,0,0,0,0,0,0,0,1,8,9,0,27,27,0,0,0,1,35,36
fa09,93,MARSHALL,HDP,Pr-HumnDev,0,2,2,0,2,2,0,4,4,1,12,13,1,7,8,0,0,0,2,27,29
fa09,93,MARSHALL,HIST,History,2,2,4,0,1,1,3,4,7,20,9,29,11,11,22,0,0,0,36,27,63
fa09,93,MARSHALL,INTL,IntSt-Anth,0,1,1,0,0,0,0,0,0,0,0,0,1,3,4,0,0,0,1,4,5
fa09,93,MARSHALL,INTL,IntSt-Econ,4,3,7,0,0,0,7,12,19,6,6,12,8,8,16,0,0,0,25,29,54
fa09,93,MARSHALL,INTL,IntSt-Hist,0,0,0,0,0,0,0,1,1,0,0,0,2,4,6,0,0,0,2,5,7
fa09,93,MARSHALL,INTL,IntSt-Ling,0,2,2,0,0,0,1,0,1,0,2,2,0,1,1,0,0,0,1,5,6
fa09,93,MARSHALL,INTL,IntSt-Lit,0,1,1,0,0,0,0,1,1,0,0,0,0,0,0,0,0,0,0,2,2
fa09,93,MARSHALL,INTL,IntSt-PolS,1,2,3,0,0,0,0,4,4,3,8,11,6,16,22,0,0,0,10,30,40
fa09,93,MARSHALL,INTL,IntSt-Soc,0,1,1,0,0,0,0,1,1,2,7,9,1,7,8,0,0,0,3,16,19
fa09,93,MARSHALL,JAPN,JapaneseSt,0,0,0,0,0,0,0,0,0,0,0,0,1,0,1,0,0,0,1,0,1
fa09,93,MARSHALL,JUDA,Judaic Stu,0,0,0,0,0,0,0,0,0,0,0,0,1,0,1,0,0,0,1,0,1
fa09,93,MARSHALL,LATI,LatinAm St,0,0,0,0,0,0,0,0,0,0,1,1,1,1,2,0,0,0,1,2,3
fa09,93,MARSHALL,LING,Lang Stu,0,0,0,0,0,0,1,1,2,0,2,2,0,2,2,0,0,0,1,5,6
fa09,93,MARSHALL,LING,Ling-CogLn,0,0,0,0,0,0,1,0,1,0,0,0,0,0,0,0,0,0,1,0,1
fa09,93,MARSHALL,LING,Linguistcs,0,1,1,0,0,0,0,2,2,0,1,1,1,0,1,0,0,0,1,4,5
fa09,93,MARSHALL,LIT,Lit/Compos,1,1,2,0,0,0,0,0,0,0,0,0,0,0,0,0,0,0,1,1,2
fa09,93,MARSHALL,LIT,Lit/Engl,1,3,4,0,1,1,1,3,4,1,4,5,2,2,4,0,0,0,5,13,18
fa09,93,MARSHALL,LIT,Lit/World,0,0,0,0,0,0,0,1,1,0,1,1,0,4,4,0,0,0,0,6,6
fa09,93,MARSHALL,LIT,Lit/Writng,0,0,0,0,0,0,0,0,0,1,3,4,5,5,10,0,0,0,6,8,14
fa09,93,MARSHALL,LIT,Pre-Lit/Wr,1,1,2,0,0,0,0,3,3,6,4,10,2,2,4,0,0,0,9,10,19
fa09,93,MARSHALL,LIT,Spanish Lt,0,0,0,0,0,0,0,1,1,0,1,1,0,3,3,0,0,0,0,5,5
fa09,93,MARSHALL,MAE,Aerosp Eng,6,1,7,1,0,1,4,1,5,8,4,12,16,4,20,0,0,0,35,10,45
fa09,93,MARSHALL,MAE,Engin Sci,1,1,2,0,0,0,0,0,0,0,0,0,1,0,1,0,0,0,2,1,3
fa09,93,MARSHALL,MAE,Envir Eng,1,1,2,0,0,0,0,3,3,0,0,0,1,2,3,0,0,0,2,6,8
fa09,93,MARSHALL,MAE,Mech Engin,7,2,9,1,0,1,15,1,16,20,2,22,49,3,52,0,0,0,92,8,100
fa09,93,MARSHALL,MATH,Appld Math,1,0,1,0,0,0,1,0,1,1,2,3,3,2,5,0,0,0,6,4,10
fa09,93,MARSHALL,MATH,Math/SecEd,2,0,2,0,0,0,1,3,4,1,0,1,1,0,1,0,0,0,5,3,8
fa09,93,MARSHALL,MATH,Mathematcs,1,1,2,0,0,0,0,4,4,5,2,7,4,1,5,0,0,0,10,8,18
fa09,93,MARSHALL,MATH,Mth-CompSc,0,0,0,1,0,1,0,1,1,0,1,1,0,1,1,0,0,0,1,3,4
fa09,93,MARSHALL,MATH,Mth-Mth&Ec,0,1,1,0,0,0,1,3,4,6,2,8,7,3,10,0,0,0,14,9,23
fa09,93,MARSHALL,MATH,Mth-SciCom,0,0,0,0,0,0,0,0,0,0,0,0,0,1,1,0,0,0,0,1,1
fa09,93,MARSHALL,MATH,Mth/ApldSc,0,1,1,0,0,0,0,1,1,0,0,0,0,0,0,0,0,0,0,2,2
fa09,93,MARSHALL,MATH,Pr-Math CS,0,0,0,0,0,0,0,0,0,0,1,1,0,0,0,0,0,0,0,1,1
fa09,93,MARSHALL,MATH,Prob&Stats,0,0,0,0,0,0,0,0,0,1,0,1,2,2,4,0,0,0,3,2,5
fa09,93,MARSHALL,MUS,Mu-CompArt,1,0,1,0,0,0,0,0,0,3,0,3,1,0,1,0,0,0,5,0,5
fa09,93,MARSHALL,MUS,Music,1,2,3,1,0,1,1,1,2,0,1,1,3,4,7,0,0,0,6,8,14
fa09,93,MARSHALL,MUS,Music Hum,0,0,0,0,0,0,0,0,0,0,0,0,0,1,1,0,0,0,0,1,1
fa09,93,MARSHALL,PHIL,Philosophy,0,1,1,0,0,0,0,2,2,5,0,5,4,2,6,0,0,0,9,5,14
fa09,93,MARSHALL,PHYS,Biophysics,1,0,1,0,0,0,1,0,1,0,0,0,0,1,1,0,0,0,2,1,3
fa09,93,MARSHALL,PHYS,Phy/ErthSc,0,0,0,0,0,0,0,0,0,1,0,1,0,1,1,0,0,0,1,1,2
fa09,93,MARSHALL,PHYS,Phys/Astro,1,1,2,0,0,0,0,0,0,0,1,1,1,2,3,0,0,0,2,4,6
fa09,93,MARSHALL,PHYS,Phys/Mtrls,0,0,0,0,0,0,0,0,0,0,1,1,0,0,0,0,0,0,0,1,1
fa09,93,MARSHALL,PHYS,Physics,2,1,3,0,0,0,2,0,2,3,0,3,3,1,4,0,0,0,10,2,12
fa09,93,MARSHALL,POLI,Polit Sci,2,1,3,0,1,1,9,13,22,23,21,44,29,22,51,0,0,0,63,58,121
fa09,93,MARSHALL,POLI,PolSc-Amer,0,2,2,0,0,0,0,2,2,3,1,4,3,1,4,0,0,0,6,6,12
fa09,93,MARSHALL,POLI,PolSc-Comp,0,0,0,0,0,0,0,1,1,1,0,1,1,1,2,0,0,0,2,2,4
fa09,93,MARSHALL,POLI,PolSc-Intl,1,7,8,0,0,0,4,8,12,13,13,26,21,13,34,0,0,0,39,41,80
fa09,93,MARSHALL,POLI,PolSc-PLaw,2,6,8,0,1,1,5,4,9,9,5,14,7,7,14,0,0,0,23,23,46
fa09,93,MARSHALL,POLI,PolSc-PPol,0,0,0,0,0,0,0,0,0,3,2,5,0,2,2,0,0,0,3,4,7
fa09,93,MARSHALL,POLI,PolSc-Thry,0,0,0,0,0,0,0,1,1,0,1,1,1,0,1,0,0,0,1,2,3
fa09,93,MARSHALL,PSYC,Psychology,8,30,38,0,4,4,8,33,41,21,58,79,31,87,118,0,0,0,68,212,280
fa09,93,MARSHALL,RELI,Relig/Stu,0,0,0,0,0,0,0,0,0,0,0,0,1,1,2,0,0,0,1,1,2
fa09,93,MARSHALL,SE,Struct Eng,8,2,10,0,0,0,5,9,14,12,2,14,11,11,22,0,0,0,36,24,60
fa09,93,MARSHALL,SOC,SocCulCom,0,0,0,0,0,0,0,0,0,1,1,2,0,1,1,0,0,0,1,2,3
fa09,93,MARSHALL,SOC,SocEconSoc,0,0,0,0,0,0,0,0,0,0,2,2,1,0,1,0,0,0,1,2,3
fa09,93,MARSHALL,SOC,SocIntlStu,0,0,0,0,0,0,0,0,0,0,1,1,0,0,0,0,0,0,0,1,1
fa09,93,MARSHALL,SOC,Sociology,1,6,7,0,2,2,1,3,4,13,26,39,11,22,33,0,0,0,26,59,85
fa09,93,MARSHALL,SOC,SocLawSoc,0,0,0,0,0,0,1,0,1,0,0,0,1,2,3,0,0,0,2,2,4
fa09,93,MARSHALL,SOC,SocSciMed,0,0,0,0,0,0,1,0,1,0,0,0,0,0,0,0,0,0,1,0,1
fa09,93,MARSHALL,SOC,SocSolneq,0,0,0,0,0,0,0,0,0,0,2,2,0,1,1,0,0,0,0,3,3
fa09,93,MARSHALL,THEA,Dance,0,0,0,0,0,0,0,0,0,0,0,0,0,1,1,0,0,0,0,1,1
fa09,93,MARSHALL,THEA,Theatre,0,1,1,0,0,0,0,2,2,2,1,3,2,3,5,0,0,0,4,7,11
fa09,93,MARSHALL,UNAF,UndecBiolS,0,0,0,0,1,1,1,0,1,0,0,0,0,0,0,0,0,0,1,1,2
fa09,93,MARSHALL,UNAF,UndecHumAr,1,6,7,0,0,0,0,1,1,0,0,0,0,0,0,0,0,0,1,7,8
fa09,93,MARSHALL,UNAF,Undeclared,40,75,115,2,1,3,8,13,21,0,1,1,0,0,0,0,0,0,50,90,140
fa09,93,MARSHALL,UNAF,UndecPhysS,5,6,11,0,0,0,1,0,1,0,0,0,0,0,0,0,0,0,6,6,12
fa09,93,MARSHALL,UNAF,UndecSocSc,2,10,12,0,0,0,0,3,3,0,0,0,0,0,0,0,0,0,2,13,15
fa09,93,MARSHALL,USP,Urb Stu&Pl,1,1,2,0,0,0,2,4,6,4,7,11,4,6,10,0,0,0,11,18,29
fa09,93,MARSHALL,VIS,Art Hst/Cr,1,1,2,0,0,0,0,2,2,0,2,2,0,5,5,0,0,0,1,10,11
fa09,93,MARSHALL,VIS,Media,0,3,3,0,0,0,2,3,5,6,8,14,7,4,11,0,0,0,15,18,33
fa09,93,MARSHALL,VIS,Studio VA,0,1,1,0,0,0,1,2,3,4,3,7,2,3,5,0,0,0,7,9,16
fa09,93,MARSHALL,VIS,VA-CompArt,0,0,0,0,0,0,0,1,1,1,0,1,2,0,2,0,0,0,3,1,4
fa09,93,MUIR,ANTH,Anth-Arch,0,1,1,0,0,0,0,1,1,0,0,0,4,2,6,0,0,0,4,4,8
fa09,93,MUIR,ANTH,Anth-Biol,0,1,1,0,0,0,0,2,2,2,5,7,2,10,12,0,0,0,4,18,22
fa09,93,MUIR,ANTH,Anth-Soci,0,3,3,0,0,0,0,2,2,2,5,7,2,3,5,0,0,0,4,13,17
fa09,93,MUIR,BENG,Bioen:Binf,0,0,0,0,0,0,1,0,1,0,0,0,1,0,1,0,0,0,2,0,2
fa09,93,MUIR,BENG,Bioeng:PM,0,0,0,0,0,0,0,0,0,1,2,3,10,3,13,0,0,0,11,5,16
fa09,93,MUIR,BENG,BioengBiot,3,7,10,0,0,0,4,3,7,2,4,6,6,3,9,0,0,0,15,17,32
fa09,93,MUIR,BENG,Bioengin,8,2,10,0,0,0,7,3,10,12,2,14,8,5,13,0,0,0,35,12,47
fa09,93,MUIR,BENG,Pr-BioenPM,10,6,16,0,0,0,1,0,1,4,0,4,3,0,3,0,0,0,18,6,24
fa09,93,MUIR,BIOL,Anml Physl,0,0,0,0,0,0,0,0,0,0,0,0,0,1,1,0,0,0,0,1,1
fa09,93,MUIR,BIOL,Bioc/CellB,7,9,16,2,1,3,14,13,27,24,28,52,63,54,117,0,0,0,110,105,215
fa09,93,MUIR,BIOL,BiolBioinf,0,0,0,0,0,0,0,0,0,1,0,1,0,0,0,0,0,0,1,0,1
fa09,93,MUIR,BIOL,Ec/Beh/Evo,1,2,3,0,0,0,2,6,8,1,10,11,4,16,20,0,0,0,8,34,42
fa09,93,MUIR,BIOL,Genl Biol,9,19,28,1,3,4,10,24,34,16,29,45,47,72,119,0,0,0,83,147,230
fa09,93,MUIR,BIOL,Human Bio,12,40,52,3,9,12,32,68,100,45,58,103,66,83,149,0,0,0,158,258,416
fa09,93,MUIR,BIOL,Microbiol,1,2,3,1,0,1,1,1,2,2,5,7,4,6,10,0,0,0,9,14,23
fa09,93,MUIR,BIOL,Molec Biol,2,5,7,2,0,2,7,2,9,4,5,9,10,9,19,0,0,0,25,21,46
fa09,93,MUIR,BIOL,PhyslNeuro,5,8,13,2,2,4,10,16,26,11,20,31,30,33,63,0,0,0,58,79,137
fa09,93,MUIR,CENG,Chem Engin,2,0,2,1,0,1,3,3,6,4,4,8,16,7,23,0,0,0,26,14,40
fa09,93,MUIR,CGS,CritGendSt,0,0,0,0,0,0,0,1,1,0,3,3,0,5,5,0,0,0,0,9,9
fa09,93,MUIR,CHEM,Bioch/Chem,10,14,24,0,1,1,4,5,9,7,11,18,13,14,27,0,0,0,34,45,79
fa09,93,MUIR,CHEM,Bioinform,1,0,1,0,0,0,0,0,0,0,0,0,0,0,0,0,0,0,1,0,1
fa09,93,MUIR,CHEM,Chem Educ,0,1,1,0,0,0,0,0,0,0,0,0,0,0,0,0,0,0,0,1,1
fa09,93,MUIR,CHEM,Chemistry,4,7,11,0,0,0,2,2,4,7,1,8,6,4,10,0,0,0,19,14,33
fa09,93,MUIR,CHEM,Envir Chem,0,1,1,0,0,0,0,0,0,0,1,1,2,0,2,0,0,0,2,2,4
fa09,93,MUIR,CHEM,MolecSynth,0,0,0,0,0,0,0,0,0,0,0,0,2,0,2,0,0,0,2,0,2
fa09,93,MUIR,CHEM,Pharm Chem,3,8,11,0,0,0,3,5,8,11,7,18,10,12,22,0,0,0,27,32,59
fa09,93,MUIR,CHIN,Chinese St,0,0,0,0,0,0,0,0,0,0,0,0,1,1,2,0,0,0,1,1,2
fa09,93,MUIR,CLAS,Classic St,0,0,0,0,0,0,0,1,1,0,0,0,0,2,2,0,0,0,0,3,3
fa09,93,MUIR,COGS,Cog Sci,3,2,5,0,0,0,3,1,4,7,7,14,10,9,19,0,0,0,23,19,42
fa09,93,MUIR,COGS,CogSc/ClAs,0,0,0,0,0,0,0,0,0,0,1,1,1,3,4,0,0,0,1,4,5
fa09,93,MUIR,COGS,CogSc/Comp,0,0,0,0,0,0,0,0,0,3,0,3,0,0,0,0,0,0,3,0,3
fa09,93,MUIR,COGS,CogSc/HCI,2,0,2,0,1,1,1,3,4,3,1,4,6,2,8,0,0,0,12,7,19
fa09,93,MUIR,COGS,CogSc/HCog,1,1,2,0,0,0,1,2,3,1,1,2,2,1,3,0,0,0,5,5,10
fa09,93,MUIR,COGS,CogSc/Neur,1,2,3,0,0,0,0,1,1,3,3,6,7,12,19,0,0,0,11,18,29
fa09,93,MUIR,COMM,Communic,0,11,11,1,1,2,1,21,22,16,41,57,12,67,79,0,0,0,30,141,171
fa09,93,MUIR,CSE,Comp Sci,13,2,15,2,0,2,2,4,6,12,5,17,34,4,38,0,0,0,63,15,78
fa09,93,MUIR,CSE,CompEngCSE,7,1,8,0,0,0,3,1,4,3,1,4,6,0,6,0,0,0,19,3,22
fa09,93,MUIR,CSE,CompScBinf,0,0,0,0,0,0,0,0,0,0,2,2,2,0,2,0,0,0,2,2,4
fa09,93,MUIR,CSE,Pr-Comp Sc,0,0,0,0,0,0,0,0,0,2,0,2,0,0,0,0,0,0,2,0,2
fa09,93,MUIR,ECE,CompEngECE,2,1,3,1,0,1,2,0,2,0,1,1,2,0,2,0,0,0,7,2,9
fa09,93,MUIR,ECE,Electr Eng,7,2,9,1,0,1,4,0,4,10,1,11,12,3,15,0,0,0,34,6,40
fa09,93,MUIR,ECE,Engin Phys,0,0,0,0,0,0,0,0,0,0,0,0,1,0,1,0,0,0,1,0,1
fa09,93,MUIR,ECE,Pr-EngPhys,1,0,1,0,0,0,0,0,0,0,0,0,0,0,0,0,0,0,1,0,1
fa09,93,MUIR,ECON,Ec-Mth&Ecn,0,3,3,0,0,0,2,1,3,3,0,3,6,2,8,0,0,0,11,6,17
fa09,93,MUIR,ECON,Econ-MgtSc,3,8,11,2,1,3,20,8,28,30,8,38,47,27,74,0,0,0,102,52,154
fa09,93,MUIR,ECON,Economics,10,12,22,3,0,3,15,13,28,69,38,107,69,46,115,0,0,0,166,109,275
fa09,93,MUIR,ESYS,EnvSys(EB),3,5,8,0,0,0,0,3,3,5,7,12,1,6,7,0,0,0,9,21,30
fa09,93,MUIR,ESYS,EnvSys(EC),0,0,0,0,0,0,0,0,0,0,0,0,0,2,2,0,0,0,0,2,2
fa09,93,MUIR,ESYS,EnvSys(EP),0,1,1,0,0,0,1,2,3,1,1,2,0,3,3,0,0,0,2,7,9
fa09,93,MUIR,ESYS,EnvSys(ES),0,3,3,0,0,0,0,3,3,0,0,0,3,0,3,0,0,0,3,6,9
fa09,93,MUIR,ETHN,Ethnic St,1,1,2,2,0,2,0,4,4,0,4,4,2,9,11,0,0,0,5,18,23
fa09,93,MUIR,GMST,German Stu,0,0,0,0,0,0,0,0,0,0,1,1,0,0,0,0,0,0,0,1,1
fa09,93,MUIR,HDP,Human Dev,0,0,0,0,0,0,0,0,0,0,1,1,0,18,18,0,0,0,0,19,19
fa09,93,MUIR,HDP,Pr-HumnDev,1,4,5,0,2,2,1,13,14,0,7,7,1,5,6,0,0,0,3,31,34
fa09,93,MUIR,HIST,History,1,1,2,1,2,3,2,8,10,17,3,20,8,12,20,0,0,0,29,26,55
fa09,93,MUIR,INTL,IntSt-Anth,0,0,0,0,0,0,0,0,0,0,0,0,3,1,4,0,0,0,3,1,4
fa09,93,MUIR,INTL,IntSt-Econ,0,4,4,0,0,0,2,7,9,3,5,8,9,14,23,0,0,0,14,30,44
fa09,93,MUIR,INTL,IntSt-Hist,0,0,0,0,0,0,0,1,1,1,3,4,2,2,4,0,0,0,3,6,9
fa09,93,MUIR,INTL,IntSt-Ling,0,0,0,0,0,0,0,0,0,0,1,1,1,3,4,0,0,0,1,4,5
fa09,93,MUIR,INTL,IntSt-Lit,0,0,0,0,0,0,0,1,1,0,1,1,1,0,1,0,0,0,1,2,3
fa09,93,MUIR,INTL,IntSt-PolS,0,5,5,0,1,1,1,2,3,3,11,14,5,12,17,0,0,0,9,31,40
fa09,93,MUIR,INTL,IntSt-Soc,0,1,1,0,1,1,0,0,0,4,2,6,1,8,9,0,0,0,5,12,17
fa09,93,MUIR,ITAL,Italian St,0,0,0,0,0,0,1,0,1,0,0,0,0,0,0,0,0,0,1,0,1
fa09,93,MUIR,JAPN,JapaneseSt,0,1,1,0,0,0,0,1,1,1,3,4,3,3,6,0,0,0,4,8,12
fa09,93,MUIR,JUDA,Judaic Stu,0,1,1,0,0,0,0,0,0,0,0,0,0,0,0,0,0,0,0,1,1
fa09,93,MUIR,LATI,LatinAm St,0,0,0,0,0,0,0,0,0,0,0,0,1,1,2,0,0,0,1,1,2
fa09,93,MUIR,LING,Lang Stu,0,0,0,0,0,0,0,1,1,0,2,2,2,1,3,0,0,0,2,4,6
fa09,93,MUIR,LING,Ling-CogLn,0,0,0,0,0,0,1,0,1,1,1,2,0,2,2,0,0,0,2,3,5
fa09,93,MUIR,LING,Ling-LSoc,0,0,0,0,0,0,0,1,1,0,0,0,0,1,1,0,0,0,0,2,2
fa09,93,MUIR,LING,Linguistcs,2,1,3,0,0,0,2,3,5,2,6,8,0,4,4,0,0,0,6,14,20
fa09,93,MUIR,LIT,French Lit,0,0,0,0,0,0,0,0,0,0,0,0,0,1,1,0,0,0,0,1,1
fa09,93,MUIR,LIT,Lit/Compos,0,0,0,0,0,0,0,1,1,0,0,0,0,0,0,0,0,0,0,1,1
fa09,93,MUIR,LIT,Lit/CultSt,0,0,0,0,0,0,0,0,0,0,1,1,0,1,1,0,0,0,0,2,2
fa09,93,MUIR,LIT,Lit/Engl,0,3,3,0,0,0,3,2,5,1,7,8,5,10,15,0,0,0,9,22,31
fa09,93,MUIR,LIT,Lit/World,0,0,0,0,0,0,0,1,1,0,3,3,2,4,6,0,0,0,2,8,10
fa09,93,MUIR,LIT,Lit/Writng,0,0,0,0,0,0,0,0,0,0,1,1,5,8,13,0,0,0,5,9,14
fa09,93,MUIR,LIT,Pre-Lit/Wr,1,2,3,0,0,0,1,4,5,2,5,7,6,5,11,0,0,0,10,16,26
fa09,93,MUIR,LIT,Spanish Lt,0,1,1,0,0,0,0,0,0,1,1,2,2,3,5,0,0,0,3,5,8
fa09,93,MUIR,MAE,Aerosp Eng,6,2,8,1,0,1,12,2,14,5,0,5,13,5,18,0,0,0,37,9,46
fa09,93,MUIR,MAE,Envir Eng,2,3,5,1,0,1,3,2,5,4,5,9,1,1,2,0,0,0,11,11,22
fa09,93,MUIR,MAE,Mech Engin,8,1,9,1,0,1,11,1,12,27,2,29,40,6,46,0,0,0,87,10,97
fa09,93,MUIR,MATH,Appld Math,0,0,0,0,0,0,0,1,1,2,2,4,4,1,5,0,0,0,6,4,10
fa09,93,MUIR,MATH,Math/SecEd,0,1,1,0,0,0,1,3,4,2,2,4,2,4,6,0,0,0,5,10,15
fa09,93,MUIR,MATH,Mathematcs,2,3,5,0,0,0,4,1,5,0,4,4,5,4,9,0,0,0,11,12,23
fa09,93,MUIR,MATH,Mth-CompSc,0,0,0,0,0,0,0,0,0,0,0,0,1,1,2,0,0,0,1,1,2
fa09,93,MUIR,MATH,Mth-Mth&Ec,0,1,1,0,0,0,1,0,1,3,1,4,2,3,5,0,0,0,6,5,11
fa09,93,MUIR,MATH,Mth-SciCom,0,0,0,0,0,0,0,0,0,0,0,0,1,0,1,0,0,0,1,0,1
fa09,93,MUIR,MATH,Mth/ApldSc,0,0,0,0,0,0,0,0,0,1,0,1,0,1,1,0,0,0,1,1,2
fa09,93,MUIR,MATH,Pr-Math CS,0,0,0,0,0,0,0,0,0,1,0,1,0,0,0,0,0,0,1,0,1
fa09,93,MUIR,MATH,Prob&Stats,1,0,1,0,0,0,1,0,1,1,2,3,0,0,0,0,0,0,3,2,5
fa09,93,MUIR,MUS,Mu-CompArt,0,0,0,0,0,0,2,0,2,8,0,8,2,1,3,0,0,0,12,1,13
fa09,93,MUIR,MUS,Music,3,1,4,0,0,0,1,1,2,3,4,7,6,6,12,0,0,0,13,12,25
fa09,93,MUIR,MUS,Music Hum,0,0,0,0,0,0,1,0,1,0,2,2,0,0,0,0,0,0,1,2,3
fa09,93,MUIR,PHIL,Philosophy,0,0,0,0,0,0,1,0,1,5,1,6,6,3,9,0,0,0,12,4,16
fa09,93,MUIR,PHYS,Biophysics,0,0,0,0,0,0,0,0,0,1,1,2,2,0,2,0,0,0,3,1,4
fa09,93,MUIR,PHYS,Phy/ErthSc,0,0,0,0,0,0,0,1,1,0,0,0,0,0,0,0,0,0,0,1,1
fa09,93,MUIR,PHYS,Phys/Astro,0,0,0,0,0,0,2,1,3,1,0,1,2,1,3,0,0,0,5,2,7
fa09,93,MUIR,PHYS,Phys/Comp,0,0,0,0,0,0,1,0,1,0,0,0,1,0,1,0,0,0,2,0,2
fa09,93,MUIR,PHYS,Phys/Mtrls,0,0,0,0,0,0,1,0,1,0,0,0,0,0,0,0,0,0,1,0,1
fa09,93,MUIR,PHYS,Physics,1,0,1,0,0,0,4,0,4,1,1,2,4,0,4,0,0,0,10,1,11
fa09,93,MUIR,POLI,Polit Sci,7,1,8,1,0,1,3,13,16,12,17,29,25,16,41,0,0,0,48,47,95
fa09,93,MUIR,POLI,PolSc-Amer,0,2,2,0,0,0,3,0,3,2,3,5,3,1,4,0,0,0,8,6,14
fa09,93,MUIR,POLI,PolSc-Comp,0,0,0,0,0,0,0,0,0,0,1,1,2,0,2,0,0,0,2,1,3
fa09,93,MUIR,POLI,PolSc-Intl,2,2,4,1,2,3,2,6,8,9,5,14,8,9,17,0,0,0,22,24,46
fa09,93,MUIR,POLI,PolSc-PLaw,0,2,2,0,0,0,3,2,5,7,6,13,3,6,9,0,0,0,13,16,29
fa09,93,MUIR,POLI,PolSc-PPol,0,1,1,0,0,0,0,0,0,2,0,2,0,2,2,0,0,0,2,3,5
fa09,93,MUIR,POLI,PolSc-Thry,0,0,0,0,0,0,0,0,0,2,1,3,6,2,8,0,0,0,8,3,11
fa09,93,MUIR,PSYC,Psychology,9,24,33,2,5,7,11,38,49,19,60,79,42,92,134,0,0,0,83,219,302
fa09,93,MUIR,RELI,Relig/Stu,0,0,0,0,0,0,0,1,1,1,1,2,5,1,6,0,0,0,6,3,9
fa09,93,MUIR,SE,Struct Eng,9,2,11,1,1,2,10,5,15,12,2,14,24,13,37,0,0,0,56,23,79
fa09,93,MUIR,SIO,ErSc-Geol,0,0,0,0,0,0,1,1,2,0,0,0,2,0,2,0,0,0,3,1,4
fa09,93,MUIR,SIO,ErSc-Geoph,0,0,0,0,0,0,0,0,0,1,0,1,0,0,0,0,0,0,1,0,1
fa09,93,MUIR,SOC,Sociology,3,9,12,0,0,0,0,6,6,4,24,28,3,18,21,0,0,0,10,57,67
fa09,93,MUIR,SOC,SocLawSoc,0,0,0,0,0,0,1,0,1,1,1,2,0,0,0,0,0,0,2,1,3
fa09,93,MUIR,SOC,SocSciMed,0,0,0,0,0,0,0,0,0,2,0,2,0,0,0,0,0,0,2,0,2
fa09,93,MUIR,SOC,SocSolneq,0,0,0,0,0,0,0,0,0,0,1,1,0,0,0,0,0,0,0,1,1
fa09,93,MUIR,THEA,Dance,0,0,0,0,0,0,0,0,0,0,1,1,1,2,3,0,0,0,1,3,4
fa09,93,MUIR,THEA,Theatre,1,1,2,1,0,1,0,4,4,0,5,5,4,5,9,0,0,0,6,15,21
fa09,93,MUIR,TWS,ThirdWldSt,0,1,1,0,0,0,0,0,0,0,0,0,0,0,0,0,0,0,0,1,1
fa09,93,MUIR,UNAF,Limited St,0,0,0,0,0,0,0,0,0,0,0,0,0,0,0,1,0,1,1,0,1
fa09,93,MUIR,UNAF,UndecBiolS,0,0,0,0,1,1,0,0,0,0,0,0,0,0,0,0,0,0,0,1,1
fa09,93,MUIR,UNAF,UndecHumAr,3,6,9,0,0,0,1,1,2,0,0,0,0,0,0,0,0,0,4,7,11
fa09,93,MUIR,UNAF,Undeclared,54,64,118,3,2,5,16,19,35,0,1,1,0,0,0,0,0,0,73,86,159
fa09,93,MUIR,UNAF,UndecPhysS,10,5,15,1,0,1,0,0,0,0,0,0,0,0,0,0,0,0,11,5,16
fa09,93,MUIR,UNAF,UndecSocSc,6,7,13,0,0,0,0,2,2,0,0,0,0,0,0,0,0,0,6,9,15
fa09,93,MUIR,USP,Urb Stu&Pl,1,0,1,1,0,1,0,1,1,7,5,12,4,6,10,0,0,0,13,12,25
fa09,93,MUIR,VIS,Art Hst/Cr,0,0,0,0,0,0,0,0,0,0,8,8,0,7,7,0,0,0,0,15,15
fa09,93,MUIR,VIS,Media,0,2,2,1,1,2,1,5,6,10,5,15,12,10,22,0,0,0,24,23,47
fa09,93,MUIR,VIS,Studio VA,0,0,0,0,0,0,0,1,1,0,1,1,0,8,8,0,0,0,0,10,10
fa09,93,MUIR,VIS,VA-CompArt,0,3,3,0,0,0,1,1,2,3,2,5,3,3,6,0,0,0,7,9,16
fa09,93,REVELLE,ANTH,Anth-Arch,0,1,1,0,0,0,1,0,1,0,1,1,0,1,1,0,0,0,1,3,4
fa09,93,REVELLE,ANTH,Anth-Biol,0,1,1,0,0,0,0,2,2,1,2,3,2,2,4,0,0,0,3,7,10
fa09,93,REVELLE,ANTH,Anth-Soci,0,2,2,0,0,0,0,2,2,2,1,3,0,5,5,0,0,0,2,10,12
fa09,93,REVELLE,BENG,Bioen:Binf,0,0,0,0,0,0,1,0,1,0,1,1,2,0,2,0,0,0,3,1,4
fa09,93,REVELLE,BENG,Bioeng:PM,0,0,0,0,0,0,1,1,2,6,1,7,25,15,40,0,0,0,32,17,49
fa09,93,REVELLE,BENG,BioengBiot,6,2,8,0,0,0,5,2,7,9,4,13,9,7,16,0,0,0,29,15,44
fa09,93,REVELLE,BENG,Bioengin,2,6,8,0,0,0,3,1,4,6,5,11,9,9,18,0,0,0,20,21,41
fa09,93,REVELLE,BENG,Pr-Bioeng,0,0,0,0,0,0,0,0,0,1,0,1,0,0,0,0,0,0,1,0,1
fa09,93,REVELLE,BENG,Pr-BioenPM,20,9,29,1,0,1,3,4,7,5,2,7,0,0,0,0,0,0,29,15,44
fa09,93,REVELLE,BIOL,Bioc/CellB,9,14,23,0,2,2,19,32,51,52,40,92,71,81,152,0,0,0,151,169,320
fa09,93,REVELLE,BIOL,BiolBioinf,1,0,1,0,1,1,0,0,0,0,0,0,1,0,1,0,0,0,2,1,3
fa09,93,REVELLE,BIOL,Ec/Beh/Evo,3,1,4,1,0,1,0,3,3,5,6,11,5,4,9,0,0,0,14,14,28
fa09,93,REVELLE,BIOL,Genl Biol,14,23,37,1,0,1,15,20,35,25,40,65,42,77,119,0,0,0,97,160,257
fa09,93,REVELLE,BIOL,Human Bio,33,45,78,2,8,10,41,75,116,64,95,159,79,103,182,0,0,0,219,326,545
fa09,93,REVELLE,BIOL,Microbiol,1,1,2,0,0,0,4,2,6,5,5,10,8,14,22,0,0,0,18,22,40
fa09,93,REVELLE,BIOL,Molec Biol,5,1,6,0,0,0,1,4,5,13,8,21,23,14,37,0,0,0,42,27,69
fa09,93,REVELLE,BIOL,PhyslNeuro,7,11,18,0,1,1,9,16,25,22,30,52,30,34,64,0,0,0,68,92,160
fa09,93,REVELLE,CENG,Chem Engin,8,4,12,1,0,1,7,3,10,13,6,19,11,8,19,0,0,0,40,21,61
fa09,93,REVELLE,CHEM,Bioch/Chem,11,24,35,0,1,1,8,7,15,12,12,24,21,29,50,0,0,0,52,73,125
fa09,93,REVELLE,CHEM,Chem Phys,1,0,1,0,0,0,0,0,0,1,0,1,1,0,1,0,0,0,3,0,3
fa09,93,REVELLE,CHEM,Chemistry,10,7,17,0,0,0,2,4,6,5,4,9,10,7,17,0,0,0,27,22,49
fa09,93,REVELLE,CHEM,Envir Chem,1,0,1,0,0,0,0,0,0,1,0,1,0,0,0,0,0,0,2,0,2
fa09,93,REVELLE,CHEM,MolecSynth,0,1,1,0,0,0,0,0,0,0,0,0,2,1,3,0,0,0,2,2,4
fa09,93,REVELLE,CHEM,Pharm Chem,5,21,26,2,0,2,5,11,16,6,12,18,14,21,35,0,0,0,32,65,97
fa09,93,REVELLE,CHIN,Chinese St,0,0,0,0,0,0,0,0,0,0,0,0,2,0,2,0,0,0,2,0,2
fa09,93,REVELLE,CLAS,Classic St,0,1,1,0,0,0,0,1,1,0,0,0,1,0,1,0,0,0,1,2,3
fa09,93,REVELLE,COGS,Cog Sci,0,3,3,0,0,0,1,3,4,5,2,7,3,2,5,0,0,0,9,10,19
fa09,93,REVELLE,COGS,CogSc/ClAs,0,0,0,0,1,1,0,2,2,0,1,1,1,0,1,0,0,0,1,4,5
fa09,93,REVELLE,COGS,CogSc/Comp,0,0,0,0,0,0,0,0,0,1,1,2,0,0,0,0,0,0,1,1,2
fa09,93,REVELLE,COGS,CogSc/HCI,0,0,0,0,0,0,0,0,0,0,1,1,3,1,4,0,0,0,3,2,5
fa09,93,REVELLE,COGS,CogSc/HCog,0,0,0,0,0,0,0,2,2,0,0,0,1,0,1,0,0,0,1,2,3
fa09,93,REVELLE,COGS,CogSc/Neur,0,1,1,0,0,0,0,2,2,3,3,6,2,9,11,0,0,0,5,15,20
fa09,93,REVELLE,COMM,Communic,1,7,8,0,1,1,1,10,11,10,14,24,10,22,32,0,0,0,22,54,76
fa09,93,REVELLE,CSE,Comp Sci,11,0,11,2,1,3,10,1,11,21,4,25,24,3,27,0,0,0,68,9,77
fa09,93,REVELLE,CSE,CompEngCSE,8,0,8,1,0,1,7,1,8,6,0,6,4,0,4,0,0,0,26,1,27
fa09,93,REVELLE,CSE,CompScBinf,0,0,0,0,0,0,0,0,0,0,0,0,1,0,1,0,0,0,1,0,1
fa09,93,REVELLE,ECE,CompEngECE,2,0,2,1,0,1,1,0,1,2,0,2,1,0,1,0,0,0,7,0,7
fa09,93,REVELLE,ECE,Electr Eng,11,2,13,0,0,0,1,0,1,11,1,12,27,3,30,0,0,0,50,6,56
fa09,93,REVELLE,ECE,Engin Phys,0,0,0,0,0,0,0,0,0,1,0,1,0,0,0,0,0,0,1,0,1
fa09,93,REVELLE,ECON,Ec-Mth&Ecn,2,0,2,0,0,0,1,0,1,4,0,4,2,0,2,0,0,0,9,0,9
fa09,93,REVELLE,ECON,Econ-MgtSc,2,4,6,1,0,1,10,2,12,19,11,30,27,18,45,0,0,0,59,35,94
fa09,93,REVELLE,ECON,Economics,8,5,13,1,0,1,11,8,19,37,20,57,38,28,66,0,0,0,95,61,156
fa09,93,REVELLE,ERTH,ErthSc-Phy,0,0,0,0,0,0,0,0,0,0,0,0,1,0,1,0,0,0,1,0,1
fa09,93,REVELLE,ESYS,EnvSys(EB),0,1,1,0,0,0,0,0,0,1,1,2,3,7,10,0,0,0,4,9,13
fa09,93,REVELLE,ESYS,EnvSys(EC),0,1,1,0,0,0,0,0,0,0,0,0,1,0,1,0,0,0,1,1,2
fa09,93,REVELLE,ESYS,EnvSys(EP),0,0,0,0,0,0,0,0,0,1,1,2,0,0,0,0,0,0,1,1,2
fa09,93,REVELLE,ESYS,EnvSys(ES),0,1,1,0,0,0,0,0,0,0,1,1,0,1,1,0,0,0,0,3,3
fa09,93,REVELLE,ETHN,Ethnic St,0,0,0,0,1,1,0,1,1,2,2,4,0,2,2,0,0,0,2,6,8
fa09,93,REVELLE,HDP,Human Dev,0,0,0,0,0,0,0,0,0,0,1,1,3,11,14,0,0,0,3,12,15
fa09,93,REVELLE,HDP,Pr-HumnDev,0,2,2,0,0,0,0,7,7,0,5,5,0,5,5,0,0,0,0,19,19
fa09,93,REVELLE,HIST,History,2,1,3,1,0,1,1,2,3,6,7,13,4,7,11,0,0,0,14,17,31
fa09,93,REVELLE,INTL,IntSt-Econ,0,1,1,0,0,0,2,3,5,3,4,7,4,3,7,0,0,0,9,11,20
fa09,93,REVELLE,INTL,IntSt-Hist,0,0,0,0,0,0,0,1,1,0,1,1,0,2,2,0,0,0,0,4,4
fa09,93,REVELLE,INTL,IntSt-Ling,0,0,0,0,0,0,0,0,0,0,2,2,0,1,1,0,0,0,0,3,3
fa09,93,REVELLE,INTL,IntSt-Lit,0,0,0,0,0,0,0,0,0,0,1,1,0,0,0,0,0,0,0,1,1
fa09,93,REVELLE,INTL,IntSt-PolS,1,3,4,0,0,0,0,2,2,1,1,2,3,7,10,0,0,0,5,13,18
fa09,93,REVELLE,INTL,IntSt-Soc,0,0,0,0,0,0,0,1,1,2,3,5,0,1,1,0,0,0,2,5,7
fa09,93,REVELLE,ITAL,Italian St,0,0,0,0,0,0,0,0,0,0,0,0,0,1,1,0,0,0,0,1,1
fa09,93,REVELLE,JAPN,JapaneseSt,1,1,2,0,0,0,0,0,0,1,0,1,1,0,1,0,0,0,3,1,4
fa09,93,REVELLE,JUDA,Judaic Stu,0,0,0,0,0,0,0,1,1,0,0,0,0,0,0,0,0,0,0,1,1
fa09,93,REVELLE,LING,Lang Stu,0,0,0,0,0,0,0,0,0,0,1,1,0,1,1,0,0,0,0,2,2
fa09,93,REVELLE,LING,Ling-CogLn,0,1,1,0,0,0,0,1,1,0,0,0,0,1,1,0,0,0,0,3,3
fa09,93,REVELLE,LING,Ling-LSoc,0,1,1,0,0,0,0,0,0,0,1,1,0,0,0,0,0,0,0,2,2
fa09,93,REVELLE,LING,Linguistcs,0,1,1,0,0,0,0,1,1,0,2,2,2,2,4,0,0,0,2,6,8
fa09,93,REVELLE,LIT,Ital Lit,0,0,0,0,0,0,0,0,0,0,0,0,0,1,1,0,0,0,0,1,1
fa09,93,REVELLE,LIT,Lit/Compos,0,0,0,0,0,0,0,1,1,1,1,2,0,0,0,0,0,0,1,2,3
fa09,93,REVELLE,LIT,Lit/CultSt,1,0,1,0,0,0,0,0,0,0,0,0,0,0,0,0,0,0,1,0,1
fa09,93,REVELLE,LIT,Lit/Engl,1,2,3,0,0,0,1,1,2,0,3,3,1,9,10,0,0,0,3,15,18
fa09,93,REVELLE,LIT,Lit/World,0,0,0,0,0,0,0,1,1,3,1,4,1,5,6,0,0,0,4,7,11
fa09,93,REVELLE,LIT,Lit/Writng,0,0,0,0,0,0,0,0,0,0,0,0,0,6,6,0,0,0,0,6,6
fa09,93,REVELLE,LIT,Pre-Lit/Wr,1,2,3,0,1,1,0,1,1,5,3,8,2,1,3,0,0,0,8,8,16
fa09,93,REVELLE,LIT,Spanish Lt,0,0,0,0,0,0,0,1,1,1,0,1,1,2,3,0,0,0,2,3,5
fa09,93,REVELLE,MAE,Aerosp Eng,7,1,8,0,0,0,10,2,12,10,2,12,21,5,26,0,0,0,48,10,58
fa09,93,REVELLE,MAE,Engin Sci,2,0,2,0,0,0,0,0,0,1,0,1,1,0,1,0,0,0,4,0,4
fa09,93,REVELLE,MAE,Envir Eng,4,0,4,0,0,0,0,1,1,2,0,2,1,1,2,0,0,0,7,2,9
fa09,93,REVELLE,MAE,Mech Engin,10,3,13,0,0,0,9,1,10,18,6,24,44,9,53,0,0,0,81,19,100
fa09,93,REVELLE,MATH,Appld Math,0,0,0,0,0,0,1,0,1,1,3,4,2,3,5,0,0,0,4,6,10
fa09,93,REVELLE,MATH,Math/SecEd,0,0,0,0,1,1,0,0,0,1,2,3,0,0,0,0,0,0,1,3,4
fa09,93,REVELLE,MATH,Mathematcs,3,2,5,0,0,0,1,0,1,3,7,10,9,5,14,0,0,0,16,14,30
fa09,93,REVELLE,MATH,Mth-CompSc,0,0,0,0,0,0,0,0,0,1,0,1,3,0,3,0,0,0,4,0,4
fa09,93,REVELLE,MATH,Mth-Mth&Ec,0,1,1,0,0,0,2,0,2,4,0,4,4,1,5,0,0,0,10,2,12
fa09,93,REVELLE,MATH,Mth-SciCom,0,0,0,0,0,0,0,0,0,0,0,0,1,1,2,0,0,0,1,1,2
fa09,93,REVELLE,MATH,Mth/ApldSc,1,1,2,0,0,0,0,0,0,1,0,1,1,0,1,0,0,0,3,1,4
fa09,93,REVELLE,MATH,Prob&Stats,2,0,2,0,0,0,1,0,1,1,0,1,0,1,1,0,0,0,4,1,5
fa09,93,REVELLE,MUS,Mu-CompArt,0,0,0,0,0,0,0,0,0,2,0,2,1,0,1,0,0,0,3,0,3
fa09,93,REVELLE,MUS,Music,0,0,0,0,0,0,2,0,2,2,1,3,2,1,3,0,0,0,6,2,8
fa09,93,REVELLE,MUS,Music Hum,0,0,0,0,0,0,0,0,0,0,0,0,1,0,1,0,0,0,1,0,1
fa09,93,REVELLE,PHIL,Philosophy,0,0,0,0,0,0,2,0,2,7,2,9,2,2,4,0,0,0,11,4,15
fa09,93,REVELLE,PHYS,Biophysics,2,0,2,0,0,0,0,0,0,0,1,1,1,0,1,0,0,0,3,1,4
fa09,93,REVELLE,PHYS,Gen Physcs,0,0,0,0,0,0,1,0,1,0,0,0,0,0,0,0,0,0,1,0,1
fa09,93,REVELLE,PHYS,Phy/ErthSc,0,0,0,0,0,0,0,0,0,1,0,1,0,0,0,0,0,0,1,0,1
fa09,93,REVELLE,PHYS,Phys/Astro,1,0,1,0,0,0,0,1,1,1,0,1,2,4,6,0,0,0,4,5,9
fa09,93,REVELLE,PHYS,Phys/Comp,0,0,0,0,0,0,1,0,1,0,0,0,0,0,0,0,0,0,1,0,1
fa09,93,REVELLE,PHYS,Phys/Mtrls,2,0,2,0,0,0,0,0,0,0,0,0,1,0,1,0,0,0,3,0,3
fa09,93,REVELLE,PHYS,Physics,2,2,4,0,0,0,2,0,2,5,1,6,5,2,7,0,0,0,14,5,19
fa09,93,REVELLE,POLI,Polit Sci,4,5,9,0,1,1,5,1,6,11,2,13,10,7,17,0,0,0,30,16,46
fa09,93,REVELLE,POLI,PolSc-Amer,1,5,6,0,0,0,1,0,1,0,1,1,0,1,1,0,0,0,2,7,9
fa09,93,REVELLE,POLI,PolSc-Comp,0,0,0,0,0,0,0,0,0,1,0,1,0,0,0,0,0,0,1,0,1
fa09,93,REVELLE,POLI,PolSc-Intl,0,0,0,0,0,0,1,3,4,8,7,15,3,2,5,0,0,0,12,12,24
fa09,93,REVELLE,POLI,PolSc-PLaw,0,0,0,0,0,0,2,1,3,5,8,13,1,2,3,0,0,0,8,11,19
fa09,93,REVELLE,POLI,PolSc-PPol,0,0,0,0,0,0,0,0,0,0,4,4,0,0,0,0,0,0,0,4,4
fa09,93,REVELLE,POLI,PolSc-Thry,0,0,0,0,0,0,0,0,0,0,0,0,0,2,2,0,0,0,0,2,2
fa09,93,REVELLE,PSYC,Psychology,7,18,25,0,8,8,6,26,32,22,47,69,35,65,100,0,0,0,70,164,234
fa09,93,REVELLE,RELI,Relig/Stu,1,0,1,0,0,0,0,0,0,0,0,0,0,0,0,0,0,0,1,0,1
fa09,93,REVELLE,SE,Engin Sci,0,0,0,0,0,0,0,0,0,0,0,0,1,0,1,0,0,0,1,0,1
fa09,93,REVELLE,SE,Struct Eng,6,2,8,0,0,0,4,2,6,15,5,20,21,9,30,0,0,0,46,18,64
fa09,93,REVELLE,SIO,ErSc-Geoch,0,0,0,0,0,0,0,0,0,0,1,1,0,0,0,0,0,0,0,1,1
fa09,93,REVELLE,SIO,ErSc-Geol,0,0,0,0,0,0,0,0,0,1,1,2,2,1,3,0,0,0,3,2,5
fa09,93,REVELLE,SOC,SocEconSoc,0,0,0,0,0,0,0,0,0,1,0,1,0,0,0,0,0,0,1,0,1
fa09,93,REVELLE,SOC,Sociology,0,2,2,0,0,0,0,2,2,5,12,17,0,5,5,0,0,0,5,21,26
fa09,93,REVELLE,SOC,SocSciMed,0,0,0,0,0,0,0,0,0,0,0,0,0,1,1,0,0,0,0,1,1
fa09,93,REVELLE,THEA,Dance,0,0,0,0,0,0,0,1,1,0,1,1,1,0,1,0,0,0,1,2,3
fa09,93,REVELLE,THEA,Theatre,0,0,0,0,0,0,0,1,1,0,0,0,2,4,6,0,0,0,2,5,7
fa09,93,REVELLE,TWS,ThirdWldSt,0,0,0,0,0,0,0,1,1,0,0,0,0,0,0,0,0,0,0,1,1
fa09,93,REVELLE,UNAF,Limited St,0,0,0,0,0,0,0,0,0,0,0,0,0,0,0,7,6,13,7,6,13
fa09,93,REVELLE,UNAF,Spec-Emply,0,0,0,0,0,0,0,0,0,0,0,0,0,0,0,3,3,6,3,3,6
fa09,93,REVELLE,UNAF,UndecHumAr,0,7,7,0,0,0,0,2,2,0,1,1,0,0,0,0,0,0,0,10,10
fa09,93,REVELLE,UNAF,Undeclared,34,64,98,0,3,3,7,9,16,0,0,0,0,0,0,0,0,0,41,76,117
fa09,93,REVELLE,UNAF,UndecPhysS,8,13,21,0,0,0,3,2,5,0,0,0,0,0,0,0,0,0,11,15,26
fa09,93,REVELLE,UNAF,UndecSocSc,4,5,9,0,0,0,2,1,3,0,0,0,0,0,0,0,0,0,6,6,12
fa09,93,REVELLE,USP,Urb Stu&Pl,1,1,2,1,0,1,1,2,3,0,2,2,2,2,4,0,0,0,5,7,12
fa09,93,REVELLE,VIS,Art Hst/Cr,0,2,2,0,0,0,0,2,2,0,1,1,1,2,3,0,0,0,1,7,8
fa09,93,REVELLE,VIS,Media,1,1,2,0,0,0,2,2,4,3,1,4,2,6,8,0,0,0,8,10,18
fa09,93,REVELLE,VIS,Studio VA,0,0,0,0,0,0,0,1,1,1,3,4,0,1,1,0,0,0,1,5,6
fa09,93,REVELLE,VIS,VA-CompArt,0,0,0,0,0,0,1,0,1,4,2,6,1,0,1,0,0,0,6,2,8
fa09,93,ROOSEVELT,ANTH,Anth-Arch,0,1,1,0,0,0,0,4,4,0,2,2,4,7,11,0,0,0,4,14,18
fa09,93,ROOSEVELT,ANTH,Anth-Biol,0,1,1,0,0,0,0,3,3,1,6,7,0,5,5,0,0,0,1,15,16
fa09,93,ROOSEVELT,ANTH,Anth-Soci,1,2,3,0,1,1,1,1,2,3,3,6,1,4,5,0,0,0,6,11,17
fa09,93,ROOSEVELT,ANTH,Anthropol,0,0,0,0,0,0,0,0,0,0,0,0,0,1,1,0,0,0,0,1,1
fa09,93,ROOSEVELT,BENG,Bioen:Binf,0,0,0,0,0,0,0,0,0,0,1,1,0,0,0,0,0,0,0,1,1
fa09,93,ROOSEVELT,BENG,Bioeng:PM,0,0,0,0,0,0,2,0,2,2,0,2,7,6,13,0,0,0,11,6,17
fa09,93,ROOSEVELT,BENG,BioengBiot,3,1,4,1,0,1,0,4,4,3,1,4,2,1,3,0,0,0,9,7,16
fa09,93,ROOSEVELT,BENG,Bioengin,0,2,2,0,0,0,3,0,3,5,7,12,2,2,4,0,0,0,10,11,21
fa09,93,ROOSEVELT,BENG,Pr-BioenPM,15,4,19,0,0,0,5,3,8,1,3,4,1,0,1,0,0,0,22,10,32
fa09,93,ROOSEVELT,BIOL,Bioc/CellB,3,4,7,2,0,2,5,11,16,15,20,35,23,30,53,0,0,0,48,65,113
fa09,93,ROOSEVELT,BIOL,Ec/Beh/Evo,2,1,3,0,0,0,0,3,3,2,3,5,1,5,6,0,0,0,5,12,17
fa09,93,ROOSEVELT,BIOL,Genl Biol,5,9,14,0,1,1,5,10,15,17,38,55,25,47,72,0,0,0,52,105,157
fa09,93,ROOSEVELT,BIOL,Human Bio,11,25,36,4,5,9,19,54,73,31,54,85,27,50,77,0,0,0,92,188,280
fa09,93,ROOSEVELT,BIOL,Microbiol,1,2,3,0,0,0,2,0,2,3,1,4,3,4,7,0,0,0,9,7,16
fa09,93,ROOSEVELT,BIOL,Molec Biol,2,2,4,0,0,0,1,3,4,5,0,5,5,9,14,0,0,0,13,14,27
fa09,93,ROOSEVELT,BIOL,PhyslNeuro,3,6,9,0,0,0,4,9,13,8,9,17,16,20,36,0,0,0,31,44,75
fa09,93,ROOSEVELT,CENG,Chem Engin,5,1,6,1,0,1,0,1,1,1,1,2,4,4,8,0,0,0,11,7,18
fa09,93,ROOSEVELT,CGS,CritGendSt,0,0,0,0,0,0,0,0,0,0,0,0,0,1,1,0,0,0,0,1,1
fa09,93,ROOSEVELT,CHEM,Bioch/Chem,12,13,25,0,0,0,5,4,9,6,5,11,7,4,11,0,0,0,30,26,56
fa09,93,ROOSEVELT,CHEM,Chemistry,3,3,6,1,0,1,0,0,0,2,3,5,3,0,3,0,0,0,9,6,15
fa09,93,ROOSEVELT,CHEM,Envir Chem,0,1,1,0,0,0,2,0,2,0,0,0,0,2,2,0,0,0,2,3,5
fa09,93,ROOSEVELT,CHEM,Pharm Chem,1,12,13,0,0,0,5,4,9,4,3,7,4,2,6,0,0,0,14,21,35
fa09,93,ROOSEVELT,CHIN,Chinese St,1,2,3,0,0,0,0,1,1,1,0,1,5,2,7,0,0,0,7,5,12
fa09,93,ROOSEVELT,CLAS,Classic St,0,1,1,0,0,0,0,0,0,0,0,0,2,0,2,0,0,0,2,1,3
fa09,93,ROOSEVELT,COGS,Cog Sci,1,5,6,0,0,0,2,1,3,3,3,6,4,4,8,0,0,0,10,13,23
fa09,93,ROOSEVELT,COGS,CogSc/ClAs,0,0,0,0,0,0,0,0,0,0,1,1,0,0,0,0,0,0,0,1,1
fa09,93,ROOSEVELT,COGS,CogSc/HCI,0,0,0,0,0,0,1,0,1,1,0,1,3,3,6,0,0,0,5,3,8
fa09,93,ROOSEVELT,COGS,CogSc/HCog,1,0,1,0,0,0,1,3,4,0,1,1,0,1,1,0,0,0,2,5,7
fa09,93,ROOSEVELT,COGS,CogSc/Neur,0,0,0,0,1,1,2,4,6,0,4,4,2,11,13,0,0,0,4,20,24
fa09,93,ROOSEVELT,COMM,Communic,1,15,16,2,3,5,10,23,33,19,47,66,19,54,73,0,0,0,51,142,193
fa09,93,ROOSEVELT,CSE,Comp Sci,9,4,13,0,0,0,10,0,10,9,2,11,20,3,23,0,0,0,48,9,57
fa09,93,ROOSEVELT,CSE,CompEngCSE,3,0,3,1,0,1,1,1,2,3,1,4,3,0,3,0,0,0,11,2,13
fa09,93,ROOSEVELT,CSE,Pr-Comp Sc,0,0,0,0,0,0,0,1,1,0,0,0,0,0,0,0,0,0,0,1,1
fa09,93,ROOSEVELT,ECE,CompEngECE,2,0,2,0,0,0,2,0,2,1,0,1,1,0,1,0,0,0,6,0,6
fa09,93,ROOSEVELT,ECE,Electr Eng,5,0,5,0,0,0,2,2,4,6,2,8,18,5,23,0,0,0,31,9,40
fa09,93,ROOSEVELT,ECE,Pr-EngPhys,1,0,1,0,0,0,1,0,1,0,0,0,0,0,0,0,0,0,2,0,2
fa09,93,ROOSEVELT,ECON,Ec-Mth&Ecn,3,3,6,0,0,0,0,1,1,8,1,9,3,3,6,0,0,0,14,8,22
fa09,93,ROOSEVELT,ECON,Econ-MgtSc,7,5,12,2,1,3,16,14,30,28,19,47,46,25,71,0,0,0,99,64,163
fa09,93,ROOSEVELT,ECON,Economics,7,17,24,2,1,3,19,11,30,57,28,85,60,34,94,0,0,0,145,91,236
fa09,93,ROOSEVELT,ERTH,ErSc-Geol,0,0,0,0,0,0,0,0,0,0,0,0,0,1,1,0,0,0,0,1,1
fa09,93,ROOSEVELT,ESYS,EnvSys(EB),0,2,2,1,0,1,0,1,1,1,5,6,2,5,7,0,0,0,4,13,17
fa09,93,ROOSEVELT,ESYS,EnvSys(EC),0,0,0,0,0,0,0,1,1,0,0,0,1,2,3,0,0,0,1,3,4
fa09,93,ROOSEVELT,ESYS,EnvSys(EP),0,0,0,0,0,0,0,2,2,3,2,5,1,1,2,0,0,0,4,5,9
fa09,93,ROOSEVELT,ESYS,EnvSys(ES),0,1,1,0,0,0,0,2,2,0,0,0,3,1,4,0,0,0,3,4,7
fa09,93,ROOSEVELT,ETHN,Ethnic St,0,1,1,0,0,0,0,0,0,0,5,5,0,13,13,0,0,0,0,19,19
fa09,93,ROOSEVELT,HDP,Human Dev,0,0,0,0,0,0,0,0,0,0,6,6,2,15,17,0,0,0,2,21,23
fa09,93,ROOSEVELT,HDP,Pr-HumnDev,3,6,9,0,1,1,0,5,5,1,7,8,0,4,4,0,0,0,4,23,27
fa09,93,ROOSEVELT,HIST,History,3,5,8,0,0,0,2,6,8,12,17,29,17,21,38,0,0,0,34,49,83
fa09,93,ROOSEVELT,INTD,Roos IndSt,0,0,0,0,0,0,0,0,0,0,0,0,1,0,1,0,0,0,1,0,1
fa09,93,ROOSEVELT,INTL,Int-5yrEC,0,0,0,0,0,0,0,0,0,0,0,0,0,1,1,0,0,0,0,1,1
fa09,93,ROOSEVELT,INTL,IntSt-Anth,0,2,2,0,0,0,0,3,3,1,4,5,0,6,6,0,0,0,1,15,16
fa09,93,ROOSEVELT,INTL,IntSt-Econ,5,12,17,0,0,0,5,14,19,17,21,38,17,26,43,0,0,0,44,73,117
fa09,93,ROOSEVELT,INTL,IntSt-Hist,1,0,1,0,0,0,1,3,4,4,5,9,2,6,8,0,0,0,8,14,22
fa09,93,ROOSEVELT,INTL,IntSt-Ling,0,4,4,0,0,0,0,2,2,0,2,2,2,4,6,0,0,0,2,12,14
fa09,93,ROOSEVELT,INTL,IntSt-Lit,0,1,1,0,0,0,0,0,0,0,1,1,0,2,2,0,0,0,0,4,4
fa09,93,ROOSEVELT,INTL,IntSt-PolS,1,14,15,0,2,2,4,19,23,5,32,37,21,35,56,0,0,0,31,102,133
fa09,93,ROOSEVELT,INTL,IntSt-Soc,0,5,5,0,1,1,0,10,10,2,11,13,1,24,25,0,0,0,3,51,54
fa09,93,ROOSEVELT,ITAL,Italian St,0,0,0,0,0,0,0,1,1,1,0,1,0,0,0,0,0,0,1,1,2
fa09,93,ROOSEVELT,JAPN,JapaneseSt,1,1,2,0,0,0,0,1,1,1,1,2,1,3,4,0,0,0,3,6,9
fa09,93,ROOSEVELT,JUDA,Judaic Stu,0,0,0,0,0,0,1,0,1,0,0,0,0,1,1,0,0,0,1,1,2
fa09,93,ROOSEVELT,LATI,LatinAm St,0,1,1,0,0,0,0,0,0,0,2,2,2,1,3,0,0,0,2,4,6
fa09,93,ROOSEVELT,LING,Lang Stu,0,1,1,0,0,0,0,2,2,0,2,2,0,2,2,0,0,0,0,7,7
fa09,93,ROOSEVELT,LING,Ling-CogLn,0,0,0,0,0,0,0,1,1,0,0,0,0,1,1,0,0,0,0,2,2
fa09,93,ROOSEVELT,LING,Ling-LSoc,0,1,1,0,0,0,0,0,0,1,0,1,0,3,3,0,0,0,1,4,5
fa09,93,ROOSEVELT,LING,Linguistcs,1,0,1,0,0,0,0,3,3,1,3,4,0,0,0,0,0,0,2,6,8
fa09,93,ROOSEVELT,LIT,French Lit,0,0,0,0,0,0,0,0,0,1,0,1,0,1,1,0,0,0,1,1,2
fa09,93,ROOSEVELT,LIT,Lit/Compos,1,0,1,0,0,0,0,0,0,1,1,2,0,1,1,0,0,0,2,2,4
fa09,93,ROOSEVELT,LIT,Lit/CultSt,0,0,0,0,0,0,0,1,1,0,2,2,0,0,0,0,0,0,0,3,3
fa09,93,ROOSEVELT,LIT,Lit/Engl,1,3,4,0,1,1,1,7,8,7,4,11,2,5,7,0,0,0,11,20,31
fa09,93,ROOSEVELT,LIT,Lit/World,0,0,0,0,0,0,0,2,2,0,0,0,2,1,3,0,0,0,2,3,5
fa09,93,ROOSEVELT,LIT,Lit/Writng,0,0,0,0,0,0,0,0,0,0,3,3,3,11,14,0,0,0,3,14,17
fa09,93,ROOSEVELT,LIT,Pre-Lit/Wr,0,4,4,0,1,1,2,5,7,5,5,10,1,4,5,0,0,0,8,19,27
fa09,93,ROOSEVELT,LIT,Spanish Lt,0,0,0,0,0,0,0,0,0,1,0,1,0,2,2,0,0,0,1,2,3
fa09,93,ROOSEVELT,MAE,Aerosp Eng,9,1,10,0,0,0,4,0,4,7,2,9,10,3,13,0,0,0,30,6,36
fa09,93,ROOSEVELT,MAE,Engin Sci,0,1,1,0,0,0,1,0,1,0,0,0,1,0,1,0,0,0,2,1,3
fa09,93,ROOSEVELT,MAE,Envir Eng,2,2,4,0,0,0,2,0,2,0,1,1,2,2,4,0,0,0,6,5,11
fa09,93,ROOSEVELT,MAE,Mech Engin,5,2,7,2,0,2,11,0,11,11,3,14,20,9,29,0,0,0,49,14,63
fa09,93,ROOSEVELT,MATH,Appld Math,0,0,0,0,0,0,0,0,0,0,1,1,3,2,5,0,0,0,3,3,6
fa09,93,ROOSEVELT,MATH,Math/SecEd,1,1,2,0,1,1,0,0,0,1,0,1,1,0,1,0,0,0,3,2,5
fa09,93,ROOSEVELT,MATH,Mathematcs,1,3,4,0,1,1,2,1,3,1,1,2,1,4,5,0,0,0,5,10,15
fa09,93,ROOSEVELT,MATH,Mth-CompSc,0,0,0,0,0,0,0,0,0,0,0,0,2,1,3,0,0,0,2,1,3
fa09,93,ROOSEVELT,MATH,Mth-Mth&Ec,1,0,1,0,0,0,3,0,3,2,0,2,4,1,5,0,0,0,10,1,11
fa09,93,ROOSEVELT,MATH,Mth-SciCom,1,0,1,0,0,0,0,0,0,0,0,0,0,0,0,0,0,0,1,0,1
fa09,93,ROOSEVELT,MATH,Mth/ApldSc,0,0,0,0,0,0,0,0,0,0,0,0,2,0,2,0,0,0,2,0,2
fa09,93,ROOSEVELT,MATH,Pr-Math CS,0,1,1,1,0,1,0,0,0,1,0,1,0,0,0,0,0,0,2,1,3
fa09,93,ROOSEVELT,MATH,Prob&Stats,0,0,0,1,0,1,1,0,1,0,0,0,0,0,0,0,0,0,2,0,2
fa09,93,ROOSEVELT,MUS,Mu-CompArt,0,0,0,0,0,0,0,1,1,3,0,3,2,1,3,0,0,0,5,2,7
fa09,93,ROOSEVELT,MUS,Music,1,2,3,0,0,0,3,0,3,3,2,5,4,2,6,0,0,0,11,6,17
fa09,93,ROOSEVELT,PHIL,Philosophy,0,0,0,0,0,0,3,0,3,0,3,3,2,2,4,0,0,0,5,5,10
fa09,93,ROOSEVELT,PHYS,Biophysics,0,0,0,0,0,0,0,0,0,0,1,1,1,0,1,0,0,0,1,1,2
fa09,93,ROOSEVELT,PHYS,GenPys/SEd,0,0,0,0,0,0,0,0,0,0,1,1,0,0,0,0,0,0,0,1,1
fa09,93,ROOSEVELT,PHYS,Phys/Astro,0,0,0,0,0,0,1,0,1,1,1,2,0,0,0,0,0,0,2,1,3
fa09,93,ROOSEVELT,PHYS,Phys/Comp,0,0,0,0,0,0,0,0,0,0,0,0,1,1,2,0,0,0,1,1,2
fa09,93,ROOSEVELT,PHYS,Phys/Mtrls,1,0,1,0,0,0,0,0,0,0,0,0,0,0,0,0,0,0,1,0,1
fa09,93,ROOSEVELT,PHYS,Physics,0,1,1,0,0,0,0,0,0,3,3,6,2,1,3,0,0,0,5,5,10
fa09,93,ROOSEVELT,POLI,Polit Sci,3,6,9,1,1,2,9,7,16,16,24,40,24,25,49,0,0,0,53,63,116
fa09,93,ROOSEVELT,POLI,PolSc-Amer,2,4,6,0,0,0,1,2,3,1,3,4,1,2,3,0,0,0,5,11,16
fa09,93,ROOSEVELT,POLI,PolSc-Comp,0,0,0,0,0,0,0,1,1,0,2,2,0,1,1,0,0,0,0,4,4
fa09,93,ROOSEVELT,POLI,PolSc-Intl,8,8,16,1,0,1,7,5,12,15,16,31,13,23,36,0,0,0,44,52,96
fa09,93,ROOSEVELT,POLI,PolSc-PLaw,4,4,8,0,0,0,3,4,7,4,14,18,7,8,15,0,0,0,18,30,48
fa09,93,ROOSEVELT,POLI,PolSc-PPol,2,2,4,0,0,0,0,1,1,1,2,3,2,0,2,0,0,0,5,5,10
fa09,93,ROOSEVELT,POLI,PolSc-Thry,0,0,0,0,0,0,0,0,0,1,1,2,0,2,2,0,0,0,1,3,4
fa09,93,ROOSEVELT,PSYC,Psychology,8,27,35,3,4,7,8,31,39,19,68,87,20,66,86,0,0,0,58,196,254
fa09,93,ROOSEVELT,RELI,Relig/Stu,0,1,1,0,0,0,0,0,0,0,1,1,0,1,1,0,0,0,0,3,3
fa09,93,ROOSEVELT,RUSS,Russ&SovSt,0,0,0,0,0,0,1,0,1,0,0,0,1,0,1,0,0,0,2,0,2
fa09,93,ROOSEVELT,SE,Engin Sci,1,2,3,0,0,0,0,1,1,0,0,0,0,0,0,0,0,0,1,3,4
fa09,93,ROOSEVELT,SE,Struct Eng,4,5,9,3,0,3,10,0,10,10,2,12,16,8,24,0,0,0,43,15,58
fa09,93,ROOSEVELT,SIO,ErSc-Geol,0,0,0,0,0,0,1,1,2,0,1,1,0,0,0,0,0,0,1,2,3
fa09,93,ROOSEVELT,SIO,ErSc-Geoph,0,1,1,0,0,0,0,0,0,0,0,0,0,0,0,0,0,0,0,1,1
fa09,93,ROOSEVELT,SOC,SocCulCom,0,0,0,0,0,0,1,0,1,0,0,0,1,2,3,0,0,0,2,2,4
fa09,93,ROOSEVELT,SOC,SocEconSoc,0,0,0,0,0,0,0,0,0,1,0,1,0,1,1,0,0,0,1,1,2
fa09,93,ROOSEVELT,SOC,Sociology,1,6,7,0,0,0,0,10,10,8,17,25,5,22,27,0,0,0,14,55,69
fa09,93,ROOSEVELT,SOC,SocLawSoc,0,0,0,0,0,0,1,0,1,2,1,3,0,0,0,0,0,0,3,1,4
fa09,93,ROOSEVELT,SOC,SocSciMed,0,0,0,0,0,0,0,0,0,1,1,2,0,0,0,0,0,0,1,1,2
fa09,93,ROOSEVELT,SOC,SocSolneq,0,0,0,0,0,0,0,0,0,0,3,3,1,1,2,0,0,0,1,4,5
fa09,93,ROOSEVELT,THEA,Dance,0,1,1,0,0,0,0,0,0,0,0,0,0,1,1,0,0,0,0,2,2
fa09,93,ROOSEVELT,THEA,Theatre,0,2,2,0,0,0,0,4,4,3,3,6,2,8,10,0,0,0,5,17,22
fa09,93,ROOSEVELT,TWS,ThirdWldSt,0,1,1,0,0,0,0,1,1,1,1,2,0,4,4,0,0,0,1,7,8
fa09,93,ROOSEVELT,UNAF,UndecHumAr,1,12,13,0,0,0,0,4,4,0,0,0,0,0,0,0,0,0,1,16,17
fa09,93,ROOSEVELT,UNAF,Undeclared,21,63,84,1,3,4,8,22,30,0,0,0,0,0,0,0,0,0,30,88,118
fa09,93,ROOSEVELT,UNAF,UndecPhysS,6,7,13,0,0,0,1,1,2,0,0,0,0,0,0,0,0,0,7,8,15
fa09,93,ROOSEVELT,UNAF,UndecSocSc,3,12,15,0,0,0,0,5,5,1,1,2,0,0,0,0,0,0,4,18,22
fa09,93,ROOSEVELT,USP,Urb Stu&Pl,1,1,2,0,0,0,1,5,6,5,8,13,3,9,12,0,0,0,10,23,33
fa09,93,ROOSEVELT,VIS,Art Hst/Cr,0,0,0,0,0,0,0,1,1,0,1,1,2,9,11,0,0,0,2,11,13
fa09,93,ROOSEVELT,VIS,Media,0,0,0,0,0,0,0,6,6,5,9,14,9,13,22,0,0,0,14,28,42
fa09,93,ROOSEVELT,VIS,Studio VA,0,3,3,0,2,2,0,0,0,2,5,7,1,4,5,0,0,0,3,14,17
fa09,93,ROOSEVELT,VIS,VA-CompArt,0,3,3,0,0,0,0,1,1,1,2,3,2,0,2,0,0,0,3,6,9
fa09,93,SIXTH,ANTH,Anth-Arch,0,0,0,0,0,0,0,0,0,0,0,0,4,2,6,0,0,0,4,2,6
fa09,93,SIXTH,ANTH,Anth-Biol,0,2,2,0,0,0,0,2,2,1,1,2,1,3,4,0,0,0,2,8,10
fa09,93,SIXTH,ANTH,Anth-Soci,1,2,3,0,0,0,0,0,0,0,5,5,2,3,5,0,0,0,3,10,13
fa09,93,SIXTH,BENG,Bioen:Binf,1,0,1,0,0,0,0,0,0,1,0,1,3,0,3,0,0,0,5,0,5
fa09,93,SIXTH,BENG,Bioeng:PM,0,0,0,0,0,0,1,0,1,1,0,1,12,5,17,0,0,0,14,5,19
fa09,93,SIXTH,BENG,BioengBiot,2,5,7,0,0,0,4,1,5,4,1,5,5,3,8,0,0,0,15,10,25
fa09,93,SIXTH,BENG,Bioengin,3,2,5,0,0,0,1,0,1,2,1,3,6,1,7,0,0,0,12,4,16
fa09,93,SIXTH,BENG,Pr-BioenPM,16,6,22,0,0,0,1,1,2,2,0,2,1,0,1,0,0,0,20,7,27
fa09,93,SIXTH,BIOL,Bioc/CellB,3,3,6,0,2,2,10,10,20,14,21,35,33,33,66,0,0,0,60,69,129
fa09,93,SIXTH,BIOL,BiolBioinf,0,0,0,0,0,0,0,0,0,0,0,0,0,1,1,0,0,0,0,1,1
fa09,93,SIXTH,BIOL,Ec/Beh/Evo,0,0,0,0,0,0,1,1,2,2,8,10,1,7,8,0,0,0,4,16,20
fa09,93,SIXTH,BIOL,Genl Biol,4,6,10,1,2,3,5,7,12,24,32,56,29,31,60,0,0,0,63,78,141
fa09,93,SIXTH,BIOL,Human Bio,7,7,14,9,2,11,25,39,64,27,39,66,38,48,86,0,0,0,106,135,241
fa09,93,SIXTH,BIOL,Microbiol,1,0,1,0,0,0,2,1,3,7,6,13,3,2,5,0,0,0,13,9,22
fa09,93,SIXTH,BIOL,Molec Biol,0,1,1,0,0,0,1,1,2,7,6,13,6,3,9,0,0,0,14,11,25
fa09,93,SIXTH,BIOL,PhyslNeuro,1,2,3,1,0,1,6,7,13,7,7,14,18,11,29,0,0,0,33,27,60
fa09,93,SIXTH,CENG,Chem Engin,10,0,10,0,0,0,5,0,5,14,0,14,9,6,15,0,0,0,38,6,44
fa09,93,SIXTH,CGS,CritGendSt,0,0,0,0,0,0,0,0,0,0,0,0,0,1,1,0,0,0,0,1,1
fa09,93,SIXTH,CHEM,Bioch/Chem,14,10,24,1,0,1,4,2,6,5,3,8,7,12,19,0,0,0,31,27,58
fa09,93,SIXTH,CHEM,Chem Educ,0,0,0,0,0,0,0,0,0,1,0,1,0,0,0,0,0,0,1,0,1
fa09,93,SIXTH,CHEM,Chem Phys,0,0,0,0,0,0,0,0,0,0,0,0,0,1,1,0,0,0,0,1,1
fa09,93,SIXTH,CHEM,Chemistry,3,4,7,0,1,1,1,0,1,2,2,4,9,2,11,0,0,0,15,9,24
fa09,93,SIXTH,CHEM,Envir Chem,1,0,1,0,0,0,0,0,0,1,0,1,1,1,2,0,0,0,3,1,4
fa09,93,SIXTH,CHEM,MolecSynth,0,0,0,0,0,0,0,0,0,0,0,0,2,1,3,0,0,0,2,1,3
fa09,93,SIXTH,CHEM,Pharm Chem,2,11,13,0,1,1,5,5,10,3,10,13,9,8,17,0,0,0,19,35,54
fa09,93,SIXTH,CHIN,Chinese St,0,1,1,0,0,0,0,0,0,0,0,0,0,0,0,0,0,0,0,1,1
fa09,93,SIXTH,CLAS,Classic St,0,0,0,0,0,0,0,1,1,0,0,0,1,0,1,0,0,0,1,1,2
fa09,93,SIXTH,COGS,Cog Sci,4,4,8,0,0,0,3,1,4,9,3,12,4,5,9,0,0,0,20,13,33
fa09,93,SIXTH,COGS,CogSc/Comp,0,0,0,0,0,0,0,0,0,0,0,0,2,0,2,0,0,0,2,0,2
fa09,93,SIXTH,COGS,CogSc/HCI,0,0,0,0,0,0,0,0,0,1,1,2,9,2,11,0,0,0,10,3,13
fa09,93,SIXTH,COGS,CogSc/HCog,1,0,1,0,0,0,0,0,0,0,0,0,0,0,0,0,0,0,1,0,1
fa09,93,SIXTH,COGS,CogSc/Neur,2,2,4,0,0,0,1,2,3,0,5,5,2,1,3,0,0,0,5,10,15
fa09,93,SIXTH,COMM,Communic,2,12,14,0,0,0,3,14,17,17,40,57,20,45,65,0,0,0,42,111,153
fa09,93,SIXTH,CSE,Comp Sci,20,7,27,1,0,1,16,5,21,29,6,35,41,12,53,0,0,0,107,30,137
fa09,93,SIXTH,CSE,CompEngCSE,7,3,10,0,0,0,7,0,7,14,0,14,10,3,13,0,0,0,38,6,44
fa09,93,SIXTH,CSE,CompScBinf,0,0,0,0,0,0,2,0,2,0,0,0,1,1,2,0,0,0,3,1,4
fa09,93,SIXTH,ECE,CompEngECE,3,0,3,0,0,0,4,0,4,3,0,3,5,0,5,0,0,0,15,0,15
fa09,93,SIXTH,ECE,Electr Eng,15,0,15,0,0,0,11,2,13,24,0,24,34,5,39,0,0,0,84,7,91
fa09,93,SIXTH,ECE,Pr-EngPhys,3,1,4,0,0,0,0,0,0,0,0,0,1,0,1,0,0,0,4,1,5
fa09,93,SIXTH,ECON,Ec-Mth&Ecn,3,2,5,0,1,1,1,3,4,5,1,6,6,1,7,0,0,0,15,8,23
fa09,93,SIXTH,ECON,Econ-MgtSc,2,2,4,3,1,4,12,5,17,36,22,58,50,23,73,0,0,0,103,53,156
fa09,93,SIXTH,ECON,Economics,10,2,12,5,1,6,25,5,30,55,34,89,51,37,88,0,0,0,146,79,225
fa09,93,SIXTH,ESYS,EnvSys(EB),0,5,5,0,0,0,0,2,2,2,4,6,4,5,9,0,0,0,6,16,22
fa09,93,SIXTH,ESYS,EnvSys(EC),0,0,0,0,0,0,0,0,0,0,0,0,2,0,2,0,0,0,2,0,2
fa09,93,SIXTH,ESYS,EnvSys(EP),0,2,2,0,0,0,2,2,4,1,0,1,0,1,1,0,0,0,3,5,8
fa09,93,SIXTH,ESYS,EnvSys(ES),0,1,1,1,0,1,0,0,0,0,1,1,1,1,2,0,0,0,2,3,5
fa09,93,SIXTH,ETHN,Ethnic St,0,0,0,0,0,0,1,1,2,0,0,0,4,5,9,0,0,0,5,6,11
fa09,93,SIXTH,HDP,Human Dev,0,0,0,0,0,0,0,0,0,0,7,7,2,10,12,0,0,0,2,17,19
fa09,93,SIXTH,HDP,Pr-HumnDev,0,2,2,0,3,3,0,9,9,1,2,3,0,2,2,0,0,0,1,18,19
fa09,93,SIXTH,HIST,History,0,2,2,0,0,0,0,0,0,2,8,10,8,3,11,0,0,0,10,13,23
fa09,93,SIXTH,INTL,IntSt-Anth,0,0,0,0,0,0,0,0,0,0,3,3,0,0,0,0,0,0,0,3,3
fa09,93,SIXTH,INTL,IntSt-Econ,1,3,4,0,0,0,2,5,7,2,6,8,8,8,16,0,0,0,13,22,35
fa09,93,SIXTH,INTL,IntSt-Hist,0,0,0,0,0,0,0,1,1,1,2,3,1,2,3,0,0,0,2,5,7
fa09,93,SIXTH,INTL,IntSt-Ling,0,1,1,0,0,0,0,0,0,0,1,1,2,0,2,0,0,0,2,2,4
fa09,93,SIXTH,INTL,IntSt-Lit,0,0,0,0,0,0,0,0,0,0,0,0,0,1,1,0,0,0,0,1,1
fa09,93,SIXTH,INTL,IntSt-PolS,5,2,7,0,0,0,0,3,3,7,11,18,7,6,13,0,0,0,19,22,41
fa09,93,SIXTH,INTL,IntSt-Soc,0,2,2,0,0,0,0,2,2,1,6,7,2,2,4,0,0,0,3,12,15
fa09,93,SIXTH,ITAL,Italian St,0,0,0,0,0,0,0,1,1,0,2,2,0,0,0,0,0,0,0,3,3
fa09,93,SIXTH,JAPN,JapaneseSt,1,0,1,0,0,0,0,1,1,1,1,2,2,1,3,0,0,0,4,3,7
fa09,93,SIXTH,LATI,LatinAm St,0,0,0,0,0,0,0,0,0,0,0,0,1,0,1,0,0,0,1,0,1
fa09,93,SIXTH,LING,Lang Stu,1,0,1,0,0,0,0,0,0,0,0,0,0,0,0,0,0,0,1,0,1
fa09,93,SIXTH,LING,Ling-CogLn,0,0,0,0,0,0,0,0,0,0,1,1,1,3,4,0,0,0,1,4,5
fa09,93,SIXTH,LING,Ling-LSoc,0,0,0,0,0,0,0,0,0,0,0,0,0,1,1,0,0,0,0,1,1
fa09,93,SIXTH,LING,Linguistcs,0,1,1,0,0,0,0,1,1,2,1,3,0,2,2,0,0,0,2,5,7
fa09,93,SIXTH,LIT,French Lit,0,1,1,0,0,0,0,0,0,0,1,1,0,0,0,0,0,0,0,2,2
fa09,93,SIXTH,LIT,Lit/Compos,1,0,1,0,0,0,0,0,0,0,0,0,0,1,1,0,0,0,1,1,2
fa09,93,SIXTH,LIT,Lit/CultSt,0,0,0,0,0,0,0,0,0,0,2,2,0,1,1,0,0,0,0,3,3
fa09,93,SIXTH,LIT,Lit/Engl,0,0,0,0,1,1,0,1,1,0,2,2,1,2,3,0,0,0,1,6,7
fa09,93,SIXTH,LIT,Lit/World,0,0,0,0,0,0,0,0,0,0,1,1,1,1,2,0,0,0,1,2,3
fa09,93,SIXTH,LIT,Lit/Writng,0,0,0,0,0,0,1,0,1,1,2,3,3,7,10,0,0,0,5,9,14
fa09,93,SIXTH,LIT,Pre-Lit/Wr,2,4,6,0,0,0,1,8,9,2,4,6,3,1,4,0,0,0,8,17,25
fa09,93,SIXTH,MAE,Aerosp Eng,14,2,16,0,0,0,12,1,13,16,2,18,22,3,25,0,0,0,64,8,72
fa09,93,SIXTH,MAE,Engin Sci,0,0,0,0,0,0,0,0,0,1,0,1,0,1,1,0,0,0,1,1,2
fa09,93,SIXTH,MAE,Envir Eng,4,1,5,0,1,1,2,2,4,2,1,3,1,3,4,0,0,0,9,8,17
fa09,93,SIXTH,MAE,Mech Engin,18,3,21,1,0,1,20,4,24,27,4,31,55,12,67,0,0,0,121,23,144
fa09,93,SIXTH,MATH,Appld Math,1,0,1,0,1,1,1,1,2,1,1,2,2,2,4,0,0,0,5,5,10
fa09,93,SIXTH,MATH,Math/SecEd,1,2,3,0,0,0,1,1,2,1,4,5,0,0,0,0,0,0,3,7,10
fa09,93,SIXTH,MATH,Mathematcs,1,1,2,0,0,0,3,0,3,3,3,6,5,1,6,0,0,0,12,5,17
fa09,93,SIXTH,MATH,Mth-CompSc,0,0,0,0,0,0,0,0,0,0,0,0,1,0,1,0,0,0,1,0,1
fa09,93,SIXTH,MATH,Mth-Mth&Ec,0,3,3,0,0,0,1,0,1,2,2,4,3,1,4,0,0,0,6,6,12
fa09,93,SIXTH,MATH,Mth-SciCom,0,0,0,0,0,0,0,1,1,0,0,0,0,0,0,0,0,0,0,1,1
fa09,93,SIXTH,MATH,Mth/ApldSc,0,0,0,1,0,1,0,0,0,0,0,0,1,0,1,0,0,0,2,0,2
fa09,93,SIXTH,MATH,Pr-Math CS,0,1,1,0,0,0,1,0,1,1,0,1,0,0,0,0,0,0,2,1,3
fa09,93,SIXTH,MATH,Prob&Stats,0,1,1,0,0,0,0,0,0,1,0,1,0,0,0,0,0,0,1,1,2
fa09,93,SIXTH,MUS,Mu-CompArt,3,0,3,2,1,3,3,3,6,6,2,8,8,1,9,0,0,0,22,7,29
fa09,93,SIXTH,MUS,Music,1,2,3,0,0,0,0,1,1,6,1,7,5,3,8,0,0,0,12,7,19
fa09,93,SIXTH,MUS,Music Hum,0,0,0,0,0,0,0,0,0,1,1,2,0,1,1,0,0,0,1,2,3
fa09,93,SIXTH,PHIL,Philosophy,1,0,1,0,0,0,0,0,0,2,0,2,3,2,5,0,0,0,6,2,8
fa09,93,SIXTH,PHYS,Biophysics,2,0,2,0,0,0,0,0,0,1,0,1,2,0,2,0,0,0,5,0,5
fa09,93,SIXTH,PHYS,Phys/Astro,0,0,0,0,0,0,0,0,0,2,0,2,1,0,1,0,0,0,3,0,3
fa09,93,SIXTH,PHYS,Phys/Comp,0,0,0,0,0,0,1,0,1,0,0,0,0,0,0,0,0,0,1,0,1
fa09,93,SIXTH,PHYS,Physics,6,0,6,0,0,0,1,0,1,5,0,5,4,1,5,0,0,0,16,1,17
fa09,93,SIXTH,POLI,Polit Sci,4,3,7,0,0,0,3,1,4,21,9,30,14,8,22,0,0,0,42,21,63
fa09,93,SIXTH,POLI,PolSc-Amer,0,0,0,0,0,0,1,2,3,2,0,2,3,4,7,0,0,0,6,6,12
fa09,93,SIXTH,POLI,PolSc-Comp,0,0,0,0,1,1,0,0,0,0,0,0,0,1,1,0,0,0,0,2,2
fa09,93,SIXTH,POLI,PolSc-Intl,3,4,7,1,0,1,1,0,1,13,5,18,10,7,17,0,0,0,28,16,44
fa09,93,SIXTH,POLI,PolSc-PLaw,1,4,5,0,3,3,2,0,2,6,2,8,4,5,9,0,0,0,13,14,27
fa09,93,SIXTH,POLI,PolSc-PPol,0,0,0,0,0,0,1,0,1,0,0,0,0,1,1,0,0,0,1,1,2
fa09,93,SIXTH,POLI,PolSc-Thry,0,0,0,0,0,0,1,0,1,0,0,0,1,0,1,0,0,0,2,0,2
fa09,93,SIXTH,PSYC,Psychology,8,18,26,0,3,3,14,15,29,16,49,65,27,38,65,0,0,0,65,123,188
fa09,93,SIXTH,RELI,Relig/Stu,1,0,1,0,0,0,0,0,0,0,0,0,0,0,0,0,0,0,1,0,1
fa09,93,SIXTH,RUSS,Russ&SovSt,0,0,0,0,0,0,0,0,0,0,1,1,0,0,0,0,0,0,0,1,1
fa09,93,SIXTH,SE,Engin Sci,2,0,2,0,0,0,0,0,0,0,0,0,0,0,0,0,0,0,2,0,2
fa09,93,SIXTH,SE,Struct Eng,9,4,13,3,0,3,7,5,12,18,8,26,22,10,32,0,0,0,59,27,86
fa09,93,SIXTH,SIO,ErSc-Geoch,1,0,1,0,0,0,0,0,0,0,0,0,0,0,0,0,0,0,1,0,1
fa09,93,SIXTH,SIO,ErSc-Geol,0,0,0,0,0,0,0,0,0,1,0,1,0,0,0,0,0,0,1,0,1
fa09,93,SIXTH,SIO,ErSc-Geoph,0,1,1,0,0,0,0,0,0,0,0,0,0,0,0,0,0,0,0,1,1
fa09,93,SIXTH,SOC,SocCulCom,0,0,0,0,0,0,0,0,0,0,1,1,0,0,0,0,0,0,0,1,1
fa09,93,SIXTH,SOC,SocIntlStu,0,0,0,0,0,0,0,1,1,0,1,1,0,0,0,0,0,0,0,2,2
fa09,93,SIXTH,SOC,Sociology,0,1,1,0,0,0,1,2,3,4,17,21,5,15,20,0,0,0,10,35,45
fa09,93,SIXTH,SOC,SocLawSoc,0,0,0,0,0,0,0,0,0,1,3,4,0,1,1,0,0,0,1,4,5
fa09,93,SIXTH,SOC,SocSciMed,0,0,0,0,0,0,0,0,0,0,2,2,0,0,0,0,0,0,0,2,2
fa09,93,SIXTH,SOC,SocSolneq,0,0,0,0,0,0,0,0,0,0,1,1,0,0,0,0,0,0,0,1,1
fa09,93,SIXTH,THEA,Dance,0,0,0,0,0,0,0,0,0,0,1,1,0,4,4,0,0,0,0,5,5
fa09,93,SIXTH,THEA,Theatre,2,4,6,0,0,0,0,1,1,1,2,3,1,7,8,0,0,0,4,14,18
fa09,93,SIXTH,TWS,ThirdWldSt,0,1,1,0,0,0,0,0,0,0,1,1,0,0,0,0,0,0,0,2,2
fa09,93,SIXTH,UNAF,Limited St,0,0,0,0,0,0,0,0,0,0,0,0,0,0,0,1,0,1,1,0,1
fa09,93,SIXTH,UNAF,UndecHumAr,2,10,12,0,0,0,0,1,1,0,0,0,0,0,0,0,0,0,2,11,13
fa09,93,SIXTH,UNAF,Undeclared,45,63,108,1,3,4,8,8,16,0,1,1,0,0,0,0,0,0,54,75,129
fa09,93,SIXTH,UNAF,UndecPhysS,3,2,5,0,0,0,0,0,0,0,0,0,0,0,0,0,0,0,3,2,5
fa09,93,SIXTH,UNAF,UndecSocSc,7,3,10,0,0,0,0,1,1,0,1,1,0,0,0,0,0,0,7,5,12
fa09,93,SIXTH,USP,Urb Stu&Pl,1,0,1,0,0,0,1,1,2,4,6,10,6,2,8,0,0,0,12,9,21
fa09,93,SIXTH,VIS,Art Hst/Cr,0,1,1,0,0,0,1,2,3,0,6,6,0,10,10,0,0,0,1,19,20
fa09,93,SIXTH,VIS,Media,4,10,14,0,1,1,6,7,13,14,15,29,12,11,23,0,0,0,36,44,80
fa09,93,SIXTH,VIS,Studio VA,2,1,3,0,0,0,0,4,4,3,6,9,8,9,17,0,0,0,13,20,33
fa09,93,SIXTH,VIS,VA-CompArt,2,1,3,0,0,0,4,1,5,7,7,14,5,5,10,0,0,0,18,14,32
fa09,93,WARREN,ANTH,Anth-Arch,0,0,0,0,0,0,0,2,2,1,1,2,0,2,2,0,0,0,1,5,6
fa09,93,WARREN,ANTH,Anth-Biol,0,1,1,0,1,1,0,1,1,0,3,3,1,4,5,0,0,0,1,10,11
fa09,93,WARREN,ANTH,Anth-Soci,0,0,0,0,0,0,0,0,0,0,4,4,0,2,2,0,0,0,0,6,6
fa09,93,WARREN,BENG,Bioen:Binf,0,0,0,0,0,0,1,0,1,3,0,3,3,1,4,0,0,0,7,1,8
fa09,93,WARREN,BENG,Bioeng:PM,0,0,0,0,0,0,0,0,0,6,5,11,29,11,40,0,0,0,35,16,51
fa09,93,WARREN,BENG,BioengBiot,15,4,19,0,0,0,9,5,14,9,3,12,27,6,33,0,0,0,60,18,78
fa09,93,WARREN,BENG,Bioengin,6,7,13,0,0,0,9,2,11,11,4,15,15,8,23,0,0,0,41,21,62
fa09,93,WARREN,BENG,Pr-BioenPM,25,13,38,0,0,0,5,4,9,6,0,6,3,0,3,0,0,0,39,17,56
fa09,93,WARREN,BIOL,Anml Physl,0,0,0,0,0,0,0,1,1,0,0,0,0,0,0,0,0,0,0,1,1
fa09,93,WARREN,BIOL,Bioc/CellB,9,8,17,0,0,0,11,9,20,25,34,59,67,67,134,0,0,0,112,118,230
fa09,93,WARREN,BIOL,BiolBioinf,0,0,0,0,0,0,1,0,1,0,0,0,1,0,1,0,0,0,2,0,2
fa09,93,WARREN,BIOL,Ec/Beh/Evo,0,1,1,0,0,0,3,2,5,5,8,13,3,7,10,0,0,0,11,18,29
fa09,93,WARREN,BIOL,Genl Biol,13,18,31,0,0,0,5,13,18,19,34,53,38,57,95,0,0,0,75,122,197
fa09,93,WARREN,BIOL,Human Bio,14,25,39,2,2,4,17,50,67,35,58,93,47,80,127,0,0,0,115,215,330
fa09,93,WARREN,BIOL,Microbiol,1,1,2,0,0,0,0,1,1,3,6,9,8,5,13,0,0,0,12,13,25
fa09,93,WARREN,BIOL,Molec Biol,3,1,4,0,0,0,2,4,6,3,6,9,14,10,24,0,0,0,22,21,43
fa09,93,WARREN,BIOL,PhyslNeuro,11,7,18,1,1,2,10,11,21,12,16,28,18,25,43,0,0,0,52,60,112
fa09,93,WARREN,CENG,Chem Engin,9,9,18,1,0,1,11,1,12,14,5,19,24,14,38,0,0,0,59,29,88
fa09,93,WARREN,CGS,CritGendSt,0,0,0,0,0,0,0,1,1,0,1,1,0,1,1,0,0,0,0,3,3
fa09,93,WARREN,CHEM,Bioch/Chem,17,10,27,0,0,0,2,5,7,5,8,13,15,12,27,0,0,0,39,35,74
fa09,93,WARREN,CHEM,Chem Phys,0,0,0,0,0,0,0,0,0,0,0,0,2,0,2,0,0,0,2,0,2
fa09,93,WARREN,CHEM,Chemistry,5,7,12,0,0,0,2,1,3,4,6,10,5,2,7,0,0,0,16,16,32
fa09,93,WARREN,CHEM,Envir Chem,0,0,0,0,0,0,1,0,1,0,0,0,0,0,0,0,0,0,1,0,1
fa09,93,WARREN,CHEM,MolecSynth,0,0,0,0,0,0,0,0,0,4,0,4,2,1,3,0,0,0,6,1,7
fa09,93,WARREN,CHEM,Pharm Chem,6,13,19,0,0,0,0,3,3,5,5,10,10,14,24,0,0,0,21,35,56
fa09,93,WARREN,CHIN,Chinese St,0,0,0,0,0,0,0,0,0,0,0,0,0,6,6,0,0,0,0,6,6
fa09,93,WARREN,CLAS,Classic St,0,1,1,0,0,0,0,0,0,0,0,0,0,0,0,0,0,0,0,1,1
fa09,93,WARREN,COGS,Cog Sci,0,2,2,0,0,0,1,2,3,1,5,6,7,6,13,0,0,0,9,15,24
fa09,93,WARREN,COGS,CogSc/ClAs,0,2,2,0,0,0,0,0,0,0,2,2,1,0,1,0,0,0,1,4,5
fa09,93,WARREN,COGS,CogSc/Clin,0,0,0,0,0,0,0,0,0,0,1,1,0,0,0,0,0,0,0,1,1
fa09,93,WARREN,COGS,CogSc/HCI,0,0,0,0,0,0,1,3,4,2,1,3,2,1,3,0,0,0,5,5,10
fa09,93,WARREN,COGS,CogSc/HCog,0,0,0,0,0,0,0,0,0,0,0,0,0,1,1,0,0,0,0,1,1
fa09,93,WARREN,COGS,CogSc/Neur,1,2,3,0,0,0,1,1,2,3,2,5,4,6,10,0,0,0,9,11,20
fa09,93,WARREN,COMM,Communic,3,7,10,1,1,2,5,14,19,18,37,55,11,33,44,0,0,0,38,92,130
fa09,93,WARREN,CSE,Comp Sci,19,4,23,2,0,2,19,5,24,37,6,43,44,12,56,0,0,0,121,27,148
fa09,93,WARREN,CSE,CompEngCSE,20,4,24,1,1,2,10,0,10,12,1,13,12,3,15,0,0,0,55,9,64
fa09,93,WARREN,CSE,CompScBinf,1,3,4,0,0,0,0,0,0,0,0,0,1,0,1,0,0,0,2,3,5
fa09,93,WARREN,ECE,CompEngECE,7,4,11,0,0,0,4,1,5,1,0,1,6,0,6,0,0,0,18,5,23
fa09,93,WARREN,ECE,Electr Eng,25,4,29,0,0,0,7,2,9,23,2,25,75,13,88,0,0,0,130,21,151
fa09,93,WARREN,ECE,Engin Phys,0,0,0,0,0,0,0,0,0,0,0,0,1,0,1,0,0,0,1,0,1
fa09,93,WARREN,ECE,Pr-EngPhys,0,0,0,0,0,0,5,0,5,1,0,1,3,0,3,0,0,0,9,0,9
fa09,93,WARREN,ECON,Ec-Mth&Ecn,1,1,2,0,0,0,6,2,8,3,2,5,6,3,9,0,0,0,16,8,24
fa09,93,WARREN,ECON,Econ-MgtSc,2,4,6,0,0,0,8,9,17,24,21,45,50,33,83,0,0,0,84,67,151
fa09,93,WARREN,ECON,Economics,11,5,16,2,0,2,14,7,21,47,33,80,67,28,95,0,0,0,141,73,214
fa09,93,WARREN,ESYS,EnvSys(EB),1,3,4,0,0,0,0,0,0,0,1,1,2,2,4,0,0,0,3,6,9
fa09,93,WARREN,ESYS,EnvSys(EC),0,1,1,0,0,0,0,0,0,1,1,2,1,1,2,0,0,0,2,3,5
fa09,93,WARREN,ESYS,EnvSys(EP),1,1,2,0,0,0,0,0,0,0,0,0,1,2,3,0,0,0,2,3,5
fa09,93,WARREN,ESYS,EnvSys(ES),0,0,0,0,0,0,1,0,1,0,0,0,1,0,1,0,0,0,2,0,2
fa09,93,WARREN,ETHN,Ethnic St,0,1,1,0,1,1,0,2,2,1,2,3,1,2,3,0,0,0,2,8,10
fa09,93,WARREN,GMST,German Stu,0,0,0,0,0,0,0,0,0,0,0,0,1,0,1,0,0,0,1,0,1
fa09,93,WARREN,HDP,Human Dev,0,0,0,0,0,0,0,0,0,2,1,3,3,19,22,0,0,0,5,20,25
fa09,93,WARREN,HDP,Pr-HumnDev,0,0,0,0,1,1,0,2,2,0,4,4,0,1,1,0,0,0,0,8,8
fa09,93,WARREN,HIST,History,4,2,6,0,0,0,2,2,4,14,9,23,16,10,26,0,0,0,36,23,59
fa09,93,WARREN,INTL,Int-5yrEC,0,0,0,0,0,0,0,0,0,0,0,0,0,1,1,0,0,0,0,1,1
fa09,93,WARREN,INTL,IntSt-Anth,0,0,0,0,0,0,0,0,0,0,2,2,0,2,2,0,0,0,0,4,4
fa09,93,WARREN,INTL,IntSt-Econ,1,5,6,0,0,0,1,4,5,10,5,15,4,8,12,0,0,0,16,22,38
fa09,93,WARREN,INTL,IntSt-Hist,0,0,0,0,0,0,0,0,0,0,2,2,2,4,6,0,0,0,2,6,8
fa09,93,WARREN,INTL,IntSt-Ling,0,0,0,0,0,0,0,1,1,0,2,2,1,0,1,0,0,0,1,3,4
fa09,93,WARREN,INTL,IntSt-Lit,0,0,0,0,0,0,0,1,1,0,0,0,0,1,1,0,0,0,0,2,2
fa09,93,WARREN,INTL,IntSt-PolS,1,1,2,0,1,1,1,3,4,4,5,9,4,10,14,0,0,0,10,20,30
fa09,93,WARREN,INTL,IntSt-Soc,1,1,2,0,1,1,0,0,0,1,3,4,1,6,7,0,0,0,3,11,14
fa09,93,WARREN,ITAL,Italian St,0,0,0,0,0,0,0,0,0,0,0,0,1,0,1,0,0,0,1,0,1
fa09,93,WARREN,JAPN,JapaneseSt,0,0,0,0,0,0,0,0,0,1,0,1,0,0,0,0,0,0,1,0,1
fa09,93,WARREN,LATI,LatinAm St,0,0,0,0,0,0,0,0,0,1,0,1,0,0,0,0,0,0,1,0,1
fa09,93,WARREN,LING,Lang Stu,0,0,0,0,0,0,0,0,0,0,2,2,0,0,0,0,0,0,0,2,2
fa09,93,WARREN,LING,Ling-CogLn,0,0,0,0,0,0,0,1,1,0,0,0,1,0,1,0,0,0,1,1,2
fa09,93,WARREN,LING,Ling-LSoc,0,1,1,0,0,0,0,0,0,1,0,1,0,0,0,0,0,0,1,1,2
fa09,93,WARREN,LING,Linguistcs,0,0,0,0,0,0,0,1,1,0,2,2,0,1,1,0,0,0,0,4,4
fa09,93,WARREN,LIT,French Lit,0,0,0,0,0,0,0,0,0,0,0,0,1,0,1,0,0,0,1,0,1
fa09,93,WARREN,LIT,Hn-Span Lt,0,0,0,0,0,0,0,0,0,0,1,1,0,1,1,0,0,0,0,2,2
fa09,93,WARREN,LIT,Lit/CultSt,0,0,0,0,0,0,0,0,0,0,1,1,0,0,0,0,0,0,0,1,1
fa09,93,WARREN,LIT,Lit/Engl,1,2,3,0,0,0,1,2,3,0,4,4,1,2,3,0,0,0,3,10,13
fa09,93,WARREN,LIT,Lit/World,0,0,0,0,0,0,0,1,1,0,0,0,0,1,1,0,0,0,0,2,2
fa09,93,WARREN,LIT,Lit/Writng,0,0,0,0,0,0,0,0,0,0,1,1,0,9,9,0,0,0,0,10,10
fa09,93,WARREN,LIT,Pre-Lit/Wr,1,1,2,0,0,0,1,2,3,5,6,11,0,1,1,0,0,0,7,10,17
fa09,93,WARREN,LIT,Spanish Lt,0,1,1,0,0,0,0,0,0,0,1,1,2,2,4,0,0,0,2,4,6
fa09,93,WARREN,MAE,Aerosp Eng,19,2,21,1,0,1,9,3,12,12,2,14,31,3,34,0,0,0,72,10,82
fa09,93,WARREN,MAE,Envir Eng,2,6,8,0,1,1,4,1,5,0,1,1,3,4,7,0,0,0,9,13,22
fa09,93,WARREN,MAE,Mech Engin,30,6,36,3,0,3,27,4,31,48,8,56,84,7,91,0,0,0,192,25,217
fa09,93,WARREN,MATH,Appld Math,2,1,3,0,0,0,0,2,2,4,3,7,3,3,6,0,0,0,9,9,18
fa09,93,WARREN,MATH,Math/SecEd,1,0,1,0,0,0,0,0,0,0,0,0,1,1,2,0,0,0,2,1,3
fa09,93,WARREN,MATH,Mathematcs,3,1,4,0,0,0,2,1,3,3,3,6,11,5,16,0,0,0,19,10,29
fa09,93,WARREN,MATH,Mth-CompSc,0,0,0,0,0,0,0,0,0,0,0,0,5,2,7,0,0,0,5,2,7
fa09,93,WARREN,MATH,Mth-Mth&Ec,2,0,2,0,0,0,0,1,1,1,2,3,4,3,7,0,0,0,7,6,13
fa09,93,WARREN,MATH,Mth-SciCom,0,0,0,0,0,0,0,0,0,0,0,0,2,0,2,0,0,0,2,0,2
fa09,93,WARREN,MATH,Mth/ApldSc,0,0,0,0,0,0,1,0,1,0,0,0,2,0,2,0,0,0,3,0,3
fa09,93,WARREN,MATH,Pr-Math CS,0,1,1,0,0,0,0,0,0,0,0,0,0,0,0,0,0,0,0,1,1
fa09,93,WARREN,MATH,Prob&Stats,1,2,3,0,0,0,0,0,0,2,1,3,2,3,5,0,0,0,5,6,11
fa09,93,WARREN,MUS,Mu-CompArt,0,0,0,0,0,0,1,0,1,3,0,3,7,1,8,0,0,0,11,1,12
fa09,93,WARREN,MUS,Music,1,0,1,0,0,0,0,0,0,3,1,4,8,1,9,0,0,0,12,2,14
fa09,93,WARREN,MUS,Music Hum,0,0,0,0,0,0,0,0,0,0,0,0,0,1,1,0,0,0,0,1,1
fa09,93,WARREN,PHIL,Philosophy,1,1,2,0,0,0,2,0,2,4,2,6,11,1,12,0,0,0,18,4,22
fa09,93,WARREN,PHYS,Biophysics,3,0,3,0,0,0,0,0,0,1,0,1,3,1,4,0,0,0,7,1,8
fa09,93,WARREN,PHYS,Gen Physcs,0,0,0,0,0,0,0,0,0,0,0,0,1,0,1,0,0,0,1,0,1
fa09,93,WARREN,PHYS,GenPys/SEd,0,1,1,0,0,0,0,0,0,0,0,0,0,0,0,0,0,0,0,1,1
fa09,93,WARREN,PHYS,Phys/Astro,0,0,0,1,0,1,1,1,2,1,0,1,3,0,3,0,0,0,6,1,7
fa09,93,WARREN,PHYS,Phys/Comp,0,0,0,0,0,0,0,0,0,0,0,0,1,0,1,0,0,0,1,0,1
fa09,93,WARREN,PHYS,Physics,2,0,2,0,0,0,0,0,0,4,0,4,7,0,7,0,0,0,13,0,13
fa09,93,WARREN,POLI,Polit Sci,9,3,12,1,2,3,7,6,13,24,12,36,17,20,37,0,0,0,58,43,101
fa09,93,WARREN,POLI,PolSc-Amer,2,2,4,0,0,0,3,2,5,0,2,2,4,2,6,0,0,0,9,8,17
fa09,93,WARREN,POLI,PolSc-Comp,0,0,0,0,0,0,0,0,0,1,0,1,1,0,1,0,0,0,2,0,2
fa09,93,WARREN,POLI,PolSc-Intl,1,3,4,0,0,0,5,7,12,11,2,13,13,13,26,0,0,0,30,25,55
fa09,93,WARREN,POLI,PolSc-PLaw,1,4,5,0,0,0,4,7,11,7,7,14,6,7,13,0,0,0,18,25,43
fa09,93,WARREN,POLI,PolSc-PPol,0,0,0,0,0,0,0,2,2,1,2,3,1,1,2,0,0,0,2,5,7
fa09,93,WARREN,POLI,PolSc-Thry,0,0,0,0,0,0,1,0,1,2,1,3,3,2,5,0,0,0,6,3,9
fa09,93,WARREN,PSYC,Psychology,4,22,26,1,0,1,7,24,31,24,43,67,22,69,91,0,0,0,58,158,216
fa09,93,WARREN,RELI,Relig/Stu,0,0,0,0,0,0,0,0,0,0,1,1,0,1,1,0,0,0,0,2,2
fa09,93,WARREN,SE,Engin Sci,0,0,0,0,0,0,0,0,0,1,0,1,0,0,0,0,0,0,1,0,1
fa09,93,WARREN,SE,Struct Eng,27,12,39,3,0,3,13,6,19,27,10,37,45,20,65,0,0,0,115,48,163
fa09,93,WARREN,SIO,ErSc-Geoch,0,0,0,0,0,0,1,0,1,0,1,1,0,1,1,0,0,0,1,2,3
fa09,93,WARREN,SIO,ErSc-Geoph,0,1,1,0,0,0,0,0,0,0,0,0,0,0,0,0,0,0,0,1,1
fa09,93,WARREN,SOC,SocIntlStu,0,0,0,0,0,0,0,0,0,1,0,1,0,0,0,0,0,0,1,0,1
fa09,93,WARREN,SOC,Sociology,2,3,5,0,0,0,2,2,4,3,13,16,7,14,21,0,0,0,14,32,46
fa09,93,WARREN,SOC,SocLawSoc,0,1,1,0,0,0,0,1,1,0,1,1,1,1,2,0,0,0,1,4,5
fa09,93,WARREN,SOC,SocSolneq,0,0,0,0,0,0,0,0,0,0,0,0,0,1,1,0,0,0,0,1,1
fa09,93,WARREN,THEA,Dance,0,0,0,0,0,0,1,0,1,0,0,0,0,1,1,0,0,0,1,1,2
fa09,93,WARREN,THEA,Theatre,0,1,1,0,0,0,1,0,1,0,2,2,1,7,8,0,0,0,2,10,12
fa09,93,WARREN,TWS,ThirdWldSt,0,0,0,0,0,0,0,1,1,0,0,0,0,0,0,0,0,0,0,1,1
fa09,93,WARREN,UNAF,IntcampVis,0,0,0,0,0,0,1,0,1,0,0,0,0,0,0,0,0,0,1,0,1
fa09,93,WARREN,UNAF,Limited St,0,0,0,0,0,0,0,0,0,0,0,0,0,0,0,1,0,1,1,0,1
fa09,93,WARREN,UNAF,UndecHumAr,2,2,4,0,1,1,3,2,5,0,0,0,0,0,0,0,0,0,5,5,10
fa09,93,WARREN,UNAF,Undeclared,37,45,82,3,6,9,4,1,5,1,1,2,0,0,0,0,0,0,45,53,98
fa09,93,WARREN,UNAF,UndecPhysS,4,2,6,0,0,0,0,2,2,0,0,0,0,0,0,0,0,0,4,4,8
fa09,93,WARREN,UNAF,UndecSocSc,1,4,5,0,1,1,0,1,1,0,0,0,0,0,0,0,0,0,1,6,7
fa09,93,WARREN,USP,Urb Stu&Pl,0,1,1,2,0,2,1,2,3,2,2,4,4,1,5,0,0,0,9,6,15
fa09,93,WARREN,VIS,Art Hst/Cr,0,0,0,0,1,1,0,0,0,0,2,2,1,5,6,0,0,0,1,8,9
fa09,93,WARREN,VIS,Media,0,1,1,1,1,2,0,2,2,3,4,7,13,10,23,0,0,0,17,18,35
fa09,93,WARREN,VIS,Studio VA,0,0,0,0,1,1,1,0,1,2,2,4,1,4,5,0,0,0,4,7,11
fa09,93,WARREN,VIS,VA-CompArt,0,0,0,0,0,0,0,0,0,0,0,0,3,0,3,0,0,0,3,0,3
wi14,141,MARSHALL,ANTH,Anth-Arch,0,0,0,0,0,0,0,0,0,0,0,0,2,0,2,0,0,0,2,0,2
wi14,141,MARSHALL,ANTH,Anth-Biol,0,0,0,0,0,0,0,0,0,0,3,3,0,6,6,0,0,0,0,9,9
wi14,141,MARSHALL,ANTH,Anth-Soci,0,0,0,0,0,0,0,0,0,1,3,4,0,4,4,0,0,0,1,7,8
wi14,141,MARSHALL,BENG,Bioen:Binf,0,0,0,0,0,0,2,2,4,2,2,4,2,4,6,0,0,0,6,8,14
wi14,141,MARSHALL,BENG,Bioeng:PM,0,0,0,0,0,0,0,0,0,0,0,0,0,1,1,0,0,0,0,1,1
wi14,141,MARSHALL,BENG,BioengBioS,0,0,0,1,2,3,4,1,5,0,0,0,0,0,0,0,0,0,5,3,8
wi14,141,MARSHALL,BENG,BioengBiot,0,0,0,0,0,0,1,1,2,6,1,7,9,7,16,0,0,0,16,9,25
wi14,141,MARSHALL,BENG,Bioengin,0,0,0,1,0,1,0,1,1,3,2,5,4,5,9,0,0,0,8,8,16
wi14,141,MARSHALL,BIOL,Bioc/CellB,0,0,0,7,10,17,23,25,48,18,47,65,25,35,60,0,0,0,73,117,190
wi14,141,MARSHALL,BIOL,BiolBioinf,0,0,0,0,0,0,0,2,2,3,1,4,0,0,0,0,0,0,3,3,6
wi14,141,MARSHALL,BIOL,Ec/Beh/Evo,0,0,0,0,0,0,0,1,1,1,0,1,4,4,8,0,0,0,5,5,10
wi14,141,MARSHALL,BIOL,Genl Biol,0,0,0,6,12,18,6,19,25,14,33,47,37,42,79,0,0,0,63,106,169
wi14,141,MARSHALL,BIOL,Human Bio,0,0,0,13,31,44,20,44,64,35,38,73,35,53,88,0,0,0,103,166,269
wi14,141,MARSHALL,BIOL,Microbiol,0,0,0,1,2,3,3,2,5,3,5,8,3,5,8,0,0,0,10,14,24
wi14,141,MARSHALL,BIOL,Molec Biol,0,0,0,2,0,2,3,3,6,5,3,8,4,2,6,0,0,0,14,8,22
wi14,141,MARSHALL,BIOL,PhyslNeuro,0,0,0,9,12,21,9,25,34,15,24,39,16,19,35,0,0,0,49,80,129
wi14,141,MARSHALL,CENG,Chem Engin,0,0,0,12,2,14,17,8,25,11,15,26,29,10,39,0,0,0,69,35,104
wi14,141,MARSHALL,CGS,CritGendSt,0,0,0,0,0,0,0,0,0,0,0,0,0,1,1,0,0,0,0,1,1
wi14,141,MARSHALL,CHEM,Bioch/Chem,0,0,0,3,1,4,3,4,7,2,7,9,11,19,30,0,0,0,19,31,50
wi14,141,MARSHALL,CHEM,Bioinform,0,0,0,1,0,1,0,0,0,0,0,0,1,0,1,0,0,0,2,0,2
wi14,141,MARSHALL,CHEM,Chem Phys,0,0,0,0,0,0,0,0,0,1,1,2,0,0,0,0,0,0,1,1,2
wi14,141,MARSHALL,CHEM,Chemistry,0,0,0,1,3,4,0,2,2,4,7,11,5,4,9,0,0,0,10,16,26
wi14,141,MARSHALL,CHEM,Envir Chem,0,0,0,0,0,0,0,0,0,0,0,0,0,1,1,0,0,0,0,1,1
wi14,141,MARSHALL,CHEM,MolecSynth,0,0,0,0,0,0,0,0,0,0,0,0,1,0,1,0,0,0,1,0,1
wi14,141,MARSHALL,CHEM,Pharm Chem,0,0,0,2,3,5,5,7,12,3,6,9,10,18,28,0,0,0,20,34,54
wi14,141,MARSHALL,CLAS,Classic St,0,0,0,0,0,0,0,1,1,0,0,0,0,0,0,0,0,0,0,1,1
wi14,141,MARSHALL,COGS,Cog Sci,0,0,0,2,1,3,3,6,9,2,7,9,5,5,10,0,0,0,12,19,31
wi14,141,MARSHALL,COGS,CogSc/ClAs,0,0,0,0,1,1,0,0,0,0,3,3,0,0,0,0,0,0,0,4,4
wi14,141,MARSHALL,COGS,CogSc/Comp,0,0,0,0,0,0,1,0,1,0,1,1,2,0,2,0,0,0,3,1,4
wi14,141,MARSHALL,COGS,CogSc/HCI,0,0,0,0,2,2,1,2,3,2,1,3,3,8,11,0,0,0,6,13,19
wi14,141,MARSHALL,COGS,CogSc/HCog,0,0,0,0,0,0,1,1,2,2,1,3,0,3,3,0,0,0,3,5,8
wi14,141,MARSHALL,COGS,CogSc/Neur,0,0,0,0,0,0,1,0,1,1,6,7,7,12,19,0,0,0,9,18,27
wi14,141,MARSHALL,COMM,Communic,0,0,0,0,9,9,3,17,20,18,40,58,11,59,70,0,0,0,32,125,157
wi14,141,MARSHALL,CSE,Comp Sci,0,0,0,4,1,5,22,6,28,50,11,61,65,16,81,0,0,0,141,34,175
wi14,141,MARSHALL,CSE,CompEngCSE,0,0,0,2,0,2,6,0,6,11,2,13,16,2,18,0,0,0,35,4,39
wi14,141,MARSHALL,CSE,CompScBinf,0,0,0,2,3,5,7,2,9,0,1,1,4,2,6,0,0,0,13,8,21
wi14,141,MARSHALL,ECE,CompEngECE,0,0,0,6,0,6,3,0,3,7,0,7,3,1,4,0,0,0,19,1,20
wi14,141,MARSHALL,ECE,Electr Eng,0,0,0,10,3,13,21,4,25,32,9,41,39,6,45,0,0,0,102,22,124
wi14,141,MARSHALL,ECE,Engin Phys,0,0,0,0,1,1,0,0,0,0,0,0,0,0,0,0,0,0,0,1,1
wi14,141,MARSHALL,ECE,Pr-EngPhys,0,0,0,1,0,1,0,0,0,0,0,0,0,0,0,0,0,0,1,0,1
wi14,141,MARSHALL,ECON,Ec-Mth&Ecn,0,0,0,2,6,8,7,7,14,10,5,15,11,5,16,0,0,0,30,23,53
wi14,141,MARSHALL,ECON,Econ-MgtSc,0,0,0,5,13,18,12,15,27,32,27,59,46,40,86,0,0,0,95,95,190
wi14,141,MARSHALL,ECON,Economics,0,0,0,15,15,30,29,13,42,69,59,128,70,61,131,0,0,0,183,148,331
wi14,141,MARSHALL,ESYS,EnvSys(EB),0,0,0,0,1,1,2,1,3,2,3,5,1,10,11,0,0,0,5,15,20
wi14,141,MARSHALL,ESYS,EnvSys(EC),0,0,0,0,0,0,1,1,2,0,1,1,3,1,4,0,0,0,4,3,7
wi14,141,MARSHALL,ESYS,EnvSys(EP),0,0,0,0,0,0,0,1,1,1,2,3,1,2,3,0,0,0,2,5,7
wi14,141,MARSHALL,ESYS,EnvSys(ES),0,0,0,0,0,0,1,0,1,0,0,0,0,1,1,0,0,0,1,1,2
wi14,141,MARSHALL,ETHN,Ethnic St,0,0,0,0,1,1,0,0,0,0,0,0,3,5,8,0,0,0,3,6,9
wi14,141,MARSHALL,FPMU,Public Hlt,0,0,0,1,3,4,2,14,16,2,12,14,0,4,4,0,0,0,5,33,38
wi14,141,MARSHALL,HDP,Human Dev,0,0,0,0,0,0,0,0,0,0,8,8,4,34,38,0,0,0,4,42,46
wi14,141,MARSHALL,HDP,Pr-HumnDev,0,0,0,0,3,3,0,9,9,0,9,9,0,4,4,0,0,0,0,25,25
wi14,141,MARSHALL,HIST,History,0,0,0,0,1,1,0,1,1,4,1,5,11,8,19,0,0,0,15,11,26
wi14,141,MARSHALL,INTL,Int-5yrEC,0,0,0,0,0,0,0,0,0,0,0,0,1,2,3,0,0,0,1,2,3
wi14,141,MARSHALL,INTL,Int-5yrPS,0,0,0,0,0,0,0,0,0,0,0,0,1,0,1,0,0,0,1,0,1
wi14,141,MARSHALL,INTL,IntSt-Anth,0,0,0,0,0,0,0,1,1,0,0,0,1,1,2,0,0,0,1,2,3
wi14,141,MARSHALL,INTL,IntSt-Econ,0,0,0,2,3,5,0,1,1,4,4,8,3,16,19,0,0,0,9,24,33
wi14,141,MARSHALL,INTL,IntSt-Ling,0,0,0,0,0,0,0,0,0,0,0,0,0,2,2,0,0,0,0,2,2
wi14,141,MARSHALL,INTL,IntSt-Lit,0,0,0,0,0,0,0,0,0,0,0,0,0,1,1,0,0,0,0,1,1
wi14,141,MARSHALL,INTL,IntSt-PolS,0,0,0,0,4,4,1,4,5,2,8,10,5,14,19,0,0,0,8,30,38
wi14,141,MARSHALL,INTL,IntSt-Soc,0,0,0,1,0,1,0,2,2,2,3,5,2,3,5,0,0,0,5,8,13
wi14,141,MARSHALL,JAPN,JapaneseSt,0,0,0,0,0,0,0,0,0,1,0,1,0,1,1,0,0,0,1,1,2
wi14,141,MARSHALL,LATI,LatinAm St,0,0,0,0,0,0,0,1,1,0,0,0,0,0,0,0,0,0,0,1,1
wi14,141,MARSHALL,LING,Lang Stu,0,0,0,0,0,0,0,0,0,1,1,2,1,0,1,0,0,0,2,1,3
wi14,141,MARSHALL,LING,Ling-CogLn,0,0,0,1,0,1,0,2,2,0,1,1,0,0,0,0,0,0,1,3,4
wi14,141,MARSHALL,LING,Ling-LSoc,0,0,0,0,0,0,0,0,0,0,1,1,0,3,3,0,0,0,0,4,4
wi14,141,MARSHALL,LING,Linguistcs,0,0,0,0,0,0,0,0,0,1,1,2,3,2,5,0,0,0,4,3,7
wi14,141,MARSHALL,LIT,Ital Lit,0,0,0,0,0,0,0,0,0,0,0,0,1,0,1,0,0,0,1,0,1
wi14,141,MARSHALL,LIT,Lit/Compos,0,0,0,0,0,0,0,0,0,0,1,1,0,0,0,0,0,0,0,1,1
wi14,141,MARSHALL,LIT,Lit/CultSt,0,0,0,0,0,0,0,0,0,0,0,0,0,1,1,0,0,0,0,1,1
wi14,141,MARSHALL,LIT,Lit/Engl,0,0,0,1,0,1,0,0,0,3,3,6,3,3,6,0,0,0,7,6,13
wi14,141,MARSHALL,LIT,Lit/World,0,0,0,0,0,0,0,0,0,0,1,1,0,1,1,0,0,0,0,2,2
wi14,141,MARSHALL,LIT,Lit/Writng,0,0,0,0,0,0,3,4,7,1,2,3,0,4,4,0,0,0,4,10,14
wi14,141,MARSHALL,LIT,Spanish Lt,0,0,0,0,0,0,0,0,0,0,0,0,0,1,1,0,0,0,0,1,1
wi14,141,MARSHALL,MAE,Aerosp Eng,0,0,0,1,0,1,2,0,2,3,0,3,16,5,21,0,0,0,22,5,27
wi14,141,MARSHALL,MAE,Engin Sci,0,0,0,0,0,0,0,0,0,0,0,0,1,0,1,0,0,0,1,0,1
wi14,141,MARSHALL,MAE,Envir Eng,0,0,0,3,0,3,3,7,10,6,1,7,7,4,11,0,0,0,19,12,31
wi14,141,MARSHALL,MAE,Mech Engin,0,0,0,1,0,1,1,0,1,7,1,8,23,5,28,0,0,0,32,6,38
wi14,141,MARSHALL,MATH,Appld Math,0,0,0,0,5,5,3,5,8,5,1,6,4,8,12,0,0,0,12,19,31
wi14,141,MARSHALL,MATH,Math/SecEd,0,0,0,1,1,2,2,0,2,1,0,1,1,1,2,0,0,0,5,2,7
wi14,141,MARSHALL,MATH,Mathematcs,0,0,0,2,3,5,3,3,6,1,2,3,3,6,9,0,0,0,9,14,23
wi14,141,MARSHALL,MATH,Mth-CompSc,0,0,0,6,3,9,2,1,3,1,2,3,2,1,3,0,0,0,11,7,18
wi14,141,MARSHALL,MATH,Mth-Mth&Ec,0,0,0,1,1,2,4,5,9,4,4,8,5,8,13,0,0,0,14,18,32
wi14,141,MARSHALL,MATH,Mth/ApldSc,0,0,0,0,1,1,1,0,1,0,0,0,1,0,1,0,0,0,2,1,3
wi14,141,MARSHALL,MATH,Prob&Stats,0,0,0,0,1,1,3,3,6,0,2,2,2,1,3,0,0,0,5,7,12
wi14,141,MARSHALL,MUS,Music,0,0,0,1,0,1,0,0,0,0,0,0,1,1,2,0,0,0,2,1,3
wi14,141,MARSHALL,MUS,Music Hum,0,0,0,0,0,0,0,1,1,0,0,0,1,0,1,0,0,0,1,1,2
wi14,141,MARSHALL,NENG,NanoEng,0,0,0,6,0,6,9,2,11,9,2,11,10,3,13,0,0,0,34,7,41
wi14,141,MARSHALL,PHIL,Philosophy,0,0,0,0,0,0,0,0,0,2,1,3,5,3,8,0,0,0,7,4,11
wi14,141,MARSHALL,PHYS,Biophysics,0,0,0,1,0,1,0,1,1,1,0,1,1,0,1,0,0,0,3,1,4
wi14,141,MARSHALL,PHYS,GenPys/SEd,0,0,0,0,0,0,0,0,0,0,1,1,1,0,1,0,0,0,1,1,2
wi14,141,MARSHALL,PHYS,Phys/Astro,0,0,0,2,0,2,0,0,0,0,0,0,2,0,2,0,0,0,4,0,4
wi14,141,MARSHALL,PHYS,Phys/Mtrls,0,0,0,0,0,0,0,0,0,1,0,1,0,0,0,0,0,0,1,0,1
wi14,141,MARSHALL,PHYS,Physics,0,0,0,1,0,1,2,2,4,1,0,1,3,2,5,0,0,0,7,4,11
wi14,141,MARSHALL,POLI,Polit Sci,0,0,0,2,5,7,5,3,8,10,11,21,22,9,31,0,0,0,39,28,67
wi14,141,MARSHALL,POLI,PolSc-Amer,0,0,0,0,0,0,0,1,1,1,1,2,5,6,11,0,0,0,6,8,14
wi14,141,MARSHALL,POLI,PolSc-Comp,0,0,0,0,0,0,0,0,0,0,0,0,1,3,4,0,0,0,1,3,4
wi14,141,MARSHALL,POLI,PolSc-Intl,0,0,0,0,1,1,2,4,6,6,5,11,10,8,18,0,0,0,18,18,36
wi14,141,MARSHALL,POLI,PolSc-PLaw,0,0,0,0,3,3,1,3,4,9,6,15,3,4,7,0,0,0,13,16,29
wi14,141,MARSHALL,POLI,PolSc-PPol,0,0,0,0,0,0,0,0,0,3,1,4,2,2,4,0,0,0,5,3,8
wi14,141,MARSHALL,POLI,PolSc-Thry,0,0,0,0,0,0,0,0,0,2,0,2,2,2,4,0,0,0,4,2,6
wi14,141,MARSHALL,PSYC,Psychology,0,0,0,8,15,23,7,27,34,23,42,65,27,84,111,0,0,0,65,168,233
wi14,141,MARSHALL,SE,Engin Sci,0,0,0,0,0,0,0,0,0,2,0,2,0,0,0,0,0,0,2,0,2
wi14,141,MARSHALL,SE,Struct Eng,0,0,0,5,2,7,9,0,9,22,4,26,28,8,36,0,0,0,64,14,78
wi14,141,MARSHALL,SIO,Earth Sci,0,0,0,0,1,1,0,0,0,0,0,0,0,1,1,0,0,0,0,2,2
wi14,141,MARSHALL,SIO,Marine Bio,0,0,0,0,2,2,1,3,4,0,3,3,1,0,1,0,0,0,2,8,10
wi14,141,MARSHALL,SOC,SocAmSt,0,0,0,0,0,0,0,0,0,0,2,2,0,0,0,0,0,0,0,2,2
wi14,141,MARSHALL,SOC,SocCulCom,0,0,0,0,0,0,0,0,0,0,2,2,0,0,0,0,0,0,0,2,2
wi14,141,MARSHALL,SOC,SocEconSoc,0,0,0,0,0,0,0,0,0,0,0,0,2,4,6,0,0,0,2,4,6
wi14,141,MARSHALL,SOC,SocIntlStu,0,0,0,0,0,0,0,0,0,0,1,1,1,0,1,0,0,0,1,1,2
wi14,141,MARSHALL,SOC,Sociology,0,0,0,1,2,3,0,1,1,6,10,16,12,15,27,0,0,0,19,28,47
wi14,141,MARSHALL,SOC,SocLawSoc,0,0,0,0,1,1,0,1,1,2,1,3,2,5,7,0,0,0,4,8,12
wi14,141,MARSHALL,SOC,SocSciMed,0,0,0,0,0,0,0,0,0,0,0,0,4,4,8,0,0,0,4,4,8
wi14,141,MARSHALL,SOC,SocSolneq,0,0,0,0,0,0,0,0,0,0,2,2,0,4,4,0,0,0,0,6,6
wi14,141,MARSHALL,THEA,Dance,0,0,0,0,1,1,0,0,0,0,0,0,1,1,2,0,0,0,1,2,3
wi14,141,MARSHALL,THEA,Theatre,0,0,0,0,0,0,0,0,0,0,2,2,3,5,8,0,0,0,3,7,10
wi14,141,MARSHALL,UNAF,Limited St,0,0,0,0,0,0,0,0,0,0,0,0,0,0,0,1,0,1,1,0,1
wi14,141,MARSHALL,UNAF,UndecHumAr,0,0,0,1,1,2,0,2,2,0,0,0,0,0,0,0,0,0,1,3,4
wi14,141,MARSHALL,UNAF,Undeclared,0,0,0,17,17,34,13,15,28,1,1,2,0,0,0,0,0,0,31,33,64
wi14,141,MARSHALL,UNAF,UndecPhysS,0,0,0,2,0,2,2,1,3,0,0,0,0,0,0,0,0,0,4,1,5
wi14,141,MARSHALL,UNAF,UndecSocSc,0,0,0,3,3,6,3,0,3,0,0,0,0,0,0,0,0,0,6,3,9
wi14,141,MARSHALL,USP,Urb Stu&Pl,0,0,0,0,1,1,1,0,1,2,4,6,10,8,18,0,0,0,13,13,26
wi14,141,MARSHALL,VIS,Art Hst/Cr,0,0,0,0,0,0,0,1,1,0,2,2,0,2,2,0,0,0,0,5,5
wi14,141,MARSHALL,VIS,Media,0,0,0,0,1,1,0,2,2,1,8,9,12,1,13,0,0,0,13,12,25
wi14,141,MARSHALL,VIS,Studio VA,0,0,0,0,2,2,1,0,1,0,2,2,1,4,5,0,0,0,2,8,10
wi14,141,MARSHALL,VIS,VA-CompArt,0,0,0,0,1,1,1,3,4,1,1,2,4,1,5,0,0,0,6,6,12
wi14,141,MUIR,ANTH,Anth-Arch,0,0,0,0,0,0,0,0,0,1,2,3,3,5,8,0,0,0,4,7,11
wi14,141,MUIR,ANTH,Anth-Biol,0,0,0,0,0,0,0,3,3,0,8,8,2,7,9,0,0,0,2,18,20
wi14,141,MUIR,ANTH,Anth-Soci,0,0,0,0,0,0,0,1,1,1,3,4,1,4,5,0,0,0,2,8,10
wi14,141,MUIR,BENG,Bioen:Binf,0,0,0,1,1,2,2,3,5,2,2,4,4,1,5,0,0,0,9,7,16
wi14,141,MUIR,BENG,Bioeng:PM,0,0,0,0,0,0,0,0,0,0,0,0,1,0,1,0,0,0,1,0,1
wi14,141,MUIR,BENG,BioengBioS,0,0,0,3,0,3,0,2,2,0,0,0,0,0,0,0,0,0,3,2,5
wi14,141,MUIR,BENG,BioengBiot,0,0,0,1,2,3,3,4,7,2,2,4,8,7,15,0,0,0,14,15,29
wi14,141,MUIR,BENG,Bioengin,0,0,0,0,1,1,5,3,8,10,4,14,8,5,13,0,0,0,23,13,36
wi14,141,MUIR,BIOL,Bioc/CellB,0,0,0,10,19,29,12,22,34,25,30,55,32,26,58,0,0,0,79,97,176
wi14,141,MUIR,BIOL,BiolBioinf,0,0,0,0,0,0,0,0,0,2,0,2,0,2,2,0,0,0,2,2,4
wi14,141,MUIR,BIOL,Ec/Beh/Evo,0,0,0,0,2,2,1,2,3,5,7,12,4,16,20,0,0,0,10,27,37
wi14,141,MUIR,BIOL,Genl Biol,0,0,0,11,28,39,20,24,44,17,25,42,34,59,93,0,0,0,82,136,218
wi14,141,MUIR,BIOL,Human Bio,0,0,0,12,35,47,22,52,74,19,50,69,37,52,89,0,0,0,90,189,279
wi14,141,MUIR,BIOL,Microbiol,0,0,0,1,2,3,5,3,8,1,1,2,4,2,6,0,0,0,11,8,19
wi14,141,MUIR,BIOL,Molec Biol,0,0,0,1,1,2,5,7,12,8,5,13,1,10,11,0,0,0,15,23,38
wi14,141,MUIR,BIOL,PhyslNeuro,0,0,0,10,16,26,11,26,37,18,19,37,26,22,48,0,0,0,65,83,148
wi14,141,MUIR,CENG,Chem Engin,0,0,0,11,6,17,14,10,24,12,9,21,19,14,33,0,0,0,56,39,95
wi14,141,MUIR,CGS,CritGendSt,0,0,0,1,1,2,0,0,0,0,3,3,0,2,2,0,0,0,1,6,7
wi14,141,MUIR,CHEM,Bioch/Chem,0,0,0,3,5,8,1,4,5,6,12,18,15,17,32,0,0,0,25,38,63
wi14,141,MUIR,CHEM,Bioinform,0,0,0,0,0,0,1,0,1,1,0,1,0,0,0,0,0,0,2,0,2
wi14,141,MUIR,CHEM,Chem Educ,0,0,0,0,0,0,0,1,1,0,0,0,0,0,0,0,0,0,0,1,1
wi14,141,MUIR,CHEM,Chem Phys,0,0,0,1,0,1,1,0,1,0,0,0,0,0,0,0,0,0,2,0,2
wi14,141,MUIR,CHEM,Chemistry,0,0,0,0,2,2,4,2,6,3,1,4,9,4,13,0,0,0,16,9,25
wi14,141,MUIR,CHEM,Envir Chem,0,0,0,0,0,0,0,0,0,1,2,3,0,0,0,0,0,0,1,2,3
wi14,141,MUIR,CHEM,MolecSynth,0,0,0,0,0,0,1,0,1,0,0,0,1,1,2,0,0,0,2,1,3
wi14,141,MUIR,CHEM,Pharm Chem,0,0,0,2,5,7,1,9,10,5,12,17,22,15,37,0,0,0,30,41,71
wi14,141,MUIR,CHIN,Chinese St,0,0,0,0,0,0,0,0,0,0,0,0,1,2,3,0,0,0,1,2,3
wi14,141,MUIR,CLAS,Classic St,0,0,0,0,0,0,1,0,1,0,0,0,0,0,0,0,0,0,1,0,1
wi14,141,MUIR,COGS,Cog Sci,0,0,0,0,4,4,5,6,11,1,5,6,3,7,10,0,0,0,9,22,31
wi14,141,MUIR,COGS,CogSc/ClAs,0,0,0,0,1,1,0,2,2,0,0,0,1,8,9,0,0,0,1,11,12
wi14,141,MUIR,COGS,CogSc/Comp,0,0,0,0,0,0,0,0,0,0,0,0,4,1,5,0,0,0,4,1,5
wi14,141,MUIR,COGS,CogSc/HCI,0,0,0,2,0,2,0,3,3,2,6,8,5,10,15,0,0,0,9,19,28
wi14,141,MUIR,COGS,CogSc/HCog,0,0,0,0,1,1,0,1,1,0,2,2,0,4,4,0,0,0,0,8,8
wi14,141,MUIR,COGS,CogSc/Neur,0,0,0,0,1,1,2,2,4,4,9,13,15,21,36,0,0,0,21,33,54
wi14,141,MUIR,COMM,Communic,0,0,0,5,11,16,2,9,11,14,31,45,14,41,55,0,0,0,35,92,127
wi14,141,MUIR,CSE,Comp Sci,0,0,0,2,3,5,25,10,35,57,15,72,82,19,101,0,0,0,166,47,213
wi14,141,MUIR,CSE,CompEngCSE,0,0,0,0,0,0,10,1,11,12,1,13,15,0,15,0,0,0,37,2,39
wi14,141,MUIR,CSE,CompScBinf,0,0,0,1,2,3,1,0,1,3,0,3,4,1,5,0,0,0,9,3,12
wi14,141,MUIR,ECE,CompEngECE,0,0,0,0,0,0,3,1,4,4,1,5,3,0,3,0,0,0,10,2,12
wi14,141,MUIR,ECE,Electr Eng,0,0,0,17,3,20,23,3,26,21,2,23,30,9,39,0,0,0,91,17,108
wi14,141,MUIR,ECE,Engin Phys,0,0,0,0,0,0,0,0,0,1,0,1,1,0,1,0,0,0,2,0,2
wi14,141,MUIR,ECE,Pr-EngPhys,0,0,0,0,0,0,2,0,2,0,0,0,0,0,0,0,0,0,2,0,2
wi14,141,MUIR,ECON,Ec-Mth&Ecn,0,0,0,3,2,5,4,3,7,5,3,8,10,3,13,0,0,0,22,11,33
wi14,141,MUIR,ECON,Econ-MgtSc,0,0,0,2,3,5,11,9,20,19,19,38,28,26,54,0,0,0,60,57,117
wi14,141,MUIR,ECON,Economics,0,0,0,10,4,14,16,15,31,35,31,66,57,31,88,0,0,0,118,81,199
wi14,141,MUIR,ESYS,EnvSys(EB),0,0,0,0,1,1,3,2,5,2,4,6,9,17,26,0,0,0,14,24,38
wi14,141,MUIR,ESYS,EnvSys(EC),0,0,0,0,0,0,0,0,0,1,1,2,0,0,0,0,0,0,1,1,2
wi14,141,MUIR,ESYS,EnvSys(EP),0,0,0,1,3,4,1,0,1,0,1,1,1,2,3,0,0,0,3,6,9
wi14,141,MUIR,ESYS,EnvSys(ES),0,0,0,0,0,0,1,0,1,2,0,2,3,2,5,0,0,0,6,2,8
wi14,141,MUIR,ETHN,Ethnic St,0,0,0,0,1,1,0,0,0,0,1,1,4,0,4,0,0,0,4,2,6
wi14,141,MUIR,FPMU,Public Hlt,0,0,0,0,3,3,2,5,7,2,15,17,1,1,2,0,0,0,5,24,29
wi14,141,MUIR,HDP,Human Dev,0,0,0,0,0,0,0,0,0,1,7,8,6,27,33,0,0,0,7,34,41
wi14,141,MUIR,HDP,Pr-HumnDev,0,0,0,0,4,4,0,11,11,1,9,10,3,4,7,0,0,0,4,28,32
wi14,141,MUIR,HIST,History,0,0,0,2,0,2,1,3,4,4,3,7,6,6,12,0,0,0,13,12,25
wi14,141,MUIR,INTD,Muir Sp Pr,0,0,0,0,0,0,0,0,0,0,0,0,0,1,1,0,0,0,0,1,1
wi14,141,MUIR,INTL,Int-5yrPS,0,0,0,0,0,0,0,0,0,0,0,0,0,1,1,0,0,0,0,1,1
wi14,141,MUIR,INTL,IntSt-Anth,0,0,0,0,0,0,0,1,1,0,0,0,0,1,1,0,0,0,0,2,2
wi14,141,MUIR,INTL,IntSt-Econ,0,0,0,0,5,5,3,4,7,2,8,10,4,6,10,0,0,0,9,23,32
wi14,141,MUIR,INTL,IntSt-Hist,0,0,0,0,0,0,0,0,0,1,0,1,0,0,0,0,0,0,1,0,1
wi14,141,MUIR,INTL,IntSt-Ling,0,0,0,0,0,0,0,0,0,1,0,1,0,2,2,0,0,0,1,2,3
wi14,141,MUIR,INTL,IntSt-PolS,0,0,0,0,0,0,0,2,2,3,6,9,4,8,12,0,0,0,7,16,23
wi14,141,MUIR,INTL,IntSt-Soc,0,0,0,0,0,0,0,1,1,3,4,7,1,5,6,0,0,0,4,10,14
wi14,141,MUIR,ITAL,Italian St,0,0,0,0,0,0,0,1,1,0,0,0,0,0,0,0,0,0,0,1,1
wi14,141,MUIR,JAPN,JapaneseSt,0,0,0,0,0,0,0,1,1,0,2,2,2,0,2,0,0,0,2,3,5
wi14,141,MUIR,LING,Lang Stu,0,0,0,0,0,0,0,0,0,1,0,1,0,1,1,0,0,0,1,1,2
wi14,141,MUIR,LING,Ling-CogLn,0,0,0,0,0,0,1,0,1,3,1,4,0,6,6,0,0,0,4,7,11
wi14,141,MUIR,LING,Linguistcs,0,0,0,0,0,0,0,2,2,0,4,4,4,1,5,0,0,0,4,7,11
wi14,141,MUIR,LIT,Lit/CultSt,0,0,0,0,0,0,0,0,0,0,0,0,0,1,1,0,0,0,0,1,1
wi14,141,MUIR,LIT,Lit/Engl,0,0,0,0,2,2,0,2,2,0,3,3,3,9,12,0,0,0,3,16,19
wi14,141,MUIR,LIT,Lit/World,0,0,0,0,0,0,0,0,0,0,0,0,0,1,1,0,0,0,0,1,1
wi14,141,MUIR,LIT,Lit/Writng,0,0,0,0,3,3,3,4,7,1,8,9,6,10,16,0,0,0,10,25,35
wi14,141,MUIR,LIT,Spanish Lt,0,0,0,0,0,0,0,0,0,0,3,3,1,3,4,0,0,0,1,6,7
wi14,141,MUIR,MAE,Aerosp Eng,0,0,0,1,0,1,3,1,4,8,0,8,14,5,19,0,0,0,26,6,32
wi14,141,MUIR,MAE,Engin Sci,0,0,0,0,0,0,0,0,0,0,0,0,1,1,2,0,0,0,1,1,2
wi14,141,MUIR,MAE,Envir Eng,0,0,0,5,7,12,5,6,11,6,3,9,12,13,25,0,0,0,28,29,57
wi14,141,MUIR,MAE,Mech Engin,0,0,0,1,0,1,12,2,14,7,3,10,25,2,27,0,0,0,45,7,52
wi14,141,MUIR,MATH,Appld Math,0,0,0,0,6,6,3,3,6,8,0,8,1,5,6,0,0,0,12,14,26
wi14,141,MUIR,MATH,Math/SecEd,0,0,0,0,1,1,0,0,0,2,2,4,1,5,6,0,0,0,3,8,11
wi14,141,MUIR,MATH,Mathematcs,0,0,0,2,2,4,3,3,6,10,4,14,6,2,8,0,0,0,21,11,32
wi14,141,MUIR,MATH,Mth-CompSc,0,0,0,1,2,3,1,0,1,3,0,3,2,2,4,0,0,0,7,4,11
wi14,141,MUIR,MATH,Mth-Mth&Ec,0,0,0,1,2,3,2,1,3,5,4,9,5,2,7,0,0,0,13,9,22
wi14,141,MUIR,MATH,Mth-SciCom,0,0,0,0,0,0,0,1,1,0,0,0,0,0,0,0,0,0,0,1,1
wi14,141,MUIR,MATH,Mth/ApldSc,0,0,0,0,0,0,0,0,0,0,0,0,1,0,1,0,0,0,1,0,1
wi14,141,MUIR,MATH,Prob&Stats,0,0,0,0,0,0,3,0,3,2,2,4,0,2,2,0,0,0,5,4,9
wi14,141,MUIR,MUS,Mu-CompArt,0,0,0,1,1,2,1,1,2,4,1,5,4,1,5,0,0,0,10,4,14
wi14,141,MUIR,MUS,Music,0,0,0,1,2,3,1,0,1,1,2,3,2,1,3,0,0,0,5,5,10
wi14,141,MUIR,MUS,Music Hum,0,0,0,0,0,0,0,0,0,1,0,1,1,1,2,0,0,0,2,1,3
wi14,141,MUIR,NENG,NanoEng,0,0,0,1,0,1,12,5,17,6,1,7,16,6,22,0,0,0,35,12,47
wi14,141,MUIR,PHIL,Philosophy,0,0,0,0,0,0,0,1,1,1,0,1,4,2,6,0,0,0,5,3,8
wi14,141,MUIR,PHYS,Biophysics,0,0,0,1,0,1,0,2,2,0,1,1,3,1,4,0,0,0,4,4,8
wi14,141,MUIR,PHYS,Phys/Astro,0,0,0,1,0,1,0,1,1,1,0,1,2,0,2,0,0,0,4,1,5
wi14,141,MUIR,PHYS,Phys/Comp,0,0,0,1,0,1,0,0,0,0,0,0,1,0,1,0,0,0,2,0,2
wi14,141,MUIR,PHYS,Phys/Mtrls,0,0,0,0,0,0,0,0,0,2,0,2,1,0,1,0,0,0,3,0,3
wi14,141,MUIR,PHYS,Physics,0,0,0,1,0,1,7,2,9,2,0,2,8,0,8,0,0,0,18,2,20
wi14,141,MUIR,POLI,Polit Sci,0,0,0,0,7,7,1,6,7,12,5,17,19,13,32,0,0,0,32,31,63
wi14,141,MUIR,POLI,PolSc-Amer,0,0,0,0,0,0,0,1,1,2,2,4,7,2,9,0,0,0,9,5,14
wi14,141,MUIR,POLI,PolSc-Comp,0,0,0,1,0,1,0,0,0,2,0,2,0,0,0,0,0,0,3,0,3
wi14,141,MUIR,POLI,PolSc-Intl,0,0,0,0,3,3,0,1,1,12,7,19,5,9,14,0,0,0,17,20,37
wi14,141,MUIR,POLI,PolSc-PLaw,0,0,0,1,2,3,2,5,7,3,3,6,6,3,9,0,0,0,12,13,25
wi14,141,MUIR,POLI,PolSc-PPol,0,0,0,0,0,0,0,2,2,1,3,4,1,1,2,0,0,0,2,6,8
wi14,141,MUIR,POLI,PolSc-Thry,0,0,0,0,1,1,0,0,0,1,0,1,1,0,1,0,0,0,2,1,3
wi14,141,MUIR,PSYC,Psychology,0,0,0,8,21,29,6,33,39,16,64,80,37,86,123,0,0,0,67,204,271
wi14,141,MUIR,RELI,Relig/Stu,0,0,0,0,0,0,0,0,0,0,0,0,0,1,1,0,0,0,0,1,1
wi14,141,MUIR,RUSS,Russ&SovSt,0,0,0,0,0,0,0,0,0,0,0,0,0,2,2,0,0,0,0,2,2
wi14,141,MUIR,SE,Struct Eng,0,0,0,8,3,11,14,9,23,18,6,24,27,12,39,0,0,0,67,30,97
wi14,141,MUIR,SIO,Earth Sci,0,0,0,2,1,3,1,0,1,2,1,3,3,1,4,0,0,0,8,3,11
wi14,141,MUIR,SIO,Marine Bio,0,0,0,5,5,10,3,3,6,1,9,10,3,6,9,0,0,0,12,23,35
wi14,141,MUIR,SOC,SocCulCom,0,0,0,0,0,0,0,0,0,0,4,4,1,1,2,0,0,0,1,5,6
wi14,141,MUIR,SOC,SocEconSoc,0,0,0,0,0,0,0,0,0,0,2,2,0,1,1,0,0,0,0,3,3
wi14,141,MUIR,SOC,SocIntlStu,0,0,0,0,0,0,0,0,0,0,1,1,0,1,1,0,0,0,0,2,2
wi14,141,MUIR,SOC,Sociology,0,0,0,0,3,3,0,0,0,5,12,17,4,15,19,0,0,0,9,30,39
wi14,141,MUIR,SOC,SocLawSoc,0,0,0,0,2,2,0,1,1,1,5,6,2,5,7,0,0,0,3,13,16
wi14,141,MUIR,SOC,SocSciMed,0,0,0,0,0,0,0,0,0,0,0,0,1,2,3,0,0,0,1,2,3
wi14,141,MUIR,SOC,SocSolneq,0,0,0,0,0,0,0,2,2,0,3,3,0,1,1,0,0,0,0,6,6
wi14,141,MUIR,THEA,Dance,0,0,0,0,0,0,0,0,0,0,1,1,0,2,2,0,0,0,0,3,3
wi14,141,MUIR,THEA,Theatre,0,0,0,0,4,4,1,3,4,2,4,6,3,5,8,0,0,0,6,16,22
wi14,141,MUIR,TWS,ThirdWldSt,0,0,0,0,1,1,0,0,0,0,0,0,0,0,0,0,0,0,0,1,1
wi14,141,MUIR,UNAF,UndecHumAr,0,0,0,1,4,5,1,1,2,0,0,0,0,0,0,0,0,0,2,5,7
wi14,141,MUIR,UNAF,Undeclared,0,0,0,21,28,49,14,17,31,1,0,1,0,0,0,0,0,0,36,45,81
wi14,141,MUIR,UNAF,UndecPhysS,0,0,0,1,2,3,4,1,5,0,2,2,0,0,0,0,0,0,5,5,10
wi14,141,MUIR,UNAF,UndecSocSc,0,0,0,3,5,8,4,3,7,0,0,0,0,0,0,0,0,0,7,8,15
wi14,141,MUIR,USP,Urb Stu&Pl,0,0,0,1,0,1,0,2,2,3,5,8,10,5,15,0,0,0,14,12,26
wi14,141,MUIR,VIS,Art Hst/Cr,0,0,0,0,0,0,0,0,0,1,2,3,1,1,2,0,0,0,2,3,5
wi14,141,MUIR,VIS,Media,0,0,0,0,0,0,1,4,5,3,5,8,15,7,22,0,0,0,19,16,35
wi14,141,MUIR,VIS,Studio VA,0,0,0,0,1,1,0,1,1,0,3,3,0,6,6,0,0,0,0,11,11
wi14,141,MUIR,VIS,VA-CompArt,0,0,0,0,0,0,1,0,1,1,2,3,4,3,7,0,0,0,6,5,11
wi14,141,REVELLE,ANTH,Anth-Arch,0,0,0,0,0,0,0,1,1,0,0,0,0,3,3,0,0,0,0,4,4
wi14,141,REVELLE,ANTH,Anth-Biol,0,0,0,0,0,0,0,1,1,1,2,3,2,3,5,0,0,0,3,6,9
wi14,141,REVELLE,ANTH,Anth-Soci,0,0,0,0,0,0,0,2,2,0,0,0,0,2,2,0,0,0,0,4,4
wi14,141,REVELLE,BENG,Bioen:Binf,0,0,0,5,0,5,5,2,7,4,3,7,6,5,11,0,0,0,20,10,30
wi14,141,REVELLE,BENG,BioengBioS,0,0,0,3,1,4,5,2,7,0,0,0,0,0,0,0,0,0,8,3,11
wi14,141,REVELLE,BENG,BioengBiot,0,0,0,1,0,1,2,4,6,15,1,16,19,8,27,0,0,0,37,13,50
wi14,141,REVELLE,BENG,Bioengin,0,0,0,1,0,1,6,2,8,8,5,13,10,10,20,0,0,0,25,17,42
wi14,141,REVELLE,BIOL,Bioc/CellB,0,0,0,7,17,24,28,42,70,32,32,64,41,44,85,0,0,0,108,135,243
wi14,141,REVELLE,BIOL,BiolBioinf,0,0,0,0,0,0,1,1,2,1,1,2,2,0,2,0,0,0,4,2,6
wi14,141,REVELLE,BIOL,Ec/Beh/Evo,0,0,0,0,1,1,2,0,2,0,3,3,5,7,12,0,0,0,7,11,18
wi14,141,REVELLE,BIOL,Genl Biol,0,0,0,8,20,28,22,22,44,23,34,57,26,51,77,0,0,0,79,127,206
wi14,141,REVELLE,BIOL,Human Bio,0,0,0,15,52,67,28,75,103,47,59,106,32,55,87,0,0,0,122,241,363
wi14,141,REVELLE,BIOL,Microbiol,0,0,0,3,2,5,4,10,14,5,6,11,8,3,11,0,0,0,20,21,41
wi14,141,REVELLE,BIOL,Molec Biol,0,0,0,2,3,5,10,7,17,7,6,13,3,6,9,0,0,0,22,22,44
wi14,141,REVELLE,BIOL,PhyslNeuro,0,0,0,10,15,25,23,20,43,26,32,58,19,27,46,0,0,0,78,94,172
wi14,141,REVELLE,CENG,Chem Engin,0,0,0,16,7,23,24,8,32,35,12,47,42,18,60,0,0,0,117,45,162
wi14,141,REVELLE,CGS,CritGendSt,0,0,0,0,0,0,0,0,0,0,0,0,1,1,2,0,0,0,1,1,2
wi14,141,REVELLE,CHEM,Bioch/Chem,0,0,0,1,5,6,8,7,15,9,6,15,24,19,43,0,0,0,42,37,79
wi14,141,REVELLE,CHEM,Bioinform,0,0,0,0,0,0,1,0,1,0,1,1,0,0,0,0,0,0,1,1,2
wi14,141,REVELLE,CHEM,Chem Educ,0,0,0,0,0,0,0,0,0,0,1,1,0,0,0,0,0,0,0,1,1
wi14,141,REVELLE,CHEM,Chem Phys,0,0,0,0,0,0,2,0,2,2,1,3,0,0,0,0,0,0,4,1,5
wi14,141,REVELLE,CHEM,Chemistry,0,0,0,3,6,9,7,3,10,9,4,13,7,7,14,0,0,0,26,20,46
wi14,141,REVELLE,CHEM,Envir Chem,0,0,0,0,0,0,0,1,1,1,1,2,1,1,2,0,0,0,2,3,5
wi14,141,REVELLE,CHEM,MolecSynth,0,0,0,0,1,1,1,0,1,0,0,0,0,0,0,0,0,0,1,1,2
wi14,141,REVELLE,CHEM,Pharm Chem,0,0,0,5,5,10,5,10,15,12,12,24,20,32,52,0,0,0,42,59,101
wi14,141,REVELLE,CLAS,Classic St,0,0,0,0,0,0,0,0,0,0,0,0,1,0,1,0,0,0,1,0,1
wi14,141,REVELLE,COGS,Cog Sci,0,0,0,0,4,4,2,3,5,2,10,12,7,9,16,0,0,0,11,26,37
wi14,141,REVELLE,COGS,CogSc/ClAs,0,0,0,0,0,0,0,1,1,1,1,2,2,4,6,0,0,0,3,6,9
wi14,141,REVELLE,COGS,CogSc/Comp,0,0,0,0,0,0,0,0,0,0,0,0,0,1,1,0,0,0,0,1,1
wi14,141,REVELLE,COGS,CogSc/HCI,0,0,0,0,0,0,1,1,2,1,4,5,4,7,11,0,0,0,6,12,18
wi14,141,REVELLE,COGS,CogSc/HCog,0,0,0,0,0,0,0,1,1,0,0,0,1,2,3,0,0,0,1,3,4
wi14,141,REVELLE,COGS,CogSc/Neur,0,0,0,0,2,2,1,3,4,1,2,3,10,20,30,0,0,0,12,27,39
wi14,141,REVELLE,COMM,Communic,0,0,0,0,3,3,2,6,8,8,11,19,6,9,15,0,0,0,16,29,45
wi14,141,REVELLE,CSE,Comp Sci,0,0,0,1,0,1,25,4,29,72,16,88,88,12,100,0,0,0,186,32,218
wi14,141,REVELLE,CSE,CompEngCSE,0,0,0,1,0,1,6,1,7,9,2,11,19,1,20,0,0,0,35,4,39
wi14,141,REVELLE,CSE,CompScBinf,0,0,0,3,2,5,5,1,6,1,0,1,5,2,7,0,0,0,14,5,19
wi14,141,REVELLE,ECE,CompEngECE,0,0,0,1,1,2,5,0,5,7,1,8,5,0,5,0,0,0,18,2,20
wi14,141,REVELLE,ECE,Electr Eng,0,0,0,22,10,32,20,5,25,40,6,46,51,3,54,0,0,0,133,24,157
wi14,141,REVELLE,ECE,EleEng&Soc,0,0,0,0,0,0,0,0,0,0,0,0,1,0,1,0,0,0,1,0,1
wi14,141,REVELLE,ECE,Engin Phys,0,0,0,0,0,0,1,0,1,1,0,1,4,0,4,0,0,0,6,0,6
wi14,141,REVELLE,ECE,Pr-EngPhys,0,0,0,0,0,0,3,1,4,3,0,3,0,0,0,0,0,0,6,1,7
wi14,141,REVELLE,ECON,Ec-Mth&Ecn,0,0,0,3,4,7,4,2,6,5,2,7,8,3,11,0,0,0,20,11,31
wi14,141,REVELLE,ECON,Econ-MgtSc,0,0,0,5,2,7,8,5,13,18,8,26,27,11,38,0,0,0,58,26,84
wi14,141,REVELLE,ECON,Economics,0,0,0,9,7,16,18,13,31,29,19,48,42,24,66,0,0,0,98,63,161
wi14,141,REVELLE,ESYS,EnvSys(EB),0,0,0,0,2,2,0,1,1,1,1,2,7,12,19,0,0,0,8,16,24
wi14,141,REVELLE,ESYS,EnvSys(EC),0,0,0,1,0,1,0,0,0,2,0,2,0,1,1,0,0,0,3,1,4
wi14,141,REVELLE,ESYS,EnvSys(EP),0,0,0,0,0,0,0,1,1,0,0,0,0,1,1,0,0,0,0,2,2
wi14,141,REVELLE,ESYS,EnvSys(ES),0,0,0,0,0,0,0,0,0,0,1,1,2,0,2,0,0,0,2,1,3
wi14,141,REVELLE,ETHN,Ethnic St,0,0,0,0,0,0,0,0,0,0,3,3,3,3,6,0,0,0,3,6,9
wi14,141,REVELLE,FPMU,Public Hlt,0,0,0,1,3,4,2,8,10,3,12,15,0,5,5,0,0,0,6,28,34
wi14,141,REVELLE,HDP,Human Dev,0,0,0,0,0,0,0,0,0,0,1,1,0,16,16,0,0,0,0,17,17
wi14,141,REVELLE,HDP,Pr-HumnDev,0,0,0,0,3,3,0,6,6,0,4,4,0,3,3,0,0,0,0,16,16
wi14,141,REVELLE,HIST,History,0,0,0,0,3,3,1,3,4,1,3,4,4,1,5,0,0,0,6,10,16
wi14,141,REVELLE,INTL,Int-5yrPS,0,0,0,0,0,0,0,0,0,0,0,0,0,1,1,0,0,0,0,1,1
wi14,141,REVELLE,INTL,IntSt-Anth,0,0,0,0,0,0,0,0,0,0,0,0,1,0,1,0,0,0,1,0,1
wi14,141,REVELLE,INTL,IntSt-Econ,0,0,0,2,1,3,0,1,1,4,1,5,4,4,8,0,0,0,10,7,17
wi14,141,REVELLE,INTL,IntSt-Hist,0,0,0,0,0,0,0,0,0,0,1,1,0,1,1,0,0,0,0,2,2
wi14,141,REVELLE,INTL,IntSt-Ling,0,0,0,0,0,0,0,0,0,0,1,1,0,0,0,0,0,0,0,1,1
wi14,141,REVELLE,INTL,IntSt-PolS,0,0,0,0,1,1,2,1,3,1,4,5,2,5,7,0,0,0,5,11,16
wi14,141,REVELLE,INTL,IntSt-Soc,0,0,0,0,0,0,0,0,0,0,2,2,0,1,1,0,0,0,0,3,3
wi14,141,REVELLE,LING,Ling-CogLn,0,0,0,0,0,0,0,0,0,0,1,1,0,2,2,0,0,0,0,3,3
wi14,141,REVELLE,LING,Ling-LSoc,0,0,0,0,0,0,1,0,1,0,0,0,0,0,0,0,0,0,1,0,1
wi14,141,REVELLE,LING,Linguistcs,0,0,0,0,0,0,1,1,2,1,4,5,3,1,4,0,0,0,5,6,11
wi14,141,REVELLE,LIT,Lit/Compos,0,0,0,0,0,0,0,0,0,0,1,1,1,0,1,0,0,0,1,1,2
wi14,141,REVELLE,LIT,Lit/CultSt,0,0,0,0,0,0,0,1,1,0,0,0,0,0,0,0,0,0,0,1,1
wi14,141,REVELLE,LIT,Lit/Engl,0,0,0,0,1,1,2,0,2,0,1,1,1,1,2,0,0,0,3,3,6
wi14,141,REVELLE,LIT,Lit/World,0,0,0,0,0,0,0,0,0,1,0,1,0,1,1,0,0,0,1,1,2
wi14,141,REVELLE,LIT,Lit/Writng,0,0,0,0,0,0,0,1,1,0,3,3,2,7,9,0,0,0,2,11,13
wi14,141,REVELLE,LIT,Spanish Lt,0,0,0,0,0,0,0,0,0,1,1,2,0,1,1,0,0,0,1,2,3
wi14,141,REVELLE,MAE,Aerosp Eng,0,0,0,1,1,2,14,3,17,13,1,14,21,6,27,0,0,0,49,11,60
wi14,141,REVELLE,MAE,Engin Sci,0,0,0,0,0,0,0,0,0,0,0,0,5,2,7,0,0,0,5,2,7
wi14,141,REVELLE,MAE,Envir Eng,0,0,0,6,1,7,3,9,12,9,1,10,19,4,23,0,0,0,37,15,52
wi14,141,REVELLE,MAE,Mech Engin,0,0,0,2,2,4,9,1,10,12,2,14,34,4,38,0,0,0,57,9,66
wi14,141,REVELLE,MATH,Appld Math,0,0,0,1,4,5,5,6,11,9,7,16,6,3,9,0,0,0,21,20,41
wi14,141,REVELLE,MATH,Math/SecEd,0,0,0,0,0,0,0,0,0,1,0,1,0,0,0,0,0,0,1,0,1
wi14,141,REVELLE,MATH,Mathematcs,0,0,0,2,3,5,2,2,4,4,3,7,2,3,5,0,0,0,10,11,21
wi14,141,REVELLE,MATH,Mth-CompSc,0,0,0,2,0,2,1,0,1,0,2,2,1,1,2,0,0,0,4,3,7
wi14,141,REVELLE,MATH,Mth-Mth&Ec,0,0,0,0,2,2,1,1,2,0,3,3,2,1,3,0,0,0,3,7,10
wi14,141,REVELLE,MATH,Mth-SciCom,0,0,0,0,0,0,0,0,0,0,0,0,0,1,1,0,0,0,0,1,1
wi14,141,REVELLE,MATH,Mth/ApldSc,0,0,0,1,2,3,2,1,3,1,0,1,1,1,2,0,0,0,5,4,9
wi14,141,REVELLE,MATH,Pr-Math CS,0,0,0,1,0,1,0,1,1,0,0,0,0,0,0,0,0,0,1,1,2
wi14,141,REVELLE,MATH,Prob&Stats,0,0,0,0,1,1,2,1,3,3,4,7,3,2,5,0,0,0,8,8,16
wi14,141,REVELLE,MUS,Mu-CompArt,0,0,0,0,0,0,1,0,1,0,0,0,2,0,2,0,0,0,3,0,3
wi14,141,REVELLE,MUS,Music,0,0,0,1,0,1,1,0,1,0,0,0,0,2,2,0,0,0,2,2,4
wi14,141,REVELLE,NENG,NanoEng,0,0,0,4,2,6,12,2,14,14,4,18,28,10,38,0,0,0,58,18,76
wi14,141,REVELLE,PHIL,Philosophy,0,0,0,0,0,0,0,1,1,1,0,1,4,1,5,0,0,0,5,2,7
wi14,141,REVELLE,PHYS,Biophysics,0,0,0,1,0,1,4,0,4,0,2,2,5,2,7,0,0,0,10,4,14
wi14,141,REVELLE,PHYS,GenPys/SEd,0,0,0,0,0,0,0,0,0,0,0,0,1,0,1,0,0,0,1,0,1
wi14,141,REVELLE,PHYS,Phys/Astro,0,0,0,2,0,2,6,0,6,2,2,4,7,4,11,0,0,0,17,6,23
wi14,141,REVELLE,PHYS,Phys/Comp,0,0,0,1,0,1,1,0,1,0,0,0,1,0,1,0,0,0,3,0,3
wi14,141,REVELLE,PHYS,Phys/Mtrls,0,0,0,0,1,1,0,0,0,0,0,0,1,0,1,0,0,0,1,1,2
wi14,141,REVELLE,PHYS,Physics,0,0,0,3,1,4,10,4,14,9,2,11,8,3,11,0,0,0,30,10,40
wi14,141,REVELLE,POLI,Polit Sci,0,0,0,1,0,1,1,1,2,2,2,4,6,10,16,0,0,0,10,13,23
wi14,141,REVELLE,POLI,PolSc-Amer,0,0,0,0,0,0,1,0,1,1,0,1,1,1,2,0,0,0,3,1,4
wi14,141,REVELLE,POLI,PolSc-Comp,0,0,0,0,0,0,0,0,0,0,0,0,1,0,1,0,0,0,1,0,1
wi14,141,REVELLE,POLI,PolSc-Intl,0,0,0,0,0,0,1,5,6,1,0,1,4,3,7,0,0,0,6,8,14
wi14,141,REVELLE,POLI,PolSc-PLaw,0,0,0,0,0,0,1,0,1,0,2,2,2,4,6,0,0,0,3,6,9
wi14,141,REVELLE,POLI,PolSc-PPol,0,0,0,0,0,0,0,0,0,1,0,1,0,1,1,0,0,0,1,1,2
wi14,141,REVELLE,POLI,PolSc-Thry,0,0,0,0,0,0,0,0,0,0,0,0,0,1,1,0,0,0,0,1,1
wi14,141,REVELLE,PSYC,Psychology,0,0,0,2,6,8,11,15,26,10,35,45,29,70,99,0,0,0,52,126,178
wi14,141,REVELLE,RELI,Relig/Stu,0,0,0,0,0,0,0,0,0,0,0,0,0,1,1,0,0,0,0,1,1
wi14,141,REVELLE,RUSS,Russ&SovSt,0,0,0,0,0,0,0,0,0,0,0,0,1,0,1,0,0,0,1,0,1
wi14,141,REVELLE,SE,Engin Sci,0,0,0,0,1,1,0,0,0,0,0,0,0,0,0,0,0,0,0,1,1
wi14,141,REVELLE,SE,Struct Eng,0,0,0,9,3,12,22,10,32,27,4,31,30,9,39,0,0,0,88,26,114
wi14,141,REVELLE,SIO,Earth Sci,0,0,0,0,0,0,1,1,2,1,1,2,2,4,6,0,0,0,4,6,10
wi14,141,REVELLE,SIO,Marine Bio,0,0,0,4,5,9,1,7,8,1,7,8,3,3,6,0,0,0,9,22,31
wi14,141,REVELLE,SOC,SocEconSoc,0,0,0,0,0,0,1,0,1,0,1,1,0,0,0,0,0,0,1,1,2
wi14,141,REVELLE,SOC,Sociology,0,0,0,0,2,2,2,0,2,2,2,4,3,3,6,0,0,0,7,7,14
wi14,141,REVELLE,SOC,SocLawSoc,0,0,0,0,0,0,0,1,1,0,2,2,1,1,2,0,0,0,1,4,5
wi14,141,REVELLE,SOC,SocSciMed,0,0,0,0,0,0,0,0,0,0,1,1,1,4,5,0,0,0,1,5,6
wi14,141,REVELLE,SOC,SocSolneq,0,0,0,0,0,0,0,0,0,0,1,1,0,1,1,0,0,0,0,2,2
wi14,141,REVELLE,THEA,Dance,0,0,0,0,0,0,0,1,1,0,0,0,0,0,0,0,0,0,0,1,1
wi14,141,REVELLE,THEA,Theatre,0,0,0,0,1,1,0,2,2,0,4,4,1,2,3,0,0,0,1,9,10
wi14,141,REVELLE,UNAF,Limited St,0,0,0,0,0,0,0,0,0,0,0,0,0,0,0,1,2,3,1,2,3
wi14,141,REVELLE,UNAF,Spec-Emply,0,0,0,0,0,0,0,0,0,0,0,0,0,0,0,2,2,4,2,2,4
wi14,141,REVELLE,UNAF,UndecHumAr,0,0,0,0,0,0,0,1,1,0,0,0,0,0,0,0,0,0,0,1,1
wi14,141,REVELLE,UNAF,Undeclared,0,0,0,15,9,24,15,15,30,2,1,3,0,0,0,0,0,0,32,25,57
wi14,141,REVELLE,UNAF,UndecPhysS,0,0,0,1,3,4,2,1,3,0,1,1,0,0,0,0,0,0,3,5,8
wi14,141,REVELLE,UNAF,UndecSocSc,0,0,0,2,1,3,2,1,3,0,0,0,0,0,0,0,0,0,4,2,6
wi14,141,REVELLE,USP,Urb Stu&Pl,0,0,0,0,0,0,0,1,1,0,0,0,0,1,1,0,0,0,0,2,2
wi14,141,REVELLE,VIS,Art Hst/Cr,0,0,0,0,0,0,0,0,0,0,1,1,0,0,0,0,0,0,0,1,1
wi14,141,REVELLE,VIS,Media,0,0,0,0,1,1,0,1,1,1,1,2,2,2,4,0,0,0,3,5,8
wi14,141,REVELLE,VIS,Studio VA,0,0,0,0,0,0,0,0,0,0,1,1,1,1,2,0,0,0,1,2,3
wi14,141,REVELLE,VIS,VA-CompArt,0,0,0,0,1,1,2,1,3,1,1,2,4,2,6,0,0,0,7,5,12
wi14,141,ROOSEVELT,ANTH,Anth-Arch,0,0,0,0,0,0,0,0,0,2,4,6,2,5,7,0,0,0,4,9,13
wi14,141,ROOSEVELT,ANTH,Anth-Biol,0,0,0,0,0,0,0,0,0,0,4,4,1,4,5,0,0,0,1,8,9
wi14,141,ROOSEVELT,ANTH,Anth-Soci,0,0,0,1,0,1,1,4,5,1,7,8,4,9,13,0,0,0,7,20,27
wi14,141,ROOSEVELT,BENG,Bioen:Binf,0,0,0,4,0,4,4,2,6,4,3,7,1,3,4,0,0,0,13,8,21
wi14,141,ROOSEVELT,BENG,Bioeng:PM,0,0,0,0,0,0,0,0,0,0,0,0,1,0,1,0,0,0,1,0,1
wi14,141,ROOSEVELT,BENG,BioengBioS,0,0,0,2,2,4,0,2,2,0,1,1,0,0,0,0,0,0,2,5,7
wi14,141,ROOSEVELT,BENG,BioengBiot,0,0,0,0,0,0,1,0,1,0,4,4,5,3,8,0,0,0,6,7,13
wi14,141,ROOSEVELT,BENG,Bioengin,0,0,0,0,0,0,1,0,1,2,0,2,5,3,8,0,0,0,8,3,11
wi14,141,ROOSEVELT,BIOL,Bioc/CellB,0,0,0,8,14,22,17,19,36,20,17,37,28,28,56,0,0,0,73,78,151
wi14,141,ROOSEVELT,BIOL,BiolBioinf,0,0,0,1,0,1,0,0,0,0,0,0,0,0,0,0,0,0,1,0,1
wi14,141,ROOSEVELT,BIOL,Ec/Beh/Evo,0,0,0,0,1,1,0,1,1,3,4,7,3,5,8,0,0,0,6,11,17
wi14,141,ROOSEVELT,BIOL,Genl Biol,0,0,0,4,27,31,8,18,26,13,26,39,26,24,50,0,0,0,51,95,146
wi14,141,ROOSEVELT,BIOL,Human Bio,0,0,0,18,42,60,13,36,49,18,36,54,28,45,73,0,0,0,77,159,236
wi14,141,ROOSEVELT,BIOL,Microbiol,0,0,0,0,0,0,2,2,4,3,3,6,2,4,6,0,0,0,7,9,16
wi14,141,ROOSEVELT,BIOL,Molec Biol,0,0,0,0,1,1,4,7,11,1,1,2,2,3,5,0,0,0,7,12,19
wi14,141,ROOSEVELT,BIOL,PhyslNeuro,0,0,0,5,18,23,12,19,31,7,20,27,9,17,26,0,0,0,33,74,107
wi14,141,ROOSEVELT,CENG,Chem Engin,0,0,0,3,4,7,5,5,10,12,4,16,19,6,25,0,0,0,39,19,58
wi14,141,ROOSEVELT,CHEM,Bioch/Chem,0,0,0,4,3,7,3,4,7,4,2,6,19,11,30,0,0,0,30,20,50
wi14,141,ROOSEVELT,CHEM,Chem Phys,0,0,0,0,0,0,1,0,1,0,0,0,0,1,1,0,0,0,1,1,2
wi14,141,ROOSEVELT,CHEM,Chemistry,0,0,0,1,4,5,3,4,7,2,2,4,3,2,5,0,0,0,9,12,21
wi14,141,ROOSEVELT,CHEM,Envir Chem,0,0,0,0,0,0,1,0,1,0,0,0,2,1,3,0,0,0,3,1,4
wi14,141,ROOSEVELT,CHEM,MolecSynth,0,0,0,0,1,1,0,0,0,0,0,0,0,1,1,0,0,0,0,2,2
wi14,141,ROOSEVELT,CHEM,Pharm Chem,0,0,0,5,5,10,3,3,6,3,6,9,11,16,27,0,0,0,22,30,52
wi14,141,ROOSEVELT,CHIN,Chinese St,0,0,0,0,0,0,0,0,0,0,0,0,0,1,1,0,0,0,0,1,1
wi14,141,ROOSEVELT,CLAS,Classic St,0,0,0,0,0,0,0,1,1,1,0,1,0,2,2,0,0,0,1,3,4
wi14,141,ROOSEVELT,COGS,Cog Sci,0,0,0,0,1,1,2,4,6,1,7,8,3,7,10,0,0,0,6,19,25
wi14,141,ROOSEVELT,COGS,CogSc/ClAs,0,0,0,0,0,0,0,0,0,0,3,3,0,1,1,0,0,0,0,4,4
wi14,141,ROOSEVELT,COGS,CogSc/Comp,0,0,0,0,0,0,0,0,0,1,0,1,1,1,2,0,0,0,2,1,3
wi14,141,ROOSEVELT,COGS,CogSc/HCI,0,0,0,1,0,1,1,1,2,1,3,4,3,7,10,0,0,0,6,11,17
wi14,141,ROOSEVELT,COGS,CogSc/HCog,0,0,0,0,0,0,0,0,0,0,2,2,2,1,3,0,0,0,2,3,5
wi14,141,ROOSEVELT,COGS,CogSc/Neur,0,0,0,1,1,2,0,1,1,1,4,5,5,17,22,0,0,0,7,23,30
wi14,141,ROOSEVELT,COMM,Communic,0,0,0,2,11,13,3,12,15,12,34,46,4,49,53,0,0,0,21,106,127
wi14,141,ROOSEVELT,CSE,Comp Sci,0,0,0,0,0,0,12,9,21,33,5,38,52,7,59,0,0,0,97,21,118
wi14,141,ROOSEVELT,CSE,CompEngCSE,0,0,0,0,0,0,4,1,5,10,1,11,8,1,9,0,0,0,22,3,25
wi14,141,ROOSEVELT,CSE,CompScBinf,0,0,0,3,0,3,2,0,2,3,2,5,1,0,1,0,0,0,9,2,11
wi14,141,ROOSEVELT,ECE,CompEngECE,0,0,0,3,0,3,4,0,4,1,0,1,2,0,2,0,0,0,10,0,10
wi14,141,ROOSEVELT,ECE,Electr Eng,0,0,0,18,5,23,19,7,26,30,5,35,31,8,39,0,0,0,98,25,123
wi14,141,ROOSEVELT,ECE,EleEng&Soc,0,0,0,2,0,2,0,0,0,0,0,0,0,0,0,0,0,0,2,0,2
wi14,141,ROOSEVELT,ECE,Engin Phys,0,0,0,1,0,1,0,0,0,0,0,0,1,0,1,0,0,0,2,0,2
wi14,141,ROOSEVELT,ECE,Pr-EngPhys,0,0,0,1,0,1,2,0,2,0,0,0,0,0,0,0,0,0,3,0,3
wi14,141,ROOSEVELT,ECON,Ec-Mth&Ecn,0,0,0,4,5,9,8,2,10,0,4,4,8,4,12,0,0,0,20,15,35
wi14,141,ROOSEVELT,ECON,Econ-MgtSc,0,0,0,6,8,14,15,14,29,28,15,43,34,32,66,0,0,0,83,69,152
wi14,141,ROOSEVELT,ECON,Economics,0,0,0,19,16,35,21,17,38,54,46,100,51,42,93,0,0,0,145,121,266
wi14,141,ROOSEVELT,ESYS,EnvSys(EB),0,0,0,0,2,2,0,4,4,3,3,6,2,7,9,0,0,0,5,16,21
wi14,141,ROOSEVELT,ESYS,EnvSys(EC),0,0,0,0,1,1,0,0,0,0,0,0,1,5,6,0,0,0,1,6,7
wi14,141,ROOSEVELT,ESYS,EnvSys(EP),0,0,0,3,0,3,0,1,1,1,2,3,0,1,1,0,0,0,4,4,8
wi14,141,ROOSEVELT,ESYS,EnvSys(ES),0,0,0,1,1,2,0,2,2,1,1,2,0,3,3,0,0,0,2,7,9
wi14,141,ROOSEVELT,ETHN,Ethnic St,0,0,0,0,1,1,0,0,0,0,0,0,1,3,4,0,0,0,1,4,5
wi14,141,ROOSEVELT,FPMU,Public Hlt,0,0,0,1,5,6,4,12,16,2,11,13,0,5,5,0,0,0,7,33,40
wi14,141,ROOSEVELT,GMST,German Stu,0,0,0,0,0,0,0,0,0,1,0,1,0,0,0,0,0,0,1,0,1
wi14,141,ROOSEVELT,HDP,Human Dev,0,0,0,0,0,0,0,0,0,0,6,6,1,20,21,0,0,0,1,26,27
wi14,141,ROOSEVELT,HDP,Pr-HumnDev,0,0,0,0,6,6,0,5,5,2,4,6,0,2,2,0,0,0,2,17,19
wi14,141,ROOSEVELT,HIST,History,0,0,0,1,4,5,6,9,15,6,10,16,17,16,33,0,0,0,30,39,69
wi14,141,ROOSEVELT,INTD,Roos IndSt,0,0,0,0,0,0,0,0,0,0,0,0,0,1,1,0,0,0,0,1,1
wi14,141,ROOSEVELT,INTL,Int-5yrEC,0,0,0,0,0,0,0,0,0,0,0,0,0,2,2,0,0,0,0,2,2
wi14,141,ROOSEVELT,INTL,Int-5yrPS,0,0,0,0,0,0,0,0,0,0,0,0,1,1,2,0,0,0,1,1,2
wi14,141,ROOSEVELT,INTL,IntSt-Anth,0,0,0,0,0,0,0,0,0,0,1,1,0,5,5,0,0,0,0,6,6
wi14,141,ROOSEVELT,INTL,IntSt-Econ,0,0,0,2,5,7,8,9,17,6,11,17,7,17,24,0,0,0,23,42,65
wi14,141,ROOSEVELT,INTL,IntSt-Hist,0,0,0,0,1,1,0,0,0,1,2,3,1,5,6,0,0,0,2,8,10
wi14,141,ROOSEVELT,INTL,IntSt-Ling,0,0,0,1,1,2,1,2,3,1,2,3,0,2,2,0,0,0,3,7,10
wi14,141,ROOSEVELT,INTL,IntSt-Lit,0,0,0,0,1,1,0,0,0,0,0,0,0,1,1,0,0,0,0,2,2
wi14,141,ROOSEVELT,INTL,IntSt-PolS,0,0,0,1,5,6,7,11,18,7,20,27,12,33,45,0,0,0,27,69,96
wi14,141,ROOSEVELT,INTL,IntSt-Soc,0,0,0,2,3,5,2,7,9,2,11,13,3,5,8,0,0,0,9,26,35
wi14,141,ROOSEVELT,JAPN,JapaneseSt,0,0,0,0,1,1,1,1,2,0,2,2,2,0,2,0,0,0,3,4,7
wi14,141,ROOSEVELT,LATI,LatinAm St,0,0,0,0,1,1,0,0,0,0,0,0,0,1,1,0,0,0,0,2,2
wi14,141,ROOSEVELT,LING,Lang Stu,0,0,0,0,2,2,0,3,3,2,2,4,0,1,1,0,0,0,2,8,10
wi14,141,ROOSEVELT,LING,Ling-CogLn,0,0,0,0,1,1,0,4,4,0,2,2,0,2,2,0,0,0,0,9,9
wi14,141,ROOSEVELT,LING,Ling-LSoc,0,0,0,0,0,0,0,2,2,2,0,2,0,1,1,0,0,0,2,3,5
wi14,141,ROOSEVELT,LING,Linguistcs,0,0,0,0,2,2,1,2,3,2,3,5,0,3,3,0,0,0,3,10,13
wi14,141,ROOSEVELT,LIT,Lit/Compos,0,0,0,0,1,1,0,0,0,0,0,0,0,0,0,0,0,0,0,1,1
wi14,141,ROOSEVELT,LIT,Lit/CultSt,0,0,0,0,0,0,0,0,0,0,1,1,1,1,2,0,0,0,1,2,3
wi14,141,ROOSEVELT,LIT,Lit/Engl,0,0,0,0,1,1,2,3,5,0,2,2,0,8,8,0,0,0,2,14,16
wi14,141,ROOSEVELT,LIT,Lit/World,0,0,0,0,0,0,0,0,0,1,4,5,0,1,1,0,0,0,1,5,6
wi14,141,ROOSEVELT,LIT,Lit/Writng,0,0,0,0,1,1,1,2,3,1,4,5,4,16,20,0,0,0,6,23,29
wi14,141,ROOSEVELT,LIT,Spanish Lt,0,0,0,0,1,1,0,1,1,0,0,0,1,2,3,0,0,0,1,4,5
wi14,141,ROOSEVELT,MAE,Aerosp Eng,0,0,0,0,1,1,1,0,1,2,0,2,16,3,19,0,0,0,19,4,23
wi14,141,ROOSEVELT,MAE,Engin Sci,0,0,0,0,0,0,0,0,0,0,0,0,5,0,5,0,0,0,5,0,5
wi14,141,ROOSEVELT,MAE,Envir Eng,0,0,0,8,1,9,1,4,5,5,4,9,9,2,11,0,0,0,23,11,34
wi14,141,ROOSEVELT,MAE,Mech Engin,0,0,0,0,3,3,0,0,0,0,1,1,17,1,18,0,0,0,17,5,22
wi14,141,ROOSEVELT,MATH,Appld Math,0,0,0,2,4,6,5,4,9,3,4,7,3,2,5,0,0,0,13,14,27
wi14,141,ROOSEVELT,MATH,Math/SecEd,0,0,0,0,0,0,0,0,0,0,2,2,1,0,1,0,0,0,1,2,3
wi14,141,ROOSEVELT,MATH,Mathematcs,0,0,0,2,3,5,2,1,3,1,0,1,3,3,6,0,0,0,8,7,15
wi14,141,ROOSEVELT,MATH,Mth-CompSc,0,0,0,3,1,4,1,0,1,0,0,0,1,1,2,0,0,0,5,2,7
wi14,141,ROOSEVELT,MATH,Mth-Mth&Ec,0,0,0,5,4,9,7,5,12,3,1,4,0,7,7,0,0,0,15,17,32
wi14,141,ROOSEVELT,MATH,Mth/ApldSc,0,0,0,0,0,0,1,0,1,0,0,0,0,0,0,0,0,0,1,0,1
wi14,141,ROOSEVELT,MATH,Prob&Stats,0,0,0,0,1,1,0,0,0,1,1,2,0,0,0,0,0,0,1,2,3
wi14,141,ROOSEVELT,MUS,Mu-CompArt,0,0,0,0,0,0,0,0,0,0,0,0,2,2,4,0,0,0,2,2,4
wi14,141,ROOSEVELT,MUS,Music,0,0,0,0,1,1,1,1,2,1,0,1,1,1,2,0,0,0,3,3,6
wi14,141,ROOSEVELT,MUS,Music Hum,0,0,0,0,0,0,0,0,0,0,0,0,0,2,2,0,0,0,0,2,2
wi14,141,ROOSEVELT,NENG,NanoEng,0,0,0,0,0,0,6,5,11,5,4,9,16,5,21,0,0,0,27,14,41
wi14,141,ROOSEVELT,PHIL,Philosophy,0,0,0,0,0,0,0,2,2,2,0,2,3,1,4,0,0,0,5,3,8
wi14,141,ROOSEVELT,PHYS,Biophysics,0,0,0,0,2,2,0,0,0,0,0,0,2,1,3,0,0,0,2,3,5
wi14,141,ROOSEVELT,PHYS,Gen Physcs,0,0,0,1,0,1,0,0,0,0,0,0,0,0,0,0,0,0,1,0,1
wi14,141,ROOSEVELT,PHYS,Phy/ErthSc,0,0,0,0,0,0,0,0,0,0,0,0,0,1,1,0,0,0,0,1,1
wi14,141,ROOSEVELT,PHYS,Phys/Astro,0,0,0,1,0,1,0,0,0,1,0,1,0,1,1,0,0,0,2,1,3
wi14,141,ROOSEVELT,PHYS,Phys/Comp,0,0,0,0,0,0,0,0,0,0,0,0,1,0,1,0,0,0,1,0,1
wi14,141,ROOSEVELT,PHYS,Phys/Mtrls,0,0,0,0,0,0,0,0,0,0,0,0,1,0,1,0,0,0,1,0,1
wi14,141,ROOSEVELT,PHYS,Physics,0,0,0,4,0,4,3,1,4,2,1,3,1,1,2,0,0,0,10,3,13
wi14,141,ROOSEVELT,POLI,Polit Sci,0,0,0,4,5,9,4,14,18,14,14,28,15,25,40,0,0,0,37,58,95
wi14,141,ROOSEVELT,POLI,PolSc-Amer,0,0,0,0,0,0,2,3,5,0,2,2,3,1,4,0,0,0,5,6,11
wi14,141,ROOSEVELT,POLI,PolSc-Comp,0,0,0,0,0,0,0,0,0,2,0,2,1,1,2,0,0,0,3,1,4
wi14,141,ROOSEVELT,POLI,PolSc-Intl,0,0,0,1,5,6,9,11,20,14,9,23,17,22,39,0,0,0,41,47,88
wi14,141,ROOSEVELT,POLI,PolSc-PLaw,0,0,0,0,3,3,4,10,14,4,6,10,5,5,10,0,0,0,13,24,37
wi14,141,ROOSEVELT,POLI,PolSc-PPol,0,0,0,0,0,0,3,1,4,3,2,5,1,1,2,0,0,0,7,4,11
wi14,141,ROOSEVELT,POLI,PolSc-Thry,0,0,0,0,0,0,0,2,2,1,1,2,1,0,1,0,0,0,2,3,5
wi14,141,ROOSEVELT,PSYC,Psychology,0,0,0,7,24,31,7,24,31,8,47,55,27,75,102,0,0,0,49,170,219
wi14,141,ROOSEVELT,RELI,Relig/Stu,0,0,0,0,0,0,0,0,0,0,0,0,0,1,1,0,0,0,0,1,1
wi14,141,ROOSEVELT,SE,Engin Sci,0,0,0,1,0,1,0,0,0,0,1,1,0,0,0,0,0,0,1,1,2
wi14,141,ROOSEVELT,SE,Struct Eng,0,0,0,9,1,10,10,4,14,16,4,20,21,6,27,0,0,0,56,15,71
wi14,141,ROOSEVELT,SIO,Earth Sci,0,0,0,0,0,0,0,0,0,1,6,7,1,0,1,0,0,0,2,6,8
wi14,141,ROOSEVELT,SIO,Marine Bio,0,0,0,1,6,7,2,2,4,2,3,5,4,5,9,0,0,0,9,16,25
wi14,141,ROOSEVELT,SOC,SocCulCom,0,0,0,0,0,0,0,0,0,0,0,0,0,4,4,0,0,0,0,4,4
wi14,141,ROOSEVELT,SOC,SocEconSoc,0,0,0,0,1,1,0,0,0,1,1,2,0,2,2,0,0,0,1,4,5
wi14,141,ROOSEVELT,SOC,SocIntlStu,0,0,0,0,0,0,0,0,0,0,0,0,0,1,1,0,0,0,0,1,1
wi14,141,ROOSEVELT,SOC,Sociology,0,0,0,1,3,4,2,6,8,4,13,17,2,8,10,0,0,0,9,30,39
wi14,141,ROOSEVELT,SOC,SocLawSoc,0,0,0,0,0,0,0,0,0,1,2,3,2,3,5,0,0,0,3,5,8
wi14,141,ROOSEVELT,SOC,SocSciMed,0,0,0,0,0,0,1,0,1,0,1,1,0,2,2,0,0,0,1,3,4
wi14,141,ROOSEVELT,SOC,SocSolneq,0,0,0,0,0,0,0,0,0,0,1,1,0,4,4,0,0,0,0,5,5
wi14,141,ROOSEVELT,THEA,Dance,0,0,0,0,1,1,0,0,0,0,0,0,0,1,1,0,0,0,0,2,2
wi14,141,ROOSEVELT,THEA,Theatre,0,0,0,0,1,1,1,0,1,0,3,3,1,5,6,0,0,0,2,9,11
wi14,141,ROOSEVELT,TWS,ThirdWldSt,0,0,0,0,0,0,0,0,0,0,1,1,0,0,0,0,0,0,0,1,1
wi14,141,ROOSEVELT,UNAF,UndecHumAr,0,0,0,1,4,5,0,4,4,0,0,0,0,0,0,0,0,0,1,8,9
wi14,141,ROOSEVELT,UNAF,Undeclared,0,1,1,23,25,48,14,20,34,0,0,0,0,0,0,0,0,0,37,46,83
wi14,141,ROOSEVELT,UNAF,UndecPhysS,0,0,0,3,3,6,2,2,4,0,0,0,0,0,0,0,0,0,5,5,10
wi14,141,ROOSEVELT,UNAF,UndecSocSc,0,0,0,1,5,6,2,4,6,0,0,0,0,0,0,0,0,0,3,9,12
wi14,141,ROOSEVELT,USP,Urb Stu&Pl,0,0,0,0,0,0,0,1,1,1,0,1,5,10,15,0,0,0,6,11,17
wi14,141,ROOSEVELT,VIS,Art Hst/Cr,0,0,0,0,0,0,0,0,0,0,3,3,0,4,4,0,0,0,0,7,7
wi14,141,ROOSEVELT,VIS,Media,0,0,0,0,1,1,3,2,5,0,2,2,7,3,10,0,0,0,10,8,18
wi14,141,ROOSEVELT,VIS,Studio VA,0,0,0,1,0,1,1,0,1,1,4,5,1,2,3,0,0,0,4,6,10
wi14,141,ROOSEVELT,VIS,VA-CompArt,0,0,0,0,0,0,2,3,5,0,2,2,1,1,2,0,0,0,3,6,9
wi14,141,SIXTH,ANTH,Anth-Arch,0,0,0,0,0,0,0,0,0,1,1,2,0,1,1,0,0,0,1,2,3
wi14,141,SIXTH,ANTH,Anth-Biol,0,0,0,0,0,0,0,1,1,0,0,0,0,2,2,0,0,0,0,3,3
wi14,141,SIXTH,ANTH,Anth-Soci,0,0,0,0,0,0,0,1,1,1,5,6,1,0,1,0,0,0,2,6,8
wi14,141,SIXTH,BENG,Bioen:Binf,0,0,0,1,2,3,2,5,7,2,5,7,6,2,8,0,0,0,11,14,25
wi14,141,SIXTH,BENG,Bioeng:PM,0,0,0,0,0,0,0,0,0,0,0,0,1,1,2,0,0,0,1,1,2
wi14,141,SIXTH,BENG,BioengBioS,0,0,0,3,2,5,1,2,3,1,0,1,0,0,0,0,0,0,5,4,9
wi14,141,SIXTH,BENG,BioengBiot,0,0,0,1,0,1,3,2,5,5,3,8,8,7,15,0,0,0,17,12,29
wi14,141,SIXTH,BENG,Bioengin,0,0,0,0,1,1,1,0,1,2,2,4,10,7,17,0,0,0,13,10,23
wi14,141,SIXTH,BIOL,Bioc/CellB,0,0,0,13,11,24,18,11,29,20,27,47,31,29,60,0,0,0,82,78,160
wi14,141,SIXTH,BIOL,BiolBioinf,0,0,0,1,0,1,0,1,1,1,1,2,0,0,0,0,0,0,2,2,4
wi14,141,SIXTH,BIOL,Ec/Beh/Evo,0,0,0,0,0,0,2,1,3,1,6,7,3,5,8,0,0,0,6,12,18
wi14,141,SIXTH,BIOL,Genl Biol,0,0,0,7,12,19,7,16,23,11,20,31,24,22,46,0,0,0,49,70,119
wi14,141,SIXTH,BIOL,Human Bio,0,0,0,18,30,48,22,21,43,29,27,56,36,30,66,0,0,0,105,108,213
wi14,141,SIXTH,BIOL,Microbiol,0,0,0,0,2,2,3,4,7,2,4,6,4,5,9,0,0,0,9,15,24
wi14,141,SIXTH,BIOL,Molec Biol,0,0,0,1,2,3,4,3,7,4,0,4,3,5,8,0,0,0,12,10,22
wi14,141,SIXTH,BIOL,PhyslNeuro,0,0,0,8,5,13,7,14,21,15,9,24,16,14,30,0,0,0,46,42,88
wi14,141,SIXTH,CENG,Chem Engin,0,0,0,11,5,16,14,8,22,17,7,24,16,10,26,0,0,0,58,30,88
wi14,141,SIXTH,CGS,CritGendSt,0,0,0,0,0,0,0,0,0,1,1,2,1,0,1,0,0,0,2,1,3
wi14,141,SIXTH,CHEM,Bioch/Chem,0,0,0,6,3,9,3,3,6,5,5,10,27,15,42,0,0,0,41,26,67
wi14,141,SIXTH,CHEM,Bioinform,0,0,0,0,1,1,0,0,0,0,0,0,0,0,0,0,0,0,0,1,1
wi14,141,SIXTH,CHEM,Chem Educ,0,0,0,0,0,0,0,0,0,0,0,0,0,1,1,0,0,0,0,1,1
wi14,141,SIXTH,CHEM,Chem Phys,0,0,0,0,0,0,0,0,0,0,0,0,1,0,1,0,0,0,1,0,1
wi14,141,SIXTH,CHEM,Chemistry,0,0,0,3,3,6,0,1,1,1,2,3,8,2,10,0,0,0,12,8,20
wi14,141,SIXTH,CHEM,Envir Chem,0,0,0,0,0,0,0,0,0,0,1,1,1,4,5,0,0,0,1,5,6
wi14,141,SIXTH,CHEM,MolecSynth,0,0,0,0,0,0,0,0,0,1,1,2,0,1,1,0,0,0,1,2,3
wi14,141,SIXTH,CHEM,Pharm Chem,0,0,0,2,12,14,5,14,19,6,5,11,17,12,29,0,0,0,30,43,73
wi14,141,SIXTH,CHIN,Chinese St,0,0,0,0,0,0,0,0,0,0,0,0,1,0,1,0,0,0,1,0,1
wi14,141,SIXTH,COGS,Cog Sci,0,0,0,1,2,3,6,2,8,3,6,9,7,0,7,0,0,0,17,10,27
wi14,141,SIXTH,COGS,CogSc/ClAs,0,0,0,0,0,0,0,0,0,0,0,0,0,1,1,0,0,0,0,1,1
wi14,141,SIXTH,COGS,CogSc/Comp,0,0,0,0,0,0,0,1,1,0,0,0,3,2,5,0,0,0,3,3,6
wi14,141,SIXTH,COGS,CogSc/HCI,0,0,0,0,0,0,2,2,4,1,4,5,7,14,21,0,0,0,10,20,30
wi14,141,SIXTH,COGS,CogSc/HCog,0,0,0,0,0,0,0,0,0,0,2,2,0,1,1,0,0,0,0,3,3
wi14,141,SIXTH,COGS,CogSc/Neur,0,0,0,1,0,1,1,2,3,3,3,6,6,14,20,0,0,0,11,19,30
wi14,141,SIXTH,COMM,Communic,0,0,0,3,6,9,6,22,28,17,41,58,15,41,56,0,0,0,41,110,151
wi14,141,SIXTH,CSE,Comp Sci,0,0,0,5,1,6,43,10,53,96,27,123,103,23,126,0,0,0,247,61,308
wi14,141,SIXTH,CSE,CompEngCSE,0,0,0,7,0,7,18,2,20,25,1,26,22,1,23,0,0,0,72,4,76
wi14,141,SIXTH,CSE,CompScBinf,0,0,0,5,0,5,2,3,5,1,2,3,3,2,5,0,0,0,11,7,18
wi14,141,SIXTH,ECE,CompEngECE,0,0,0,3,0,3,7,0,7,5,0,5,3,0,3,0,0,0,18,0,18
wi14,141,SIXTH,ECE,Electr Eng,0,0,0,36,3,39,41,2,43,56,6,62,45,4,49,0,0,0,178,15,193
wi14,141,SIXTH,ECE,Engin Phys,0,0,0,0,0,0,0,0,0,0,0,0,1,0,1,0,0,0,1,0,1
wi14,141,SIXTH,ECE,Pr-EngPhys,0,0,0,1,0,1,0,0,0,1,0,1,0,0,0,0,0,0,2,0,2
wi14,141,SIXTH,ECON,Ec-Mth&Ecn,0,0,0,5,4,9,4,4,8,3,1,4,5,0,5,0,0,0,17,9,26
wi14,141,SIXTH,ECON,Econ-MgtSc,0,0,0,8,2,10,14,7,21,17,13,30,43,26,69,0,0,0,82,48,130
wi14,141,SIXTH,ECON,Economics,0,0,0,14,10,24,21,7,28,44,26,70,45,32,77,0,0,0,124,75,199
wi14,141,SIXTH,ESYS,EnvSys(EB),0,0,0,0,0,0,0,2,2,1,2,3,3,14,17,0,0,0,4,18,22
wi14,141,SIXTH,ESYS,EnvSys(EC),0,0,0,0,0,0,0,0,0,0,1,1,1,0,1,0,0,0,1,1,2
wi14,141,SIXTH,ESYS,EnvSys(EP),0,0,0,0,0,0,0,0,0,0,3,3,0,3,3,0,0,0,0,6,6
wi14,141,SIXTH,ESYS,EnvSys(ES),0,0,0,0,0,0,0,1,1,1,0,1,1,2,3,0,0,0,2,3,5
wi14,141,SIXTH,ETHN,Ethnic St,0,0,0,0,1,1,0,1,1,0,0,0,2,0,2,0,0,0,2,2,4
wi14,141,SIXTH,FPMU,Public Hlt,0,0,0,0,3,3,1,12,13,0,6,6,2,2,4,0,0,0,3,23,26
wi14,141,SIXTH,HDP,Human Dev,0,0,0,0,0,0,0,0,0,1,6,7,2,27,29,0,0,0,3,33,36
wi14,141,SIXTH,HDP,Pr-HumnDev,0,0,0,0,2,2,0,7,7,0,7,7,1,2,3,0,0,0,1,18,19
wi14,141,SIXTH,HIST,History,0,0,0,0,0,0,0,0,0,3,3,6,7,3,10,0,0,0,10,6,16
wi14,141,SIXTH,INTL,IntSt-Anth,0,0,0,0,0,0,0,1,1,0,0,0,0,0,0,0,0,0,0,1,1
wi14,141,SIXTH,INTL,IntSt-Econ,0,0,0,0,3,3,2,1,3,4,2,6,4,9,13,0,0,0,10,15,25
wi14,141,SIXTH,INTL,IntSt-Hist,0,0,0,0,0,0,0,0,0,1,0,1,0,1,1,0,0,0,1,1,2
wi14,141,SIXTH,INTL,IntSt-Ling,0,0,0,0,0,0,0,0,0,0,0,0,0,1,1,0,0,0,0,1,1
wi14,141,SIXTH,INTL,IntSt-PolS,0,0,0,0,0,0,1,3,4,1,0,1,2,10,12,0,0,0,4,13,17
wi14,141,SIXTH,INTL,IntSt-Soc,0,0,0,0,1,1,1,2,3,0,0,0,1,1,2,0,0,0,2,4,6
wi14,141,SIXTH,ITAL,Italian St,0,0,0,0,0,0,0,0,0,0,1,1,0,0,0,0,0,0,0,1,1
wi14,141,SIXTH,JAPN,JapaneseSt,0,0,0,0,0,0,0,0,0,0,0,0,0,1,1,0,0,0,0,1,1
wi14,141,SIXTH,LING,Lang Stu,0,0,0,0,0,0,0,0,0,0,0,0,0,1,1,0,0,0,0,1,1
wi14,141,SIXTH,LING,Ling-CogLn,0,0,0,0,0,0,0,1,1,1,2,3,1,1,2,0,0,0,2,4,6
wi14,141,SIXTH,LING,Ling-LSoc,0,0,0,0,0,0,0,0,0,0,1,1,1,2,3,0,0,0,1,3,4
wi14,141,SIXTH,LING,Linguistcs,0,0,0,0,1,1,0,0,0,1,2,3,0,3,3,0,0,0,1,6,7
wi14,141,SIXTH,LIT,Lit/CultSt,0,0,0,0,0,0,0,0,0,0,0,0,0,1,1,0,0,0,0,1,1
wi14,141,SIXTH,LIT,Lit/Engl,0,0,0,0,0,0,0,1,1,1,3,4,1,2,3,0,0,0,2,6,8
wi14,141,SIXTH,LIT,Lit/World,0,0,0,0,0,0,0,0,0,0,0,0,0,1,1,0,0,0,0,1,1
wi14,141,SIXTH,LIT,Lit/Writng,0,0,0,1,4,5,1,2,3,1,3,4,2,3,5,0,0,0,5,12,17
wi14,141,SIXTH,LIT,Spanish Lt,0,0,0,0,0,0,0,0,0,0,0,0,0,1,1,0,0,0,0,1,1
wi14,141,SIXTH,MAE,Aerosp Eng,0,0,0,1,1,2,4,1,5,6,2,8,15,1,16,0,0,0,26,5,31
wi14,141,SIXTH,MAE,Engin Sci,0,0,0,0,0,0,0,0,0,0,0,0,5,0,5,0,0,0,5,0,5
wi14,141,SIXTH,MAE,Envir Eng,0,0,0,9,2,11,4,3,7,8,4,12,10,13,23,0,0,0,31,22,53
wi14,141,SIXTH,MAE,Mech Engin,0,0,0,0,0,0,12,3,15,8,3,11,38,5,43,0,0,0,58,11,69
wi14,141,SIXTH,MATH,Appld Math,0,0,0,5,4,9,4,5,9,5,4,9,4,3,7,0,0,0,18,16,34
wi14,141,SIXTH,MATH,Math/SecEd,0,0,0,0,0,0,0,0,0,0,0,0,0,1,1,0,0,0,0,1,1
wi14,141,SIXTH,MATH,Mathematcs,0,0,0,5,1,6,3,2,5,2,1,3,3,1,4,0,0,0,13,5,18
wi14,141,SIXTH,MATH,Mth-CompSc,0,0,0,5,0,5,5,4,9,2,0,2,3,2,5,0,0,0,15,6,21
wi14,141,SIXTH,MATH,Mth-Mth&Ec,0,0,0,2,0,2,5,2,7,3,4,7,5,1,6,0,0,0,15,7,22
wi14,141,SIXTH,MATH,Mth/ApldSc,0,0,0,0,2,2,1,1,2,0,0,0,0,1,1,0,0,0,1,4,5
wi14,141,SIXTH,MATH,Prob&Stats,0,0,0,0,1,1,0,1,1,1,1,2,1,0,1,0,0,0,2,3,5
wi14,141,SIXTH,MUS,Mu-CompArt,0,0,0,1,1,2,1,0,1,7,1,8,11,0,11,0,0,0,20,2,22
wi14,141,SIXTH,MUS,Music,0,0,0,1,0,1,0,0,0,1,2,3,6,4,10,0,0,0,8,6,14
wi14,141,SIXTH,NENG,NanoEng,0,0,0,7,2,9,9,5,14,14,1,15,20,4,24,0,0,0,50,12,62
wi14,141,SIXTH,PHIL,Philosophy,0,0,0,0,0,0,0,1,1,0,0,0,2,2,4,0,0,0,2,3,5
wi14,141,SIXTH,PHYS,Biophysics,0,0,0,0,0,0,1,0,1,0,0,0,4,0,4,0,0,0,5,0,5
wi14,141,SIXTH,PHYS,GenPys/SEd,0,0,0,1,0,1,1,0,1,0,0,0,0,0,0,0,0,0,2,0,2
wi14,141,SIXTH,PHYS,Phy/ErthSc,0,0,0,0,0,0,1,0,1,0,0,0,1,0,1,0,0,0,2,0,2
wi14,141,SIXTH,PHYS,Phys/Astro,0,0,0,0,2,2,2,1,3,2,1,3,0,1,1,0,0,0,4,5,9
wi14,141,SIXTH,PHYS,Phys/Comp,0,0,0,0,0,0,1,0,1,1,0,1,1,0,1,0,0,0,3,0,3
wi14,141,SIXTH,PHYS,Phys/Mtrls,0,0,0,0,0,0,1,0,1,1,0,1,0,0,0,0,0,0,2,0,2
wi14,141,SIXTH,PHYS,Physics,0,0,0,6,0,6,4,1,5,3,0,3,5,0,5,0,0,0,18,1,19
wi14,141,SIXTH,POLI,Polit Sci,0,0,0,3,0,3,3,4,7,7,6,13,7,7,14,0,0,0,20,17,37
wi14,141,SIXTH,POLI,PolSc-Amer,0,0,0,0,0,0,1,1,2,1,1,2,3,2,5,0,0,0,5,4,9
wi14,141,SIXTH,POLI,PolSc-Comp,0,0,0,0,0,0,0,0,0,0,0,0,0,1,1,0,0,0,0,1,1
wi14,141,SIXTH,POLI,PolSc-Intl,0,0,0,1,1,2,1,1,2,3,7,10,5,3,8,0,0,0,10,12,22
wi14,141,SIXTH,POLI,PolSc-PLaw,0,0,0,0,0,0,0,2,2,1,2,3,5,3,8,0,0,0,6,7,13
wi14,141,SIXTH,POLI,PolSc-PPol,0,0,0,0,0,0,0,0,0,0,0,0,1,2,3,0,0,0,1,2,3
wi14,141,SIXTH,POLI,PolSc-Thry,0,0,0,0,0,0,0,0,0,0,0,0,0,1,1,0,0,0,0,1,1
wi14,141,SIXTH,PSYC,Psychology,0,0,0,5,8,13,5,23,28,16,42,58,27,59,86,0,0,0,53,132,185
wi14,141,SIXTH,RELI,Relig/Stu,0,0,0,0,0,0,0,0,0,0,0,0,0,1,1,0,0,0,0,1,1
wi14,141,SIXTH,SE,Engin Sci,0,0,0,2,0,2,1,0,1,0,0,0,0,0,0,0,0,0,3,0,3
wi14,141,SIXTH,SE,Struct Eng,0,0,0,16,5,21,21,4,25,24,8,32,46,10,56,0,0,0,107,27,134
wi14,141,SIXTH,SIO,Earth Sci,0,0,0,0,0,0,0,0,0,0,1,1,2,3,5,0,0,0,2,4,6
wi14,141,SIXTH,SIO,Marine Bio,0,0,0,0,6,6,1,4,5,1,4,5,2,1,3,0,0,0,4,15,19
wi14,141,SIXTH,SOC,SocCulCom,0,0,0,0,0,0,0,0,0,0,1,1,0,1,1,0,0,0,0,2,2
wi14,141,SIXTH,SOC,SocEconSoc,0,0,0,0,1,1,1,0,1,0,0,0,1,0,1,0,0,0,2,1,3
wi14,141,SIXTH,SOC,SocIntlStu,0,0,0,0,0,0,0,0,0,0,0,0,0,2,2,0,0,0,0,2,2
wi14,141,SIXTH,SOC,Sociology,0,0,0,2,1,3,0,1,1,5,8,13,2,7,9,0,0,0,9,17,26
wi14,141,SIXTH,SOC,SocLawSoc,0,0,0,0,0,0,0,0,0,0,3,3,1,2,3,0,0,0,1,5,6
wi14,141,SIXTH,SOC,SocSciMed,0,0,0,0,0,0,0,1,1,0,1,1,1,0,1,0,0,0,1,2,3
wi14,141,SIXTH,SOC,SocSolneq,0,0,0,0,0,0,0,0,0,0,0,0,0,4,4,0,0,0,0,4,4
wi14,141,SIXTH,THEA,Dance,0,0,0,0,0,0,0,0,0,0,1,1,0,0,0,0,0,0,0,1,1
wi14,141,SIXTH,THEA,Theatre,0,0,0,0,6,6,0,2,2,5,4,9,5,11,16,0,0,0,10,23,33
wi14,141,SIXTH,UNAF,UndecHumAr,0,0,0,2,1,3,0,1,1,0,0,0,0,0,0,0,0,0,2,2,4
wi14,141,SIXTH,UNAF,Undeclared,0,0,0,46,28,74,33,15,48,0,0,0,0,0,0,0,0,0,79,43,122
wi14,141,SIXTH,UNAF,UndecPhysS,0,1,1,5,3,8,1,0,1,0,0,0,0,0,0,0,0,0,6,4,10
wi14,141,SIXTH,UNAF,UndecSocSc,0,0,0,2,6,8,1,0,1,0,0,0,0,0,0,0,0,0,3,6,9
wi14,141,SIXTH,USP,Urb Stu&Pl,0,0,0,0,0,0,0,2,2,3,9,12,4,7,11,0,0,0,7,18,25
wi14,141,SIXTH,VIS,Art Hst/Cr,0,0,0,0,0,0,0,0,0,0,4,4,0,5,5,0,0,0,0,9,9
wi14,141,SIXTH,VIS,Media,0,0,0,7,6,13,7,7,14,7,15,22,17,11,28,0,0,0,38,39,77
wi14,141,SIXTH,VIS,Studio VA,0,0,0,0,0,0,1,4,5,1,5,6,1,16,17,0,0,0,3,25,28
wi14,141,SIXTH,VIS,VA-CompArt,0,0,0,1,7,8,1,9,10,2,1,3,8,8,16,0,0,0,12,25,37
wi14,141,WARREN,ANTH,Anth-Arch,0,0,0,0,1,1,0,0,0,1,2,3,0,2,2,0,0,0,1,5,6
wi14,141,WARREN,ANTH,Anth-Biol,0,0,0,0,0,0,0,0,0,0,0,0,0,2,2,0,0,0,0,2,2
wi14,141,WARREN,ANTH,Anth-Soci,0,0,0,0,0,0,0,0,0,0,0,0,1,2,3,0,0,0,1,2,3
wi14,141,WARREN,BENG,Bioen:Binf,0,0,0,3,4,7,3,5,8,4,3,7,4,7,11,0,0,0,14,19,33
wi14,141,WARREN,BENG,BioengBioS,0,0,0,2,0,2,10,0,10,0,1,1,0,0,0,0,0,0,12,1,13
wi14,141,WARREN,BENG,BioengBiot,0,0,0,2,0,2,7,10,17,10,9,19,24,22,46,0,0,0,43,41,84
wi14,141,WARREN,BENG,Bioengin,0,0,0,0,0,0,5,7,12,12,4,16,19,13,32,0,0,0,36,24,60
wi14,141,WARREN,BIOL,Bioc/CellB,0,0,0,5,11,16,18,15,33,27,26,53,35,34,69,0,0,0,85,86,171
wi14,141,WARREN,BIOL,BiolBioinf,0,0,0,0,0,0,0,2,2,2,0,2,1,0,1,0,0,0,3,2,5
wi14,141,WARREN,BIOL,Ec/Beh/Evo,0,0,0,0,1,1,3,1,4,1,1,2,2,7,9,0,0,0,6,10,16
wi14,141,WARREN,BIOL,Genl Biol,0,0,0,4,7,11,4,16,20,13,20,33,29,38,67,0,0,0,50,81,131
wi14,141,WARREN,BIOL,Human Bio,0,0,0,3,22,25,23,29,52,24,34,58,35,39,74,0,0,0,85,124,209
wi14,141,WARREN,BIOL,Microbiol,0,0,0,0,0,0,1,2,3,2,2,4,3,7,10,0,0,0,6,11,17
wi14,141,WARREN,BIOL,Molec Biol,0,0,0,1,0,1,2,1,3,2,4,6,9,7,16,0,0,0,14,12,26
wi14,141,WARREN,BIOL,PhyslNeuro,0,0,0,2,8,10,13,13,26,17,11,28,12,18,30,0,0,0,44,50,94
wi14,141,WARREN,CENG,Chem Engin,0,0,0,12,5,17,23,12,35,34,14,48,54,31,85,0,0,0,123,62,185
wi14,141,WARREN,CGS,CritGendSt,0,0,0,0,0,0,1,0,1,0,0,0,0,0,0,0,0,0,1,0,1
wi14,141,WARREN,CHEM,Bioch/Chem,0,0,0,2,3,5,5,3,8,5,8,13,23,18,41,0,0,0,35,32,67
wi14,141,WARREN,CHEM,Chem Phys,0,0,0,0,0,0,0,0,0,0,0,0,0,1,1,0,0,0,0,1,1
wi14,141,WARREN,CHEM,Chemistry,0,0,0,0,4,4,1,4,5,3,4,7,4,11,15,0,0,0,8,23,31
wi14,141,WARREN,CHEM,Envir Chem,0,0,0,0,0,0,0,0,0,1,0,1,0,3,3,0,0,0,1,3,4
wi14,141,WARREN,CHEM,MolecSynth,0,0,0,0,0,0,0,0,0,0,0,0,3,0,3,0,0,0,3,0,3
wi14,141,WARREN,CHEM,Pharm Chem,0,0,0,0,1,1,1,3,4,3,9,12,19,24,43,0,0,0,23,37,60
wi14,141,WARREN,CHIN,Chinese St,0,0,0,0,0,0,0,0,0,0,2,2,0,0,0,0,0,0,0,2,2
wi14,141,WARREN,COGS,Cog Sci,0,0,0,0,1,1,1,4,5,1,4,5,7,4,11,0,0,0,9,13,22
wi14,141,WARREN,COGS,CogSc/ClAs,0,0,0,0,0,0,1,2,3,0,1,1,0,2,2,0,0,0,1,5,6
wi14,141,WARREN,COGS,CogSc/Comp,0,0,0,0,0,0,0,0,0,0,0,0,1,1,2,0,0,0,1,1,2
wi14,141,WARREN,COGS,CogSc/HCI,0,0,0,0,0,0,0,1,1,1,2,3,5,5,10,0,0,0,6,8,14
wi14,141,WARREN,COGS,CogSc/HCog,0,0,0,0,0,0,1,0,1,1,1,2,0,1,1,0,0,0,2,2,4
wi14,141,WARREN,COGS,CogSc/Neur,0,0,0,0,1,1,0,1,1,0,4,4,11,21,32,0,0,0,11,27,38
wi14,141,WARREN,COMM,Communic,0,0,0,0,4,4,3,5,8,10,27,37,11,23,34,0,0,0,24,59,83
wi14,141,WARREN,CSE,Comp Sci,0,0,0,11,4,15,60,7,67,121,26,147,166,28,194,0,0,0,358,65,423
wi14,141,WARREN,CSE,CompEngCSE,0,0,0,4,0,4,16,3,19,34,4,38,45,5,50,0,0,0,99,12,111
wi14,141,WARREN,CSE,CompScBinf,0,0,0,7,2,9,12,0,12,3,3,6,9,5,14,0,0,0,31,10,41
wi14,141,WARREN,ECE,CompEngECE,0,0,0,4,0,4,9,3,12,9,0,9,12,0,12,0,0,0,34,3,37
wi14,141,WARREN,ECE,Electr Eng,0,0,0,38,12,50,49,17,66,65,13,78,90,10,100,0,0,0,242,52,294
wi14,141,WARREN,ECE,EleEng&Soc,0,0,0,0,1,1,0,0,0,0,0,0,0,0,0,0,0,0,0,1,1
wi14,141,WARREN,ECE,Engin Phys,0,0,0,1,0,1,2,0,2,2,0,2,2,0,2,0,0,0,7,0,7
wi14,141,WARREN,ECE,Pr-EngPhys,0,0,0,1,0,1,1,0,1,1,0,1,0,0,0,0,0,0,3,0,3
wi14,141,WARREN,ECON,Ec-Mth&Ecn,0,0,0,4,1,5,5,3,8,3,3,6,5,0,5,0,0,0,17,7,24
wi14,141,WARREN,ECON,Econ-MgtSc,0,0,0,7,7,14,15,7,22,24,18,42,34,21,55,0,0,0,80,53,133
wi14,141,WARREN,ECON,Economics,0,0,0,13,6,19,18,8,26,61,29,90,53,37,90,0,0,0,145,80,225
wi14,141,WARREN,ESYS,EnvSys(EB),0,0,0,0,0,0,0,0,0,0,2,2,3,4,7,0,0,0,3,6,9
wi14,141,WARREN,ESYS,EnvSys(EP),0,0,0,1,0,1,0,0,0,0,1,1,1,1,2,0,0,0,2,2,4
wi14,141,WARREN,ESYS,EnvSys(ES),0,0,0,0,0,0,1,0,1,0,0,0,1,0,1,0,0,0,2,0,2
wi14,141,WARREN,ETHN,Ethnic St,0,0,0,0,1,1,1,1,2,1,1,2,0,2,2,0,0,0,2,5,7
wi14,141,WARREN,FPMU,Public Hlt,0,0,0,0,0,0,0,4,4,0,8,8,2,0,2,0,0,0,2,12,14
wi14,141,WARREN,HDP,Human Dev,0,0,0,0,0,0,1,0,1,0,6,6,4,15,19,0,0,0,5,21,26
wi14,141,WARREN,HDP,Pr-HumnDev,0,0,0,0,1,1,1,2,3,1,5,6,0,0,0,0,0,0,2,8,10
wi14,141,WARREN,HIST,History,0,0,0,1,0,1,0,1,1,4,0,4,7,2,9,0,0,0,12,3,15
wi14,141,WARREN,INTD,Wa Ind St,0,0,0,0,0,0,0,0,0,0,0,0,0,2,2,0,0,0,0,2,2
wi14,141,WARREN,INTL,IntSt-Econ,0,0,0,0,2,2,0,0,0,1,2,3,0,10,10,0,0,0,1,14,15
wi14,141,WARREN,INTL,IntSt-Hist,0,0,0,0,0,0,0,0,0,0,0,0,0,2,2,0,0,0,0,2,2
wi14,141,WARREN,INTL,IntSt-Ling,0,0,0,0,0,0,0,0,0,0,1,1,0,1,1,0,0,0,0,2,2
wi14,141,WARREN,INTL,IntSt-PolS,0,0,0,0,0,0,0,3,3,3,2,5,4,0,4,0,0,0,7,5,12
wi14,141,WARREN,INTL,IntSt-Soc,0,0,0,0,0,0,0,1,1,0,1,1,0,2,2,0,0,0,0,4,4
wi14,141,WARREN,JAPN,JapaneseSt,0,0,0,0,0,0,1,0,1,1,0,1,0,0,0,0,0,0,2,0,2
wi14,141,WARREN,JUDA,Judaic Stu,0,0,0,0,0,0,0,0,0,1,0,1,1,0,1,0,0,0,2,0,2
wi14,141,WARREN,LING,Lang Stu,0,0,0,0,0,0,0,0,0,0,0,0,1,1,2,0,0,0,1,1,2
wi14,141,WARREN,LING,Ling-CogLn,0,0,0,0,0,0,0,1,1,0,1,1,0,1,1,0,0,0,0,3,3
wi14,141,WARREN,LING,Ling-LSoc,0,0,0,1,0,1,0,0,0,0,1,1,0,0,0,0,0,0,1,1,2
wi14,141,WARREN,LING,Linguistcs,0,0,0,0,0,0,0,0,0,0,0,0,3,2,5,0,0,0,3,2,5
wi14,141,WARREN,LIT,Lit/Engl,0,0,0,1,0,1,0,0,0,0,5,5,1,2,3,0,0,0,2,7,9
wi14,141,WARREN,LIT,Lit/Writng,0,0,0,0,0,0,0,2,2,5,5,10,1,7,8,0,0,0,6,14,20
wi14,141,WARREN,LIT,Spanish Lt,0,0,0,0,0,0,0,0,0,1,1,2,0,0,0,0,0,0,1,1,2
wi14,141,WARREN,MAE,Aerosp Eng,0,0,0,6,0,6,16,5,21,19,6,25,28,3,31,0,0,0,69,14,83
wi14,141,WARREN,MAE,Engin Sci,0,0,0,0,0,0,0,0,0,2,0,2,7,1,8,0,0,0,9,1,10
wi14,141,WARREN,MAE,Envir Eng,0,0,0,7,1,8,13,8,21,10,4,14,16,15,31,0,0,0,46,28,74
wi14,141,WARREN,MAE,Mech Engin,0,0,0,5,0,5,30,5,35,28,5,33,52,13,65,0,0,0,115,23,138
wi14,141,WARREN,MATH,Appld Math,0,0,0,6,2,8,4,5,9,6,3,9,9,6,15,0,0,0,25,16,41
wi14,141,WARREN,MATH,Math/SecEd,0,0,0,1,0,1,0,3,3,0,3,3,2,2,4,0,0,0,3,8,11
wi14,141,WARREN,MATH,Mathematcs,0,0,0,1,3,4,3,1,4,1,4,5,4,4,8,0,0,0,9,12,21
wi14,141,WARREN,MATH,Mth-CompSc,0,0,0,7,3,10,2,0,2,1,1,2,4,2,6,0,0,0,14,6,20
wi14,141,WARREN,MATH,Mth-Mth&Ec,0,0,0,4,7,11,8,4,12,4,6,10,7,6,13,0,0,0,23,23,46
wi14,141,WARREN,MATH,Mth/ApldSc,0,0,0,0,0,0,1,0,1,2,1,3,0,3,3,0,0,0,3,4,7
wi14,141,WARREN,MATH,Prob&Stats,0,0,0,1,1,2,2,3,5,0,2,2,5,1,6,0,0,0,8,7,15
wi14,141,WARREN,MUS,Mu-CompArt,0,0,0,0,0,0,1,1,2,1,1,2,2,1,3,0,0,0,4,3,7
wi14,141,WARREN,MUS,Music,0,0,0,0,0,0,0,0,0,0,1,1,2,0,2,0,0,0,2,1,3
wi14,141,WARREN,MUS,Music Hum,0,0,0,0,0,0,0,0,0,0,0,0,1,0,1,0,0,0,1,0,1
wi14,141,WARREN,NENG,NanoEng,0,0,0,6,1,7,13,4,17,17,1,18,36,10,46,0,0,0,72,16,88
wi14,141,WARREN,PHIL,Philosophy,0,0,0,0,0,0,0,2,2,2,2,4,8,1,9,0,0,0,10,5,15
wi14,141,WARREN,PHYS,Biophysics,0,0,0,0,0,0,0,1,1,1,1,2,1,2,3,0,0,0,2,4,6
wi14,141,WARREN,PHYS,GenPys/SEd,0,0,0,0,0,0,0,1,1,0,0,0,0,0,0,0,0,0,0,1,1
wi14,141,WARREN,PHYS,Phys/Astro,0,0,0,1,0,1,4,1,5,0,2,2,2,0,2,0,0,0,7,3,10
wi14,141,WARREN,PHYS,Phys/Comp,0,0,0,0,0,0,0,0,0,0,0,0,1,1,2,0,0,0,1,1,2
wi14,141,WARREN,PHYS,Physics,0,0,0,2,0,2,2,0,2,3,1,4,6,1,7,0,0,0,13,2,15
wi14,141,WARREN,POLI,Polit Sci,0,0,0,1,0,1,5,3,8,11,9,20,24,22,46,0,0,0,41,34,75
wi14,141,WARREN,POLI,PolSc-Amer,0,0,0,0,0,0,2,0,2,2,2,4,10,6,16,0,0,0,14,8,22
wi14,141,WARREN,POLI,PolSc-Comp,0,0,0,0,0,0,0,0,0,0,0,0,0,1,1,0,0,0,0,1,1
wi14,141,WARREN,POLI,PolSc-Intl,0,0,0,0,2,2,6,2,8,3,2,5,8,3,11,0,0,0,17,9,26
wi14,141,WARREN,POLI,PolSc-PLaw,0,0,0,0,1,1,2,4,6,6,3,9,4,5,9,0,0,0,12,13,25
wi14,141,WARREN,POLI,PolSc-PPol,0,0,0,0,0,0,0,1,1,2,1,3,4,3,7,0,0,0,6,5,11
wi14,141,WARREN,POLI,PolSc-Thry,0,0,0,0,0,0,0,0,0,1,0,1,2,1,3,0,0,0,3,1,4
wi14,141,WARREN,PSYC,Psychology,0,0,0,6,13,19,3,16,19,18,41,59,30,54,84,0,0,0,57,124,181
wi14,141,WARREN,RELI,Relig/Stu,0,0,0,0,0,0,0,0,0,0,0,0,1,1,2,0,0,0,1,1,2
wi14,141,WARREN,SE,Engin Sci,0,0,0,0,0,0,2,2,4,0,0,0,0,0,0,0,0,0,2,2,4
wi14,141,WARREN,SE,Struct Eng,0,0,0,21,10,31,30,12,42,37,11,48,71,19,90,0,0,0,159,52,211
wi14,141,WARREN,SIO,Earth Sci,0,0,0,0,0,0,1,0,1,1,0,1,2,3,5,0,0,0,4,3,7
wi14,141,WARREN,SIO,Marine Bio,0,0,0,0,1,1,0,0,0,0,3,3,2,1,3,0,0,0,2,5,7
wi14,141,WARREN,SOC,SocCulCom,0,0,0,0,0,0,0,0,0,0,0,0,0,1,1,0,0,0,0,1,1
wi14,141,WARREN,SOC,SocEconSoc,0,0,0,0,0,0,0,0,0,2,0,2,0,1,1,0,0,0,2,1,3
wi14,141,WARREN,SOC,Sociology,0,0,0,0,0,0,0,1,1,2,7,9,6,8,14,0,0,0,8,16,24
wi14,141,WARREN,SOC,SocLawSoc,0,0,0,0,0,0,0,1,1,3,2,5,1,5,6,0,0,0,4,8,12
wi14,141,WARREN,SOC,SocSciMed,0,0,0,0,0,0,0,1,1,0,0,0,0,2,2,0,0,0,0,3,3
wi14,141,WARREN,SOC,SocSolneq,0,0,0,0,0,0,0,0,0,0,1,1,0,2,2,0,0,0,0,3,3
wi14,141,WARREN,THEA,Theatre,0,0,0,0,0,0,0,0,0,0,1,1,4,2,6,0,0,0,4,3,7
wi14,141,WARREN,UNAF,IntcampVis,0,0,0,0,2,2,0,0,0,0,1,1,0,0,0,0,0,0,0,3,3
wi14,141,WARREN,UNAF,Limited St,0,0,0,0,0,0,0,0,0,0,0,0,0,0,0,3,0,3,3,0,3
wi14,141,WARREN,UNAF,UndecHumAr,0,0,0,0,0,0,0,1,1,0,0,0,0,0,0,0,0,0,0,1,1
wi14,141,WARREN,UNAF,Undeclared,0,0,0,23,12,35,16,8,24,1,0,1,0,0,0,0,0,0,40,20,60
wi14,141,WARREN,UNAF,UndecPhysS,0,0,0,2,0,2,0,0,0,0,0,0,0,0,0,0,0,0,2,0,2
wi14,141,WARREN,UNAF,UndecSocSc,0,0,0,0,0,0,2,1,3,0,0,0,0,0,0,0,0,0,2,1,3
wi14,141,WARREN,USP,Urb Stu&Pl,0,0,0,0,0,0,1,1,2,2,1,3,4,1,5,0,0,0,7,3,10
wi14,141,WARREN,VIS,Art Hst/Cr,0,0,0,0,0,0,0,0,0,0,1,1,1,0,1,0,0,0,1,1,2
wi14,141,WARREN,VIS,Media,0,0,0,0,0,0,2,2,4,5,3,8,3,4,7,0,0,0,10,9,19
wi14,141,WARREN,VIS,Studio VA,0,0,0,0,0,0,0,1,1,1,0,1,2,2,4,0,0,0,3,3,6
wi14,141,WARREN,VIS,VA-CompArt,0,0,0,1,0,1,0,0,0,1,1,2,1,0,1,0,0,0,3,1,4
wi13,131,MARSHALL,ANTH,Anth-Arch,0,0,0,0,0,0,0,0,0,1,0,1,1,2,3,0,0,0,2,2,4
wi13,131,MARSHALL,ANTH,Anth-Biol,0,0,0,0,0,0,0,0,0,0,7,7,4,4,8,0,0,0,4,11,15
wi13,131,MARSHALL,ANTH,Anth-Soci,0,0,0,0,2,2,0,1,1,0,1,1,0,5,5,0,0,0,0,9,9
wi13,131,MARSHALL,BENG,Bioen:Binf,0,0,0,2,1,3,2,4,6,1,1,2,4,3,7,0,0,0,9,9,18
wi13,131,MARSHALL,BENG,Bioeng:PM,0,0,0,0,0,0,0,0,0,0,0,0,3,4,7,0,0,0,3,4,7
wi13,131,MARSHALL,BENG,BioengBiot,0,0,0,0,2,2,7,1,8,4,3,7,14,10,24,0,0,0,25,16,41
wi13,131,MARSHALL,BENG,Bioengin,0,0,0,0,0,0,2,4,6,4,3,7,4,2,6,0,0,0,10,9,19
wi13,131,MARSHALL,BIOL,Bioc/CellB,0,0,0,2,9,11,8,17,25,9,16,25,28,40,68,0,0,0,47,82,129
wi13,131,MARSHALL,BIOL,BiolBioinf,0,0,0,0,0,0,1,0,1,0,0,0,1,0,1,0,0,0,2,0,2
wi13,131,MARSHALL,BIOL,Ec/Beh/Evo,0,0,0,0,0,0,0,0,0,3,1,4,1,3,4,0,0,0,4,4,8
wi13,131,MARSHALL,BIOL,Genl Biol,0,0,0,0,7,7,5,14,19,6,14,20,32,59,91,0,0,0,43,94,137
wi13,131,MARSHALL,BIOL,Human Bio,0,0,0,5,21,26,15,32,47,17,29,46,38,58,96,0,0,0,75,140,215
wi13,131,MARSHALL,BIOL,Microbiol,0,0,0,1,0,1,0,2,2,0,3,3,5,8,13,0,0,0,6,13,19
wi13,131,MARSHALL,BIOL,Molec Biol,0,0,0,2,0,2,2,2,4,0,0,0,3,2,5,0,0,0,7,4,11
wi13,131,MARSHALL,BIOL,PhyslNeuro,0,0,0,1,6,7,10,13,23,6,8,14,25,22,47,0,0,0,42,49,91
wi13,131,MARSHALL,CENG,Chem Engin,0,0,0,4,6,10,4,12,16,16,6,22,22,9,31,0,0,0,46,33,79
wi13,131,MARSHALL,CGS,CritGendSt,0,0,0,0,0,0,0,0,0,0,2,2,0,0,0,0,0,0,0,2,2
wi13,131,MARSHALL,CHEM,Bioch/Chem,0,0,0,4,11,15,8,10,18,11,15,26,17,35,52,0,0,0,40,71,111
wi13,131,MARSHALL,CHEM,Bioinform,0,0,0,0,0,0,0,1,1,0,0,0,1,0,1,0,0,0,1,1,2
wi13,131,MARSHALL,CHEM,Chem Phys,0,0,0,0,0,0,0,0,0,0,0,0,2,0,2,0,0,0,2,0,2
wi13,131,MARSHALL,CHEM,Chemistry,0,0,0,3,3,6,1,5,6,7,3,10,10,7,17,0,0,0,21,18,39
wi13,131,MARSHALL,CHEM,Envir Chem,0,0,0,0,0,0,0,0,0,0,0,0,1,1,2,0,0,0,1,1,2
wi13,131,MARSHALL,CHEM,MolecSynth,0,0,0,0,0,0,0,0,0,0,0,0,1,0,1,0,0,0,1,0,1
wi13,131,MARSHALL,CHEM,Pharm Chem,0,0,0,3,4,7,3,8,11,3,12,15,15,21,36,0,0,0,24,45,69
wi13,131,MARSHALL,CHIN,Chinese St,0,0,0,0,0,0,0,0,0,0,0,0,2,0,2,0,0,0,2,0,2
wi13,131,MARSHALL,COGS,Cog Sci,0,0,0,2,2,4,0,7,7,4,4,8,4,6,10,0,0,0,10,19,29
wi13,131,MARSHALL,COGS,CogSc/ClAs,0,0,0,0,0,0,0,2,2,0,0,0,1,5,6,0,0,0,1,7,8
wi13,131,MARSHALL,COGS,CogSc/Comp,0,0,0,0,0,0,1,0,1,1,0,1,2,0,2,0,0,0,4,0,4
wi13,131,MARSHALL,COGS,CogSc/HCI,0,0,0,0,1,1,1,2,3,1,4,5,6,7,13,0,0,0,8,14,22
wi13,131,MARSHALL,COGS,CogSc/HCog,0,0,0,0,1,1,1,2,3,0,2,2,1,0,1,0,0,0,2,5,7
wi13,131,MARSHALL,COGS,CogSc/Neur,0,0,0,1,1,2,0,4,4,1,5,6,10,15,25,0,0,0,12,25,37
wi13,131,MARSHALL,COMM,Communic,0,0,0,3,13,16,0,7,7,12,52,64,17,62,79,0,0,0,32,134,166
wi13,131,MARSHALL,CSE,Comp Sci,0,0,0,14,4,18,30,6,36,37,3,40,40,17,57,0,0,0,121,30,151
wi13,131,MARSHALL,CSE,CompEngCSE,0,0,0,7,0,7,9,2,11,9,2,11,14,1,15,0,0,0,39,5,44
wi13,131,MARSHALL,CSE,CompScBinf,0,0,0,1,0,1,0,0,0,2,1,3,3,0,3,0,0,0,6,1,7
wi13,131,MARSHALL,ECE,CompEngECE,0,0,0,4,0,4,3,0,3,2,0,2,1,1,2,0,0,0,10,1,11
wi13,131,MARSHALL,ECE,Electr Eng,0,0,0,10,2,12,8,7,15,15,2,17,37,4,41,0,0,0,70,15,85
wi13,131,MARSHALL,ECE,EleEng&Soc,0,0,0,0,0,0,0,0,0,0,0,0,1,0,1,0,0,0,1,0,1
wi13,131,MARSHALL,ECE,Engin Phys,0,0,0,0,0,0,1,0,1,0,0,0,0,0,0,0,0,0,1,0,1
wi13,131,MARSHALL,ECON,Ec-Mth&Ecn,0,0,0,1,3,4,6,1,7,7,3,10,8,7,15,0,0,0,22,14,36
wi13,131,MARSHALL,ECON,Econ-MgtSc,0,0,0,6,9,15,8,5,13,36,29,65,51,37,88,0,0,0,101,80,181
wi13,131,MARSHALL,ECON,Economics,0,0,0,22,12,34,10,7,17,60,62,122,72,60,132,0,0,0,164,141,305
wi13,131,MARSHALL,ESYS,EnvSys(EB),0,0,0,1,0,1,1,2,3,3,5,8,6,21,27,0,0,0,11,28,39
wi13,131,MARSHALL,ESYS,EnvSys(EC),0,0,0,0,0,0,0,0,0,0,1,1,3,1,4,0,0,0,3,2,5
wi13,131,MARSHALL,ESYS,EnvSys(EP),0,0,0,0,0,0,1,0,1,1,1,2,1,3,4,0,0,0,3,4,7
wi13,131,MARSHALL,ESYS,EnvSys(ES),0,0,0,0,1,1,0,0,0,0,0,0,1,1,2,0,0,0,1,2,3
wi13,131,MARSHALL,ETHN,Ethnic St,0,0,0,0,0,0,0,0,0,1,3,4,3,5,8,0,0,0,4,8,12
wi13,131,MARSHALL,HDP,Human Dev,0,0,0,0,0,0,0,1,1,1,5,6,6,33,39,0,0,0,7,39,46
wi13,131,MARSHALL,HDP,Pr-HumnDev,0,0,0,0,4,4,0,12,12,1,21,22,1,4,5,0,0,0,2,41,43
wi13,131,MARSHALL,HIST,History,0,0,0,0,1,1,1,0,1,11,5,16,18,16,34,0,0,0,30,22,52
wi13,131,MARSHALL,INTL,Int-5yrEC,0,0,0,0,0,0,0,0,0,0,0,0,0,1,1,0,0,0,0,1,1
wi13,131,MARSHALL,INTL,IntSt-Anth,0,0,0,0,0,0,0,0,0,1,2,3,0,2,2,0,0,0,1,4,5
wi13,131,MARSHALL,INTL,IntSt-Econ,0,0,0,1,1,2,2,7,9,1,13,14,7,7,14,0,0,0,11,28,39
wi13,131,MARSHALL,INTL,IntSt-Hist,0,0,0,0,0,0,0,1,1,0,0,0,0,2,2,0,0,0,0,3,3
wi13,131,MARSHALL,INTL,IntSt-Ling,0,0,0,0,1,1,0,0,0,0,1,1,1,0,1,0,0,0,1,2,3
wi13,131,MARSHALL,INTL,IntSt-PolS,0,0,0,0,0,0,0,5,5,4,7,11,6,16,22,0,0,0,10,28,38
wi13,131,MARSHALL,INTL,IntSt-Soc,0,0,0,0,2,2,1,2,3,3,2,5,2,8,10,0,0,0,6,14,20
wi13,131,MARSHALL,JAPN,JapaneseSt,0,0,0,0,0,0,0,0,0,0,1,1,0,0,0,0,0,0,0,1,1
wi13,131,MARSHALL,JUDA,Judaic Stu,0,0,0,0,1,1,0,0,0,0,0,0,0,0,0,0,0,0,0,1,1
wi13,131,MARSHALL,LATI,LatinAm St,0,0,0,0,1,1,0,0,0,0,1,1,0,0,0,0,0,0,0,2,2
wi13,131,MARSHALL,LING,Lang Stu,0,0,0,0,0,0,0,0,0,0,0,0,0,1,1,0,0,0,0,1,1
wi13,131,MARSHALL,LING,Ling-CogLn,0,0,0,0,2,2,0,0,0,0,0,0,0,1,1,0,0,0,0,3,3
wi13,131,MARSHALL,LING,Ling-LSoc,0,0,0,0,0,0,0,1,1,0,0,0,0,3,3,0,0,0,0,4,4
wi13,131,MARSHALL,LING,Linguistcs,0,0,0,0,0,0,0,0,0,2,2,4,4,4,8,0,0,0,6,6,12
wi13,131,MARSHALL,LIT,Ital Lit,0,0,0,0,0,0,0,0,0,1,0,1,0,0,0,0,0,0,1,0,1
wi13,131,MARSHALL,LIT,Lit/Compos,0,0,0,0,0,0,0,1,1,0,0,0,0,0,0,0,0,0,0,1,1
wi13,131,MARSHALL,LIT,Lit/CultSt,0,0,0,0,0,0,0,0,0,0,0,0,0,1,1,0,0,0,0,1,1
wi13,131,MARSHALL,LIT,Lit/Engl,0,0,0,0,0,0,1,2,3,2,4,6,4,4,8,0,0,0,7,10,17
wi13,131,MARSHALL,LIT,Lit/World,0,0,0,0,0,0,0,1,1,1,0,1,0,0,0,0,0,0,1,1,2
wi13,131,MARSHALL,LIT,Lit/Writng,0,0,0,2,1,3,0,2,2,0,2,2,4,7,11,0,0,0,6,12,18
wi13,131,MARSHALL,LIT,Spanish Lt,0,0,0,0,0,0,0,0,0,0,0,0,1,2,3,0,0,0,1,2,3
wi13,131,MARSHALL,MAE,Aerosp Eng,0,0,0,0,0,0,4,0,4,6,1,7,13,6,19,0,0,0,23,7,30
wi13,131,MARSHALL,MAE,Engin Sci,0,0,0,0,0,0,0,0,0,0,1,1,3,0,3,0,0,0,3,1,4
wi13,131,MARSHALL,MAE,Envir Eng,0,0,0,4,2,6,4,1,5,5,1,6,8,4,12,0,0,0,21,8,29
wi13,131,MARSHALL,MAE,Mech Engin,0,0,0,1,0,1,6,0,6,7,2,9,31,8,39,0,0,0,45,10,55
wi13,131,MARSHALL,MATH,Appld Math,0,0,0,0,4,4,4,1,5,3,5,8,0,3,3,0,0,0,7,13,20
wi13,131,MARSHALL,MATH,Math/SecEd,0,0,0,0,0,0,0,0,0,0,1,1,3,2,5,0,0,0,3,3,6
wi13,131,MARSHALL,MATH,Mathematcs,0,0,0,3,3,6,2,3,5,1,5,6,5,5,10,0,0,0,11,16,27
wi13,131,MARSHALL,MATH,Mth-CompSc,0,0,0,0,0,0,0,0,0,1,1,2,3,0,3,0,0,0,4,1,5
wi13,131,MARSHALL,MATH,Mth-Mth&Ec,0,0,0,2,7,9,4,2,6,3,2,5,6,7,13,0,0,0,15,18,33
wi13,131,MARSHALL,MATH,Mth/ApldSc,0,0,0,0,0,0,0,0,0,0,0,0,2,0,2,0,0,0,2,0,2
wi13,131,MARSHALL,MATH,Pr-Math CS,0,0,0,1,0,1,0,0,0,0,0,0,0,0,0,0,0,0,1,0,1
wi13,131,MARSHALL,MATH,Prob&Stats,0,0,0,1,0,1,1,2,3,1,0,1,1,3,4,0,0,0,4,5,9
wi13,131,MARSHALL,MUS,Mu-CompArt,0,0,0,0,0,0,0,0,0,1,0,1,0,1,1,0,0,0,1,1,2
wi13,131,MARSHALL,MUS,Music,0,0,0,0,0,0,0,0,0,2,0,2,3,2,5,0,0,0,5,2,7
wi13,131,MARSHALL,MUS,Music Hum,0,0,0,0,1,1,0,0,0,0,0,0,0,0,0,0,0,0,0,1,1
wi13,131,MARSHALL,NENG,NanoEng,0,0,0,1,1,2,10,1,11,4,1,5,9,1,10,0,0,0,24,4,28
wi13,131,MARSHALL,PHIL,Philosophy,0,0,0,0,0,0,1,0,1,1,0,1,6,2,8,0,0,0,8,2,10
wi13,131,MARSHALL,PHYS,Biophysics,0,0,0,0,1,1,0,0,0,0,0,0,2,1,3,0,0,0,2,2,4
wi13,131,MARSHALL,PHYS,GenPys/SEd,0,0,0,0,0,0,0,1,1,1,0,1,0,0,0,0,0,0,1,1,2
wi13,131,MARSHALL,PHYS,Phy/ErthSc,0,0,0,0,0,0,0,0,0,0,0,0,1,0,1,0,0,0,1,0,1
wi13,131,MARSHALL,PHYS,Phys/Astro,0,0,0,1,0,1,0,0,0,2,0,2,1,0,1,0,0,0,4,0,4
wi13,131,MARSHALL,PHYS,Phys/Comp,0,0,0,0,0,0,0,0,0,1,0,1,0,1,1,0,0,0,1,1,2
wi13,131,MARSHALL,PHYS,Physics,0,0,0,1,2,3,1,0,1,1,1,2,4,2,6,0,0,0,7,5,12
wi13,131,MARSHALL,POLI,Polit Sci,0,0,0,2,2,4,5,7,12,13,8,21,23,21,44,0,0,0,43,38,81
wi13,131,MARSHALL,POLI,PolSc-Amer,0,0,0,0,0,0,3,1,4,1,1,2,7,6,13,0,0,0,11,8,19
wi13,131,MARSHALL,POLI,PolSc-Comp,0,0,0,0,0,0,0,0,0,1,2,3,2,1,3,0,0,0,3,3,6
wi13,131,MARSHALL,POLI,PolSc-Intl,0,0,0,1,0,1,2,2,4,7,3,10,13,15,28,0,0,0,23,20,43
wi13,131,MARSHALL,POLI,PolSc-PLaw,0,0,0,1,5,6,4,3,7,2,7,9,8,2,10,0,0,0,15,17,32
wi13,131,MARSHALL,POLI,PolSc-PPol,0,0,0,0,0,0,3,1,4,4,2,6,1,1,2,0,0,0,8,4,12
wi13,131,MARSHALL,POLI,PolSc-Thry,0,0,0,0,0,0,0,0,0,2,2,4,1,1,2,0,0,0,3,3,6
wi13,131,MARSHALL,PSYC,Psychology,0,0,0,6,20,26,9,27,36,19,57,76,51,96,147,0,0,0,85,200,285
wi13,131,MARSHALL,SE,Engin Sci,0,0,0,0,0,0,0,0,0,1,0,1,0,0,0,0,0,0,1,0,1
wi13,131,MARSHALL,SE,Struct Eng,0,0,0,3,2,5,11,6,17,12,7,19,35,8,43,0,0,0,61,23,84
wi13,131,MARSHALL,SIO,Earth Sci,0,0,0,0,0,0,0,0,0,0,0,0,3,2,5,0,0,0,3,2,5
wi13,131,MARSHALL,SIO,Marine Bio,0,0,0,0,4,4,0,0,0,1,3,4,1,2,3,0,0,0,2,9,11
wi13,131,MARSHALL,SOC,SocAmSt,0,0,0,0,0,0,0,0,0,0,1,1,1,0,1,0,0,0,1,1,2
wi13,131,MARSHALL,SOC,SocCulCom,0,0,0,0,0,0,0,0,0,0,0,0,0,3,3,0,0,0,0,3,3
wi13,131,MARSHALL,SOC,SocEconSoc,0,0,0,0,0,0,0,0,0,2,3,5,0,1,1,0,0,0,2,4,6
wi13,131,MARSHALL,SOC,SocIntlStu,0,0,0,0,0,0,0,0,0,1,0,1,1,0,1,0,0,0,2,0,2
wi13,131,MARSHALL,SOC,Sociology,0,0,0,1,2,3,1,0,1,12,18,30,9,33,42,0,0,0,23,53,76
wi13,131,MARSHALL,SOC,SocLawSoc,0,0,0,0,0,0,0,0,0,1,1,2,0,5,5,0,0,0,1,6,7
wi13,131,MARSHALL,SOC,SocSciMed,0,0,0,0,1,1,0,0,0,2,3,5,4,5,9,0,0,0,6,9,15
wi13,131,MARSHALL,SOC,SocSolneq,0,0,0,0,0,0,0,0,0,0,1,1,0,4,4,0,0,0,0,5,5
wi13,131,MARSHALL,THEA,Dance,0,0,0,0,0,0,1,0,1,0,0,0,1,2,3,0,0,0,2,2,4
wi13,131,MARSHALL,THEA,Theatre,0,0,0,0,1,1,0,0,0,3,3,6,2,2,4,0,0,0,5,6,11
wi13,131,MARSHALL,UNAF,UndecHumAr,0,0,0,0,2,2,1,1,2,1,0,1,0,0,0,0,0,0,2,3,5
wi13,131,MARSHALL,UNAF,Undeclared,0,0,0,20,27,47,11,14,25,0,2,2,0,0,0,0,0,0,31,43,74
wi13,131,MARSHALL,UNAF,UndecPhysS,0,0,0,3,2,5,2,2,4,0,0,0,0,0,0,0,0,0,5,4,9
wi13,131,MARSHALL,UNAF,UndecSocSc,0,0,0,4,3,7,1,3,4,0,0,0,0,0,0,0,0,0,5,6,11
wi13,131,MARSHALL,USP,Urb Stu&Pl,0,0,0,0,0,0,0,2,2,4,4,8,8,15,23,0,0,0,12,21,33
wi13,131,MARSHALL,VIS,Art Hst/Cr,0,0,0,0,0,0,0,1,1,0,0,0,0,3,3,0,0,0,0,4,4
wi13,131,MARSHALL,VIS,Media,0,0,0,1,0,1,1,0,1,9,1,10,10,2,12,0,0,0,21,3,24
wi13,131,MARSHALL,VIS,Studio VA,0,0,0,1,0,1,0,0,0,1,2,3,0,6,6,0,0,0,2,8,10
wi13,131,MARSHALL,VIS,VA-CompArt,0,0,0,0,1,1,1,0,1,1,1,2,2,2,4,0,0,0,4,4,8
wi13,131,MUIR,ANTH,Anth-Arch,0,0,0,0,0,0,0,1,1,2,5,7,1,2,3,0,0,0,3,8,11
wi13,131,MUIR,ANTH,Anth-Biol,0,0,0,0,2,2,1,1,2,1,5,6,1,2,3,0,0,0,3,10,13
wi13,131,MUIR,ANTH,Anth-Soci,0,0,0,0,2,2,1,1,2,2,3,5,3,9,12,0,0,0,6,15,21
wi13,131,MUIR,BENG,Bioen:Binf,0,0,0,4,1,5,1,2,3,2,1,3,2,0,2,0,0,0,9,4,13
wi13,131,MUIR,BENG,Bioeng:PM,0,0,0,0,0,0,0,0,0,0,0,0,5,1,6,0,0,0,5,1,6
wi13,131,MUIR,BENG,BioengBiot,0,0,0,0,0,0,6,2,8,2,3,5,8,5,13,0,0,0,16,10,26
wi13,131,MUIR,BENG,Bioengin,0,0,0,1,1,2,5,3,8,2,4,6,10,5,15,0,0,0,18,13,31
wi13,131,MUIR,BIOL,Bioc/CellB,0,0,0,3,4,7,14,17,31,11,7,18,28,36,64,0,0,0,56,64,120
wi13,131,MUIR,BIOL,BiolBioinf,0,0,0,0,0,0,1,0,1,0,1,1,0,1,1,0,0,0,1,2,3
wi13,131,MUIR,BIOL,Ec/Beh/Evo,0,0,0,1,0,1,4,3,7,3,4,7,3,15,18,0,0,0,11,22,33
wi13,131,MUIR,BIOL,Genl Biol,0,0,0,8,12,20,10,17,27,9,20,29,30,60,90,0,0,0,57,109,166
wi13,131,MUIR,BIOL,Human Bio,0,1,1,5,20,25,12,41,53,23,26,49,32,60,92,0,0,0,72,148,220
wi13,131,MUIR,BIOL,Microbiol,0,0,0,3,0,3,0,0,0,0,2,2,6,5,11,0,0,0,9,7,16
wi13,131,MUIR,BIOL,Molec Biol,0,0,0,4,2,6,4,4,8,1,8,9,7,5,12,0,0,0,16,19,35
wi13,131,MUIR,BIOL,PhyslNeuro,0,0,0,4,3,7,6,14,20,9,11,20,29,27,56,0,0,0,48,55,103
wi13,131,MUIR,CENG,Chem Engin,0,0,0,8,3,11,5,5,10,11,6,17,17,13,30,0,0,0,41,27,68
wi13,131,MUIR,CGS,CritGendSt,0,0,0,0,0,0,0,1,1,0,3,3,0,0,0,0,0,0,0,4,4
wi13,131,MUIR,CHEM,Bioch/Chem,0,0,0,3,2,5,6,12,18,12,16,28,27,18,45,0,0,0,48,48,96
wi13,131,MUIR,CHEM,Bioinform,0,0,0,1,0,1,0,0,0,0,0,0,0,0,0,0,0,0,1,0,1
wi13,131,MUIR,CHEM,Chem Educ,0,0,0,0,0,0,0,0,0,0,0,0,0,1,1,0,0,0,0,1,1
wi13,131,MUIR,CHEM,Chem Phys,0,0,0,0,0,0,0,0,0,1,0,1,0,0,0,0,0,0,1,0,1
wi13,131,MUIR,CHEM,Chemistry,0,0,0,2,2,4,2,0,2,9,4,13,9,7,16,0,0,0,22,13,35
wi13,131,MUIR,CHEM,Envir Chem,0,0,0,0,0,0,2,2,4,0,0,0,2,1,3,0,0,0,4,3,7
wi13,131,MUIR,CHEM,MolecSynth,0,0,0,0,0,0,0,1,1,0,1,1,1,0,1,0,0,0,1,2,3
wi13,131,MUIR,CHEM,Pharm Chem,0,0,0,1,1,2,6,8,14,12,7,19,20,23,43,0,0,0,39,39,78
wi13,131,MUIR,CHIN,Chinese St,0,0,0,0,1,1,0,0,0,0,1,1,1,1,2,0,0,0,1,3,4
wi13,131,MUIR,COGS,Cog Sci,0,0,0,2,4,6,3,8,11,5,7,12,8,9,17,0,0,0,18,28,46
wi13,131,MUIR,COGS,CogSc/ClAs,0,0,0,0,0,0,0,0,0,0,4,4,0,7,7,0,0,0,0,11,11
wi13,131,MUIR,COGS,CogSc/Comp,0,0,0,0,0,0,0,0,0,2,1,3,2,0,2,0,0,0,4,1,5
wi13,131,MUIR,COGS,CogSc/HCI,0,0,0,0,0,0,1,2,3,3,4,7,6,9,15,0,0,0,10,15,25
wi13,131,MUIR,COGS,CogSc/HCog,0,0,0,0,0,0,0,1,1,0,2,2,1,2,3,0,0,0,1,5,6
wi13,131,MUIR,COGS,CogSc/Neur,0,0,0,1,2,3,1,3,4,2,8,10,15,25,40,0,0,0,19,38,57
wi13,131,MUIR,COMM,Communic,0,0,0,1,11,12,1,13,14,15,34,49,15,34,49,0,0,0,32,92,124
wi13,131,MUIR,CSE,Comp Sci,0,0,0,13,5,18,26,9,35,34,9,43,63,19,82,0,0,0,136,42,178
wi13,131,MUIR,CSE,CompEngCSE,0,0,0,1,0,1,12,1,13,8,2,10,15,1,16,0,0,0,36,4,40
wi13,131,MUIR,CSE,CompScBinf,0,0,0,0,1,1,1,1,2,3,0,3,3,0,3,0,0,0,7,2,9
wi13,131,MUIR,ECE,CompEngECE,0,0,0,4,0,4,3,0,3,2,0,2,3,0,3,0,0,0,12,0,12
wi13,131,MUIR,ECE,Electr Eng,0,0,0,12,0,12,12,2,14,13,6,19,28,5,33,0,0,0,65,13,78
wi13,131,MUIR,ECE,Engin Phys,0,0,0,1,0,1,1,0,1,0,0,0,1,0,1,0,0,0,3,0,3
wi13,131,MUIR,ECON,Ec-Mth&Ecn,0,0,0,1,2,3,6,3,9,6,2,8,5,3,8,0,0,0,18,10,28
wi13,131,MUIR,ECON,Econ-MgtSc,0,0,0,4,7,11,11,13,24,14,14,28,48,38,86,0,0,0,77,72,149
wi13,131,MUIR,ECON,Economics,0,0,0,10,11,21,10,16,26,43,32,75,63,25,88,0,0,0,126,84,210
wi13,131,MUIR,ESYS,EnvSys(EB),0,0,0,0,4,4,2,5,7,6,13,19,7,28,35,0,0,0,15,50,65
wi13,131,MUIR,ESYS,EnvSys(EC),0,0,0,1,0,1,0,1,1,0,0,0,1,1,2,0,0,0,2,2,4
wi13,131,MUIR,ESYS,EnvSys(EP),0,0,0,0,1,1,0,1,1,1,0,1,0,6,6,0,0,0,1,8,9
wi13,131,MUIR,ESYS,EnvSys(ES),0,0,0,1,0,1,2,0,2,0,0,0,2,2,4,0,0,0,5,2,7
wi13,131,MUIR,ETHN,Ethnic St,0,0,0,0,0,0,0,1,1,2,0,2,2,6,8,0,0,0,4,7,11
wi13,131,MUIR,HDP,Human Dev,0,0,0,0,0,0,0,0,0,2,8,10,5,27,32,0,0,0,7,35,42
wi13,131,MUIR,HDP,Pr-HumnDev,0,0,0,1,2,3,1,10,11,4,12,16,3,4,7,0,0,0,9,28,37
wi13,131,MUIR,HIST,History,0,0,0,2,1,3,3,0,3,4,7,11,10,6,16,0,0,0,19,14,33
wi13,131,MUIR,INTL,IntSt-Anth,0,0,0,0,1,1,0,0,0,0,1,1,0,0,0,0,0,0,0,2,2
wi13,131,MUIR,INTL,IntSt-Econ,0,0,0,0,1,1,5,3,8,2,6,8,5,17,22,0,0,0,12,27,39
wi13,131,MUIR,INTL,IntSt-Hist,0,0,0,0,0,0,0,0,0,0,0,0,2,0,2,0,0,0,2,0,2
wi13,131,MUIR,INTL,IntSt-Ling,0,0,0,0,0,0,0,0,0,0,1,1,0,1,1,0,0,0,0,2,2
wi13,131,MUIR,INTL,IntSt-Lit,0,0,0,0,0,0,0,0,0,0,0,0,0,1,1,0,0,0,0,1,1
wi13,131,MUIR,INTL,IntSt-PolS,0,0,0,0,1,1,0,5,5,3,7,10,3,10,13,0,0,0,6,23,29
wi13,131,MUIR,INTL,IntSt-Soc,0,0,0,0,1,1,1,4,5,1,1,2,1,6,7,0,0,0,3,12,15
wi13,131,MUIR,ITAL,Italian St,0,0,0,0,1,1,0,0,0,0,0,0,0,0,0,0,0,0,0,1,1
wi13,131,MUIR,JAPN,JapaneseSt,0,0,0,0,0,0,0,1,1,0,0,0,3,1,4,0,0,0,3,2,5
wi13,131,MUIR,LATI,LatinAm St,0,0,0,0,0,0,0,0,0,0,0,0,1,0,1,0,0,0,1,0,1
wi13,131,MUIR,LING,Lang Stu,0,0,0,0,0,0,0,0,0,0,1,1,0,1,1,0,0,0,0,2,2
wi13,131,MUIR,LING,Ling-CogLn,0,0,0,0,0,0,2,2,4,0,1,1,1,3,4,0,0,0,3,6,9
wi13,131,MUIR,LING,Ling-LSoc,0,0,0,0,0,0,0,0,0,0,0,0,1,3,4,0,0,0,1,3,4
wi13,131,MUIR,LING,Linguistcs,0,0,0,0,0,0,0,2,2,2,0,2,7,2,9,0,0,0,9,4,13
wi13,131,MUIR,LIT,Lit/Compos,0,0,0,0,0,0,0,0,0,1,0,1,0,1,1,0,0,0,1,1,2
wi13,131,MUIR,LIT,Lit/CultSt,0,0,0,0,1,1,0,0,0,0,1,1,0,0,0,0,0,0,0,2,2
wi13,131,MUIR,LIT,Lit/Engl,0,0,0,0,0,0,0,0,0,3,6,9,2,11,13,0,0,0,5,17,22
wi13,131,MUIR,LIT,Lit/World,0,0,0,0,0,0,0,0,0,0,0,0,0,1,1,0,0,0,0,1,1
wi13,131,MUIR,LIT,Lit/Writng,0,0,0,1,5,6,0,4,4,2,5,7,8,9,17,0,0,0,11,23,34
wi13,131,MUIR,LIT,Pre-Lit/Wr,0,0,0,0,0,0,0,0,0,0,0,0,1,0,1,0,0,0,1,0,1
wi13,131,MUIR,LIT,Spanish Lt,0,0,0,0,0,0,0,2,2,1,2,3,1,2,3,0,0,0,2,6,8
wi13,131,MUIR,MAE,Aerosp Eng,0,0,0,1,0,1,6,0,6,6,2,8,18,4,22,0,0,0,31,6,37
wi13,131,MUIR,MAE,Engin Sci,0,0,0,1,0,1,0,0,0,1,0,1,4,1,5,0,0,0,6,1,7
wi13,131,MUIR,MAE,Envir Eng,0,0,0,4,2,6,10,2,12,6,8,14,10,6,16,0,0,0,30,18,48
wi13,131,MUIR,MAE,Mech Engin,0,0,0,1,0,1,7,3,10,7,1,8,27,5,32,0,0,0,42,9,51
wi13,131,MUIR,MATH,Appld Math,0,0,0,1,2,3,4,3,7,1,3,4,2,5,7,0,0,0,8,13,21
wi13,131,MUIR,MATH,Math/SecEd,0,0,0,0,0,0,0,1,1,2,5,7,1,2,3,0,0,0,3,8,11
wi13,131,MUIR,MATH,Mathematcs,0,0,0,1,1,2,2,3,5,5,4,9,8,0,8,0,0,0,16,8,24
wi13,131,MUIR,MATH,Mth-CompSc,0,0,0,0,0,0,1,0,1,1,0,1,0,1,1,0,0,0,2,1,3
wi13,131,MUIR,MATH,Mth-Mth&Ec,0,0,0,0,1,1,4,1,5,5,2,7,4,4,8,0,0,0,13,8,21
wi13,131,MUIR,MATH,Mth/ApldSc,0,0,0,0,0,0,0,0,0,0,0,0,1,0,1,0,0,0,1,0,1
wi13,131,MUIR,MATH,Prob&Stats,0,0,0,1,0,1,1,0,1,0,0,0,3,0,3,0,0,0,5,0,5
wi13,131,MUIR,MUS,Mu-CompArt,0,0,0,0,0,0,0,0,0,3,1,4,4,0,4,0,0,0,7,1,8
wi13,131,MUIR,MUS,Music,0,0,0,2,1,3,0,2,2,3,1,4,0,1,1,0,0,0,5,5,10
wi13,131,MUIR,MUS,Music Hum,0,0,0,0,0,0,1,0,1,1,0,1,0,0,0,0,0,0,2,0,2
wi13,131,MUIR,NENG,NanoEng,0,0,0,2,2,4,5,2,7,9,2,11,9,4,13,0,0,0,25,10,35
wi13,131,MUIR,PHIL,Philosophy,0,0,0,0,0,0,0,0,0,2,1,3,10,4,14,0,0,0,12,5,17
wi13,131,MUIR,PHYS,Biophysics,0,0,0,0,0,0,0,0,0,4,0,4,4,0,4,0,0,0,8,0,8
wi13,131,MUIR,PHYS,Phy/ErthSc,0,0,0,0,0,0,0,0,0,0,0,0,0,1,1,0,0,0,0,1,1
wi13,131,MUIR,PHYS,Phys/Astro,0,0,0,1,2,3,1,0,1,1,0,1,4,1,5,0,0,0,7,3,10
wi13,131,MUIR,PHYS,Physics,0,0,0,2,1,3,1,0,1,3,0,3,8,0,8,0,0,0,14,1,15
wi13,131,MUIR,POLI,Polit Sci,0,0,0,0,1,1,6,2,8,7,14,21,29,17,46,0,0,0,42,34,76
wi13,131,MUIR,POLI,PolSc-Amer,0,0,0,1,2,3,0,0,0,1,2,3,4,3,7,0,0,0,6,7,13
wi13,131,MUIR,POLI,PolSc-Intl,0,0,0,0,2,2,1,3,4,4,5,9,7,10,17,0,0,0,12,20,32
wi13,131,MUIR,POLI,PolSc-PLaw,0,0,0,1,1,2,1,2,3,8,1,9,3,6,9,0,0,0,13,10,23
wi13,131,MUIR,POLI,PolSc-PPol,0,0,0,0,0,0,0,1,1,1,1,2,1,0,1,0,0,0,2,2,4
wi13,131,MUIR,POLI,PolSc-Thry,0,0,0,0,0,0,1,0,1,0,0,0,1,0,1,0,0,0,2,0,2
wi13,131,MUIR,PSYC,Psychology,0,0,0,6,30,36,11,42,53,23,58,81,37,112,149,0,0,0,77,242,319
wi13,131,MUIR,RELI,Relig/Stu,0,0,0,0,0,0,0,0,0,0,0,0,1,1,2,0,0,0,1,1,2
wi13,131,MUIR,RUSS,Russ&SovSt,0,0,0,0,0,0,0,0,0,0,1,1,0,0,0,0,0,0,0,1,1
wi13,131,MUIR,SE,Engin Sci,0,0,0,1,0,1,0,0,0,0,0,0,1,0,1,0,0,0,2,0,2
wi13,131,MUIR,SE,Struct Eng,0,0,0,6,6,12,9,3,12,16,6,22,28,9,37,0,0,0,59,24,83
wi13,131,MUIR,SIO,Earth Sci,0,0,0,0,1,1,2,0,2,1,2,3,4,2,6,0,0,0,7,5,12
wi13,131,MUIR,SIO,Marine Bio,0,0,0,1,2,3,1,8,9,2,5,7,3,1,4,0,0,0,7,16,23
wi13,131,MUIR,SOC,SocCulCom,0,0,0,0,0,0,0,1,1,0,0,0,3,1,4,0,0,0,3,2,5
wi13,131,MUIR,SOC,SocEconSoc,0,0,0,0,1,1,0,0,0,0,1,1,1,0,1,0,0,0,1,2,3
wi13,131,MUIR,SOC,SocIntlStu,0,0,0,0,0,0,0,0,0,0,0,0,0,1,1,0,0,0,0,1,1
wi13,131,MUIR,SOC,Sociology,0,0,0,0,0,0,2,5,7,6,18,24,10,22,32,0,0,0,18,45,63
wi13,131,MUIR,SOC,SocLawSoc,0,0,0,0,0,0,0,2,2,0,4,4,2,4,6,0,0,0,2,10,12
wi13,131,MUIR,SOC,SocSciMed,0,0,0,0,0,0,0,1,1,0,0,0,1,4,5,0,0,0,1,5,6
wi13,131,MUIR,SOC,SocSolneq,0,0,0,0,0,0,0,0,0,0,1,1,0,2,2,0,0,0,0,3,3
wi13,131,MUIR,THEA,Dance,0,0,0,0,1,1,0,1,1,0,1,1,0,3,3,0,0,0,0,6,6
wi13,131,MUIR,THEA,Theatre,0,0,0,1,1,2,1,3,4,3,3,6,4,8,12,0,0,0,9,15,24
wi13,131,MUIR,TWS,ThirdWldSt,0,0,0,0,0,0,0,0,0,0,0,0,0,1,1,0,0,0,0,1,1
wi13,131,MUIR,UNAF,UndecHumAr,0,0,0,1,4,5,1,0,1,0,0,0,0,0,0,0,0,0,2,4,6
wi13,131,MUIR,UNAF,Undeclared,0,0,0,19,46,65,21,21,42,2,0,2,0,0,0,0,0,0,42,67,109
wi13,131,MUIR,UNAF,UndecPhysS,0,0,0,2,3,5,0,2,2,2,0,2,0,0,0,0,0,0,4,5,9
wi13,131,MUIR,UNAF,UndecSocSc,0,0,0,0,5,5,0,2,2,0,0,0,0,0,0,0,0,0,0,7,7
wi13,131,MUIR,USP,Urb Stu&Pl,0,0,0,0,1,1,1,3,4,5,4,9,10,7,17,0,0,0,16,15,31
wi13,131,MUIR,VIS,Art Hst/Cr,0,0,0,0,0,0,0,0,0,1,2,3,0,3,3,0,0,0,1,5,6
wi13,131,MUIR,VIS,Media,0,0,0,1,0,1,0,2,2,7,5,12,13,13,26,0,0,0,21,20,41
wi13,131,MUIR,VIS,Studio VA,0,0,0,0,1,1,0,1,1,0,4,4,3,4,7,0,0,0,3,10,13
wi13,131,MUIR,VIS,VA-CompArt,0,0,0,0,0,0,1,2,3,2,2,4,1,3,4,0,0,0,4,7,11
wi13,131,REVELLE,ANTH,Anth-Arch,0,0,0,0,1,1,0,1,1,1,1,2,0,1,1,0,0,0,1,4,5
wi13,131,REVELLE,ANTH,Anth-Biol,0,0,0,0,2,2,1,2,3,1,1,2,2,1,3,0,0,0,4,6,10
wi13,131,REVELLE,ANTH,Anth-Soci,0,0,0,1,0,1,0,0,0,1,3,4,0,1,1,0,0,0,2,4,6
wi13,131,REVELLE,BENG,Bioen:Binf,0,0,0,1,0,1,3,3,6,3,5,8,4,3,7,0,0,0,11,11,22
wi13,131,REVELLE,BENG,Bioeng:PM,0,0,0,0,0,0,0,0,0,0,0,0,2,2,4,0,0,0,2,2,4
wi13,131,REVELLE,BENG,BioengBiot,0,0,0,3,0,3,10,5,15,8,4,12,22,12,34,0,0,0,43,21,64
wi13,131,REVELLE,BENG,Bioengin,0,0,0,1,1,2,7,7,14,6,6,12,10,6,16,0,0,0,24,20,44
wi13,131,REVELLE,BIOL,Bioc/CellB,0,0,0,5,9,14,18,16,34,14,14,28,46,43,89,0,0,0,83,82,165
wi13,131,REVELLE,BIOL,BiolBioinf,0,0,0,1,0,1,0,1,1,0,0,0,2,0,2,0,0,0,3,1,4
wi13,131,REVELLE,BIOL,Ec/Beh/Evo,0,0,0,2,0,2,0,2,2,2,2,4,3,7,10,0,0,0,7,11,18
wi13,131,REVELLE,BIOL,Genl Biol,0,0,0,8,15,23,17,20,37,10,12,22,30,68,98,0,0,0,65,115,180
wi13,131,REVELLE,BIOL,Human Bio,0,0,0,12,29,41,25,42,67,18,34,52,61,81,142,0,0,0,116,186,302
wi13,131,REVELLE,BIOL,Microbiol,0,0,0,1,1,2,5,3,8,2,1,3,6,8,14,0,0,0,14,13,27
wi13,131,REVELLE,BIOL,Molec Biol,0,0,0,2,0,2,4,7,11,2,4,6,3,10,13,0,0,0,11,21,32
wi13,131,REVELLE,BIOL,PhyslNeuro,0,0,0,10,10,20,9,13,22,11,6,17,18,39,57,0,0,0,48,68,116
wi13,131,REVELLE,CENG,Chem Engin,0,0,0,15,8,23,22,6,28,23,7,30,20,15,35,0,0,0,80,36,116
wi13,131,REVELLE,CGS,CritGendSt,0,0,0,0,0,0,0,0,0,0,0,0,1,1,2,0,0,0,1,1,2
wi13,131,REVELLE,CHEM,Bioch/Chem,0,0,0,6,9,15,14,16,30,17,18,35,24,24,48,0,0,0,61,67,128
wi13,131,REVELLE,CHEM,Bioinform,0,0,0,0,0,0,0,1,1,0,1,1,0,0,0,0,0,0,0,2,2
wi13,131,REVELLE,CHEM,Chem Educ,0,0,0,0,0,0,0,0,0,0,0,0,0,2,2,0,0,0,0,2,2
wi13,131,REVELLE,CHEM,Chem Phys,0,0,0,0,0,0,2,1,3,0,0,0,1,1,2,0,0,0,3,2,5
wi13,131,REVELLE,CHEM,Chemistry,0,0,0,6,6,12,5,5,10,7,2,9,11,11,22,0,0,0,29,24,53
wi13,131,REVELLE,CHEM,Envir Chem,0,0,0,0,1,1,0,1,1,0,0,0,0,4,4,0,0,0,0,6,6
wi13,131,REVELLE,CHEM,MolecSynth,0,0,0,0,0,0,0,0,0,0,1,1,0,0,0,0,0,0,0,1,1
wi13,131,REVELLE,CHEM,Pharm Chem,0,0,0,5,6,11,7,18,25,11,11,22,25,51,76,0,0,0,48,86,134
wi13,131,REVELLE,CLAS,Classic St,0,0,0,0,0,0,0,0,0,0,0,0,1,1,2,0,0,0,1,1,2
wi13,131,REVELLE,COGS,Cog Sci,0,0,0,0,0,0,0,11,11,2,7,9,8,8,16,0,0,0,10,26,36
wi13,131,REVELLE,COGS,CogSc/ClAs,0,0,0,0,1,1,0,1,1,0,3,3,1,5,6,0,0,0,1,10,11
wi13,131,REVELLE,COGS,CogSc/Comp,0,0,0,0,0,0,0,0,0,0,0,0,1,1,2,0,0,0,1,1,2
wi13,131,REVELLE,COGS,CogSc/HCI,0,0,0,0,1,1,0,0,0,2,0,2,5,3,8,0,0,0,7,4,11
wi13,131,REVELLE,COGS,CogSc/HCog,0,0,0,0,0,0,0,0,0,1,2,3,0,2,2,0,0,0,1,4,5
wi13,131,REVELLE,COGS,CogSc/Neur,0,0,0,1,2,3,2,4,6,4,12,16,8,28,36,0,0,0,15,46,61
wi13,131,REVELLE,COMM,Communic,0,0,0,2,1,3,2,3,5,4,6,10,10,10,20,0,0,0,18,20,38
wi13,131,REVELLE,CSE,Comp Sci,0,0,0,20,3,23,33,5,38,36,7,43,73,9,82,0,0,0,162,24,186
wi13,131,REVELLE,CSE,CompEngCSE,0,0,0,6,1,7,10,2,12,4,0,4,12,2,14,0,0,0,32,5,37
wi13,131,REVELLE,CSE,CompScBinf,0,0,0,0,1,1,2,1,3,3,1,4,5,3,8,0,0,0,10,6,16
wi13,131,REVELLE,ECE,CompEngECE,1,0,1,2,1,3,3,1,4,2,0,2,6,0,6,0,0,0,14,2,16
wi13,131,REVELLE,ECE,Electr Eng,0,0,0,13,2,15,28,4,32,16,2,18,41,4,45,0,0,0,98,12,110
wi13,131,REVELLE,ECE,EleEng&Soc,0,0,0,0,0,0,0,0,0,2,0,2,0,0,0,0,0,0,2,0,2
wi13,131,REVELLE,ECE,Engin Phys,0,0,0,0,0,0,0,0,0,4,0,4,1,0,1,0,0,0,5,0,5
wi13,131,REVELLE,ECE,Pr-EngPhys,0,0,0,0,0,0,4,0,4,0,0,0,0,0,0,0,0,0,4,0,4
wi13,131,REVELLE,ECON,Ec-Mth&Ecn,0,0,0,0,1,1,5,2,7,7,1,8,7,3,10,0,0,0,19,7,26
wi13,131,REVELLE,ECON,Econ-MgtSc,0,0,0,6,5,11,9,6,15,8,4,12,44,15,59,0,0,0,67,30,97
wi13,131,REVELLE,ECON,Economics,0,0,0,8,12,20,12,5,17,27,19,46,51,31,82,0,0,0,98,67,165
wi13,131,REVELLE,ESYS,EnvSys(EB),0,0,0,0,3,3,2,2,4,3,6,9,6,18,24,0,0,0,11,29,40
wi13,131,REVELLE,ESYS,EnvSys(EC),0,0,0,0,0,0,1,0,1,0,0,0,1,2,3,0,0,0,2,2,4
wi13,131,REVELLE,ESYS,EnvSys(EP),0,0,0,0,0,0,0,0,0,0,0,0,0,1,1,0,0,0,0,1,1
wi13,131,REVELLE,ESYS,EnvSys(ES),0,0,0,0,2,2,1,1,2,1,0,1,4,0,4,0,0,0,6,3,9
wi13,131,REVELLE,ETHN,Ethnic St,0,0,0,0,0,0,0,0,0,0,2,2,3,1,4,0,0,0,3,3,6
wi13,131,REVELLE,GMST,German Stu,0,0,0,0,0,0,0,0,0,1,0,1,0,0,0,0,0,0,1,0,1
wi13,131,REVELLE,HDP,Human Dev,0,0,0,0,0,0,0,0,0,0,0,0,0,13,13,0,0,0,0,13,13
wi13,131,REVELLE,HDP,Pr-HumnDev,0,0,0,0,2,2,3,4,7,0,6,6,0,3,3,0,0,0,3,15,18
wi13,131,REVELLE,HIST,History,0,0,0,0,1,1,1,0,1,1,1,2,8,5,13,0,0,0,10,7,17
wi13,131,REVELLE,INTD,Rev Ind Mj,0,0,0,0,0,0,0,0,0,0,0,0,1,1,2,0,0,0,1,1,2
wi13,131,REVELLE,INTL,Int-5yrEC,0,0,0,0,0,0,0,0,0,0,0,0,0,1,1,0,0,0,0,1,1
wi13,131,REVELLE,INTL,Int-5yrPS,0,0,0,0,0,0,0,0,0,0,0,0,0,1,1,0,0,0,0,1,1
wi13,131,REVELLE,INTL,IntSt-Anth,0,0,0,0,0,0,0,0,0,0,0,0,2,0,2,0,0,0,2,0,2
wi13,131,REVELLE,INTL,IntSt-Econ,0,0,0,2,0,2,0,1,1,1,3,4,5,4,9,0,0,0,8,8,16
wi13,131,REVELLE,INTL,IntSt-Hist,0,0,0,0,0,0,0,1,1,0,0,0,0,1,1,0,0,0,0,2,2
wi13,131,REVELLE,INTL,IntSt-Ling,0,0,0,0,0,0,1,2,3,0,1,1,0,1,1,0,0,0,1,4,5
wi13,131,REVELLE,INTL,IntSt-Lit,0,0,0,0,1,1,0,0,0,0,0,0,0,0,0,0,0,0,0,1,1
wi13,131,REVELLE,INTL,IntSt-PolS,0,0,0,0,0,0,1,0,1,0,3,3,4,6,10,0,0,0,5,9,14
wi13,131,REVELLE,INTL,IntSt-Soc,0,0,0,0,0,0,0,1,1,0,1,1,0,3,3,0,0,0,0,5,5
wi13,131,REVELLE,JAPN,JapaneseSt,0,0,0,0,0,0,0,0,0,0,0,0,1,1,2,0,0,0,1,1,2
wi13,131,REVELLE,LING,Ling-CogLn,0,0,0,0,0,0,0,0,0,0,1,1,0,2,2,0,0,0,0,3,3
wi13,131,REVELLE,LING,Ling-LSoc,0,0,0,0,0,0,0,0,0,0,0,0,0,1,1,0,0,0,0,1,1
wi13,131,REVELLE,LING,Linguistcs,0,0,0,0,1,1,1,0,1,1,0,1,2,2,4,0,0,0,4,3,7
wi13,131,REVELLE,LIT,Lit/Compos,0,0,0,0,0,0,0,0,0,0,0,0,1,0,1,0,0,0,1,0,1
wi13,131,REVELLE,LIT,Lit/Engl,0,0,0,0,0,0,1,2,3,0,1,1,3,1,4,0,0,0,4,4,8
wi13,131,REVELLE,LIT,Lit/World,0,0,0,0,0,0,0,0,0,0,0,0,1,0,1,0,0,0,1,0,1
wi13,131,REVELLE,LIT,Lit/Writng,0,0,0,0,1,1,0,1,1,2,2,4,2,9,11,0,0,0,4,13,17
wi13,131,REVELLE,LIT,Spanish Lt,0,0,0,0,0,0,1,1,2,1,2,3,0,2,2,0,0,0,2,5,7
wi13,131,REVELLE,MAE,Aerosp Eng,0,0,0,5,2,7,12,2,14,8,3,11,19,5,24,0,0,0,44,12,56
wi13,131,REVELLE,MAE,Engin Sci,0,0,0,0,0,0,0,0,0,3,1,4,8,2,10,0,0,0,11,3,14
wi13,131,REVELLE,MAE,Envir Eng,0,0,0,4,1,5,4,4,8,7,6,13,14,2,16,0,0,0,29,13,42
wi13,131,REVELLE,MAE,Mech Engin,0,0,0,0,0,0,8,1,9,13,2,15,37,6,43,0,0,0,58,9,67
wi13,131,REVELLE,MATH,Appld Math,0,0,0,5,5,10,4,4,8,4,1,5,6,4,10,0,0,0,19,14,33
wi13,131,REVELLE,MATH,Math/SecEd,0,0,0,0,1,1,1,0,1,0,0,0,1,0,1,0,0,0,2,1,3
wi13,131,REVELLE,MATH,Mathematcs,0,0,0,3,2,5,2,5,7,3,1,4,4,6,10,0,0,0,12,14,26
wi13,131,REVELLE,MATH,Mth-CompSc,0,0,0,0,0,0,0,0,0,0,0,0,2,1,3,0,0,0,2,1,3
wi13,131,REVELLE,MATH,Mth-Mth&Ec,0,0,0,1,6,7,1,5,6,0,0,0,5,2,7,0,0,0,7,13,20
wi13,131,REVELLE,MATH,Mth-SciCom,0,0,0,0,0,0,0,0,0,0,0,0,0,1,1,0,0,0,0,1,1
wi13,131,REVELLE,MATH,Mth/ApldSc,0,0,0,1,1,2,2,1,3,0,0,0,0,1,1,0,0,0,3,3,6
wi13,131,REVELLE,MATH,Pr-Math CS,0,0,0,1,0,1,0,0,0,0,0,0,0,0,0,0,0,0,1,0,1
wi13,131,REVELLE,MATH,Prob&Stats,0,0,0,1,0,1,1,0,1,1,0,1,3,2,5,0,0,0,6,2,8
wi13,131,REVELLE,MUS,Mu-CompArt,0,0,0,1,0,1,0,0,0,1,0,1,5,0,5,0,0,0,7,0,7
wi13,131,REVELLE,MUS,Music,0,0,0,1,1,2,1,2,3,0,0,0,4,1,5,0,0,0,6,4,10
wi13,131,REVELLE,NENG,NanoEng,0,0,0,6,0,6,17,5,22,10,2,12,25,8,33,0,0,0,58,15,73
wi13,131,REVELLE,PHIL,Philosophy,0,0,0,0,1,1,0,0,0,4,2,6,3,0,3,0,0,0,7,3,10
wi13,131,REVELLE,PHYS,Biophysics,0,0,0,0,1,1,2,1,3,5,1,6,2,2,4,0,0,0,9,5,14
wi13,131,REVELLE,PHYS,GenPys/SEd,0,0,0,0,0,0,0,0,0,0,0,0,1,0,1,0,0,0,1,0,1
wi13,131,REVELLE,PHYS,Phy/ErthSc,0,0,0,0,1,1,0,0,0,0,0,0,1,0,1,0,0,0,1,1,2
wi13,131,REVELLE,PHYS,Phys/Astro,0,0,0,0,2,2,1,1,2,3,2,5,5,2,7,0,0,0,9,7,16
wi13,131,REVELLE,PHYS,Phys/Comp,0,0,0,0,0,0,1,0,1,0,0,0,0,0,0,0,0,0,1,0,1
wi13,131,REVELLE,PHYS,Phys/Mtrls,0,0,0,0,0,0,0,0,0,2,1,3,2,0,2,0,0,0,4,1,5
wi13,131,REVELLE,PHYS,Physics,0,0,0,1,1,2,2,0,2,4,2,6,9,2,11,0,0,0,16,5,21
wi13,131,REVELLE,POLI,Polit Sci,0,0,0,0,2,2,2,0,2,8,8,16,7,8,15,0,0,0,17,18,35
wi13,131,REVELLE,POLI,PolSc-Amer,0,0,0,1,0,1,0,0,0,3,1,4,4,2,6,0,0,0,8,3,11
wi13,131,REVELLE,POLI,PolSc-Comp,0,0,0,0,0,0,0,0,0,0,0,0,0,1,1,0,0,0,0,1,1
wi13,131,REVELLE,POLI,PolSc-Intl,0,0,0,0,1,1,2,1,3,1,3,4,6,4,10,0,0,0,9,9,18
wi13,131,REVELLE,POLI,PolSc-PLaw,0,0,0,1,1,2,0,3,3,0,3,3,2,0,2,0,0,0,3,7,10
wi13,131,REVELLE,POLI,PolSc-PPol,0,0,0,0,0,0,1,1,2,0,0,0,0,1,1,0,0,0,1,2,3
wi13,131,REVELLE,POLI,PolSc-Thry,0,0,0,0,0,0,0,0,0,0,1,1,1,1,2,0,0,0,1,2,3
wi13,131,REVELLE,PSYC,Psychology,0,0,0,14,10,24,9,19,28,13,31,44,38,77,115,0,0,0,74,137,211
wi13,131,REVELLE,RELI,Relig/Stu,0,0,0,0,0,0,0,0,0,0,0,0,0,1,1,0,0,0,0,1,1
wi13,131,REVELLE,RUSS,Russ&SovSt,0,0,0,0,0,0,0,0,0,0,0,0,1,0,1,0,0,0,1,0,1
wi13,131,REVELLE,SE,Engin Sci,0,0,0,1,0,1,2,0,2,0,0,0,0,0,0,0,0,0,3,0,3
wi13,131,REVELLE,SE,Struct Eng,1,0,1,9,8,17,17,1,18,16,2,18,23,10,33,0,0,0,66,21,87
wi13,131,REVELLE,SIO,Earth Sci,0,0,0,0,0,0,0,0,0,1,1,2,1,3,4,0,0,0,2,4,6
wi13,131,REVELLE,SIO,Marine Bio,0,0,0,1,4,5,1,4,5,1,3,4,2,0,2,0,0,0,5,11,16
wi13,131,REVELLE,SOC,SocEconSoc,0,0,0,1,0,1,0,0,0,0,0,0,0,2,2,0,0,0,1,2,3
wi13,131,REVELLE,SOC,Sociology,0,0,0,0,0,0,0,2,2,1,4,5,5,1,6,0,0,0,6,7,13
wi13,131,REVELLE,SOC,SocLawSoc,0,0,0,0,1,1,0,3,3,1,0,1,0,2,2,0,0,0,1,6,7
wi13,131,REVELLE,SOC,SocSciMed,0,0,0,0,1,1,0,1,1,0,3,3,1,2,3,0,0,0,1,7,8
wi13,131,REVELLE,SOC,SocSolneq,0,0,0,0,0,0,0,0,0,0,1,1,0,0,0,0,0,0,0,1,1
wi13,131,REVELLE,THEA,Dance,0,0,0,0,1,1,0,0,0,0,0,0,0,0,0,0,0,0,0,1,1
wi13,131,REVELLE,THEA,Theatre,0,0,0,0,2,2,0,1,1,1,0,1,1,3,4,0,0,0,2,6,8
wi13,131,REVELLE,TWS,ThirdWldSt,0,0,0,0,0,0,0,0,0,0,0,0,0,1,1,0,0,0,0,1,1
wi13,131,REVELLE,UNAF,Limited St,0,0,0,0,0,0,0,0,0,0,0,0,0,0,0,9,8,17,9,8,17
wi13,131,REVELLE,UNAF,Spec-Emply,0,0,0,0,0,0,0,0,0,0,0,0,0,0,0,1,5,6,1,5,6
wi13,131,REVELLE,UNAF,UndecHumAr,0,0,0,1,1,2,0,2,2,0,0,0,0,0,0,0,0,0,1,3,4
wi13,131,REVELLE,UNAF,Undeclared,0,0,0,16,32,48,17,13,30,2,4,6,0,0,0,0,0,0,35,49,84
wi13,131,REVELLE,UNAF,UndecPhysS,0,0,0,4,8,12,5,2,7,0,0,0,0,0,0,0,0,0,9,10,19
wi13,131,REVELLE,UNAF,UndecSocSc,0,0,0,3,1,4,1,3,4,0,0,0,0,0,0,0,0,0,4,4,8
wi13,131,REVELLE,USP,Urb Stu&Pl,0,0,0,0,1,1,0,0,0,1,1,2,3,0,3,0,0,0,4,2,6
wi13,131,REVELLE,VIS,Art Hst/Cr,0,0,0,0,0,0,0,1,1,0,0,0,0,0,0,0,0,0,0,1,1
wi13,131,REVELLE,VIS,Media,0,0,0,0,0,0,1,0,1,0,0,0,3,2,5,0,0,0,4,2,6
wi13,131,REVELLE,VIS,Studio VA,0,0,0,0,0,0,0,0,0,1,0,1,0,3,3,0,0,0,1,3,4
wi13,131,REVELLE,VIS,VA-CompArt,0,0,0,1,0,1,1,0,1,0,2,2,2,5,7,0,0,0,4,7,11
wi13,131,ROOSEVELT,ANTH,Anth-Arch,0,0,0,0,1,1,1,2,3,1,5,6,0,2,2,0,0,0,2,10,12
wi13,131,ROOSEVELT,ANTH,Anth-Biol,0,0,0,0,0,0,0,0,0,1,3,4,1,4,5,0,0,0,2,7,9
wi13,131,ROOSEVELT,ANTH,Anth-Soci,0,0,0,0,1,1,0,3,3,2,8,10,7,7,14,0,0,0,9,19,28
wi13,131,ROOSEVELT,BENG,Bioen:Binf,0,0,0,0,2,2,3,2,5,1,5,6,3,1,4,0,0,0,7,10,17
wi13,131,ROOSEVELT,BENG,Bioeng:PM,0,0,0,0,0,0,0,0,0,0,0,0,6,0,6,0,0,0,6,0,6
wi13,131,ROOSEVELT,BENG,BioengBiot,0,0,0,0,0,0,1,2,3,2,1,3,10,4,14,0,0,0,13,7,20
wi13,131,ROOSEVELT,BENG,Bioengin,0,0,0,0,0,0,2,4,6,1,4,5,4,4,8,0,0,0,7,12,19
wi13,131,ROOSEVELT,BIOL,Bioc/CellB,0,0,0,3,3,6,6,1,7,7,7,14,15,30,45,0,0,0,31,41,72
wi13,131,ROOSEVELT,BIOL,BiolBioinf,0,0,0,0,0,0,1,0,1,0,0,0,0,0,0,0,0,0,1,0,1
wi13,131,ROOSEVELT,BIOL,Ec/Beh/Evo,0,0,0,0,0,0,0,2,2,1,2,3,5,4,9,0,0,0,6,8,14
wi13,131,ROOSEVELT,BIOL,Genl Biol,0,0,0,1,5,6,6,12,18,6,8,14,31,33,64,0,0,0,44,58,102
wi13,131,ROOSEVELT,BIOL,Human Bio,0,0,0,2,6,8,9,20,29,13,29,42,35,45,80,0,0,0,59,100,159
wi13,131,ROOSEVELT,BIOL,Microbiol,0,0,0,0,0,0,2,2,4,1,3,4,1,4,5,0,0,0,4,9,13
wi13,131,ROOSEVELT,BIOL,Molec Biol,0,0,0,0,1,1,1,1,2,2,2,4,1,4,5,0,0,0,4,8,12
wi13,131,ROOSEVELT,BIOL,PhyslNeuro,0,0,0,2,3,5,4,15,19,2,8,10,13,11,24,0,0,0,21,37,58
wi13,131,ROOSEVELT,CENG,Chem Engin,0,0,0,3,1,4,6,2,8,7,6,13,18,2,20,0,0,0,34,11,45
wi13,131,ROOSEVELT,CGS,CritGendSt,0,0,0,0,0,0,0,0,0,0,0,0,0,1,1,0,0,0,0,1,1
wi13,131,ROOSEVELT,CHEM,Bioch/Chem,0,0,0,4,5,9,3,12,15,14,11,25,16,23,39,0,0,0,37,51,88
wi13,131,ROOSEVELT,CHEM,Chem Educ,0,0,0,0,1,1,0,0,0,0,0,0,0,0,0,0,0,0,0,1,1
wi13,131,ROOSEVELT,CHEM,Chem Phys,0,0,0,0,0,0,0,0,0,0,0,0,0,1,1,0,0,0,0,1,1
wi13,131,ROOSEVELT,CHEM,Chemistry,0,0,0,4,8,12,1,2,3,7,2,9,5,3,8,0,0,0,17,15,32
wi13,131,ROOSEVELT,CHEM,Envir Chem,0,0,0,0,1,1,0,0,0,1,0,1,3,0,3,0,0,0,4,1,5
wi13,131,ROOSEVELT,CHEM,MolecSynth,0,0,0,0,0,0,0,0,0,1,0,1,0,3,3,0,0,0,1,3,4
wi13,131,ROOSEVELT,CHEM,Pharm Chem,0,0,0,6,9,15,5,6,11,7,10,17,11,15,26,0,0,0,29,40,69
wi13,131,ROOSEVELT,CHIN,Chinese St,0,0,0,0,0,0,0,0,0,0,0,0,0,4,4,0,0,0,0,4,4
wi13,131,ROOSEVELT,CLAS,Classic St,0,0,0,0,1,1,1,0,1,1,0,1,0,3,3,0,0,0,2,4,6
wi13,131,ROOSEVELT,COGS,Cog Sci,0,0,0,1,5,6,0,8,8,3,5,8,3,8,11,0,0,0,7,26,33
wi13,131,ROOSEVELT,COGS,CogSc/ClAs,0,0,0,0,1,1,0,1,1,0,1,1,0,3,3,0,0,0,0,6,6
wi13,131,ROOSEVELT,COGS,CogSc/Comp,0,0,0,0,0,0,0,1,1,0,0,0,1,0,1,0,0,0,1,1,2
wi13,131,ROOSEVELT,COGS,CogSc/HCI,0,0,0,0,0,0,1,0,1,2,3,5,1,5,6,0,0,0,4,8,12
wi13,131,ROOSEVELT,COGS,CogSc/HCog,0,0,0,0,0,0,1,2,3,0,1,1,2,1,3,0,0,0,3,4,7
wi13,131,ROOSEVELT,COGS,CogSc/Neur,0,0,0,1,1,2,1,1,2,2,8,10,8,22,30,0,0,0,12,32,44
wi13,131,ROOSEVELT,COMM,Communic,0,0,0,5,9,14,1,12,13,4,39,43,14,54,68,0,0,0,24,114,138
wi13,131,ROOSEVELT,CSE,Comp Sci,0,0,0,14,10,24,14,3,17,30,1,31,37,8,45,0,0,0,95,22,117
wi13,131,ROOSEVELT,CSE,CompEngCSE,0,0,0,7,0,7,9,1,10,4,0,4,6,1,7,0,0,0,26,2,28
wi13,131,ROOSEVELT,CSE,CompScBinf,0,0,0,0,0,0,1,0,1,1,0,1,0,0,0,0,0,0,2,0,2
wi13,131,ROOSEVELT,ECE,CompEngECE,0,0,0,2,0,2,3,0,3,0,1,1,2,0,2,0,0,0,7,1,8
wi13,131,ROOSEVELT,ECE,Electr Eng,0,0,0,14,1,15,14,3,17,17,3,20,19,7,26,0,0,0,64,14,78
wi13,131,ROOSEVELT,ECE,Engin Phys,0,0,0,1,0,1,0,0,0,1,0,1,1,0,1,0,0,0,3,0,3
wi13,131,ROOSEVELT,ECON,Ec-Mth&Ecn,0,0,0,5,1,6,0,3,3,4,3,7,12,2,14,0,0,0,21,9,30
wi13,131,ROOSEVELT,ECON,Econ-MgtSc,0,0,0,9,4,13,9,5,14,19,15,34,36,24,60,0,0,0,73,48,121
wi13,131,ROOSEVELT,ECON,Economics,0,0,0,21,13,34,15,12,27,46,31,77,70,45,115,0,0,0,152,101,253
wi13,131,ROOSEVELT,ESYS,EnvSys(EB),0,0,0,1,3,4,1,4,5,2,6,8,3,15,18,0,0,0,7,28,35
wi13,131,ROOSEVELT,ESYS,EnvSys(EC),0,0,0,0,0,0,0,0,0,1,2,3,1,4,5,0,0,0,2,6,8
wi13,131,ROOSEVELT,ESYS,EnvSys(EP),0,0,0,0,2,2,1,0,1,1,0,1,0,0,0,0,0,0,2,2,4
wi13,131,ROOSEVELT,ESYS,EnvSys(ES),0,0,0,0,2,2,0,1,1,1,1,2,1,3,4,0,0,0,2,7,9
wi13,131,ROOSEVELT,ETHN,Ethnic St,0,0,0,0,0,0,0,0,0,0,1,1,1,1,2,0,0,0,1,2,3
wi13,131,ROOSEVELT,GMST,German Stu,0,0,0,0,0,0,0,0,0,1,0,1,0,0,0,0,0,0,1,0,1
wi13,131,ROOSEVELT,HDP,Human Dev,0,0,0,0,0,0,0,0,0,0,5,5,4,18,22,0,0,0,4,23,27
wi13,131,ROOSEVELT,HDP,Pr-HumnDev,0,0,0,0,6,6,0,13,13,0,13,13,0,3,3,0,0,0,0,35,35
wi13,131,ROOSEVELT,HIST,History,0,0,0,3,3,6,3,8,11,14,11,25,13,18,31,0,0,0,33,40,73
wi13,131,ROOSEVELT,INTL,Int-5yrEC,0,0,0,0,0,0,0,0,0,0,0,0,0,1,1,0,0,0,0,1,1
wi13,131,ROOSEVELT,INTL,Int-5yrPS,0,0,0,0,0,0,0,0,0,0,0,0,1,1,2,0,0,0,1,1,2
wi13,131,ROOSEVELT,INTL,IntSt-Anth,0,0,0,0,1,1,0,0,0,0,4,4,0,3,3,0,0,0,0,8,8
wi13,131,ROOSEVELT,INTL,IntSt-Econ,0,0,0,4,3,7,1,11,12,9,11,20,7,18,25,0,0,0,21,43,64
wi13,131,ROOSEVELT,INTL,IntSt-Hist,0,0,0,0,1,1,0,0,0,0,3,3,4,7,11,0,0,0,4,11,15
wi13,131,ROOSEVELT,INTL,IntSt-Ling,0,0,0,0,5,5,2,2,4,1,2,3,1,3,4,0,0,0,4,12,16
wi13,131,ROOSEVELT,INTL,IntSt-Lit,0,0,0,0,1,1,0,0,0,0,0,0,0,2,2,0,0,0,0,3,3
wi13,131,ROOSEVELT,INTL,IntSt-PolS,0,0,0,6,5,11,3,13,16,7,20,27,13,38,51,0,0,0,29,76,105
wi13,131,ROOSEVELT,INTL,IntSt-Soc,0,0,0,1,4,5,0,4,4,4,8,12,2,9,11,0,0,0,7,25,32
wi13,131,ROOSEVELT,ITAL,Italian St,0,0,0,0,0,0,1,0,1,0,0,0,0,0,0,0,0,0,1,0,1
wi13,131,ROOSEVELT,JAPN,JapaneseSt,0,0,0,0,1,1,0,1,1,1,1,2,3,0,3,0,0,0,4,3,7
wi13,131,ROOSEVELT,LATI,LatinAm St,0,0,0,0,0,0,0,0,0,0,0,0,0,2,2,0,0,0,0,2,2
wi13,131,ROOSEVELT,LING,Lang Stu,0,0,0,0,0,0,0,0,0,0,2,2,1,1,2,0,0,0,1,3,4
wi13,131,ROOSEVELT,LING,Ling-CogLn,0,0,0,0,2,2,0,1,1,0,1,1,0,3,3,0,0,0,0,7,7
wi13,131,ROOSEVELT,LING,Ling-LSoc,0,0,0,0,1,1,0,0,0,2,1,3,1,4,5,0,0,0,3,6,9
wi13,131,ROOSEVELT,LING,Linguistcs,0,0,0,0,0,0,0,0,0,1,3,4,1,2,3,0,0,0,2,5,7
wi13,131,ROOSEVELT,LIT,Lit/CultSt,0,0,0,0,0,0,1,0,1,0,1,1,1,1,2,0,0,0,2,2,4
wi13,131,ROOSEVELT,LIT,Lit/Engl,0,0,0,1,2,3,0,0,0,1,3,4,2,7,9,0,0,0,4,12,16
wi13,131,ROOSEVELT,LIT,Lit/World,0,0,0,0,2,2,0,1,1,0,1,1,0,0,0,0,0,0,0,4,4
wi13,131,ROOSEVELT,LIT,Lit/Writng,0,0,0,1,3,4,1,3,4,3,8,11,3,17,20,0,0,0,8,31,39
wi13,131,ROOSEVELT,LIT,Spanish Lt,0,0,0,0,0,0,0,1,1,0,1,1,2,1,3,0,0,0,2,3,5
wi13,131,ROOSEVELT,MAE,Aerosp Eng,0,0,0,1,0,1,4,0,4,3,0,3,12,3,15,0,0,0,20,3,23
wi13,131,ROOSEVELT,MAE,Engin Sci,0,0,0,0,0,0,0,0,0,1,0,1,4,0,4,0,0,0,5,0,5
wi13,131,ROOSEVELT,MAE,Envir Eng,0,0,0,1,4,5,2,6,8,3,0,3,8,4,12,0,0,0,14,14,28
wi13,131,ROOSEVELT,MAE,Mech Engin,0,0,0,0,0,0,3,2,5,4,0,4,33,5,38,0,0,0,40,7,47
wi13,131,ROOSEVELT,MATH,Appld Math,0,0,0,4,2,6,2,3,5,1,1,2,1,1,2,0,0,0,8,7,15
wi13,131,ROOSEVELT,MATH,Math/SecEd,0,0,0,0,0,0,0,3,3,1,0,1,1,2,3,0,0,0,2,5,7
wi13,131,ROOSEVELT,MATH,Mathematcs,0,0,0,1,0,1,1,1,2,4,1,5,3,2,5,0,0,0,9,4,13
wi13,131,ROOSEVELT,MATH,Mth-CompSc,0,0,0,0,0,0,0,0,0,0,2,2,2,1,3,0,0,0,2,3,5
wi13,131,ROOSEVELT,MATH,Mth-Mth&Ec,0,0,0,4,5,9,0,1,1,1,7,8,1,4,5,0,0,0,6,17,23
wi13,131,ROOSEVELT,MATH,Mth/ApldSc,0,0,0,1,1,2,0,0,0,0,0,0,1,0,1,0,0,0,2,1,3
wi13,131,ROOSEVELT,MATH,Prob&Stats,0,0,0,0,0,0,0,0,0,0,0,0,0,1,1,0,0,0,0,1,1
wi13,131,ROOSEVELT,MUS,Mu-CompArt,0,0,0,0,0,0,0,0,0,0,1,1,1,1,2,0,0,0,1,2,3
wi13,131,ROOSEVELT,MUS,Music,0,0,0,0,0,0,0,0,0,0,1,1,1,2,3,0,0,0,1,3,4
wi13,131,ROOSEVELT,MUS,Music Hum,0,0,0,0,0,0,0,0,0,0,1,1,0,0,0,0,0,0,0,1,1
wi13,131,ROOSEVELT,NENG,NanoEng,0,0,0,1,3,4,4,3,7,12,2,14,10,4,14,0,0,0,27,12,39
wi13,131,ROOSEVELT,PHIL,Philosophy,0,0,0,0,0,0,0,0,0,1,1,2,4,2,6,0,0,0,5,3,8
wi13,131,ROOSEVELT,PHYS,Biophysics,0,0,0,0,0,0,0,1,1,2,0,2,1,1,2,0,0,0,3,2,5
wi13,131,ROOSEVELT,PHYS,Phy/ErthSc,0,0,0,0,0,0,0,0,0,0,0,0,0,1,1,0,0,0,0,1,1
wi13,131,ROOSEVELT,PHYS,Phys/Astro,0,0,0,0,0,0,2,1,3,1,0,1,0,1,1,0,0,0,3,2,5
wi13,131,ROOSEVELT,PHYS,Phys/Comp,0,0,0,0,0,0,0,0,0,0,0,0,1,0,1,0,0,0,1,0,1
wi13,131,ROOSEVELT,PHYS,Phys/Mtrls,0,0,0,0,0,0,0,0,0,0,0,0,1,0,1,0,0,0,1,0,1
wi13,131,ROOSEVELT,PHYS,Physics,0,0,0,2,0,2,1,1,2,2,0,2,0,1,1,0,0,0,5,2,7
wi13,131,ROOSEVELT,POLI,Polit Sci,0,0,0,3,7,10,3,7,10,11,15,26,29,26,55,0,0,0,46,55,101
wi13,131,ROOSEVELT,POLI,PolSc-Amer,0,0,0,0,2,2,1,0,1,0,1,1,4,4,8,0,0,0,5,7,12
wi13,131,ROOSEVELT,POLI,PolSc-Intl,0,0,0,6,6,12,4,10,14,11,15,26,25,30,55,0,0,0,46,61,107
wi13,131,ROOSEVELT,POLI,PolSc-PLaw,0,0,0,1,7,8,5,5,10,3,7,10,7,9,16,0,0,0,16,28,44
wi13,131,ROOSEVELT,POLI,PolSc-PPol,0,0,0,1,1,2,2,1,3,1,1,2,1,1,2,0,0,0,5,4,9
wi13,131,ROOSEVELT,POLI,PolSc-Thry,0,0,0,1,0,1,1,0,1,2,0,2,1,0,1,0,0,0,5,0,5
wi13,131,ROOSEVELT,PSYC,Psychology,0,0,0,5,18,23,7,24,31,14,48,62,31,88,119,0,0,0,57,178,235
wi13,131,ROOSEVELT,RELI,Relig/Stu,0,0,0,0,0,0,0,0,0,0,1,1,0,3,3,0,0,0,0,4,4
wi13,131,ROOSEVELT,SE,Engin Sci,0,0,0,0,1,1,1,1,2,1,0,1,1,0,1,0,0,0,3,2,5
wi13,131,ROOSEVELT,SE,Struct Eng,0,0,0,6,6,12,5,3,8,12,4,16,23,5,28,0,0,0,46,18,64
wi13,131,ROOSEVELT,SIO,Earth Sci,0,0,0,1,0,1,0,0,0,1,0,1,0,0,0,0,0,0,2,0,2
wi13,131,ROOSEVELT,SIO,ErSc-Geol,0,0,0,0,0,0,0,0,0,0,1,1,0,0,0,0,0,0,0,1,1
wi13,131,ROOSEVELT,SIO,Marine Bio,0,0,0,1,3,4,0,2,2,2,4,6,1,2,3,0,0,0,4,11,15
wi13,131,ROOSEVELT,SOC,SocAmSt,0,0,0,0,0,0,0,0,0,0,1,1,0,1,1,0,0,0,0,2,2
wi13,131,ROOSEVELT,SOC,SocCulCom,0,0,0,0,0,0,0,0,0,0,0,0,1,4,5,0,0,0,1,4,5
wi13,131,ROOSEVELT,SOC,SocEconSoc,0,0,0,0,1,1,0,0,0,0,2,2,1,1,2,0,0,0,1,4,5
wi13,131,ROOSEVELT,SOC,SocIntlStu,0,0,0,0,0,0,0,0,0,0,0,0,1,2,3,0,0,0,1,2,3
wi13,131,ROOSEVELT,SOC,Sociology,0,0,0,1,5,6,0,4,4,1,13,14,7,14,21,0,0,0,9,36,45
wi13,131,ROOSEVELT,SOC,SocLawSoc,0,0,0,0,0,0,0,1,1,1,2,3,1,3,4,0,0,0,2,6,8
wi13,131,ROOSEVELT,SOC,SocSciMed,0,0,0,1,0,1,0,0,0,0,2,2,1,2,3,0,0,0,2,4,6
wi13,131,ROOSEVELT,SOC,SocSolneq,0,0,0,0,0,0,0,1,1,0,0,0,0,3,3,0,0,0,0,4,4
wi13,131,ROOSEVELT,THEA,Dance,0,0,0,0,0,0,0,1,1,0,1,1,0,1,1,0,0,0,0,3,3
wi13,131,ROOSEVELT,THEA,Theatre,0,0,0,0,3,3,0,1,1,1,2,3,1,8,9,0,0,0,2,14,16
wi13,131,ROOSEVELT,TWS,ThirdWldSt,0,0,0,0,0,0,0,1,1,0,0,0,0,2,2,0,0,0,0,3,3
wi13,131,ROOSEVELT,UNAF,UndecHumAr,0,0,0,2,2,4,1,4,5,0,1,1,0,0,0,0,0,0,3,7,10
wi13,131,ROOSEVELT,UNAF,Undeclared,0,0,0,29,37,66,18,27,45,0,2,2,0,0,0,0,0,0,47,66,113
wi13,131,ROOSEVELT,UNAF,UndecPhysS,0,0,0,4,3,7,3,2,5,0,0,0,0,0,0,0,0,0,7,5,12
wi13,131,ROOSEVELT,UNAF,UndecSocSc,0,0,0,2,4,6,2,3,5,0,0,0,0,0,0,0,0,0,4,7,11
wi13,131,ROOSEVELT,USP,Urb Stu&Pl,0,0,0,1,0,1,1,2,3,3,8,11,7,14,21,0,0,0,12,24,36
wi13,131,ROOSEVELT,VIS,Art Hst/Cr,0,0,0,0,0,0,0,0,0,0,2,2,0,2,2,0,0,0,0,4,4
wi13,131,ROOSEVELT,VIS,Media,0,0,0,4,3,7,1,1,2,8,6,14,4,9,13,0,0,0,17,19,36
wi13,131,ROOSEVELT,VIS,Studio VA,0,0,0,0,2,2,2,1,3,0,2,2,1,3,4,0,0,0,3,8,11
wi13,131,ROOSEVELT,VIS,VA-CompArt,0,0,0,0,0,0,0,0,0,1,0,1,0,2,2,0,0,0,1,2,3
wi13,131,SIXTH,ANTH,Anth-Arch,0,0,0,1,0,1,0,0,0,0,0,0,0,2,2,0,0,0,1,2,3
wi13,131,SIXTH,ANTH,Anth-Biol,0,0,0,0,0,0,1,1,2,0,1,1,0,5,5,0,0,0,1,7,8
wi13,131,SIXTH,ANTH,Anth-Soci,0,0,0,0,1,1,1,0,1,1,3,4,1,7,8,0,0,0,3,11,14
wi13,131,SIXTH,BENG,Bioen:Binf,0,0,0,3,5,8,2,2,4,2,3,5,6,1,7,0,0,0,13,11,24
wi13,131,SIXTH,BENG,Bioeng:PM,0,0,0,0,0,0,0,0,0,0,0,0,5,1,6,0,0,0,5,1,6
wi13,131,SIXTH,BENG,BioengBiot,0,0,0,1,1,2,5,3,8,7,6,13,14,6,20,0,0,0,27,16,43
wi13,131,SIXTH,BENG,Bioengin,0,0,0,0,0,0,2,1,3,4,6,10,9,3,12,0,0,0,15,10,25
wi13,131,SIXTH,BIOL,Bioc/CellB,0,0,0,4,2,6,9,12,21,11,16,27,20,26,46,0,0,0,44,56,100
wi13,131,SIXTH,BIOL,BiolBioinf,0,0,0,0,0,0,0,1,1,1,0,1,0,0,0,0,0,0,1,1,2
wi13,131,SIXTH,BIOL,Ec/Beh/Evo,0,0,0,0,0,0,0,1,1,0,3,3,3,4,7,0,0,0,3,8,11
wi13,131,SIXTH,BIOL,Genl Biol,0,0,0,4,8,12,3,11,14,7,8,15,26,26,52,0,0,0,40,53,93
wi13,131,SIXTH,BIOL,Human Bio,0,0,0,7,12,19,11,20,31,17,13,30,32,32,64,0,0,0,67,77,144
wi13,131,SIXTH,BIOL,Microbiol,0,0,0,0,2,2,0,1,1,3,1,4,4,2,6,0,0,0,7,6,13
wi13,131,SIXTH,BIOL,Molec Biol,0,0,0,1,0,1,3,1,4,0,2,2,3,2,5,0,0,0,7,5,12
wi13,131,SIXTH,BIOL,PhyslNeuro,0,0,0,1,0,1,3,3,6,5,5,10,13,17,30,0,0,0,22,25,47
wi13,131,SIXTH,CENG,Chem Engin,0,0,0,7,2,9,13,4,17,7,4,11,23,5,28,0,0,0,50,15,65
wi13,131,SIXTH,CGS,CritGendSt,0,0,0,0,0,0,0,0,0,0,0,0,1,1,2,0,0,0,1,1,2
wi13,131,SIXTH,CHEM,Bioch/Chem,0,0,0,8,6,14,2,7,9,10,12,22,32,16,48,0,0,0,52,41,93
wi13,131,SIXTH,CHEM,Chem Phys,0,0,0,0,0,0,0,0,0,1,0,1,1,0,1,0,0,0,2,0,2
wi13,131,SIXTH,CHEM,Chemistry,0,0,0,2,4,6,1,4,5,6,5,11,5,4,9,0,0,0,14,17,31
wi13,131,SIXTH,CHEM,Envir Chem,0,0,0,0,0,0,0,0,0,0,1,1,1,1,2,0,0,0,1,2,3
wi13,131,SIXTH,CHEM,MolecSynth,0,0,0,0,0,0,0,1,1,0,0,0,1,2,3,0,0,0,1,3,4
wi13,131,SIXTH,CHEM,Pharm Chem,0,0,0,4,5,9,5,9,14,17,7,24,21,22,43,0,0,0,47,43,90
wi13,131,SIXTH,CHIN,Chinese St,0,0,0,0,0,0,1,0,1,0,0,0,2,1,3,0,0,0,3,1,4
wi13,131,SIXTH,COGS,Cog Sci,0,0,0,3,1,4,1,1,2,3,4,7,8,3,11,0,0,0,15,9,24
wi13,131,SIXTH,COGS,CogSc/ClAs,0,0,0,0,0,0,0,0,0,0,0,0,1,3,4,0,0,0,1,3,4
wi13,131,SIXTH,COGS,CogSc/Comp,0,0,0,0,0,0,0,0,0,0,1,1,4,1,5,0,0,0,4,2,6
wi13,131,SIXTH,COGS,CogSc/HCI,0,0,0,0,0,0,0,1,1,1,3,4,7,8,15,0,0,0,8,12,20
wi13,131,SIXTH,COGS,CogSc/HCog,0,0,0,0,0,0,0,0,0,1,0,1,0,2,2,0,0,0,1,2,3
wi13,131,SIXTH,COGS,CogSc/Neur,0,0,0,2,0,2,4,1,5,6,4,10,13,18,31,0,0,0,25,23,48
wi13,131,SIXTH,COMM,Communic,0,0,0,2,17,19,3,13,16,9,40,49,19,65,84,0,0,0,33,135,168
wi13,131,SIXTH,CSE,Comp Sci,0,0,0,34,6,40,47,17,64,61,12,73,89,21,110,0,0,0,231,56,287
wi13,131,SIXTH,CSE,CompEngCSE,0,0,0,16,4,20,22,2,24,13,4,17,16,0,16,0,0,0,67,10,77
wi13,131,SIXTH,CSE,CompScBinf,0,0,0,0,0,0,2,1,3,0,1,1,8,1,9,0,0,0,10,3,13
wi13,131,SIXTH,ECE,CompEngECE,0,0,0,4,0,4,4,0,4,1,0,1,3,0,3,0,0,0,12,0,12
wi13,131,SIXTH,ECE,Electr Eng,0,0,0,18,2,20,34,3,37,23,1,24,41,3,44,0,0,0,116,9,125
wi13,131,SIXTH,ECE,EleEng&Soc,0,0,0,0,0,0,0,2,2,0,0,0,0,0,0,0,0,0,0,2,2
wi13,131,SIXTH,ECE,Engin Phys,0,0,0,0,0,0,1,0,1,0,0,0,1,1,2,0,0,0,2,1,3
wi13,131,SIXTH,ECON,Ec-Mth&Ecn,0,0,0,1,3,4,3,2,5,5,1,6,6,1,7,0,0,0,15,7,22
wi13,131,SIXTH,ECON,Econ-MgtSc,0,0,0,9,6,15,3,6,9,32,22,54,25,29,54,0,0,0,69,63,132
wi13,131,SIXTH,ECON,Economics,0,0,0,20,9,29,11,5,16,44,26,70,55,27,82,0,0,0,130,67,197
wi13,131,SIXTH,ESYS,EnvSys(EB),0,0,0,0,3,3,0,2,2,5,9,14,7,22,29,0,0,0,12,36,48
wi13,131,SIXTH,ESYS,EnvSys(EC),0,0,0,0,0,0,0,0,0,1,0,1,3,0,3,0,0,0,4,0,4
wi13,131,SIXTH,ESYS,EnvSys(EP),0,0,0,1,1,2,1,1,2,1,2,3,1,5,6,0,0,0,4,9,13
wi13,131,SIXTH,ESYS,EnvSys(ES),0,0,0,1,0,1,1,1,2,1,2,3,2,0,2,0,0,0,5,3,8
wi13,131,SIXTH,ETHN,Ethnic St,0,0,0,0,0,0,0,0,0,1,1,2,2,4,6,0,0,0,3,5,8
wi13,131,SIXTH,GMST,German Stu,0,0,0,0,0,0,0,0,0,0,0,0,0,1,1,0,0,0,0,1,1
wi13,131,SIXTH,HDP,Human Dev,0,0,0,0,0,0,0,0,0,0,9,9,3,14,17,0,0,0,3,23,26
wi13,131,SIXTH,HDP,Pr-HumnDev,0,0,0,0,5,5,3,10,13,2,10,12,0,4,4,0,0,0,5,29,34
wi13,131,SIXTH,HIST,History,0,0,0,0,0,0,1,0,1,4,3,7,9,7,16,0,0,0,14,10,24
wi13,131,SIXTH,INTL,IntSt-Anth,0,0,0,0,2,2,0,0,0,0,0,0,0,1,1,0,0,0,0,3,3
wi13,131,SIXTH,INTL,IntSt-Econ,0,0,0,3,2,5,1,1,2,2,9,11,9,10,19,0,0,0,15,22,37
wi13,131,SIXTH,INTL,IntSt-Hist,0,0,0,0,1,1,1,0,1,0,1,1,0,1,1,0,0,0,1,3,4
wi13,131,SIXTH,INTL,IntSt-Ling,0,0,0,0,0,0,0,0,0,0,1,1,1,3,4,0,0,0,1,4,5
wi13,131,SIXTH,INTL,IntSt-PolS,0,0,0,0,0,0,0,1,1,1,2,3,5,10,15,0,0,0,6,13,19
wi13,131,SIXTH,INTL,IntSt-Soc,0,0,0,0,2,2,0,1,1,1,1,2,0,5,5,0,0,0,1,9,10
wi13,131,SIXTH,JAPN,JapaneseSt,0,0,0,0,0,0,0,0,0,0,0,0,0,2,2,0,0,0,0,2,2
wi13,131,SIXTH,LATI,LatinAm St,0,0,0,0,0,0,0,0,0,1,0,1,0,0,0,0,0,0,1,0,1
wi13,131,SIXTH,LING,Lang Stu,0,0,0,0,0,0,0,0,0,0,1,1,1,0,1,0,0,0,1,1,2
wi13,131,SIXTH,LING,Ling-CogLn,0,0,0,0,2,2,0,1,1,1,3,4,1,0,1,0,0,0,2,6,8
wi13,131,SIXTH,LING,Ling-LSoc,0,0,0,0,0,0,0,0,0,0,2,2,0,1,1,0,0,0,0,3,3
wi13,131,SIXTH,LING,Linguistcs,0,0,0,0,1,1,0,1,1,0,0,0,2,4,6,0,0,0,2,6,8
wi13,131,SIXTH,LIT,French Lit,0,0,0,0,0,0,0,0,0,0,0,0,0,1,1,0,0,0,0,1,1
wi13,131,SIXTH,LIT,Lit/CultSt,0,0,0,0,0,0,0,0,0,0,1,1,0,0,0,0,0,0,0,1,1
wi13,131,SIXTH,LIT,Lit/Engl,0,0,0,0,0,0,1,2,3,0,1,1,0,1,1,0,0,0,1,4,5
wi13,131,SIXTH,LIT,Lit/World,0,0,0,0,0,0,0,0,0,0,0,0,0,2,2,0,0,0,0,2,2
wi13,131,SIXTH,LIT,Lit/Writng,0,0,0,1,2,3,0,1,1,2,3,5,1,11,12,0,0,0,4,17,21
wi13,131,SIXTH,LIT,Spanish Lt,0,0,0,0,0,0,0,0,0,0,0,0,0,1,1,0,0,0,0,1,1
wi13,131,SIXTH,MAE,Aerosp Eng,0,0,0,2,0,2,5,3,8,7,0,7,25,6,31,0,0,0,39,9,48
wi13,131,SIXTH,MAE,Engin Sci,0,0,0,0,0,0,1,0,1,3,0,3,6,0,6,0,0,0,10,0,10
wi13,131,SIXTH,MAE,Envir Eng,0,0,0,5,1,6,4,5,9,7,4,11,10,10,20,0,0,0,26,20,46
wi13,131,SIXTH,MAE,Mech Engin,0,0,0,2,1,3,4,3,7,19,4,23,46,6,52,0,0,0,71,14,85
wi13,131,SIXTH,MATH,Appld Math,0,0,0,4,3,7,2,3,5,2,3,5,3,1,4,0,0,0,11,10,21
wi13,131,SIXTH,MATH,Math/SecEd,0,0,0,1,0,1,0,0,0,0,0,0,0,1,1,0,0,0,1,1,2
wi13,131,SIXTH,MATH,Mathematcs,0,0,0,2,2,4,1,1,2,1,0,1,6,4,10,0,0,0,10,7,17
wi13,131,SIXTH,MATH,Mth-CompSc,0,0,0,0,1,1,0,0,0,1,1,2,2,0,2,0,0,0,3,2,5
wi13,131,SIXTH,MATH,Mth-Mth&Ec,0,0,0,5,3,8,2,1,3,1,3,4,5,3,8,0,0,0,13,10,23
wi13,131,SIXTH,MATH,Mth-SciCom,0,0,0,0,1,1,0,0,0,0,0,0,0,0,0,0,0,0,0,1,1
wi13,131,SIXTH,MATH,Mth/ApldSc,0,0,0,1,1,2,0,0,0,0,0,0,1,0,1,0,0,0,2,1,3
wi13,131,SIXTH,MATH,Pr-Math CS,0,0,0,1,0,1,0,0,0,2,0,2,0,0,0,0,0,0,3,0,3
wi13,131,SIXTH,MATH,Prob&Stats,0,0,0,0,1,1,2,0,2,1,1,2,2,2,4,0,0,0,5,4,9
wi13,131,SIXTH,MUS,Mu-CompArt,0,0,0,0,0,0,2,0,2,7,0,7,14,1,15,0,0,0,23,1,24
wi13,131,SIXTH,MUS,Music,0,0,0,1,0,1,1,1,2,1,1,2,8,5,13,0,0,0,11,7,18
wi13,131,SIXTH,MUS,Music Hum,0,0,0,0,0,0,0,0,0,0,0,0,0,1,1,0,0,0,0,1,1
wi13,131,SIXTH,NENG,NanoEng,0,0,0,3,2,5,9,1,10,10,2,12,14,2,16,0,0,0,36,7,43
wi13,131,SIXTH,PHIL,Philosophy,0,0,0,0,0,0,0,0,0,2,0,2,3,1,4,0,0,0,5,1,6
wi13,131,SIXTH,PHYS,Biophysics,0,0,0,0,0,0,0,0,0,1,0,1,5,0,5,0,0,0,6,0,6
wi13,131,SIXTH,PHYS,Phy/ErthSc,0,0,0,0,0,0,0,0,0,2,0,2,0,0,0,0,0,0,2,0,2
wi13,131,SIXTH,PHYS,Phys/Astro,0,0,0,0,0,0,0,1,1,0,1,1,1,0,1,0,0,0,1,2,3
wi13,131,SIXTH,PHYS,Phys/Comp,0,0,0,1,0,1,0,0,0,0,0,0,1,0,1,0,0,0,2,0,2
wi13,131,SIXTH,PHYS,Phys/Mtrls,0,0,0,1,0,1,0,0,0,0,0,0,1,0,1,0,0,0,2,0,2
wi13,131,SIXTH,PHYS,Physics,0,0,0,2,1,3,4,0,4,2,0,2,7,0,7,0,0,0,15,1,16
wi13,131,SIXTH,POLI,Polit Sci,0,0,0,3,1,4,0,3,3,6,6,12,15,12,27,0,0,0,24,22,46
wi13,131,SIXTH,POLI,PolSc-Amer,0,0,0,1,0,1,0,0,0,1,1,2,2,3,5,0,0,0,4,4,8
wi13,131,SIXTH,POLI,PolSc-Comp,0,0,0,0,0,0,0,0,0,0,0,0,0,1,1,0,0,0,0,1,1
wi13,131,SIXTH,POLI,PolSc-Intl,0,0,0,1,1,2,0,5,5,5,4,9,7,8,15,0,0,0,13,18,31
wi13,131,SIXTH,POLI,PolSc-PLaw,0,0,0,0,1,1,1,2,3,4,1,5,6,3,9,0,0,0,11,7,18
wi13,131,SIXTH,POLI,PolSc-PPol,0,0,0,0,0,0,0,0,0,1,1,2,1,1,2,0,0,0,2,2,4
wi13,131,SIXTH,POLI,PolSc-Thry,0,0,0,0,0,0,0,1,1,1,0,1,0,1,1,0,0,0,1,2,3
wi13,131,SIXTH,PSYC,Psychology,0,0,0,6,14,20,12,18,30,21,43,64,30,59,89,0,0,0,69,134,203
wi13,131,SIXTH,RELI,Relig/Stu,0,0,0,0,0,0,0,0,0,0,0,0,0,1,1,0,0,0,0,1,1
wi13,131,SIXTH,SE,Engin Sci,0,0,0,0,0,0,0,0,0,0,1,1,0,0,0,0,0,0,0,1,1
wi13,131,SIXTH,SE,Struct Eng,0,0,0,15,6,21,16,5,21,20,3,23,43,13,56,0,0,0,94,27,121
wi13,131,SIXTH,SIO,Earth Sci,0,0,0,0,1,1,0,0,0,1,0,1,2,2,4,0,0,0,3,3,6
wi13,131,SIXTH,SIO,ErSc-Geoph,0,0,0,0,0,0,0,0,0,0,0,0,0,1,1,0,0,0,0,1,1
wi13,131,SIXTH,SIO,Marine Bio,0,0,0,0,1,1,4,2,6,0,0,0,0,1,1,0,0,0,4,4,8
wi13,131,SIXTH,SOC,SocCulCom,0,0,0,0,0,0,0,0,0,0,1,1,1,5,6,0,0,0,1,6,7
wi13,131,SIXTH,SOC,SocEconSoc,0,0,0,0,0,0,0,0,0,0,1,1,1,0,1,0,0,0,1,1,2
wi13,131,SIXTH,SOC,SocIntlStu,0,0,0,0,0,0,0,0,0,0,1,1,1,2,3,0,0,0,1,3,4
wi13,131,SIXTH,SOC,Sociology,0,0,0,0,1,1,0,3,3,2,5,7,6,15,21,0,0,0,8,24,32
wi13,131,SIXTH,SOC,SocLawSoc,0,0,0,0,0,0,0,1,1,1,1,2,0,2,2,0,0,0,1,4,5
wi13,131,SIXTH,SOC,SocSciMed,0,0,0,0,0,0,1,0,1,1,0,1,2,3,5,0,0,0,4,3,7
wi13,131,SIXTH,SOC,SocSolneq,0,0,0,0,0,0,0,1,1,0,1,1,0,0,0,0,0,0,0,2,2
wi13,131,SIXTH,THEA,Dance,0,0,0,0,1,1,0,0,0,0,0,0,0,0,0,0,0,0,0,1,1
wi13,131,SIXTH,THEA,Theatre,0,0,0,0,2,2,3,1,4,0,5,5,2,9,11,0,0,0,5,17,22
wi13,131,SIXTH,TWS,ThirdWldSt,0,0,0,0,0,0,0,0,0,0,0,0,0,1,1,0,0,0,0,1,1
wi13,131,SIXTH,UNAF,UndecHumAr,0,0,0,3,2,5,0,3,3,0,0,0,0,0,0,0,0,0,3,5,8
wi13,131,SIXTH,UNAF,Undeclared,0,0,0,31,29,60,16,20,36,0,1,1,0,0,0,0,0,0,47,50,97
wi13,131,SIXTH,UNAF,UndecPhysS,0,0,0,5,3,8,1,2,3,0,0,0,0,0,0,0,0,0,6,5,11
wi13,131,SIXTH,UNAF,UndecSocSc,0,0,0,1,5,6,0,2,2,0,0,0,0,0,0,0,0,0,1,7,8
wi13,131,SIXTH,USP,Urb Stu&Pl,0,0,0,1,0,1,1,4,5,1,5,6,7,7,14,0,0,0,10,16,26
wi13,131,SIXTH,VIS,Art Hst/Cr,0,0,0,0,0,0,0,1,1,0,4,4,1,6,7,0,0,0,1,11,12
wi13,131,SIXTH,VIS,Media,0,0,0,3,3,6,3,10,13,9,10,19,18,16,34,0,0,0,33,39,72
wi13,131,SIXTH,VIS,Studio VA,0,0,0,0,1,1,2,3,5,1,8,9,3,11,14,0,0,0,6,23,29
wi13,131,SIXTH,VIS,VA-CompArt,0,0,0,1,5,6,0,3,3,6,3,9,7,7,14,0,0,0,14,18,32
wi13,131,WARREN,ANTH,Anth-Arch,0,0,0,0,0,0,0,1,1,0,1,1,0,1,1,0,0,0,0,3,3
wi13,131,WARREN,ANTH,Anth-Biol,0,0,0,0,0,0,0,0,0,0,2,2,1,3,4,0,0,0,1,5,6
wi13,131,WARREN,ANTH,Anth-Soci,0,0,0,0,0,0,0,0,0,0,1,1,1,8,9,0,0,0,1,9,10
wi13,131,WARREN,BENG,Bioen:Binf,0,0,0,2,1,3,2,2,4,2,5,7,2,3,5,0,0,0,8,11,19
wi13,131,WARREN,BENG,Bioeng:PM,0,0,0,0,0,0,0,0,0,0,1,1,10,4,14,0,0,0,10,5,15
wi13,131,WARREN,BENG,BioengBiot,0,0,0,1,1,2,10,8,18,13,7,20,30,22,52,0,0,0,54,38,92
wi13,131,WARREN,BENG,Bioengin,0,0,0,1,3,4,7,7,14,10,6,16,24,11,35,0,0,0,42,27,69
wi13,131,WARREN,BIOL,Bioc/CellB,0,0,0,2,1,3,9,20,29,8,9,17,46,30,76,0,0,0,65,60,125
wi13,131,WARREN,BIOL,BiolBioinf,0,0,0,0,0,0,1,0,1,0,1,1,0,0,0,0,0,0,1,1,2
wi13,131,WARREN,BIOL,Ec/Beh/Evo,0,0,0,1,1,2,0,0,0,1,3,4,2,4,6,0,0,0,4,8,12
wi13,131,WARREN,BIOL,Genl Biol,0,0,0,2,5,7,5,15,20,13,12,25,26,35,61,0,0,0,46,67,113
wi13,131,WARREN,BIOL,Human Bio,0,0,0,4,6,10,10,24,34,11,18,29,43,46,89,0,0,0,68,94,162
wi13,131,WARREN,BIOL,Microbiol,0,0,0,0,1,1,1,3,4,2,2,4,7,8,15,0,0,0,10,14,24
wi13,131,WARREN,BIOL,Molec Biol,0,0,0,1,1,2,1,2,3,4,1,5,8,6,14,0,0,0,14,10,24
wi13,131,WARREN,BIOL,PhyslNeuro,0,0,0,4,2,6,10,9,19,5,12,17,28,14,42,0,0,0,47,37,84
wi13,131,WARREN,CENG,Chem Engin,0,0,0,6,3,9,15,12,27,26,16,42,44,16,60,0,0,0,91,47,138
wi13,131,WARREN,CGS,CritGendSt,0,0,0,1,0,1,0,0,0,0,0,0,0,0,0,0,0,0,1,0,1
wi13,131,WARREN,CHEM,Bioch/Chem,0,0,0,8,3,11,5,6,11,19,14,33,33,21,54,0,0,0,65,44,109
wi13,131,WARREN,CHEM,Chem Phys,0,0,0,0,0,0,1,0,1,0,1,1,0,1,1,0,0,0,1,2,3
wi13,131,WARREN,CHEM,Chemistry,0,0,0,1,3,4,3,3,6,6,6,12,2,11,13,0,0,0,12,23,35
wi13,131,WARREN,CHEM,Envir Chem,0,0,0,0,0,0,0,0,0,0,1,1,1,2,3,0,0,0,1,3,4
wi13,131,WARREN,CHEM,MolecSynth,0,0,0,0,0,0,0,0,0,2,0,2,1,0,1,0,0,0,3,0,3
wi13,131,WARREN,CHEM,Pharm Chem,0,0,0,1,2,3,4,7,11,13,11,24,22,27,49,0,0,0,40,47,87
wi13,131,WARREN,CHIN,Chinese St,0,0,0,0,0,0,0,1,1,0,0,0,1,1,2,0,0,0,1,2,3
wi13,131,WARREN,COGS,Cog Sci,0,0,0,0,1,1,2,5,7,6,2,8,3,4,7,0,0,0,11,12,23
wi13,131,WARREN,COGS,CogSc/ClAs,0,0,0,0,1,1,0,0,0,0,1,1,2,2,4,0,0,0,2,4,6
wi13,131,WARREN,COGS,CogSc/Comp,0,0,0,0,0,0,0,2,2,0,0,0,2,0,2,0,0,0,2,2,4
wi13,131,WARREN,COGS,CogSc/HCI,0,0,0,0,0,0,0,0,0,2,1,3,7,7,14,0,0,0,9,8,17
wi13,131,WARREN,COGS,CogSc/HCog,0,0,0,0,0,0,0,1,1,0,1,1,1,3,4,0,0,0,1,5,6
wi13,131,WARREN,COGS,CogSc/Neur,0,0,0,0,2,2,0,7,7,4,12,16,10,19,29,0,0,0,14,40,54
wi13,131,WARREN,COMM,Communic,0,0,0,1,2,3,5,10,15,7,16,23,10,27,37,0,0,0,23,55,78
wi13,131,WARREN,CSE,Comp Sci,0,0,0,36,11,47,62,17,79,70,14,84,135,28,163,0,0,0,303,70,373
wi13,131,WARREN,CSE,CompEngCSE,0,0,0,10,4,14,21,3,24,15,5,20,35,2,37,0,0,0,81,14,95
wi13,131,WARREN,CSE,CompScBinf,0,0,0,0,0,0,2,1,3,5,0,5,5,6,11,0,0,0,12,7,19
wi13,131,WARREN,ECE,CompEngECE,0,0,0,4,0,4,3,0,3,5,0,5,7,0,7,0,0,0,19,0,19
wi13,131,WARREN,ECE,Electr Eng,0,0,0,18,3,21,31,5,36,48,7,55,70,13,83,0,0,0,167,28,195
wi13,131,WARREN,ECE,Engin Phys,0,0,0,0,0,0,1,0,1,0,0,0,0,0,0,0,0,0,1,0,1
wi13,131,WARREN,ECE,Pr-EngPhys,0,0,0,0,0,0,0,0,0,0,0,0,1,0,1,0,0,0,1,0,1
wi13,131,WARREN,ECON,Ec-Mth&Ecn,0,0,0,2,1,3,4,5,9,5,1,6,7,0,7,0,0,0,18,7,25
wi13,131,WARREN,ECON,Econ-MgtSc,0,0,0,8,7,15,10,8,18,17,13,30,41,20,61,0,0,0,76,48,124
wi13,131,WARREN,ECON,Economics,0,0,0,8,10,18,9,6,15,31,28,59,77,35,112,0,0,0,125,79,204
wi13,131,WARREN,ESYS,EnvSys(EB),0,0,0,0,1,1,0,1,1,2,4,6,4,12,16,0,0,0,6,18,24
wi13,131,WARREN,ESYS,EnvSys(EC),0,0,0,0,0,0,0,0,0,0,0,0,0,1,1,0,0,0,0,1,1
wi13,131,WARREN,ESYS,EnvSys(EP),0,0,0,0,0,0,0,0,0,1,0,1,0,1,1,0,0,0,1,1,2
wi13,131,WARREN,ESYS,EnvSys(ES),0,0,0,0,0,0,0,0,0,2,0,2,1,0,1,0,0,0,3,0,3
wi13,131,WARREN,ETHN,Ethnic St,0,0,0,0,0,0,1,1,2,0,0,0,0,4,4,0,0,0,1,5,6
wi13,131,WARREN,HDP,Human Dev,0,0,0,0,0,0,0,2,2,0,4,4,0,11,11,0,0,0,0,17,17
wi13,131,WARREN,HDP,Pr-HumnDev,0,0,0,1,1,2,1,7,8,4,7,11,1,4,5,0,0,0,7,19,26
wi13,131,WARREN,HIST,History,0,0,0,0,0,0,0,2,2,6,1,7,11,5,16,0,0,0,17,8,25
wi13,131,WARREN,INTD,Wa Ind St,0,0,0,0,0,0,0,0,0,0,0,0,0,1,1,0,0,0,0,1,1
wi13,131,WARREN,INTL,IntSt-Econ,0,0,0,0,0,0,0,1,1,0,5,5,4,8,12,0,0,0,4,14,18
wi13,131,WARREN,INTL,IntSt-Hist,0,0,0,0,0,0,0,0,0,0,1,1,1,2,3,0,0,0,1,3,4
wi13,131,WARREN,INTL,IntSt-Ling,0,0,0,0,0,0,0,1,1,0,1,1,1,0,1,0,0,0,1,2,3
wi13,131,WARREN,INTL,IntSt-Lit,0,0,0,0,0,0,0,0,0,0,0,0,0,1,1,0,0,0,0,1,1
wi13,131,WARREN,INTL,IntSt-PolS,0,0,0,1,1,2,2,0,2,1,0,1,2,7,9,0,0,0,6,8,14
wi13,131,WARREN,INTL,IntSt-Soc,0,0,0,0,1,1,0,0,0,0,0,0,0,3,3,0,0,0,0,4,4
wi13,131,WARREN,ITAL,Italian St,0,0,0,0,0,0,0,0,0,0,0,0,1,0,1,0,0,0,1,0,1
wi13,131,WARREN,JAPN,JapaneseSt,0,0,0,0,0,0,0,0,0,0,0,0,2,0,2,0,0,0,2,0,2
wi13,131,WARREN,LING,Lang Stu,0,0,0,0,0,0,0,0,0,1,0,1,0,1,1,0,0,0,1,1,2
wi13,131,WARREN,LING,Ling-CogLn,0,0,0,0,0,0,0,1,1,0,0,0,0,0,0,0,0,0,0,1,1
wi13,131,WARREN,LING,Ling-LSoc,0,0,0,0,0,0,1,0,1,0,0,0,1,0,1,0,0,0,2,0,2
wi13,131,WARREN,LING,Linguistcs,0,0,0,0,0,0,0,0,0,1,0,1,1,2,3,0,0,0,2,2,4
wi13,131,WARREN,LIT,Lit/Engl,0,0,0,0,0,0,0,2,2,0,1,1,0,3,3,0,0,0,0,6,6
wi13,131,WARREN,LIT,Lit/World,0,0,0,0,0,0,0,0,0,0,0,0,0,1,1,0,0,0,0,1,1
wi13,131,WARREN,LIT,Lit/Writng,0,0,0,1,1,2,0,2,2,2,4,6,2,5,7,0,0,0,5,12,17
wi13,131,WARREN,LIT,Pre-Lit/Wr,0,0,0,0,0,0,0,0,0,0,0,0,0,1,1,0,0,0,0,1,1
wi13,131,WARREN,LIT,Spanish Lt,0,0,0,0,0,0,1,1,2,0,0,0,0,0,0,0,0,0,1,1,2
wi13,131,WARREN,MAE,Aerosp Eng,0,0,0,6,4,10,15,9,24,7,2,9,38,6,44,0,0,0,66,21,87
wi13,131,WARREN,MAE,Engin Sci,0,0,0,0,0,0,2,1,3,3,0,3,8,1,9,0,0,0,13,2,15
wi13,131,WARREN,MAE,Envir Eng,0,0,0,8,1,9,5,5,10,6,3,9,17,14,31,0,0,0,36,23,59
wi13,131,WARREN,MAE,Mech Engin,0,0,0,8,0,8,26,6,32,20,9,29,81,7,88,0,0,0,135,22,157
wi13,131,WARREN,MATH,Appld Math,0,0,0,3,2,5,1,1,2,7,3,10,6,2,8,0,0,0,17,8,25
wi13,131,WARREN,MATH,Math/SecEd,0,0,0,0,1,1,0,1,1,0,2,2,1,2,3,0,0,0,1,6,7
wi13,131,WARREN,MATH,Mathematcs,0,0,0,1,1,2,0,1,1,2,3,5,6,3,9,0,0,0,9,8,17
wi13,131,WARREN,MATH,Mth-CompSc,0,0,0,0,0,0,0,0,0,0,2,2,5,1,6,0,0,0,5,3,8
wi13,131,WARREN,MATH,Mth-Mth&Ec,0,0,0,4,3,7,1,4,5,3,5,8,4,3,7,0,0,0,12,15,27
wi13,131,WARREN,MATH,Mth/ApldSc,0,0,0,1,0,1,0,0,0,0,1,1,0,1,1,0,0,0,1,2,3
wi13,131,WARREN,MATH,Prob&Stats,0,0,0,1,0,1,1,1,2,0,0,0,2,3,5,0,0,0,4,4,8
wi13,131,WARREN,MUS,Mu-CompArt,0,0,0,0,0,0,0,0,0,1,1,2,2,1,3,0,0,0,3,2,5
wi13,131,WARREN,MUS,Music,0,0,0,0,0,0,0,0,0,3,0,3,3,1,4,0,0,0,6,1,7
wi13,131,WARREN,MUS,Music Hum,0,0,0,0,0,0,0,1,1,0,0,0,1,0,1,0,0,0,1,1,2
wi13,131,WARREN,NENG,NanoEng,1,0,1,4,1,5,16,0,16,16,5,21,24,5,29,0,0,0,61,11,72
wi13,131,WARREN,PHIL,Philosophy,0,0,0,0,0,0,1,1,2,5,2,7,12,1,13,0,0,0,18,4,22
wi13,131,WARREN,PHYS,Biophysics,0,0,0,0,0,0,2,1,3,0,1,1,1,2,3,0,0,0,3,4,7
wi13,131,WARREN,PHYS,Phys/Astro,0,0,0,2,0,2,0,0,0,2,0,2,2,0,2,0,0,0,6,0,6
wi13,131,WARREN,PHYS,Phys/Comp,0,0,0,0,0,0,0,0,0,1,0,1,1,0,1,0,0,0,2,0,2
wi13,131,WARREN,PHYS,Physics,0,0,0,4,0,4,2,0,2,2,0,2,7,2,9,0,0,0,15,2,17
wi13,131,WARREN,POLI,Polit Sci,0,0,0,4,5,9,6,3,9,17,18,35,24,18,42,0,0,0,51,44,95
wi13,131,WARREN,POLI,PolSc-Amer,0,0,0,0,0,0,1,0,1,1,4,5,4,5,9,0,0,0,6,9,15
wi13,131,WARREN,POLI,PolSc-Comp,0,0,0,0,0,0,0,0,0,0,1,1,0,2,2,0,0,0,0,3,3
wi13,131,WARREN,POLI,PolSc-Intl,0,0,0,1,2,3,4,2,6,4,4,8,12,5,17,0,0,0,21,13,34
wi13,131,WARREN,POLI,PolSc-PLaw,0,0,0,1,4,5,1,0,1,6,6,12,4,10,14,0,0,0,12,20,32
wi13,131,WARREN,POLI,PolSc-PPol,0,0,0,0,0,0,1,0,1,3,1,4,2,3,5,0,0,0,6,4,10
wi13,131,WARREN,POLI,PolSc-Thry,0,0,0,0,0,0,0,0,0,2,1,3,2,0,2,0,0,0,4,1,5
wi13,131,WARREN,PSYC,Psychology,0,0,0,2,12,14,10,24,34,26,31,57,23,83,106,0,0,0,61,150,211
wi13,131,WARREN,RELI,Relig/Stu,0,0,0,0,0,0,0,0,0,1,1,2,1,1,2,0,0,0,2,2,4
wi13,131,WARREN,SE,Engin Sci,0,0,0,2,0,2,2,0,2,0,0,0,1,0,1,0,0,0,5,0,5
wi13,131,WARREN,SE,Struct Eng,0,0,0,19,5,24,21,8,29,40,13,53,64,14,78,0,0,0,144,40,184
wi13,131,WARREN,SIO,Earth Sci,0,0,0,0,0,0,0,0,0,1,4,5,5,3,8,0,0,0,6,7,13
wi13,131,WARREN,SIO,Marine Bio,0,0,0,0,1,1,0,0,0,2,1,3,0,1,1,0,0,0,2,3,5
wi13,131,WARREN,SOC,SocCulCom,0,0,0,0,0,0,0,0,0,0,1,1,2,0,2,0,0,0,2,1,3
wi13,131,WARREN,SOC,SocEconSoc,0,0,0,0,0,0,0,0,0,0,0,0,0,1,1,0,0,0,0,1,1
wi13,131,WARREN,SOC,SocIntlStu,0,0,0,0,0,0,0,0,0,0,0,0,0,1,1,0,0,0,0,1,1
wi13,131,WARREN,SOC,Sociology,0,0,0,0,1,1,0,3,3,5,6,11,3,8,11,0,0,0,8,18,26
wi13,131,WARREN,SOC,SocLawSoc,0,0,0,0,1,1,0,0,0,0,3,3,4,2,6,0,0,0,4,6,10
wi13,131,WARREN,SOC,SocSciMed,0,0,0,0,0,0,0,1,1,0,1,1,0,2,2,0,0,0,0,4,4
wi13,131,WARREN,SOC,SocSolneq,0,0,0,0,0,0,0,0,0,0,2,2,0,2,2,0,0,0,0,4,4
wi13,131,WARREN,THEA,Dance,0,0,0,0,0,0,0,0,0,0,0,0,0,1,1,0,0,0,0,1,1
wi13,131,WARREN,THEA,Theatre,0,0,0,0,0,0,0,1,1,1,2,3,3,3,6,0,0,0,4,6,10
wi13,131,WARREN,UNAF,IntcampVis,0,0,0,0,0,0,1,2,3,0,1,1,0,2,2,0,0,0,1,5,6
wi13,131,WARREN,UNAF,UndecHumAr,0,0,0,0,0,0,1,0,1,0,0,0,0,0,0,0,0,0,1,0,1
wi13,131,WARREN,UNAF,Undeclared,0,1,1,18,14,32,15,13,28,1,0,1,0,0,0,0,0,0,34,28,62
wi13,131,WARREN,UNAF,UndecPhysS,0,0,0,0,2,2,2,2,4,0,0,0,0,0,0,0,0,0,2,4,6
wi13,131,WARREN,UNAF,UndecSocSc,0,0,0,2,0,2,0,0,0,0,0,0,0,0,0,0,0,0,2,0,2
wi13,131,WARREN,USP,Urb Stu&Pl,0,0,0,0,0,0,0,0,0,3,1,4,5,5,10,0,0,0,8,6,14
wi13,131,WARREN,VIS,Media,0,0,0,1,0,1,0,0,0,2,1,3,3,6,9,0,0,0,6,7,13
wi13,131,WARREN,VIS,Studio VA,0,0,0,0,0,0,2,0,2,2,2,4,1,0,1,0,0,0,5,2,7
wi13,131,WARREN,VIS,VA-CompArt,0,0,0,0,0,0,0,1,1,1,0,1,2,0,2,0,0,0,3,1,4
wi11,111,MARSHALL,ANTH,Anth-Arch,0,0,0,0,0,0,0,0,0,0,2,2,0,4,4,0,0,0,0,6,6
wi11,111,MARSHALL,ANTH,Anth-Biol,0,0,0,0,1,1,1,0,1,2,5,7,2,3,5,0,0,0,5,9,14
wi11,111,MARSHALL,ANTH,Anth-Soci,0,0,0,0,1,1,0,0,0,1,3,4,4,6,10,0,0,0,5,10,15
wi11,111,MARSHALL,ANTH,Anthropol,0,0,0,0,0,0,0,0,0,0,1,1,0,0,0,0,0,0,0,1,1
wi11,111,MARSHALL,BENG,Bioen:Binf,0,0,0,0,0,0,0,0,0,2,2,4,1,1,2,0,0,0,3,3,6
wi11,111,MARSHALL,BENG,Bioeng:PM,0,0,0,0,0,0,0,0,0,3,2,5,9,3,12,0,0,0,12,5,17
wi11,111,MARSHALL,BENG,BioengBiot,0,0,0,0,2,2,5,3,8,12,1,13,8,6,14,0,0,0,25,12,37
wi11,111,MARSHALL,BENG,Bioengin,0,0,0,1,1,2,1,1,2,3,2,5,2,4,6,0,0,0,7,8,15
wi11,111,MARSHALL,BENG,Pr-BioenPM,0,0,0,0,0,0,1,4,5,2,0,2,0,1,1,0,0,0,3,5,8
wi11,111,MARSHALL,BIOL,Bioc/CellB,0,0,0,3,3,6,3,10,13,19,28,47,43,45,88,0,0,0,68,86,154
wi11,111,MARSHALL,BIOL,BiolBioinf,0,0,0,0,0,0,1,1,2,0,0,0,0,0,0,0,0,0,1,1,2
wi11,111,MARSHALL,BIOL,Ec/Beh/Evo,0,0,0,1,1,2,0,1,1,3,2,5,7,8,15,0,0,0,11,12,23
wi11,111,MARSHALL,BIOL,Genl Biol,0,0,0,1,4,5,3,19,22,21,43,64,32,67,99,0,0,0,57,133,190
wi11,111,MARSHALL,BIOL,Human Bio,0,0,0,5,16,21,13,19,32,43,61,104,44,95,139,0,0,0,105,191,296
wi11,111,MARSHALL,BIOL,Microbiol,0,0,0,0,0,0,2,1,3,3,4,7,3,11,14,0,0,0,8,16,24
wi11,111,MARSHALL,BIOL,Molec Biol,0,0,0,0,0,0,2,1,3,3,2,5,2,7,9,0,0,0,7,10,17
wi11,111,MARSHALL,BIOL,PhyslNeuro,0,0,0,1,0,1,7,5,12,6,21,27,14,31,45,0,0,0,28,57,85
wi11,111,MARSHALL,CENG,Chem Engin,0,0,0,2,1,3,4,3,7,7,5,12,12,8,20,0,0,0,25,17,42
wi11,111,MARSHALL,CGS,CritGendSt,0,0,0,0,0,0,0,0,0,0,0,0,1,3,4,0,0,0,1,3,4
wi11,111,MARSHALL,CHEM,Bioch/Chem,0,0,0,6,7,13,9,13,22,18,18,36,12,18,30,0,0,0,45,56,101
wi11,111,MARSHALL,CHEM,Bioinform,0,0,0,0,1,1,0,1,1,0,0,0,0,0,0,0,0,0,0,2,2
wi11,111,MARSHALL,CHEM,Chemistry,0,0,0,1,2,3,4,4,8,8,9,17,6,6,12,0,0,0,19,21,40
wi11,111,MARSHALL,CHEM,Envir Chem,0,0,0,0,0,0,0,0,0,1,0,1,1,1,2,0,0,0,2,1,3
wi11,111,MARSHALL,CHEM,Pharm Chem,0,0,0,4,2,6,3,14,17,12,9,21,10,12,22,0,0,0,29,37,66
wi11,111,MARSHALL,CHIN,Chinese St,0,0,0,1,0,1,0,0,0,1,0,1,0,1,1,0,0,0,2,1,3
wi11,111,MARSHALL,CLAS,Classic St,0,0,0,0,0,0,0,1,1,0,0,0,0,1,1,0,0,0,0,2,2
wi11,111,MARSHALL,COGS,Cog Sci,0,0,0,1,1,2,3,6,9,5,5,10,3,4,7,0,0,0,12,16,28
wi11,111,MARSHALL,COGS,CogSc/ClAs,0,0,0,0,1,1,1,2,3,0,2,2,0,3,3,0,0,0,1,8,9
wi11,111,MARSHALL,COGS,CogSc/Comp,0,0,0,0,0,0,0,0,0,1,0,1,0,1,1,0,0,0,1,1,2
wi11,111,MARSHALL,COGS,CogSc/HCI,0,0,0,0,0,0,1,0,1,2,0,2,6,2,8,0,0,0,9,2,11
wi11,111,MARSHALL,COGS,CogSc/HCog,0,0,0,0,0,0,1,1,2,0,0,0,1,0,1,0,0,0,2,1,3
wi11,111,MARSHALL,COGS,CogSc/Neur,0,0,0,3,4,7,4,1,5,1,6,7,3,9,12,0,0,0,11,20,31
wi11,111,MARSHALL,COMM,Communic,0,0,0,1,8,9,2,15,17,19,77,96,28,48,76,0,0,0,50,148,198
wi11,111,MARSHALL,CSE,Comp Sci,0,0,0,6,0,6,2,4,6,16,8,24,50,8,58,0,0,0,74,20,94
wi11,111,MARSHALL,CSE,CompEngCSE,0,0,0,2,1,3,4,1,5,6,1,7,7,1,8,0,0,0,19,4,23
wi11,111,MARSHALL,CSE,CompScBinf,0,0,0,0,0,0,0,0,0,0,0,0,2,1,3,0,0,0,2,1,3
wi11,111,MARSHALL,ECE,CompEngECE,0,0,0,1,0,1,0,0,0,1,0,1,2,0,2,0,0,0,4,0,4
wi11,111,MARSHALL,ECE,Electr Eng,1,0,1,4,3,7,7,1,8,13,2,15,31,7,38,0,0,0,56,13,69
wi11,111,MARSHALL,ECE,EleEng&Soc,0,0,0,0,0,0,0,0,0,1,0,1,1,0,1,0,0,0,2,0,2
wi11,111,MARSHALL,ECE,Engin Phys,0,0,0,0,0,0,0,1,1,0,0,0,1,0,1,0,0,0,1,1,2
wi11,111,MARSHALL,ECON,Ec-Mth&Ecn,0,0,0,1,1,2,1,2,3,4,3,7,7,3,10,0,0,0,13,9,22
wi11,111,MARSHALL,ECON,Econ-MgtSc,0,0,0,4,7,11,17,11,28,35,32,67,52,48,100,0,0,0,108,98,206
wi11,111,MARSHALL,ECON,Economics,0,0,0,9,3,12,11,11,22,79,54,133,98,55,153,0,0,0,197,123,320
wi11,111,MARSHALL,ESYS,EnvSys(EB),0,0,0,0,4,4,3,6,9,2,5,7,3,2,5,0,0,0,8,17,25
wi11,111,MARSHALL,ESYS,EnvSys(EC),0,0,0,0,0,0,0,1,1,1,0,1,1,0,1,0,0,0,2,1,3
wi11,111,MARSHALL,ESYS,EnvSys(EP),0,0,0,0,0,0,1,2,3,1,2,3,0,3,3,0,0,0,2,7,9
wi11,111,MARSHALL,ESYS,EnvSys(ES),0,0,0,0,1,1,0,1,1,3,0,3,1,0,1,0,0,0,4,2,6
wi11,111,MARSHALL,ETHN,Ethnic St,0,0,0,1,0,1,1,1,2,2,5,7,6,13,19,0,0,0,10,19,29
wi11,111,MARSHALL,GMST,German Stu,0,0,0,0,0,0,0,0,0,0,0,0,2,0,2,0,0,0,2,0,2
wi11,111,MARSHALL,HDP,Human Dev,0,0,0,0,0,0,0,1,1,0,5,5,1,35,36,0,0,0,1,41,42
wi11,111,MARSHALL,HDP,Pr-HumnDev,0,0,0,0,4,4,1,14,15,1,18,19,1,5,6,0,0,0,3,41,44
wi11,111,MARSHALL,HIST,History,0,0,0,0,3,3,1,1,2,12,7,19,18,15,33,0,0,0,31,26,57
wi11,111,MARSHALL,INTD,Mar Ind St,0,0,0,0,0,0,0,0,0,0,0,0,1,0,1,0,0,0,1,0,1
wi11,111,MARSHALL,INTL,IntSt-Anth,0,0,0,0,2,2,0,3,3,0,1,1,0,3,3,0,0,0,0,9,9
wi11,111,MARSHALL,INTL,IntSt-Econ,0,0,0,2,2,4,0,4,4,16,12,28,8,10,18,0,0,0,26,28,54
wi11,111,MARSHALL,INTL,IntSt-Hist,0,0,0,1,0,1,0,0,0,0,1,1,1,1,2,0,0,0,2,2,4
wi11,111,MARSHALL,INTL,IntSt-Ling,0,0,0,0,1,1,0,1,1,0,0,0,0,2,2,0,0,0,0,4,4
wi11,111,MARSHALL,INTL,IntSt-Lit,0,0,0,0,0,0,0,1,1,0,1,1,0,0,0,0,0,0,0,2,2
wi11,111,MARSHALL,INTL,IntSt-PolS,0,0,0,2,1,3,1,8,9,2,11,13,10,13,23,0,0,0,15,33,48
wi11,111,MARSHALL,INTL,IntSt-Soc,0,0,0,0,3,3,1,5,6,0,4,4,3,13,16,0,0,0,4,25,29
wi11,111,MARSHALL,ITAL,Italian St,0,0,0,1,0,1,0,0,0,0,0,0,0,0,0,0,0,0,1,0,1
wi11,111,MARSHALL,LATI,LatinAm St,0,0,0,0,0,0,0,0,0,0,2,2,1,2,3,0,0,0,1,4,5
wi11,111,MARSHALL,LING,Lang Stu,0,0,0,0,1,1,0,0,0,1,3,4,0,3,3,0,0,0,1,7,8
wi11,111,MARSHALL,LING,Ling-CogLn,0,0,0,0,1,1,0,2,2,0,0,0,2,0,2,0,0,0,2,3,5
wi11,111,MARSHALL,LING,Ling-LSoc,0,0,0,0,1,1,0,0,0,0,1,1,0,1,1,0,0,0,0,3,3
wi11,111,MARSHALL,LING,Linguistcs,0,0,0,0,0,0,0,2,2,2,3,5,0,3,3,0,0,0,2,8,10
wi11,111,MARSHALL,LIT,Lit/CultSt,0,0,0,0,0,0,0,0,0,0,0,0,0,2,2,0,0,0,0,2,2
wi11,111,MARSHALL,LIT,Lit/Engl,0,0,0,0,1,1,2,1,3,2,4,6,1,7,8,0,0,0,5,13,18
wi11,111,MARSHALL,LIT,Lit/World,0,0,0,0,0,0,0,0,0,0,2,2,0,3,3,0,0,0,0,5,5
wi11,111,MARSHALL,LIT,Lit/Writng,0,0,0,0,2,2,0,1,1,2,5,7,8,7,15,0,0,0,10,15,25
wi11,111,MARSHALL,LIT,Pre-Lit/Wr,0,0,0,0,0,0,0,1,1,2,2,4,2,2,4,0,0,0,4,5,9
wi11,111,MARSHALL,LIT,Spanish Lt,0,0,0,0,0,0,0,0,0,0,1,1,0,0,0,0,0,0,0,1,1
wi11,111,MARSHALL,MAE,Aerosp Eng,0,0,0,4,1,5,6,2,8,5,1,6,19,8,27,0,0,0,34,12,46
wi11,111,MARSHALL,MAE,Engin Sci,0,0,0,0,1,1,1,0,1,2,0,2,0,0,0,0,0,0,3,1,4
wi11,111,MARSHALL,MAE,Envir Eng,0,0,0,1,3,4,4,3,7,2,1,3,2,2,4,0,0,0,9,9,18
wi11,111,MARSHALL,MAE,Mech Engin,0,0,0,2,0,2,7,3,10,24,5,29,60,5,65,0,0,0,93,13,106
wi11,111,MARSHALL,MATH,Appld Math,0,0,0,1,2,3,1,2,3,1,2,3,1,0,1,0,0,0,4,6,10
wi11,111,MARSHALL,MATH,Math/SecEd,0,0,0,0,0,0,4,2,6,0,2,2,2,2,4,0,0,0,6,6,12
wi11,111,MARSHALL,MATH,Mathematcs,0,0,0,2,2,4,0,1,1,2,2,4,10,6,16,0,0,0,14,11,25
wi11,111,MARSHALL,MATH,Mth-CompSc,0,0,0,0,0,0,0,0,0,0,0,0,1,4,5,0,0,0,1,4,5
wi11,111,MARSHALL,MATH,Mth-Mth&Ec,0,0,0,1,0,1,1,1,2,3,2,5,11,3,14,0,0,0,16,6,22
wi11,111,MARSHALL,MATH,Mth-SciCom,0,0,0,0,0,0,0,0,0,1,0,1,0,0,0,0,0,0,1,0,1
wi11,111,MARSHALL,MATH,Mth/ApldSc,0,0,0,1,1,2,0,0,0,0,0,0,0,0,0,0,0,0,1,1,2
wi11,111,MARSHALL,MATH,Pr-Math CS,0,0,0,0,1,1,0,0,0,1,0,1,0,0,0,0,0,0,1,1,2
wi11,111,MARSHALL,MATH,Prob&Stats,0,0,0,0,0,0,1,2,3,0,2,2,2,0,2,0,0,0,3,4,7
wi11,111,MARSHALL,MUS,Mu-CompArt,0,0,0,0,0,0,1,0,1,0,1,1,5,1,6,0,0,0,6,2,8
wi11,111,MARSHALL,MUS,Music,0,0,0,1,0,1,1,0,1,2,2,4,2,4,6,0,0,0,6,6,12
wi11,111,MARSHALL,NENG,NanoEng,0,0,0,1,0,1,0,2,2,2,1,3,0,0,0,0,0,0,3,3,6
wi11,111,MARSHALL,PHIL,Philosophy,0,0,0,0,0,0,1,2,3,2,3,5,11,3,14,0,0,0,14,8,22
wi11,111,MARSHALL,PHYS,Biophysics,0,0,0,1,0,1,0,0,0,3,0,3,0,1,1,0,0,0,4,1,5
wi11,111,MARSHALL,PHYS,Phy/ErthSc,0,0,0,0,0,0,0,0,0,0,0,0,1,0,1,0,0,0,1,0,1
wi11,111,MARSHALL,PHYS,Phys/Astro,0,0,0,1,1,2,1,1,2,0,1,1,1,0,1,0,0,0,3,3,6
wi11,111,MARSHALL,PHYS,Phys/Comp,0,0,0,1,0,1,0,0,0,0,0,0,0,1,1,0,0,0,1,1,2
wi11,111,MARSHALL,PHYS,Physics,0,0,0,1,0,1,1,1,2,3,1,4,2,2,4,0,0,0,7,4,11
wi11,111,MARSHALL,POLI,Polit Sci,0,0,0,7,4,11,4,3,7,22,23,45,29,26,55,0,0,0,62,56,118
wi11,111,MARSHALL,POLI,PolSc-Amer,0,0,0,0,1,1,0,2,2,3,1,4,5,4,9,0,0,0,8,8,16
wi11,111,MARSHALL,POLI,PolSc-Comp,0,0,0,0,0,0,0,0,0,0,2,2,1,2,3,0,0,0,1,4,5
wi11,111,MARSHALL,POLI,PolSc-Intl,0,0,0,1,0,1,4,5,9,11,10,21,21,19,40,0,0,0,37,34,71
wi11,111,MARSHALL,POLI,PolSc-PLaw,0,0,0,2,2,4,6,6,12,10,3,13,6,5,11,0,0,0,24,16,40
wi11,111,MARSHALL,POLI,PolSc-PPol,0,0,0,0,0,0,0,0,0,3,0,3,1,3,4,0,0,0,4,3,7
wi11,111,MARSHALL,POLI,PolSc-Thry,0,0,0,1,0,1,1,0,1,1,1,2,0,2,2,0,0,0,3,3,6
wi11,111,MARSHALL,PSYC,Psychology,0,0,0,6,17,23,7,29,36,37,65,102,25,87,112,0,0,0,75,198,273
wi11,111,MARSHALL,RELI,Relig/Stu,0,0,0,0,0,0,0,0,0,0,0,0,0,3,3,0,0,0,0,3,3
wi11,111,MARSHALL,SE,Struct Eng,0,0,0,6,3,9,9,3,12,19,7,26,18,16,34,0,0,0,52,29,81
wi11,111,MARSHALL,SIO,Earth Sci,0,0,0,1,0,1,0,0,0,2,0,2,0,1,1,0,0,0,3,1,4
wi11,111,MARSHALL,SIO,ErSc-Geol,0,0,0,0,0,0,0,0,0,0,0,0,0,1,1,0,0,0,0,1,1
wi11,111,MARSHALL,SOC,SocCulCom,0,0,0,0,0,0,0,0,0,0,3,3,0,2,2,0,0,0,0,5,5
wi11,111,MARSHALL,SOC,SocEconSoc,0,0,0,0,0,0,1,0,1,0,1,1,0,2,2,0,0,0,1,3,4
wi11,111,MARSHALL,SOC,SocIntlStu,0,0,0,0,0,0,0,2,2,0,1,1,0,0,0,0,0,0,0,3,3
wi11,111,MARSHALL,SOC,Sociology,0,0,0,1,0,1,1,7,8,11,23,34,9,17,26,0,0,0,22,47,69
wi11,111,MARSHALL,SOC,SocLawSoc,0,0,0,0,0,0,1,0,1,3,2,5,3,6,9,0,0,0,7,8,15
wi11,111,MARSHALL,SOC,SocSciMed,0,0,0,0,0,0,1,2,3,1,1,2,0,2,2,0,0,0,2,5,7
wi11,111,MARSHALL,SOC,SocSolneq,0,0,0,0,0,0,0,2,2,0,0,0,0,6,6,0,0,0,0,8,8
wi11,111,MARSHALL,THEA,Dance,0,0,0,0,0,0,0,0,0,0,1,1,0,2,2,0,0,0,0,3,3
wi11,111,MARSHALL,THEA,Theatre,0,0,0,1,1,2,0,0,0,2,1,3,1,4,5,0,0,0,4,6,10
wi11,111,MARSHALL,TWS,ThirdWldSt,0,0,0,0,0,0,0,1,1,0,0,0,0,0,0,0,0,0,0,1,1
wi11,111,MARSHALL,UNAF,UndecHumAr,0,0,0,1,3,4,0,0,0,0,0,0,0,0,0,0,0,0,1,3,4
wi11,111,MARSHALL,UNAF,Undeclared,0,0,0,14,29,43,15,17,32,1,1,2,0,0,0,0,0,0,30,47,77
wi11,111,MARSHALL,UNAF,UndecPhysS,0,0,0,3,5,8,1,2,3,0,0,0,0,0,0,0,0,0,4,7,11
wi11,111,MARSHALL,UNAF,UndecSocSc,0,0,0,1,4,5,0,2,2,0,0,0,0,0,0,0,0,0,1,6,7
wi11,111,MARSHALL,USP,Urb Stu&Pl,0,0,0,0,0,0,0,3,3,3,7,10,8,14,22,0,0,0,11,24,35
wi11,111,MARSHALL,VIS,Art Hst/Cr,0,0,0,0,0,0,0,0,0,0,3,3,0,8,8,0,0,0,0,11,11
wi11,111,MARSHALL,VIS,Media,0,0,0,3,3,6,0,2,2,6,5,11,13,10,23,0,0,0,22,20,42
wi11,111,MARSHALL,VIS,Studio VA,0,0,0,0,0,0,0,0,0,0,4,4,4,5,9,0,0,0,4,9,13
wi11,111,MARSHALL,VIS,VA-CompArt,0,0,0,0,0,0,0,1,1,0,0,0,2,2,4,0,0,0,2,3,5
wi11,111,MUIR,ANTH,Anth-Arch,0,0,0,1,0,1,0,2,2,1,3,4,4,2,6,0,0,0,6,7,13
wi11,111,MUIR,ANTH,Anth-Biol,0,0,0,0,0,0,1,0,1,1,1,2,5,10,15,0,0,0,7,11,18
wi11,111,MUIR,ANTH,Anth-Soci,0,0,0,0,2,2,0,1,1,4,9,13,2,7,9,0,0,0,6,19,25
wi11,111,MUIR,BENG,Bioen:Binf,0,0,0,2,0,2,1,0,1,1,1,2,0,0,0,0,0,0,4,1,5
wi11,111,MUIR,BENG,Bioeng:PM,0,0,0,0,0,0,0,0,0,0,1,1,8,2,10,0,0,0,8,3,11
wi11,111,MUIR,BENG,BioengBiot,0,0,0,1,0,1,5,1,6,8,6,14,8,7,15,0,0,0,22,14,36
wi11,111,MUIR,BENG,Bioengin,0,0,0,1,1,2,4,2,6,0,2,2,25,5,30,0,0,0,30,10,40
wi11,111,MUIR,BENG,Pr-BioenPM,0,0,0,0,0,0,2,2,4,3,1,4,0,0,0,0,0,0,5,3,8
wi11,111,MUIR,BIOL,Bioc/CellB,0,0,0,1,5,6,9,9,18,16,18,34,63,58,121,0,0,0,89,90,179
wi11,111,MUIR,BIOL,BiolBioinf,0,0,0,0,0,0,0,0,0,0,1,1,0,0,0,0,0,0,0,1,1
wi11,111,MUIR,BIOL,Ec/Beh/Evo,0,0,0,0,3,3,1,1,2,1,6,7,6,20,26,0,0,0,8,30,38
wi11,111,MUIR,BIOL,Genl Biol,0,0,0,7,15,22,5,21,26,21,48,69,37,77,114,0,0,0,70,161,231
wi11,111,MUIR,BIOL,Human Bio,0,0,0,12,21,33,20,28,48,31,50,81,68,81,149,0,0,0,131,180,311
wi11,111,MUIR,BIOL,Microbiol,0,0,0,1,1,2,2,1,3,4,4,8,6,4,10,0,0,0,13,10,23
wi11,111,MUIR,BIOL,Molec Biol,0,0,0,0,2,2,3,4,7,6,1,7,7,12,19,0,0,0,16,19,35
wi11,111,MUIR,BIOL,PhyslNeuro,0,0,0,5,3,8,9,12,21,17,20,37,25,32,57,0,0,0,56,67,123
wi11,111,MUIR,CENG,Chem Engin,0,0,0,2,1,3,2,1,3,7,3,10,12,10,22,0,0,0,23,15,38
wi11,111,MUIR,CGS,CritGendSt,0,0,0,1,0,1,0,1,1,0,0,0,0,3,3,0,0,0,1,4,5
wi11,111,MUIR,CHEM,Bioch/Chem,0,0,0,9,11,20,14,11,25,16,16,32,15,20,35,0,0,0,54,58,112
wi11,111,MUIR,CHEM,Chem Educ,0,0,0,0,0,0,0,0,0,0,2,2,0,0,0,0,0,0,0,2,2
wi11,111,MUIR,CHEM,Chem Phys,0,0,0,0,0,0,0,0,0,1,0,1,0,0,0,0,0,0,1,0,1
wi11,111,MUIR,CHEM,Chemistry,0,0,0,3,2,5,4,4,8,2,4,6,12,7,19,0,0,0,21,17,38
wi11,111,MUIR,CHEM,Envir Chem,0,0,0,0,0,0,0,0,0,2,0,2,1,1,2,0,0,0,3,1,4
wi11,111,MUIR,CHEM,MolecSynth,0,0,0,0,0,0,0,0,0,0,0,0,0,1,1,0,0,0,0,1,1
wi11,111,MUIR,CHEM,Pharm Chem,0,0,0,4,6,10,12,7,19,7,9,16,16,14,30,0,0,0,39,36,75
wi11,111,MUIR,CHIN,Chinese St,0,0,0,0,1,1,1,1,2,0,0,0,4,1,5,0,0,0,5,3,8
wi11,111,MUIR,CLAS,Classic St,0,0,0,0,0,0,0,0,0,0,1,1,0,1,1,0,0,0,0,2,2
wi11,111,MUIR,COGS,Cog Sci,0,0,0,4,3,7,6,6,12,3,3,6,12,7,19,0,0,0,25,19,44
wi11,111,MUIR,COGS,CogSc/ClAs,0,0,0,0,0,0,0,3,3,0,1,1,0,3,3,0,0,0,0,7,7
wi11,111,MUIR,COGS,CogSc/Comp,0,0,0,0,0,0,0,0,0,3,0,3,1,0,1,0,0,0,4,0,4
wi11,111,MUIR,COGS,CogSc/HCI,0,0,0,1,0,1,0,2,2,0,2,2,5,4,9,0,0,0,6,8,14
wi11,111,MUIR,COGS,CogSc/HCog,0,0,0,0,1,1,1,1,2,0,1,1,1,4,5,0,0,0,2,7,9
wi11,111,MUIR,COGS,CogSc/Neur,0,0,0,0,0,0,3,10,13,7,9,16,11,13,24,0,0,0,21,32,53
wi11,111,MUIR,COMM,Communic,0,0,0,0,9,9,1,9,10,18,50,68,12,54,66,0,0,0,31,122,153
wi11,111,MUIR,CSE,Comp Sci,0,0,0,6,4,10,13,4,17,23,2,25,36,12,48,0,0,0,78,22,100
wi11,111,MUIR,CSE,CompEngCSE,0,0,0,5,0,5,7,0,7,5,2,7,6,0,6,0,0,0,23,2,25
wi11,111,MUIR,CSE,CompScBinf,0,0,0,0,0,0,2,0,2,0,0,0,2,1,3,0,0,0,4,1,5
wi11,111,MUIR,ECE,CompEngECE,0,0,0,0,1,1,1,1,2,1,0,1,1,0,1,0,0,0,3,2,5
wi11,111,MUIR,ECE,Electr Eng,0,0,0,4,0,4,7,3,10,10,1,11,15,2,17,0,0,0,36,6,42
wi11,111,MUIR,ECE,Engin Phys,0,0,0,0,1,1,0,0,0,1,0,1,0,0,0,0,0,0,1,1,2
wi11,111,MUIR,ECON,Ec-Mth&Ecn,0,0,0,2,0,2,0,2,2,2,2,4,5,3,8,0,0,0,9,7,16
wi11,111,MUIR,ECON,Econ-MgtSc,0,0,0,6,4,10,15,11,26,34,21,55,44,21,65,0,0,0,99,57,156
wi11,111,MUIR,ECON,Economics,0,0,0,17,9,26,15,8,23,65,35,100,71,41,112,0,0,0,168,93,261
wi11,111,MUIR,ESYS,EnvSys(EB),0,0,0,2,8,10,4,5,9,3,13,16,8,10,18,0,0,0,17,36,53
wi11,111,MUIR,ESYS,EnvSys(EC),0,0,0,0,0,0,0,1,1,0,0,0,0,1,1,0,0,0,0,2,2
wi11,111,MUIR,ESYS,EnvSys(EP),0,0,0,0,1,1,0,2,2,0,1,1,2,3,5,0,0,0,2,7,9
wi11,111,MUIR,ESYS,EnvSys(ES),0,0,0,1,1,2,0,0,0,2,0,2,0,2,2,0,0,0,3,3,6
wi11,111,MUIR,ETHN,Ethnic St,0,0,0,0,0,0,2,0,2,0,5,5,4,7,11,0,0,0,6,12,18
wi11,111,MUIR,GMST,German Stu,0,0,0,0,0,0,0,0,0,0,0,0,0,1,1,0,0,0,0,1,1
wi11,111,MUIR,HDP,Human Dev,0,0,0,0,0,0,1,0,1,1,8,9,2,10,12,0,0,0,4,18,22
wi11,111,MUIR,HDP,Pr-HumnDev,0,0,0,1,4,5,2,12,14,2,12,14,0,2,2,0,0,0,5,30,35
wi11,111,MUIR,HIST,History,0,0,0,0,3,3,4,2,6,11,16,27,18,12,30,0,0,0,33,33,66
wi11,111,MUIR,INTD,Muir Sp Pr,0,0,0,0,0,0,0,0,0,0,0,0,0,2,2,0,0,0,0,2,2
wi11,111,MUIR,INTL,IntSt-Anth,0,0,0,0,0,0,0,0,0,0,0,0,1,1,2,0,0,0,1,1,2
wi11,111,MUIR,INTL,IntSt-Econ,0,0,0,2,5,7,1,5,6,8,11,19,7,13,20,0,0,0,18,34,52
wi11,111,MUIR,INTL,IntSt-Hist,0,0,0,0,0,0,0,0,0,0,2,2,1,3,4,0,0,0,1,5,6
wi11,111,MUIR,INTL,IntSt-Ling,0,0,0,0,0,0,0,0,0,0,0,0,0,1,1,0,0,0,0,1,1
wi11,111,MUIR,INTL,IntSt-Lit,0,0,0,0,1,1,0,0,0,0,1,1,1,1,2,0,0,0,1,3,4
wi11,111,MUIR,INTL,IntSt-PolS,0,0,0,1,1,2,0,2,2,2,9,11,2,16,18,0,0,0,5,28,33
wi11,111,MUIR,INTL,IntSt-Soc,0,0,0,1,3,4,0,4,4,0,9,9,6,4,10,0,0,0,7,20,27
wi11,111,MUIR,JAPN,JapaneseSt,0,0,0,0,1,1,1,0,1,1,0,1,2,5,7,0,0,0,4,6,10
wi11,111,MUIR,LATI,LatinAm St,0,0,0,0,0,0,1,0,1,0,2,2,0,0,0,0,0,0,1,2,3
wi11,111,MUIR,LING,Lang Stu,0,0,0,0,1,1,0,1,1,0,2,2,2,3,5,0,0,0,2,7,9
wi11,111,MUIR,LING,Ling-CogLn,0,0,0,0,0,0,1,0,1,1,1,2,1,2,3,0,0,0,3,3,6
wi11,111,MUIR,LING,Ling-LSoc,0,0,0,0,0,0,0,1,1,0,0,0,0,0,0,0,0,0,0,1,1
wi11,111,MUIR,LING,Linguistcs,0,0,0,1,0,1,0,0,0,2,2,4,3,9,12,0,0,0,6,11,17
wi11,111,MUIR,LIT,French Lit,0,0,0,0,0,0,0,0,0,0,0,0,0,1,1,0,0,0,0,1,1
wi11,111,MUIR,LIT,Lit/CultSt,0,0,0,0,1,1,0,0,0,0,0,0,0,3,3,0,0,0,0,4,4
wi11,111,MUIR,LIT,Lit/Engl,0,0,0,0,3,3,2,5,7,1,5,6,5,11,16,0,0,0,8,24,32
wi11,111,MUIR,LIT,Lit/World,0,0,0,0,0,0,0,0,0,0,1,1,0,4,4,0,0,0,0,5,5
wi11,111,MUIR,LIT,Lit/Writng,0,0,0,0,4,4,2,4,6,2,4,6,6,11,17,0,0,0,10,23,33
wi11,111,MUIR,LIT,Pre-Lit/Wr,0,0,0,0,0,0,0,1,1,2,4,6,1,2,3,0,0,0,3,7,10
wi11,111,MUIR,LIT,Spanish Lt,0,0,0,0,1,1,1,0,1,0,2,2,2,6,8,0,0,0,3,9,12
wi11,111,MUIR,MAE,Aerosp Eng,0,0,0,2,3,5,9,3,12,14,3,17,14,2,16,0,0,0,39,11,50
wi11,111,MUIR,MAE,Engin Sci,0,0,0,2,0,2,1,0,1,2,0,2,1,0,1,0,0,0,6,0,6
wi11,111,MUIR,MAE,Envir Eng,0,0,0,2,6,8,3,5,8,6,2,8,6,6,12,0,0,0,17,19,36
wi11,111,MUIR,MAE,Mech Engin,0,0,0,4,0,4,6,1,7,11,2,13,53,5,58,0,0,0,74,8,82
wi11,111,MUIR,MATH,Appld Math,0,0,0,1,0,1,1,1,2,1,1,2,3,2,5,0,0,0,6,4,10
wi11,111,MUIR,MATH,Math/SecEd,0,0,0,0,5,5,0,0,0,1,1,2,3,1,4,0,0,0,4,7,11
wi11,111,MUIR,MATH,Mathematcs,0,0,0,1,2,3,3,0,3,8,6,14,8,3,11,0,0,0,20,11,31
wi11,111,MUIR,MATH,Mth-CompSc,0,0,0,0,0,0,0,0,0,0,1,1,0,0,0,0,0,0,0,1,1
wi11,111,MUIR,MATH,Mth-Mth&Ec,0,0,0,0,0,0,3,1,4,2,0,2,6,1,7,0,0,0,11,2,13
wi11,111,MUIR,MATH,Mth-SciCom,0,0,0,0,0,0,0,0,0,0,0,0,1,0,1,0,0,0,1,0,1
wi11,111,MUIR,MATH,Mth/ApldSc,0,0,0,2,0,2,1,1,2,0,0,0,1,2,3,0,0,0,4,3,7
wi11,111,MUIR,MATH,Pr-Math CS,0,0,0,0,0,0,1,0,1,1,0,1,0,0,0,0,0,0,2,0,2
wi11,111,MUIR,MATH,Prob&Stats,0,0,0,0,0,0,0,0,0,3,0,3,3,0,3,0,0,0,6,0,6
wi11,111,MUIR,MUS,Mu-CompArt,0,0,0,0,0,0,1,0,1,3,0,3,8,1,9,0,0,0,12,1,13
wi11,111,MUIR,MUS,Music,0,0,0,1,0,1,1,1,2,0,0,0,6,6,12,0,0,0,8,7,15
wi11,111,MUIR,MUS,Music Hum,0,0,0,0,0,0,0,0,0,0,0,0,0,2,2,0,0,0,0,2,2
wi11,111,MUIR,NENG,NanoEng,0,0,0,1,1,2,4,0,4,2,1,3,0,0,0,0,0,0,7,2,9
wi11,111,MUIR,PHIL,Philosophy,0,0,0,2,0,2,1,1,2,3,3,6,7,3,10,0,0,0,13,7,20
wi11,111,MUIR,PHYS,Biophysics,0,0,0,1,0,1,4,0,4,3,0,3,2,1,3,0,0,0,10,1,11
wi11,111,MUIR,PHYS,Phy/ErthSc,0,0,0,0,0,0,0,0,0,0,0,0,0,1,1,0,0,0,0,1,1
wi11,111,MUIR,PHYS,Phys/Astro,0,0,0,1,0,1,2,0,2,2,1,3,3,1,4,0,0,0,8,2,10
wi11,111,MUIR,PHYS,Phys/Comp,0,0,0,0,0,0,0,0,0,0,0,0,1,0,1,0,0,0,1,0,1
wi11,111,MUIR,PHYS,Physics,0,0,0,1,0,1,0,1,1,4,0,4,2,2,4,0,0,0,7,3,10
wi11,111,MUIR,POLI,Polit Sci,0,0,0,3,4,7,9,2,11,15,16,31,23,27,50,0,0,0,50,49,99
wi11,111,MUIR,POLI,PolSc-Amer,0,0,0,1,1,2,2,1,3,1,1,2,3,5,8,0,0,0,7,8,15
wi11,111,MUIR,POLI,PolSc-Comp,0,0,0,0,0,0,1,0,1,0,0,0,1,1,2,0,0,0,2,1,3
wi11,111,MUIR,POLI,PolSc-Intl,0,0,0,1,4,5,4,4,8,13,9,22,18,8,26,0,0,0,36,25,61
wi11,111,MUIR,POLI,PolSc-PLaw,0,0,0,4,1,5,4,4,8,3,3,6,8,5,13,0,0,0,19,13,32
wi11,111,MUIR,POLI,PolSc-PPol,0,0,0,0,0,0,0,1,1,2,0,2,1,1,2,0,0,0,3,2,5
wi11,111,MUIR,POLI,PolSc-Thry,0,0,0,0,0,0,0,0,0,0,0,0,2,0,2,0,0,0,2,0,2
wi11,111,MUIR,PSYC,Psychology,0,0,0,10,20,30,12,42,54,31,66,97,31,81,112,0,0,0,84,209,293
wi11,111,MUIR,RELI,Relig/Stu,0,0,0,0,0,0,0,0,0,0,0,0,2,1,3,0,0,0,2,1,3
wi11,111,MUIR,RUSS,Russ&SovSt,0,0,0,0,0,0,0,1,1,1,0,1,0,0,0,0,0,0,1,1,2
wi11,111,MUIR,SE,Engin Sci,0,0,0,0,0,0,1,0,1,0,0,0,0,0,0,0,0,0,1,0,1
wi11,111,MUIR,SE,Struct Eng,0,0,0,5,2,7,11,3,14,18,3,21,24,9,33,0,0,0,58,17,75
wi11,111,MUIR,SIO,Earth Sci,0,0,0,0,1,1,0,1,1,3,1,4,0,0,0,0,0,0,3,3,6
wi11,111,MUIR,SIO,ErSc-Geol,0,0,0,0,0,0,0,0,0,1,0,1,2,0,2,0,0,0,3,0,3
wi11,111,MUIR,SOC,SocAmSt,0,0,0,0,0,0,0,0,0,0,0,0,0,1,1,0,0,0,0,1,1
wi11,111,MUIR,SOC,SocCulCom,0,0,0,0,0,0,0,1,1,0,0,0,1,0,1,0,0,0,1,1,2
wi11,111,MUIR,SOC,SocEconSoc,0,0,0,0,0,0,0,0,0,1,0,1,1,0,1,0,0,0,2,0,2
wi11,111,MUIR,SOC,SocIntlStu,0,0,0,0,0,0,0,0,0,0,1,1,0,2,2,0,0,0,0,3,3
wi11,111,MUIR,SOC,Sociology,0,0,0,1,5,6,3,6,9,10,23,33,3,20,23,0,0,0,17,54,71
wi11,111,MUIR,SOC,SocLawSoc,0,0,0,0,2,2,1,1,2,2,1,3,1,3,4,0,0,0,4,7,11
wi11,111,MUIR,SOC,SocSciMed,0,0,0,0,0,0,0,1,1,1,3,4,3,3,6,0,0,0,4,7,11
wi11,111,MUIR,SOC,SocSolneq,0,0,0,0,0,0,1,0,1,0,2,2,0,3,3,0,0,0,1,5,6
wi11,111,MUIR,THEA,Dance,0,0,0,0,1,1,0,0,0,0,1,1,2,2,4,0,0,0,2,4,6
wi11,111,MUIR,THEA,Theatre,0,0,0,1,2,3,1,1,2,2,5,7,2,11,13,0,0,0,6,19,25
wi11,111,MUIR,UNAF,Limited St,0,0,0,0,0,0,0,0,0,0,0,0,0,0,0,1,0,1,1,0,1
wi11,111,MUIR,UNAF,UndecHumAr,0,0,0,0,2,2,2,3,5,0,0,0,0,0,0,0,0,0,2,5,7
wi11,111,MUIR,UNAF,Undeclared,0,0,0,35,51,86,29,33,62,0,1,1,0,0,0,0,0,0,64,85,149
wi11,111,MUIR,UNAF,UndecPhysS,0,0,0,4,4,8,3,3,6,0,0,0,1,0,1,0,0,0,8,7,15
wi11,111,MUIR,UNAF,UndecSocSc,0,0,0,4,4,8,2,4,6,0,0,0,0,0,0,0,0,0,6,8,14
wi11,111,MUIR,USP,Urb Stu&Pl,0,0,0,1,1,2,1,2,3,5,5,10,9,10,19,0,0,0,16,18,34
wi11,111,MUIR,VIS,Art Hst/Cr,0,0,0,0,0,0,0,2,2,0,2,2,1,8,9,0,0,0,1,12,13
wi11,111,MUIR,VIS,Media,0,0,0,3,2,5,2,3,5,3,16,19,16,7,23,0,0,0,24,28,52
wi11,111,MUIR,VIS,Studio VA,0,0,0,0,4,4,0,1,1,3,5,8,0,6,6,0,0,0,3,16,19
wi11,111,MUIR,VIS,VA-CompArt,0,0,0,1,0,1,0,2,2,4,1,5,6,3,9,0,0,0,11,6,17
wi11,111,REVELLE,ANTH,Anth-Arch,0,0,0,1,0,1,0,0,0,1,1,2,0,0,0,0,0,0,2,1,3
wi11,111,REVELLE,ANTH,Anth-Biol,0,0,0,0,0,0,0,2,2,0,4,4,2,4,6,0,0,0,2,10,12
wi11,111,REVELLE,ANTH,Anth-Soci,0,0,0,0,0,0,0,0,0,1,6,7,2,6,8,0,0,0,3,12,15
wi11,111,REVELLE,BENG,Bioen:Binf,0,0,0,2,1,3,1,1,2,0,0,0,2,1,3,0,0,0,5,3,8
wi11,111,REVELLE,BENG,Bioeng:PM,0,0,0,0,0,0,1,0,1,2,0,2,26,9,35,0,0,0,29,9,38
wi11,111,REVELLE,BENG,BioengBiot,0,0,0,3,2,5,10,2,12,14,5,19,13,8,21,0,0,0,40,17,57
wi11,111,REVELLE,BENG,Bioengin,0,0,0,2,2,4,2,5,7,6,1,7,17,15,32,0,0,0,27,23,50
wi11,111,REVELLE,BENG,Pr-BioenPM,0,0,0,0,0,0,2,1,3,5,3,8,0,1,1,0,0,0,7,5,12
wi11,111,REVELLE,BIOL,Anml Physl,0,0,0,0,0,0,0,0,0,0,0,0,1,0,1,0,0,0,1,0,1
wi11,111,REVELLE,BIOL,Bioc/CellB,0,0,0,3,3,6,13,9,22,25,22,47,104,89,193,0,0,0,145,123,268
wi11,111,REVELLE,BIOL,BiolBioinf,0,0,0,0,0,0,0,0,0,3,0,3,1,0,1,0,0,0,4,0,4
wi11,111,REVELLE,BIOL,Ec/Beh/Evo,0,0,0,0,1,1,3,4,7,2,2,4,6,12,18,0,0,0,11,19,30
wi11,111,REVELLE,BIOL,Genl Biol,0,0,0,7,12,19,10,20,30,19,41,60,48,95,143,0,0,0,84,168,252
wi11,111,REVELLE,BIOL,Human Bio,0,0,0,6,19,25,16,41,57,49,72,121,99,129,228,0,0,0,170,261,431
wi11,111,REVELLE,BIOL,Microbiol,0,0,0,1,0,1,3,2,5,1,5,6,11,14,25,0,0,0,16,21,37
wi11,111,REVELLE,BIOL,Molec Biol,0,0,0,0,2,2,1,2,3,8,4,12,21,15,36,0,0,0,30,23,53
wi11,111,REVELLE,BIOL,PhyslNeuro,0,0,0,3,7,10,6,13,19,14,19,33,42,45,87,0,0,0,65,84,149
wi11,111,REVELLE,CENG,Chem Engin,0,0,0,4,2,6,4,1,5,13,7,20,24,8,32,0,0,0,45,18,63
wi11,111,REVELLE,CGS,CritGendSt,0,0,0,0,0,0,0,0,0,0,0,0,1,0,1,0,0,0,1,0,1
wi11,111,REVELLE,CHEM,Bioch/Chem,0,0,0,14,16,30,13,14,27,18,18,36,16,23,39,0,0,0,61,71,132
wi11,111,REVELLE,CHEM,Chem Phys,0,0,0,0,0,0,0,0,0,0,0,0,1,0,1,0,0,0,1,0,1
wi11,111,REVELLE,CHEM,Chemistry,0,0,0,1,3,4,4,4,8,8,7,15,9,10,19,0,0,0,22,24,46
wi11,111,REVELLE,CHEM,Envir Chem,0,0,0,0,0,0,0,1,1,1,0,1,1,0,1,0,0,0,2,1,3
wi11,111,REVELLE,CHEM,MolecSynth,0,0,0,0,1,1,0,0,0,1,0,1,3,0,3,0,0,0,4,1,5
wi11,111,REVELLE,CHEM,Pharm Chem,0,0,0,4,14,18,6,17,23,13,25,38,20,23,43,0,0,0,43,79,122
wi11,111,REVELLE,CHIN,Chinese St,0,0,0,0,0,0,0,1,1,0,0,0,2,0,2,0,0,0,2,1,3
wi11,111,REVELLE,CLAS,Classic St,0,0,0,0,0,0,1,0,1,0,1,1,0,0,0,0,0,0,1,1,2
wi11,111,REVELLE,COGS,Cog Sci,0,0,0,7,4,11,4,5,9,2,1,3,2,3,5,0,0,0,15,13,28
wi11,111,REVELLE,COGS,CogSc/ClAs,0,0,0,0,0,0,0,2,2,1,2,3,0,2,2,0,0,0,1,6,7
wi11,111,REVELLE,COGS,CogSc/Comp,0,0,0,0,0,0,0,0,0,0,0,0,1,0,1,0,0,0,1,0,1
wi11,111,REVELLE,COGS,CogSc/HCI,0,0,0,0,0,0,0,0,0,0,0,0,1,1,2,0,0,0,1,1,2
wi11,111,REVELLE,COGS,CogSc/HCog,0,0,0,0,1,1,0,1,1,0,3,3,1,0,1,0,0,0,1,5,6
wi11,111,REVELLE,COGS,CogSc/Neur,0,0,0,1,3,4,1,12,13,3,10,13,5,6,11,0,0,0,10,31,41
wi11,111,REVELLE,COMM,Communic,0,0,0,1,1,2,1,10,11,10,12,22,11,20,31,0,0,0,23,43,66
wi11,111,REVELLE,CSE,Comp Sci,0,0,0,6,2,8,12,0,12,18,3,21,41,8,49,0,0,0,77,13,90
wi11,111,REVELLE,CSE,CompEngCSE,0,0,0,5,1,6,5,0,5,6,2,8,7,0,7,0,0,0,23,3,26
wi11,111,REVELLE,CSE,CompScBinf,0,0,0,0,0,0,0,0,0,1,1,2,1,0,1,0,0,0,2,1,3
wi11,111,REVELLE,ECE,CompEngECE,0,0,0,4,0,4,1,1,2,3,0,3,2,0,2,0,0,0,10,1,11
wi11,111,REVELLE,ECE,Electr Eng,0,0,0,4,0,4,8,0,8,13,3,16,26,5,31,0,0,0,51,8,59
wi11,111,REVELLE,ECE,Engin Phys,0,0,0,0,0,0,2,0,2,0,0,0,1,0,1,0,0,0,3,0,3
wi11,111,REVELLE,ECON,Ec-Mth&Ecn,0,0,0,1,1,2,1,1,2,8,4,12,4,1,5,0,0,0,14,7,21
wi11,111,REVELLE,ECON,Econ-MgtSc,0,0,0,0,2,2,8,5,13,18,6,24,31,11,42,0,0,0,57,24,81
wi11,111,REVELLE,ECON,Economics,0,0,0,3,3,6,13,2,15,32,19,51,41,25,66,0,0,0,89,49,138
wi11,111,REVELLE,ESYS,EnvSys(EB),0,0,0,0,0,0,1,8,9,1,5,6,4,2,6,0,0,0,6,15,21
wi11,111,REVELLE,ESYS,EnvSys(EC),0,0,0,0,0,0,0,2,2,0,0,0,1,0,1,0,0,0,1,2,3
wi11,111,REVELLE,ESYS,EnvSys(EP),0,0,0,0,0,0,0,2,2,1,2,3,0,1,1,0,0,0,1,5,6
wi11,111,REVELLE,ESYS,EnvSys(ES),0,0,0,0,0,0,0,0,0,2,1,3,1,1,2,0,0,0,3,2,5
wi11,111,REVELLE,ETHN,Ethnic St,0,0,0,0,0,0,0,2,2,1,1,2,6,3,9,0,0,0,7,6,13
wi11,111,REVELLE,HDP,Human Dev,0,0,0,0,0,0,0,0,0,0,4,4,0,18,18,0,0,0,0,22,22
wi11,111,REVELLE,HDP,Pr-HumnDev,0,0,0,0,1,1,0,6,6,1,3,4,0,0,0,0,0,0,1,10,11
wi11,111,REVELLE,HIST,History,0,0,0,1,0,1,2,2,4,8,5,13,5,10,15,0,0,0,16,17,33
wi11,111,REVELLE,INTD,Rev Ind Mj,0,0,0,0,0,0,0,0,0,0,0,0,0,1,1,0,0,0,0,1,1
wi11,111,REVELLE,INTL,IntSt-Anth,0,0,0,0,0,0,1,0,1,1,0,1,0,1,1,0,0,0,2,1,3
wi11,111,REVELLE,INTL,IntSt-Econ,0,0,0,0,1,1,2,4,6,4,4,8,7,2,9,0,0,0,13,11,24
wi11,111,REVELLE,INTL,IntSt-Hist,0,0,0,0,0,0,0,2,2,0,0,0,0,2,2,0,0,0,0,4,4
wi11,111,REVELLE,INTL,IntSt-Ling,0,0,0,0,0,0,0,1,1,2,1,3,0,2,2,0,0,0,2,4,6
wi11,111,REVELLE,INTL,IntSt-Lit,0,0,0,0,0,0,0,1,1,0,0,0,0,1,1,0,0,0,0,2,2
wi11,111,REVELLE,INTL,IntSt-PolS,0,0,0,0,1,1,0,2,2,3,3,6,3,8,11,0,0,0,6,14,20
wi11,111,REVELLE,INTL,IntSt-Soc,0,0,0,0,0,0,0,2,2,0,1,1,2,3,5,0,0,0,2,6,8
wi11,111,REVELLE,JAPN,JapaneseSt,0,0,0,0,0,0,1,0,1,0,1,1,0,0,0,0,0,0,1,1,2
wi11,111,REVELLE,JUDA,Judaic Stu,0,0,0,0,0,0,0,0,0,2,0,2,0,0,0,0,0,0,2,0,2
wi11,111,REVELLE,LING,Lang Stu,0,0,0,0,0,0,0,0,0,0,1,1,0,0,0,0,0,0,0,1,1
wi11,111,REVELLE,LING,Ling-CogLn,0,0,0,0,0,0,0,0,0,2,4,6,0,2,2,0,0,0,2,6,8
wi11,111,REVELLE,LING,Ling-LSoc,0,0,0,0,0,0,0,0,0,0,1,1,0,0,0,0,0,0,0,1,1
wi11,111,REVELLE,LING,Linguistcs,0,0,0,0,2,2,2,2,4,0,2,2,1,4,5,0,0,0,3,10,13
wi11,111,REVELLE,LIT,Ital Lit,0,0,0,0,0,0,0,0,0,0,0,0,0,3,3,0,0,0,0,3,3
wi11,111,REVELLE,LIT,Lit/Compos,0,0,0,0,0,0,0,1,1,1,0,1,0,1,1,0,0,0,1,2,3
wi11,111,REVELLE,LIT,Lit/CultSt,0,0,0,0,0,0,0,0,0,0,0,0,0,1,1,0,0,0,0,1,1
wi11,111,REVELLE,LIT,Lit/Engl,0,0,0,0,0,0,0,2,2,0,1,1,0,3,3,0,0,0,0,6,6
wi11,111,REVELLE,LIT,Lit/World,0,0,0,0,0,0,0,0,0,0,0,0,1,3,4,0,0,0,1,3,4
wi11,111,REVELLE,LIT,Lit/Writng,0,0,0,1,0,1,0,5,5,0,0,0,5,3,8,0,0,0,6,8,14
wi11,111,REVELLE,LIT,Pre-Lit/Wr,0,0,0,0,0,0,0,1,1,0,1,1,4,1,5,0,0,0,4,3,7
wi11,111,REVELLE,LIT,Spanish Lt,0,0,0,0,0,0,0,1,1,1,0,1,0,3,3,0,0,0,1,4,5
wi11,111,REVELLE,MAE,Aerosp Eng,0,0,0,5,0,5,5,2,7,9,3,12,16,4,20,0,0,0,35,9,44
wi11,111,REVELLE,MAE,Engin Sci,0,0,0,5,1,6,1,0,1,1,1,2,2,1,3,0,0,0,9,3,12
wi11,111,REVELLE,MAE,Envir Eng,0,0,0,2,0,2,8,2,10,2,2,4,3,2,5,0,0,0,15,6,21
wi11,111,REVELLE,MAE,Mech Engin,0,0,0,5,2,7,9,3,12,13,0,13,43,11,54,0,0,0,70,16,86
wi11,111,REVELLE,MATH,Appld Math,0,0,0,2,3,5,1,0,1,1,0,1,3,0,3,0,0,0,7,3,10
wi11,111,REVELLE,MATH,Math/SecEd,0,0,0,0,0,0,0,0,0,1,0,1,2,2,4,0,0,0,3,2,5
wi11,111,REVELLE,MATH,Mathematcs,0,0,0,1,1,2,4,3,7,3,3,6,7,9,16,0,0,0,15,16,31
wi11,111,REVELLE,MATH,Mth-CompSc,0,0,0,0,0,0,0,0,0,1,0,1,2,0,2,0,0,0,3,0,3
wi11,111,REVELLE,MATH,Mth-Mth&Ec,0,0,0,0,0,0,2,2,4,2,0,2,7,1,8,0,0,0,11,3,14
wi11,111,REVELLE,MATH,Mth-SciCom,0,0,0,0,1,1,0,0,0,0,1,1,0,1,1,0,0,0,0,3,3
wi11,111,REVELLE,MATH,Mth/ApldSc,0,0,0,2,1,3,0,0,0,0,0,0,0,2,2,0,0,0,2,3,5
wi11,111,REVELLE,MATH,Prob&Stats,0,0,0,0,0,0,0,2,2,0,0,0,4,1,5,0,0,0,4,3,7
wi11,111,REVELLE,MUS,Mu-CompArt,0,0,0,0,0,0,0,0,0,1,0,1,6,1,7,0,0,0,7,1,8
wi11,111,REVELLE,MUS,Music,0,0,0,0,0,0,1,1,2,2,0,2,6,1,7,0,0,0,9,2,11
wi11,111,REVELLE,NENG,NanoEng,0,0,0,0,2,2,13,2,15,2,2,4,2,0,2,0,0,0,17,6,23
wi11,111,REVELLE,PHIL,Philosophy,0,0,0,0,0,0,2,0,2,6,0,6,4,2,6,0,0,0,12,2,14
wi11,111,REVELLE,PHYS,Biophysics,0,0,0,1,0,1,0,1,1,0,1,1,0,0,0,0,0,0,1,2,3
wi11,111,REVELLE,PHYS,GenPys/SEd,0,0,0,0,0,0,1,0,1,0,0,0,0,0,0,0,0,0,1,0,1
wi11,111,REVELLE,PHYS,Phy/ErthSc,0,0,0,0,0,0,0,0,0,0,0,0,1,0,1,0,0,0,1,0,1
wi11,111,REVELLE,PHYS,Phys/Astro,0,0,0,0,0,0,2,0,2,1,0,1,4,2,6,0,0,0,7,2,9
wi11,111,REVELLE,PHYS,Phys/Comp,0,0,0,0,0,0,1,0,1,1,1,2,1,0,1,0,0,0,3,1,4
wi11,111,REVELLE,PHYS,Phys/Mtrls,0,0,0,0,1,1,1,0,1,0,0,0,1,0,1,0,0,0,2,1,3
wi11,111,REVELLE,PHYS,Physics,0,0,0,4,0,4,5,1,6,6,0,6,11,3,14,0,0,0,26,4,30
wi11,111,REVELLE,POLI,Polit Sci,0,0,0,0,1,1,2,4,6,12,5,17,13,5,18,0,0,0,27,15,42
wi11,111,REVELLE,POLI,PolSc-Amer,0,0,0,0,0,0,1,1,2,2,2,4,0,4,4,0,0,0,3,7,10
wi11,111,REVELLE,POLI,PolSc-Comp,0,0,0,0,0,0,0,0,0,0,0,0,0,1,1,0,0,0,0,1,1
wi11,111,REVELLE,POLI,PolSc-Intl,0,0,0,2,1,3,0,0,0,4,8,12,8,4,12,0,0,0,14,13,27
wi11,111,REVELLE,POLI,PolSc-PLaw,0,0,0,1,1,2,1,0,1,3,1,4,4,6,10,0,0,0,9,8,17
wi11,111,REVELLE,POLI,PolSc-PPol,0,0,0,1,0,1,0,0,0,1,0,1,0,4,4,0,0,0,2,4,6
wi11,111,REVELLE,POLI,PolSc-Thry,0,0,0,0,0,0,1,0,1,0,0,0,1,0,1,0,0,0,2,0,2
wi11,111,REVELLE,PSYC,Psychology,0,0,0,5,15,20,8,26,34,18,54,72,34,68,102,0,0,0,65,163,228
wi11,111,REVELLE,RELI,Relig/Stu,0,0,0,0,0,0,0,0,0,1,0,1,1,0,1,0,0,0,2,0,2
wi11,111,REVELLE,SE,Struct Eng,0,0,0,7,1,8,5,3,8,9,3,12,27,13,40,0,0,0,48,20,68
wi11,111,REVELLE,SIO,Earth Sci,0,0,0,0,1,1,0,1,1,2,0,2,3,0,3,0,0,0,5,2,7
wi11,111,REVELLE,SIO,ErSc-Geoch,0,0,0,0,0,0,0,0,0,0,0,0,0,1,1,0,0,0,0,1,1
wi11,111,REVELLE,SIO,ErSc-Geol,0,0,0,0,0,0,0,0,0,0,0,0,2,1,3,0,0,0,2,1,3
wi11,111,REVELLE,SOC,SocCulCom,0,0,0,0,0,0,0,0,0,0,0,0,0,4,4,0,0,0,0,4,4
wi11,111,REVELLE,SOC,SocEconSoc,0,0,0,0,0,0,0,0,0,0,1,1,2,0,2,0,0,0,2,1,3
wi11,111,REVELLE,SOC,Sociology,0,0,0,0,1,1,1,3,4,1,8,9,4,5,9,0,0,0,6,17,23
wi11,111,REVELLE,SOC,SocLawSoc,0,0,0,0,0,0,0,0,0,0,2,2,2,1,3,0,0,0,2,3,5
wi11,111,REVELLE,SOC,SocSciMed,0,0,0,0,1,1,0,0,0,0,2,2,0,1,1,0,0,0,0,4,4
wi11,111,REVELLE,SOC,SocSolneq,0,0,0,0,0,0,0,0,0,0,0,0,1,1,2,0,0,0,1,1,2
wi11,111,REVELLE,THEA,Dance,0,0,0,1,0,1,0,0,0,0,0,0,0,1,1,0,0,0,1,1,2
wi11,111,REVELLE,THEA,Theatre,0,0,0,2,0,2,0,0,0,0,3,3,1,2,3,0,0,0,3,5,8
wi11,111,REVELLE,TWS,ThirdWldSt,0,0,0,0,0,0,0,0,0,0,1,1,0,0,0,0,0,0,0,1,1
wi11,111,REVELLE,UNAF,Limited St,0,0,0,0,0,0,0,0,0,0,0,0,0,0,0,5,6,11,5,6,11
wi11,111,REVELLE,UNAF,Spec-Emply,0,0,0,0,0,0,0,0,0,0,0,0,0,0,0,4,2,6,4,2,6
wi11,111,REVELLE,UNAF,UndecHumAr,0,0,0,0,1,1,0,4,4,0,0,0,0,0,0,0,0,0,0,5,5
wi11,111,REVELLE,UNAF,Undeclared,0,0,0,19,34,53,20,31,51,3,3,6,1,0,1,0,0,0,43,68,111
wi11,111,REVELLE,UNAF,UndecPhysS,0,0,0,2,5,7,2,3,5,2,0,2,0,0,0,0,0,0,6,8,14
wi11,111,REVELLE,UNAF,UndecSocSc,0,0,0,0,0,0,0,3,3,1,0,1,0,0,0,0,0,0,1,3,4
wi11,111,REVELLE,USP,Urb Stu&Pl,0,0,0,0,1,1,1,0,1,2,2,4,0,2,2,0,0,0,3,5,8
wi11,111,REVELLE,VIS,Art Hst/Cr,0,0,0,0,0,0,1,1,2,0,0,0,0,4,4,0,0,0,1,5,6
wi11,111,REVELLE,VIS,Media,0,0,0,0,1,1,1,0,1,0,1,1,4,4,8,0,0,0,5,6,11
wi11,111,REVELLE,VIS,Studio VA,0,0,0,0,0,0,0,0,0,0,0,0,2,2,4,0,0,0,2,2,4
wi11,111,REVELLE,VIS,VA-CompArt,0,0,0,0,0,0,0,1,1,0,0,0,4,2,6,0,0,0,4,3,7
wi11,111,ROOSEVELT,ANTH,Anth-Arch,0,0,0,1,1,2,1,0,1,0,2,2,3,7,10,0,0,0,5,10,15
wi11,111,ROOSEVELT,ANTH,Anth-Biol,0,0,0,0,0,0,0,0,0,0,4,4,2,6,8,0,0,0,2,10,12
wi11,111,ROOSEVELT,ANTH,Anth-Soci,0,0,0,0,1,1,0,1,1,0,7,7,2,4,6,0,0,0,2,13,15
wi11,111,ROOSEVELT,BENG,Bioen:Binf,0,0,0,0,0,0,0,0,0,0,0,0,0,1,1,0,0,0,0,1,1
wi11,111,ROOSEVELT,BENG,Bioeng:PM,0,0,0,0,0,0,1,0,1,4,1,5,7,5,12,0,0,0,12,6,18
wi11,111,ROOSEVELT,BENG,BioengBiot,0,0,0,0,1,1,3,0,3,7,2,9,7,5,12,0,0,0,17,8,25
wi11,111,ROOSEVELT,BENG,Bioengin,0,0,0,0,1,1,1,0,1,5,1,6,3,9,12,0,0,0,9,11,20
wi11,111,ROOSEVELT,BENG,Pr-BioenPM,0,0,0,0,0,0,1,0,1,1,0,1,0,1,1,0,0,0,2,1,3
wi11,111,ROOSEVELT,BIOL,Bioc/CellB,0,0,0,1,4,5,3,3,6,5,10,15,27,41,68,0,0,0,36,58,94
wi11,111,ROOSEVELT,BIOL,Ec/Beh/Evo,0,0,0,0,0,0,2,1,3,2,5,7,1,11,12,0,0,0,5,17,22
wi11,111,ROOSEVELT,BIOL,Genl Biol,0,0,0,1,6,7,7,7,14,12,20,32,26,61,87,0,0,0,46,94,140
wi11,111,ROOSEVELT,BIOL,Human Bio,0,0,0,4,16,20,11,20,31,24,43,67,46,78,124,0,0,0,85,157,242
wi11,111,ROOSEVELT,BIOL,Microbiol,0,0,0,0,0,0,1,1,2,2,3,5,3,2,5,0,0,0,6,6,12
wi11,111,ROOSEVELT,BIOL,Molec Biol,0,0,0,1,2,3,0,1,1,1,2,3,7,6,13,0,0,0,9,11,20
wi11,111,ROOSEVELT,BIOL,PhyslNeuro,0,0,0,3,2,5,3,5,8,9,9,18,12,21,33,0,0,0,27,37,64
wi11,111,ROOSEVELT,CENG,Chem Engin,0,0,0,1,1,2,3,2,5,4,3,7,3,3,6,0,0,0,11,9,20
wi11,111,ROOSEVELT,CGS,CritGendSt,0,0,0,0,0,0,0,0,0,0,0,0,0,1,1,0,0,0,0,1,1
wi11,111,ROOSEVELT,CHEM,Bioch/Chem,0,0,0,8,9,17,11,9,20,6,14,20,13,6,19,0,0,0,38,38,76
wi11,111,ROOSEVELT,CHEM,Bioinform,0,0,0,0,0,0,0,0,0,1,0,1,0,0,0,0,0,0,1,0,1
wi11,111,ROOSEVELT,CHEM,Chemistry,0,0,0,1,3,4,2,2,4,7,0,7,3,3,6,0,0,0,13,8,21
wi11,111,ROOSEVELT,CHEM,Envir Chem,0,0,0,0,0,0,1,1,2,1,0,1,1,1,2,0,0,0,3,2,5
wi11,111,ROOSEVELT,CHEM,Pharm Chem,0,0,0,5,3,8,2,6,8,7,11,18,5,4,9,0,0,0,19,24,43
wi11,111,ROOSEVELT,CHIN,Chinese St,0,0,0,0,2,2,1,3,4,0,0,0,1,2,3,0,0,0,2,7,9
wi11,111,ROOSEVELT,CLAS,Classic St,0,0,0,1,0,1,0,0,0,0,1,1,0,0,0,0,0,0,1,1,2
wi11,111,ROOSEVELT,COGS,Cog Sci,0,0,0,1,1,2,2,4,6,5,7,12,7,6,13,0,0,0,15,18,33
wi11,111,ROOSEVELT,COGS,CogSc/ClAs,0,0,0,0,0,0,0,1,1,0,1,1,0,0,0,0,0,0,0,2,2
wi11,111,ROOSEVELT,COGS,CogSc/HCI,0,0,0,0,0,0,0,1,1,1,3,4,5,2,7,0,0,0,6,6,12
wi11,111,ROOSEVELT,COGS,CogSc/HCog,0,0,0,0,0,0,3,2,5,0,0,0,1,1,2,0,0,0,4,3,7
wi11,111,ROOSEVELT,COGS,CogSc/Neur,0,0,0,1,5,6,1,7,8,5,6,11,3,14,17,0,0,0,10,32,42
wi11,111,ROOSEVELT,COMM,Communic,0,0,0,3,13,16,0,16,16,25,53,78,23,65,88,0,0,0,51,147,198
wi11,111,ROOSEVELT,CSE,Comp Sci,0,0,0,3,1,4,6,1,7,19,6,25,27,6,33,0,0,0,55,14,69
wi11,111,ROOSEVELT,CSE,CompEngCSE,0,0,0,5,1,6,3,1,4,3,0,3,5,0,5,0,0,0,16,2,18
wi11,111,ROOSEVELT,CSE,CompScBinf,0,0,0,0,0,0,0,0,0,0,0,0,1,0,1,0,0,0,1,0,1
wi11,111,ROOSEVELT,ECE,CompEngECE,0,0,0,0,0,0,0,0,0,2,0,2,0,0,0,0,0,0,2,0,2
wi11,111,ROOSEVELT,ECE,Electr Eng,0,0,0,4,2,6,6,1,7,8,0,8,14,4,18,0,0,0,32,7,39
wi11,111,ROOSEVELT,ECE,Engin Phys,0,0,0,0,0,0,0,0,0,1,0,1,0,0,0,0,0,0,1,0,1
wi11,111,ROOSEVELT,ECON,Ec-Mth&Ecn,0,0,0,0,4,4,2,1,3,2,3,5,12,4,16,0,0,0,16,12,28
wi11,111,ROOSEVELT,ECON,Econ-MgtSc,0,0,0,5,6,11,11,4,15,23,18,41,47,32,79,0,0,0,86,60,146
wi11,111,ROOSEVELT,ECON,Economics,0,0,0,5,12,17,14,13,27,53,39,92,65,31,96,0,0,0,137,95,232
wi11,111,ROOSEVELT,ESYS,EnvSys(EB),0,0,0,1,2,3,2,6,8,2,6,8,3,11,14,0,0,0,8,25,33
wi11,111,ROOSEVELT,ESYS,EnvSys(EC),0,0,0,0,0,0,1,2,3,1,1,2,0,1,1,0,0,0,2,4,6
wi11,111,ROOSEVELT,ESYS,EnvSys(EP),0,0,0,1,0,1,0,0,0,0,1,1,2,3,5,0,0,0,3,4,7
wi11,111,ROOSEVELT,ESYS,EnvSys(ES),0,0,0,0,0,0,0,2,2,1,2,3,1,3,4,0,0,0,2,7,9
wi11,111,ROOSEVELT,ETHN,Ethnic St,0,0,0,0,0,0,0,1,1,0,4,4,0,10,10,0,0,0,0,15,15
wi11,111,ROOSEVELT,HDP,Human Dev,0,0,0,0,0,0,0,2,2,1,4,5,1,20,21,0,0,0,2,26,28
wi11,111,ROOSEVELT,HDP,Pr-HumnDev,0,0,0,0,2,2,0,10,10,2,10,12,0,6,6,0,0,0,2,28,30
wi11,111,ROOSEVELT,HIST,History,0,0,0,2,4,6,4,5,9,8,16,24,19,31,50,0,0,0,33,56,89
wi11,111,ROOSEVELT,INTD,Roos IndSt,0,0,0,0,0,0,0,0,0,0,0,0,1,0,1,0,0,0,1,0,1
wi11,111,ROOSEVELT,INTL,Int-5yrPS,0,0,0,0,0,0,0,0,0,0,0,0,1,1,2,0,0,0,1,1,2
wi11,111,ROOSEVELT,INTL,IntSt-Anth,0,0,0,0,0,0,0,2,2,0,3,3,1,6,7,0,0,0,1,11,12
wi11,111,ROOSEVELT,INTL,IntSt-Econ,0,0,0,3,6,9,4,10,14,6,13,19,22,34,56,0,0,0,35,63,98
wi11,111,ROOSEVELT,INTL,IntSt-Hist,0,0,0,1,1,2,0,4,4,3,3,6,5,12,17,0,0,0,9,20,29
wi11,111,ROOSEVELT,INTL,IntSt-Ling,0,0,0,0,0,0,0,4,4,2,5,7,1,4,5,0,0,0,3,13,16
wi11,111,ROOSEVELT,INTL,IntSt-Lit,0,0,0,0,0,0,0,0,0,0,0,0,0,1,1,0,0,0,0,1,1
wi11,111,ROOSEVELT,INTL,IntSt-PolS,0,0,0,3,10,13,4,12,16,8,30,38,14,44,58,0,0,0,29,96,125
wi11,111,ROOSEVELT,INTL,IntSt-Soc,0,0,0,2,4,6,0,9,9,2,21,23,0,24,24,0,0,0,4,58,62
wi11,111,ROOSEVELT,ITAL,Italian St,0,0,0,0,0,0,0,0,0,0,0,0,1,1,2,0,0,0,1,1,2
wi11,111,ROOSEVELT,JAPN,JapaneseSt,0,0,0,0,1,1,1,0,1,1,1,2,1,1,2,0,0,0,3,3,6
wi11,111,ROOSEVELT,LATI,LatinAm St,0,0,0,0,0,0,0,1,1,0,2,2,2,2,4,0,0,0,2,5,7
wi11,111,ROOSEVELT,LING,Lang Stu,0,0,0,0,1,1,0,2,2,0,0,0,0,2,2,0,0,0,0,5,5
wi11,111,ROOSEVELT,LING,Ling-CogLn,0,0,0,0,0,0,0,0,0,0,1,1,0,2,2,0,0,0,0,3,3
wi11,111,ROOSEVELT,LING,Ling-LSoc,0,0,0,1,1,2,0,1,1,0,3,3,1,0,1,0,0,0,2,5,7
wi11,111,ROOSEVELT,LING,Linguistcs,0,0,0,0,0,0,1,0,1,0,3,3,0,6,6,0,0,0,1,9,10
wi11,111,ROOSEVELT,LIT,French Lit,0,0,0,0,0,0,0,0,0,0,0,0,1,1,2,0,0,0,1,1,2
wi11,111,ROOSEVELT,LIT,Lit/Compos,0,0,0,0,0,0,0,0,0,0,0,0,1,2,3,0,0,0,1,2,3
wi11,111,ROOSEVELT,LIT,Lit/CultSt,0,0,0,0,0,0,0,0,0,0,1,1,0,1,1,0,0,0,0,2,2
wi11,111,ROOSEVELT,LIT,Lit/Engl,0,0,0,0,1,1,0,2,2,2,4,6,3,8,11,0,0,0,5,15,20
wi11,111,ROOSEVELT,LIT,Lit/World,0,0,0,0,0,0,0,0,0,0,2,2,2,3,5,0,0,0,2,5,7
wi11,111,ROOSEVELT,LIT,Lit/Writng,0,0,0,2,2,4,0,3,3,4,2,6,4,16,20,0,0,0,10,23,33
wi11,111,ROOSEVELT,LIT,Pre-Lit/Wr,0,0,0,0,0,0,0,1,1,1,7,8,5,2,7,0,0,0,6,10,16
wi11,111,ROOSEVELT,LIT,Spanish Lt,0,0,0,0,0,0,0,0,0,1,0,1,1,1,2,0,0,0,2,1,3
wi11,111,ROOSEVELT,MAE,Aerosp Eng,0,0,0,0,0,0,7,1,8,9,2,11,13,3,16,0,0,0,29,6,35
wi11,111,ROOSEVELT,MAE,Engin Sci,0,0,0,2,1,3,0,0,0,2,0,2,1,0,1,0,0,0,5,1,6
wi11,111,ROOSEVELT,MAE,Envir Eng,0,0,0,2,0,2,2,3,5,2,0,2,3,2,5,0,0,0,9,5,14
wi11,111,ROOSEVELT,MAE,Mech Engin,0,0,0,2,0,2,7,0,7,19,3,22,30,5,35,0,0,0,58,8,66
wi11,111,ROOSEVELT,MATH,Appld Math,0,0,0,1,1,2,0,1,1,0,1,1,1,1,2,0,0,0,2,4,6
wi11,111,ROOSEVELT,MATH,Math/SecEd,0,0,0,0,0,0,0,0,0,0,1,1,0,0,0,0,0,0,0,1,1
wi11,111,ROOSEVELT,MATH,Mathematcs,0,0,0,1,2,3,2,0,2,1,1,2,4,2,6,0,0,0,8,5,13
wi11,111,ROOSEVELT,MATH,Mth-CompSc,0,0,0,0,0,0,0,1,1,0,0,0,1,0,1,0,0,0,1,1,2
wi11,111,ROOSEVELT,MATH,Mth-Mth&Ec,0,0,0,0,1,1,1,1,2,0,1,1,6,0,6,0,0,0,7,3,10
wi11,111,ROOSEVELT,MATH,Mth-SciCom,0,0,0,0,0,0,0,0,0,0,0,0,0,1,1,0,0,0,0,1,1
wi11,111,ROOSEVELT,MATH,Mth/ApldSc,0,0,0,0,0,0,0,0,0,0,0,0,2,0,2,0,0,0,2,0,2
wi11,111,ROOSEVELT,MATH,Prob&Stats,0,0,0,1,0,1,0,0,0,0,2,2,0,0,0,0,0,0,1,2,3
wi11,111,ROOSEVELT,MUS,Mu-CompArt,0,0,0,0,1,1,1,0,1,0,1,1,3,0,3,0,0,0,4,2,6
wi11,111,ROOSEVELT,MUS,Music,0,0,0,1,0,1,1,1,2,0,3,3,4,3,7,0,0,0,6,7,13
wi11,111,ROOSEVELT,NENG,NanoEng,0,0,0,3,0,3,3,0,3,1,0,1,0,1,1,0,0,0,7,1,8
wi11,111,ROOSEVELT,PHIL,Philosophy,0,0,0,1,0,1,0,1,1,3,1,4,2,2,4,0,0,0,6,4,10
wi11,111,ROOSEVELT,PHYS,Biophysics,0,0,0,0,1,1,0,0,0,1,0,1,0,1,1,0,0,0,1,2,3
wi11,111,ROOSEVELT,PHYS,GenPys/SEd,0,0,0,0,0,0,0,0,0,0,0,0,1,1,2,0,0,0,1,1,2
wi11,111,ROOSEVELT,PHYS,Phys/Astro,0,0,0,1,0,1,1,0,1,0,0,0,2,0,2,0,0,0,4,0,4
wi11,111,ROOSEVELT,PHYS,Physics,0,0,0,0,3,3,1,0,1,2,1,3,3,3,6,0,0,0,6,7,13
wi11,111,ROOSEVELT,POLI,Polit Sci,0,0,0,3,4,7,3,6,9,25,14,39,31,32,63,0,0,0,62,56,118
wi11,111,ROOSEVELT,POLI,PolSc-Amer,0,0,0,0,1,1,2,3,5,2,6,8,5,4,9,0,0,0,9,14,23
wi11,111,ROOSEVELT,POLI,PolSc-Comp,0,0,0,0,0,0,0,0,0,1,1,2,1,4,5,0,0,0,2,5,7
wi11,111,ROOSEVELT,POLI,PolSc-Intl,0,0,0,3,5,8,6,11,17,20,20,40,13,18,31,0,0,0,42,54,96
wi11,111,ROOSEVELT,POLI,PolSc-PLaw,0,0,0,0,3,3,1,2,3,10,4,14,5,10,15,0,0,0,16,19,35
wi11,111,ROOSEVELT,POLI,PolSc-PPol,0,0,0,1,0,1,0,0,0,0,0,0,4,2,6,0,0,0,5,2,7
wi11,111,ROOSEVELT,POLI,PolSc-Thry,0,0,0,0,0,0,0,0,0,1,0,1,1,4,5,0,0,0,2,4,6
wi11,111,ROOSEVELT,PSYC,Psychology,0,0,0,8,25,33,13,31,44,22,62,84,41,95,136,0,0,0,84,213,297
wi11,111,ROOSEVELT,RELI,Relig/Stu,0,0,0,0,0,0,0,1,1,0,2,2,0,2,2,0,0,0,0,5,5
wi11,111,ROOSEVELT,SE,Engin Sci,0,0,0,0,1,1,2,0,2,0,0,0,0,0,0,0,0,0,2,1,3
wi11,111,ROOSEVELT,SE,Struct Eng,0,0,0,4,3,7,3,3,6,12,5,17,31,6,37,0,0,0,50,17,67
wi11,111,ROOSEVELT,SIO,Earth Sci,0,0,0,0,0,0,0,0,0,0,1,1,0,0,0,0,0,0,0,1,1
wi11,111,ROOSEVELT,SIO,ErSc-Geol,0,0,0,0,1,1,0,0,0,0,0,0,0,1,1,0,0,0,0,2,2
wi11,111,ROOSEVELT,SIO,ErSc-Geoph,0,0,0,0,0,0,0,0,0,1,0,1,0,0,0,0,0,0,1,0,1
wi11,111,ROOSEVELT,SOC,SocAmSt,0,0,0,0,0,0,0,0,0,0,1,1,0,1,1,0,0,0,0,2,2
wi11,111,ROOSEVELT,SOC,SocCulCom,0,0,0,0,2,2,0,0,0,2,0,2,1,3,4,0,0,0,3,5,8
wi11,111,ROOSEVELT,SOC,SocIntlStu,0,0,0,0,0,0,0,0,0,0,3,3,2,3,5,0,0,0,2,6,8
wi11,111,ROOSEVELT,SOC,Sociology,0,0,0,0,2,2,0,4,4,2,15,17,9,15,24,0,0,0,11,36,47
wi11,111,ROOSEVELT,SOC,SocLawSoc,0,0,0,0,1,1,0,0,0,3,3,6,1,1,2,0,0,0,4,5,9
wi11,111,ROOSEVELT,SOC,SocSciMed,0,0,0,0,0,0,1,1,2,1,0,1,1,1,2,0,0,0,3,2,5
wi11,111,ROOSEVELT,SOC,SocSolneq,0,0,0,0,0,0,0,1,1,0,2,2,0,3,3,0,0,0,0,6,6
wi11,111,ROOSEVELT,THEA,Dance,0,0,0,0,0,0,0,0,0,0,1,1,0,0,0,0,0,0,0,1,1
wi11,111,ROOSEVELT,THEA,Theatre,0,0,0,0,2,2,0,2,2,2,6,8,4,5,9,0,0,0,6,15,21
wi11,111,ROOSEVELT,TWS,ThirdWldSt,0,0,0,1,1,2,0,2,2,0,0,0,0,2,2,0,0,0,1,5,6
wi11,111,ROOSEVELT,UNAF,UndecHumAr,0,0,0,0,5,5,1,0,1,0,0,0,0,0,0,0,0,0,1,5,6
wi11,111,ROOSEVELT,UNAF,Undeclared,0,0,0,23,41,64,10,20,30,0,1,1,0,0,0,0,0,0,33,62,95
wi11,111,ROOSEVELT,UNAF,UndecPhysS,0,0,0,3,3,6,2,4,6,0,0,0,0,0,0,0,0,0,5,7,12
wi11,111,ROOSEVELT,UNAF,UndecSocSc,0,0,0,1,7,8,0,4,4,0,0,0,0,0,0,0,0,0,1,11,12
wi11,111,ROOSEVELT,USP,Urb Stu&Pl,0,0,0,0,0,0,0,4,4,5,7,12,9,13,22,0,0,0,14,24,38
wi11,111,ROOSEVELT,VIS,Art Hst/Cr,0,0,0,0,0,0,0,1,1,1,1,2,1,4,5,0,0,0,2,6,8
wi11,111,ROOSEVELT,VIS,Media,0,0,0,1,2,3,1,1,2,4,10,14,8,10,18,0,0,0,14,23,37
wi11,111,ROOSEVELT,VIS,Studio VA,0,0,0,0,0,0,1,0,1,0,3,3,1,6,7,0,0,0,2,9,11
wi11,111,ROOSEVELT,VIS,VA-CompArt,0,0,0,0,0,0,1,1,2,0,1,1,2,4,6,0,0,0,3,6,9
wi11,111,SIXTH,ANTH,Anth-Arch,0,0,0,0,0,0,0,1,1,1,1,2,0,3,3,0,0,0,1,5,6
wi11,111,SIXTH,ANTH,Anth-Biol,0,0,0,0,0,0,0,2,2,2,5,7,1,4,5,0,0,0,3,11,14
wi11,111,SIXTH,ANTH,Anth-Soci,0,0,0,0,1,1,0,2,2,1,5,6,0,7,7,0,0,0,1,15,16
wi11,111,SIXTH,BENG,Bioen:Binf,0,0,0,1,0,1,1,0,1,0,0,0,3,0,3,0,0,0,5,0,5
wi11,111,SIXTH,BENG,Bioeng:PM,0,0,0,0,0,0,1,0,1,1,1,2,11,1,12,0,0,0,13,2,15
wi11,111,SIXTH,BENG,BioengBiot,0,0,0,3,1,4,1,2,3,7,2,9,12,3,15,0,0,0,23,8,31
wi11,111,SIXTH,BENG,Bioengin,0,0,0,1,1,2,2,0,2,5,3,8,5,2,7,0,0,0,13,6,19
wi11,111,SIXTH,BENG,Pr-BioenPM,0,0,0,0,0,0,2,0,2,2,0,2,0,0,0,0,0,0,4,0,4
wi11,111,SIXTH,BIOL,Bioc/CellB,0,0,0,1,1,2,3,2,5,13,13,26,29,28,57,0,0,0,46,44,90
wi11,111,SIXTH,BIOL,BiolBioinf,0,0,0,0,0,0,0,0,0,0,0,0,1,0,1,0,0,0,1,0,1
wi11,111,SIXTH,BIOL,Ec/Beh/Evo,0,0,0,0,1,1,0,1,1,1,2,3,1,11,12,0,0,0,2,15,17
wi11,111,SIXTH,BIOL,Genl Biol,0,0,0,1,3,4,7,9,16,10,13,23,34,40,74,0,0,0,52,65,117
wi11,111,SIXTH,BIOL,Human Bio,0,0,0,10,6,16,11,7,18,29,28,57,47,54,101,0,0,0,97,95,192
wi11,111,SIXTH,BIOL,Microbiol,0,0,0,0,1,1,2,2,4,1,2,3,4,6,10,0,0,0,7,11,18
wi11,111,SIXTH,BIOL,Molec Biol,0,0,0,0,1,1,2,2,4,1,1,2,7,10,17,0,0,0,10,14,24
wi11,111,SIXTH,BIOL,PhyslNeuro,0,0,0,3,1,4,3,6,9,6,9,15,16,21,37,0,0,0,28,37,65
wi11,111,SIXTH,CENG,Chem Engin,0,0,0,3,2,5,6,2,8,4,0,4,17,3,20,0,0,0,30,7,37
wi11,111,SIXTH,CGS,CritGendSt,0,0,0,0,0,0,0,1,1,0,0,0,0,1,1,0,0,0,0,2,2
wi11,111,SIXTH,CHEM,Bioch/Chem,0,0,0,6,8,14,18,9,27,9,13,22,11,8,19,0,0,0,44,38,82
wi11,111,SIXTH,CHEM,Bioinform,0,0,0,0,0,0,1,0,1,0,0,0,0,0,0,0,0,0,1,0,1
wi11,111,SIXTH,CHEM,Chem Educ,0,0,0,0,0,0,0,0,0,1,0,1,0,0,0,0,0,0,1,0,1
wi11,111,SIXTH,CHEM,Chemistry,0,0,0,4,3,7,4,5,9,1,3,4,7,4,11,0,0,0,16,15,31
wi11,111,SIXTH,CHEM,Envir Chem,0,0,0,0,0,0,0,0,0,0,1,1,1,0,1,0,0,0,1,1,2
wi11,111,SIXTH,CHEM,MolecSynth,0,0,0,0,0,0,0,0,0,0,1,1,0,0,0,0,0,0,0,1,1
wi11,111,SIXTH,CHEM,Pharm Chem,0,0,0,8,8,16,6,10,16,6,18,24,7,9,16,0,0,0,27,45,72
wi11,111,SIXTH,CHIN,Chinese St,0,0,0,0,0,0,0,1,1,1,0,1,0,1,1,0,0,0,1,2,3
wi11,111,SIXTH,CLAS,Classic St,0,0,0,0,0,0,0,0,0,0,0,0,1,1,2,0,0,0,1,1,2
wi11,111,SIXTH,COGS,Cog Sci,0,0,0,0,0,0,8,3,11,3,3,6,9,3,12,0,0,0,20,9,29
wi11,111,SIXTH,COGS,CogSc/ClAs,0,0,0,0,1,1,0,1,1,0,2,2,0,3,3,0,0,0,0,7,7
wi11,111,SIXTH,COGS,CogSc/Comp,0,0,0,0,0,0,0,0,0,1,1,2,0,0,0,0,0,0,1,1,2
wi11,111,SIXTH,COGS,CogSc/HCI,0,0,0,0,1,1,1,1,2,2,0,2,5,3,8,0,0,0,8,5,13
wi11,111,SIXTH,COGS,CogSc/HCog,0,0,0,1,0,1,1,1,2,1,0,1,2,0,2,0,0,0,5,1,6
wi11,111,SIXTH,COGS,CogSc/Neur,0,0,0,1,2,3,1,2,3,3,6,9,3,5,8,0,0,0,8,15,23
wi11,111,SIXTH,COMM,Communic,0,0,0,2,11,13,5,24,29,19,36,55,19,49,68,0,0,0,45,120,165
wi11,111,SIXTH,CSE,Comp Sci,0,0,0,13,4,17,22,9,31,28,7,35,71,10,81,0,0,0,134,30,164
wi11,111,SIXTH,CSE,CompEngCSE,0,0,0,8,2,10,9,0,9,8,1,9,18,0,18,0,0,0,43,3,46
wi11,111,SIXTH,CSE,CompScBinf,0,0,0,0,0,0,0,0,0,4,1,5,1,0,1,0,0,0,5,1,6
wi11,111,SIXTH,ECE,CompEngECE,0,0,0,3,1,4,2,0,2,2,0,2,4,0,4,0,0,0,11,1,12
wi11,111,SIXTH,ECE,Electr Eng,0,0,0,17,0,17,6,0,6,17,2,19,49,6,55,0,0,0,89,8,97
wi11,111,SIXTH,ECE,Engin Phys,0,0,0,1,0,1,0,0,0,0,0,0,0,0,0,0,0,0,1,0,1
wi11,111,SIXTH,ECE,Pr-EngPhys,0,0,0,1,0,1,2,0,2,3,1,4,0,0,0,0,0,0,6,1,7
wi11,111,SIXTH,ECON,Ec-Mth&Ecn,0,0,0,0,0,0,3,1,4,3,6,9,5,1,6,0,0,0,11,8,19
wi11,111,SIXTH,ECON,Econ-MgtSc,0,0,0,11,6,17,10,9,19,25,20,45,49,33,82,0,0,0,95,68,163
wi11,111,SIXTH,ECON,Economics,0,0,0,10,5,15,3,6,9,54,21,75,74,33,107,0,0,0,141,65,206
wi11,111,SIXTH,ESYS,EnvSys(EB),0,0,0,0,4,4,1,7,8,4,8,12,3,8,11,0,0,0,8,27,35
wi11,111,SIXTH,ESYS,EnvSys(EC),0,0,0,0,0,0,1,0,1,0,1,1,1,0,1,0,0,0,2,1,3
wi11,111,SIXTH,ESYS,EnvSys(EP),0,0,0,1,2,3,1,2,3,1,1,2,1,1,2,0,0,0,4,6,10
wi11,111,SIXTH,ESYS,EnvSys(ES),0,0,0,0,0,0,0,2,2,1,1,2,2,1,3,0,0,0,3,4,7
wi11,111,SIXTH,ETHN,Ethnic St,0,0,0,0,1,1,0,0,0,2,2,4,3,4,7,0,0,0,5,7,12
wi11,111,SIXTH,HDP,Human Dev,0,0,0,0,0,0,0,0,0,0,12,12,1,18,19,0,0,0,1,30,31
wi11,111,SIXTH,HDP,Pr-HumnDev,0,0,0,0,5,5,0,8,8,1,2,3,0,3,3,0,0,0,1,18,19
wi11,111,SIXTH,HIST,History,0,0,0,1,1,2,5,0,5,3,3,6,9,10,19,0,0,0,18,14,32
wi11,111,SIXTH,INTL,IntSt-Anth,0,0,0,0,0,0,0,0,0,0,2,2,2,3,5,0,0,0,2,5,7
wi11,111,SIXTH,INTL,IntSt-Econ,0,0,0,4,0,4,1,2,3,7,8,15,4,9,13,0,0,0,16,19,35
wi11,111,SIXTH,INTL,IntSt-Hist,0,0,0,0,1,1,0,0,0,0,1,1,1,4,5,0,0,0,1,6,7
wi11,111,SIXTH,INTL,IntSt-Ling,0,0,0,0,1,1,1,2,3,1,3,4,0,0,0,0,0,0,2,6,8
wi11,111,SIXTH,INTL,IntSt-PolS,0,0,0,0,1,1,5,3,8,4,4,8,9,12,21,0,0,0,18,20,38
wi11,111,SIXTH,INTL,IntSt-Soc,0,0,0,0,1,1,0,3,3,0,3,3,3,4,7,0,0,0,3,11,14
wi11,111,SIXTH,ITAL,Italian St,0,0,0,0,0,0,0,0,0,0,0,0,0,2,2,0,0,0,0,2,2
wi11,111,SIXTH,JAPN,JapaneseSt,0,0,0,0,0,0,0,1,1,0,1,1,0,1,1,0,0,0,0,3,3
wi11,111,SIXTH,LATI,LatinAm St,0,0,0,0,0,0,0,0,0,0,0,0,0,1,1,0,0,0,0,1,1
wi11,111,SIXTH,LING,Lang Stu,0,0,0,0,0,0,0,1,1,1,1,2,0,0,0,0,0,0,1,2,3
wi11,111,SIXTH,LING,Ling-CogLn,0,0,0,0,0,0,0,0,0,1,0,1,0,3,3,0,0,0,1,3,4
wi11,111,SIXTH,LING,Ling-LSoc,0,0,0,0,1,1,0,0,0,0,1,1,1,1,2,0,0,0,1,3,4
wi11,111,SIXTH,LING,Linguistcs,0,0,0,0,0,0,0,0,0,1,4,5,2,3,5,0,0,0,3,7,10
wi11,111,SIXTH,LIT,French Lit,0,0,0,0,0,0,0,0,0,0,0,0,0,1,1,0,0,0,0,1,1
wi11,111,SIXTH,LIT,Lit/Compos,0,0,0,0,0,0,1,0,1,0,0,0,0,1,1,0,0,0,1,1,2
wi11,111,SIXTH,LIT,Lit/CultSt,0,0,0,0,0,0,0,0,0,0,0,0,0,2,2,0,0,0,0,2,2
wi11,111,SIXTH,LIT,Lit/Engl,0,0,0,1,1,2,1,3,4,2,0,2,1,2,3,0,0,0,5,6,11
wi11,111,SIXTH,LIT,Lit/World,0,0,0,0,0,0,0,0,0,0,1,1,0,4,4,0,0,0,0,5,5
wi11,111,SIXTH,LIT,Lit/Writng,0,0,0,0,1,1,2,2,4,1,6,7,2,8,10,0,0,0,5,17,22
wi11,111,SIXTH,LIT,Pre-Lit/Wr,0,0,0,0,0,0,0,0,0,0,4,4,2,1,3,0,0,0,2,5,7
wi11,111,SIXTH,LIT,Spanish Lt,0,0,0,0,0,0,0,0,0,1,0,1,0,0,0,0,0,0,1,0,1
wi11,111,SIXTH,MAE,Aerosp Eng,0,0,0,4,2,6,13,3,16,15,1,16,30,4,34,0,0,0,62,10,72
wi11,111,SIXTH,MAE,Engin Sci,0,0,0,1,1,2,3,0,3,2,0,2,3,0,3,0,0,0,9,1,10
wi11,111,SIXTH,MAE,Envir Eng,0,0,0,7,3,10,7,3,10,2,3,5,4,4,8,0,0,0,20,13,33
wi11,111,SIXTH,MAE,Mech Engin,0,0,0,6,2,8,11,2,13,25,4,29,70,13,83,0,0,0,112,21,133
wi11,111,SIXTH,MATH,Appld Math,0,0,0,1,1,2,1,0,1,1,2,3,1,1,2,0,0,0,4,4,8
wi11,111,SIXTH,MATH,Math/SecEd,0,0,0,0,0,0,1,3,4,0,1,1,1,3,4,0,0,0,2,7,9
wi11,111,SIXTH,MATH,Mathematcs,0,0,0,2,2,4,1,0,1,6,4,10,3,5,8,0,0,0,12,11,23
wi11,111,SIXTH,MATH,Mth-CompSc,0,0,0,0,0,0,0,0,0,0,0,0,2,0,2,0,0,0,2,0,2
wi11,111,SIXTH,MATH,Mth-Mth&Ec,0,0,0,0,0,0,2,0,2,1,2,3,4,2,6,0,0,0,7,4,11
wi11,111,SIXTH,MATH,Mth/ApldSc,0,0,0,1,1,2,0,0,0,1,0,1,0,0,0,0,0,0,2,1,3
wi11,111,SIXTH,MATH,Pr-Math CS,0,0,0,4,0,4,1,0,1,0,0,0,0,0,0,0,0,0,5,0,5
wi11,111,SIXTH,MATH,Prob&Stats,0,0,0,0,0,0,0,0,0,0,1,1,1,0,1,0,0,0,1,1,2
wi11,111,SIXTH,MUS,Mu-CompArt,0,0,0,1,0,1,4,2,6,11,1,12,6,1,7,0,0,0,22,4,26
wi11,111,SIXTH,MUS,Music,0,0,0,1,0,1,1,1,2,4,1,5,4,4,8,0,0,0,10,6,16
wi11,111,SIXTH,MUS,Music Hum,0,0,0,0,0,0,0,0,0,0,0,0,1,0,1,0,0,0,1,0,1
wi11,111,SIXTH,NENG,NanoEng,0,0,0,0,0,0,2,1,3,2,0,2,1,0,1,0,0,0,5,1,6
wi11,111,SIXTH,PHIL,Philosophy,0,0,0,0,0,0,0,0,0,6,2,8,3,0,3,0,0,0,9,2,11
wi11,111,SIXTH,PHYS,Biophysics,0,0,0,1,0,1,2,0,2,1,0,1,2,0,2,0,0,0,6,0,6
wi11,111,SIXTH,PHYS,Phy/ErthSc,0,0,0,0,0,0,0,0,0,1,0,1,0,0,0,0,0,0,1,0,1
wi11,111,SIXTH,PHYS,Phys/Astro,0,0,0,2,0,2,0,0,0,0,1,1,3,0,3,0,0,0,5,1,6
wi11,111,SIXTH,PHYS,Phys/Comp,0,0,0,0,0,0,1,0,1,0,0,0,0,0,0,0,0,0,1,0,1
wi11,111,SIXTH,PHYS,Phys/Mtrls,0,0,0,0,0,0,1,0,1,0,0,0,0,0,0,0,0,0,1,0,1
wi11,111,SIXTH,PHYS,Physics,0,0,0,2,0,2,3,1,4,7,1,8,5,0,5,0,0,0,17,2,19
wi11,111,SIXTH,POLI,Polit Sci,0,0,0,4,2,6,5,4,9,15,6,21,25,8,33,0,0,0,49,20,69
wi11,111,SIXTH,POLI,PolSc-Amer,0,0,0,1,0,1,0,0,0,0,3,3,2,2,4,0,0,0,3,5,8
wi11,111,SIXTH,POLI,PolSc-Intl,0,0,0,1,4,5,3,0,3,5,5,10,8,3,11,0,0,0,17,12,29
wi11,111,SIXTH,POLI,PolSc-PLaw,0,0,0,1,2,3,3,3,6,2,4,6,1,1,2,0,0,0,7,10,17
wi11,111,SIXTH,POLI,PolSc-PPol,0,0,0,1,0,1,1,0,1,1,0,1,1,0,1,0,0,0,4,0,4
wi11,111,SIXTH,POLI,PolSc-Thry,0,0,0,0,0,0,0,0,0,1,0,1,2,0,2,0,0,0,3,0,3
wi11,111,SIXTH,PSYC,Psychology,0,0,0,9,17,26,15,19,34,23,33,56,31,70,101,0,0,0,78,139,217
wi11,111,SIXTH,RUSS,Russ&SovSt,0,0,0,0,0,0,0,0,0,0,1,1,0,0,0,0,0,0,0,1,1
wi11,111,SIXTH,SE,Engin Sci,0,0,0,0,1,1,1,0,1,0,0,0,1,0,1,0,0,0,2,1,3
wi11,111,SIXTH,SE,Struct Eng,0,0,0,9,6,15,12,2,14,11,4,15,32,13,45,0,0,0,64,25,89
wi11,111,SIXTH,SIO,Earth Sci,0,0,0,0,0,0,0,0,0,1,0,1,1,0,1,0,0,0,2,0,2
wi11,111,SIXTH,SIO,ErSc-Geoph,0,0,0,0,0,0,0,0,0,0,1,1,0,0,0,0,0,0,0,1,1
wi11,111,SIXTH,SOC,SocCulCom,0,0,0,0,0,0,0,1,1,0,1,1,1,2,3,0,0,0,1,4,5
wi11,111,SIXTH,SOC,SocEconSoc,0,0,0,0,0,0,0,0,0,0,0,0,0,3,3,0,0,0,0,3,3
wi11,111,SIXTH,SOC,SocIntlStu,0,0,0,0,0,0,0,0,0,0,1,1,0,4,4,0,0,0,0,5,5
wi11,111,SIXTH,SOC,Sociology,0,0,0,0,3,3,1,1,2,4,10,14,4,9,13,0,0,0,9,23,32
wi11,111,SIXTH,SOC,SocLawSoc,0,0,0,0,0,0,0,1,1,0,2,2,1,3,4,0,0,0,1,6,7
wi11,111,SIXTH,SOC,SocSciMed,0,0,0,0,0,0,0,0,0,1,1,2,0,2,2,0,0,0,1,3,4
wi11,111,SIXTH,SOC,SocSolneq,0,0,0,0,0,0,0,0,0,0,0,0,0,3,3,0,0,0,0,3,3
wi11,111,SIXTH,THEA,Dance,0,0,0,0,0,0,1,0,1,0,0,0,0,3,3,0,0,0,1,3,4
wi11,111,SIXTH,THEA,Theatre,0,0,0,0,2,2,1,1,2,4,5,9,2,4,6,0,0,0,7,12,19
wi11,111,SIXTH,TWS,ThirdWldSt,0,0,0,0,0,0,0,1,1,0,0,0,0,1,1,0,0,0,0,2,2
wi11,111,SIXTH,UNAF,UndecBiolS,0,0,0,0,1,1,0,0,0,0,0,0,0,0,0,0,0,0,0,1,1
wi11,111,SIXTH,UNAF,UndecHumAr,0,0,0,0,3,3,3,3,6,0,0,0,0,0,0,0,0,0,3,6,9
wi11,111,SIXTH,UNAF,Undeclared,0,0,0,20,33,53,19,22,41,1,1,2,0,0,0,0,0,0,40,56,96
wi11,111,SIXTH,UNAF,UndecPhysS,0,0,0,3,4,7,0,3,3,0,0,0,0,0,0,0,0,0,3,7,10
wi11,111,SIXTH,UNAF,UndecSocSc,0,0,0,2,3,5,1,1,2,0,0,0,0,0,0,0,0,0,3,4,7
wi11,111,SIXTH,USP,Urb Stu&Pl,0,0,0,1,1,2,0,1,1,3,2,5,5,8,13,0,0,0,9,12,21
wi11,111,SIXTH,VIS,Art Hst/Cr,0,0,0,0,0,0,0,0,0,1,3,4,0,10,10,0,0,0,1,13,14
wi11,111,SIXTH,VIS,Media,0,0,0,5,4,9,1,9,10,17,13,30,16,18,34,0,0,0,39,44,83
wi11,111,SIXTH,VIS,Studio VA,0,0,0,1,1,2,1,2,3,2,5,7,8,14,22,0,0,0,12,22,34
wi11,111,SIXTH,VIS,VA-CompArt,0,0,0,2,2,4,0,4,4,6,5,11,10,6,16,0,0,0,18,17,35
wi11,111,WARREN,ANTH,Anth-Arch,0,0,0,0,0,0,0,0,0,2,1,3,1,6,7,0,0,0,3,7,10
wi11,111,WARREN,ANTH,Anth-Biol,0,0,0,0,0,0,0,1,1,0,0,0,0,5,5,0,0,0,0,6,6
wi11,111,WARREN,ANTH,Anth-Soci,0,0,0,0,0,0,0,1,1,1,3,4,0,5,5,0,0,0,1,9,10
wi11,111,WARREN,BENG,Bioen:Binf,0,0,0,0,0,0,2,1,3,0,0,0,7,1,8,0,0,0,9,2,11
wi11,111,WARREN,BENG,Bioeng:PM,0,0,0,0,0,0,1,1,2,7,3,10,25,8,33,0,0,0,33,12,45
wi11,111,WARREN,BENG,BioengBiot,0,0,0,0,1,1,7,9,16,23,5,28,34,12,46,0,0,0,64,27,91
wi11,111,WARREN,BENG,Bioengin,0,0,0,1,3,4,11,4,15,11,7,18,23,7,30,0,0,0,46,21,67
wi11,111,WARREN,BENG,Pr-BioenPM,0,0,0,0,0,0,2,1,3,7,3,10,0,0,0,0,0,0,9,4,13
wi11,111,WARREN,BIOL,Anml Physl,0,0,0,0,0,0,0,0,0,0,0,0,0,1,1,0,0,0,0,1,1
wi11,111,WARREN,BIOL,Bioc/CellB,0,0,0,4,5,9,9,8,17,20,9,29,55,69,124,0,0,0,88,91,179
wi11,111,WARREN,BIOL,Ec/Beh/Evo,0,0,0,1,1,2,0,0,0,3,3,6,8,12,20,0,0,0,12,16,28
wi11,111,WARREN,BIOL,Genl Biol,0,0,0,5,4,9,7,11,18,14,31,45,40,72,112,0,0,0,66,118,184
wi11,111,WARREN,BIOL,Human Bio,0,0,0,5,7,12,16,21,37,34,30,64,43,88,131,0,0,0,98,146,244
wi11,111,WARREN,BIOL,Microbiol,0,0,0,1,1,2,2,0,2,2,3,5,6,6,12,0,0,0,11,10,21
wi11,111,WARREN,BIOL,Molec Biol,0,0,0,1,0,1,2,0,2,6,3,9,6,9,15,0,0,0,15,12,27
wi11,111,WARREN,BIOL,PhyslNeuro,0,0,0,2,4,6,3,6,9,19,15,34,25,27,52,0,0,0,49,52,101
wi11,111,WARREN,CENG,Chem Engin,0,0,0,7,2,9,12,5,17,22,7,29,23,8,31,0,0,0,64,22,86
wi11,111,WARREN,CGS,CritGendSt,0,0,0,0,0,0,0,0,0,0,0,0,1,2,3,0,0,0,1,2,3
wi11,111,WARREN,CHEM,Bioch/Chem,0,0,0,13,12,25,19,13,32,12,13,25,17,10,27,0,0,0,61,48,109
wi11,111,WARREN,CHEM,Chem Phys,0,0,0,0,0,0,0,1,1,0,0,0,1,0,1,0,0,0,1,1,2
wi11,111,WARREN,CHEM,Chemistry,0,0,0,2,5,7,5,5,10,3,2,5,10,7,17,0,0,0,20,19,39
wi11,111,WARREN,CHEM,Envir Chem,0,0,0,0,0,0,0,0,0,0,0,0,1,0,1,0,0,0,1,0,1
wi11,111,WARREN,CHEM,MolecSynth,0,0,0,0,0,0,1,0,1,0,0,0,2,2,4,0,0,0,3,2,5
wi11,111,WARREN,CHEM,Pharm Chem,0,0,0,8,11,19,5,9,14,9,9,18,14,15,29,0,0,0,36,44,80
wi11,111,WARREN,CHIN,Chinese St,0,0,0,0,0,0,0,0,0,0,1,1,2,4,6,0,0,0,2,5,7
wi11,111,WARREN,CLAS,Classic St,0,0,0,0,0,0,0,0,0,0,1,1,0,0,0,0,0,0,0,1,1
wi11,111,WARREN,COGS,Cog Sci,0,0,0,1,2,3,3,1,4,0,8,8,3,6,9,0,0,0,7,17,24
wi11,111,WARREN,COGS,CogSc/ClAs,0,0,0,0,0,0,1,2,3,0,1,1,2,2,4,0,0,0,3,5,8
wi11,111,WARREN,COGS,CogSc/Comp,0,0,0,1,0,1,1,0,1,0,0,0,2,0,2,0,0,0,4,0,4
wi11,111,WARREN,COGS,CogSc/HCI,0,0,0,0,0,0,1,1,2,1,3,4,5,1,6,0,0,0,7,5,12
wi11,111,WARREN,COGS,CogSc/HCog,0,0,0,0,1,1,0,0,0,0,3,3,0,0,0,0,0,0,0,4,4
wi11,111,WARREN,COGS,CogSc/Neur,0,0,0,2,4,6,2,7,9,5,2,7,5,7,12,0,0,0,14,20,34
wi11,111,WARREN,COMM,Communic,0,0,0,0,4,4,6,11,17,13,22,35,18,42,60,0,0,0,37,79,116
wi11,111,WARREN,CSE,Comp Sci,0,0,0,13,3,16,32,9,41,44,11,55,72,13,85,0,0,0,161,36,197
wi11,111,WARREN,CSE,CompEngCSE,0,0,0,7,4,11,10,5,15,16,1,17,14,1,15,0,0,0,47,11,58
wi11,111,WARREN,CSE,CompScBinf,0,0,0,1,0,1,1,2,3,0,0,0,3,2,5,0,0,0,5,4,9
wi11,111,WARREN,ECE,CompEngECE,0,0,0,3,0,3,10,0,10,3,0,3,4,0,4,0,0,0,20,0,20
wi11,111,WARREN,ECE,Electr Eng,0,0,0,18,2,20,14,4,18,30,5,35,64,12,76,0,0,0,126,23,149
wi11,111,WARREN,ECE,Engin Phys,0,0,0,0,0,0,0,0,0,3,0,3,1,0,1,0,0,0,4,0,4
wi11,111,WARREN,ECE,Pr-EngPhys,0,0,0,0,0,0,2,0,2,1,0,1,0,0,0,0,0,0,3,0,3
wi11,111,WARREN,ECON,Ec-Mth&Ecn,0,0,0,1,1,2,3,1,4,7,1,8,11,7,18,0,0,0,22,10,32
wi11,111,WARREN,ECON,Econ-MgtSc,0,0,0,6,6,12,7,9,16,21,11,32,39,33,72,0,0,0,73,59,132
wi11,111,WARREN,ECON,Economics,0,0,0,9,6,15,13,9,22,54,26,80,65,38,103,0,0,0,141,79,220
wi11,111,WARREN,ESYS,EnvSys(EB),0,0,0,1,1,2,1,5,6,1,5,6,1,4,5,0,0,0,4,15,19
wi11,111,WARREN,ESYS,EnvSys(EC),0,0,0,0,0,0,0,0,0,0,1,1,1,1,2,0,0,0,1,2,3
wi11,111,WARREN,ESYS,EnvSys(EP),0,0,0,0,1,1,0,2,2,1,0,1,1,1,2,0,0,0,2,4,6
wi11,111,WARREN,ESYS,EnvSys(ES),0,0,0,0,0,0,0,1,1,2,0,2,0,0,0,0,0,0,2,1,3
wi11,111,WARREN,ETHN,Ethnic St,0,0,0,0,0,0,0,2,2,0,2,2,4,4,8,0,0,0,4,8,12
wi11,111,WARREN,HDP,Human Dev,0,0,0,0,0,0,0,1,1,0,3,3,2,12,14,0,0,0,2,16,18
wi11,111,WARREN,HDP,Pr-HumnDev,0,0,0,0,3,3,0,15,15,1,1,2,0,6,6,0,0,0,1,25,26
wi11,111,WARREN,HIST,History,0,0,0,0,1,1,6,0,6,7,6,13,26,8,34,0,0,0,39,15,54
wi11,111,WARREN,INTD,Wa Ind St,0,0,0,0,0,0,0,0,0,0,0,0,1,2,3,0,0,0,1,2,3
wi11,111,WARREN,INTL,IntSt-Anth,0,0,0,0,0,0,0,0,0,0,2,2,0,0,0,0,0,0,0,2,2
wi11,111,WARREN,INTL,IntSt-Econ,0,0,0,0,2,2,0,1,1,6,2,8,12,7,19,0,0,0,18,12,30
wi11,111,WARREN,INTL,IntSt-Hist,0,0,0,0,1,1,0,0,0,3,1,4,2,1,3,0,0,0,5,3,8
wi11,111,WARREN,INTL,IntSt-Ling,0,0,0,0,0,0,0,0,0,1,0,1,0,2,2,0,0,0,1,2,3
wi11,111,WARREN,INTL,IntSt-Lit,0,0,0,0,0,0,0,0,0,0,1,1,0,0,0,0,0,0,0,1,1
wi11,111,WARREN,INTL,IntSt-PolS,0,0,0,1,1,2,1,0,1,1,6,7,10,10,20,0,0,0,13,17,30
wi11,111,WARREN,INTL,IntSt-Soc,0,0,0,1,1,2,0,3,3,0,2,2,0,6,6,0,0,0,1,12,13
wi11,111,WARREN,ITAL,Italian St,0,0,0,0,1,1,0,0,0,0,0,0,0,0,0,0,0,0,0,1,1
wi11,111,WARREN,JAPN,JapaneseSt,0,0,0,0,0,0,0,0,0,0,0,0,3,1,4,0,0,0,3,1,4
wi11,111,WARREN,LING,Lang Stu,0,0,0,0,0,0,0,0,0,0,1,1,0,0,0,0,0,0,0,1,1
wi11,111,WARREN,LING,Ling-CogLn,0,0,0,0,0,0,0,1,1,0,0,0,0,1,1,0,0,0,0,2,2
wi11,111,WARREN,LING,Ling-LSoc,0,0,0,0,0,0,0,0,0,0,0,0,1,2,3,0,0,0,1,2,3
wi11,111,WARREN,LING,Linguistcs,0,0,0,0,0,0,1,0,1,0,3,3,0,3,3,0,0,0,1,6,7
wi11,111,WARREN,LIT,French Lit,0,0,0,0,0,0,0,0,0,0,0,0,1,0,1,0,0,0,1,0,1
wi11,111,WARREN,LIT,Lit/CultSt,0,0,0,0,0,0,0,0,0,0,0,0,0,1,1,0,0,0,0,1,1
wi11,111,WARREN,LIT,Lit/Engl,0,0,0,0,0,0,0,3,3,2,5,7,0,6,6,0,0,0,2,14,16
wi11,111,WARREN,LIT,Lit/World,0,0,0,0,0,0,0,0,0,0,0,0,0,2,2,0,0,0,0,2,2
wi11,111,WARREN,LIT,Lit/Writng,0,0,0,0,2,2,0,0,0,3,3,6,2,10,12,0,0,0,5,15,20
wi11,111,WARREN,LIT,Pre-Lit/Wr,0,0,0,0,0,0,1,0,1,1,0,1,2,2,4,0,0,0,4,2,6
wi11,111,WARREN,LIT,Spanish Lt,0,0,0,0,0,0,0,0,0,0,0,0,0,2,2,0,0,0,0,2,2
wi11,111,WARREN,MAE,Aerosp Eng,0,0,0,6,0,6,13,1,14,22,7,29,20,2,22,0,0,0,61,10,71
wi11,111,WARREN,MAE,Engin Sci,0,0,0,5,1,6,2,2,4,3,0,3,1,1,2,0,0,0,11,4,15
wi11,111,WARREN,MAE,Envir Eng,0,0,0,6,1,7,4,7,11,9,6,15,4,3,7,0,0,0,23,17,40
wi11,111,WARREN,MAE,Mech Engin,0,0,0,11,3,14,29,3,32,43,3,46,98,14,112,0,0,0,181,23,204
wi11,111,WARREN,MATH,Appld Math,0,0,0,3,0,3,0,0,0,2,1,3,6,2,8,0,0,0,11,3,14
wi11,111,WARREN,MATH,Math/SecEd,0,0,0,0,2,2,0,1,1,1,1,2,1,2,3,0,0,0,2,6,8
wi11,111,WARREN,MATH,Mathematcs,0,0,0,0,3,3,1,2,3,5,5,10,12,5,17,0,0,0,18,15,33
wi11,111,WARREN,MATH,Mth-CompSc,0,0,0,0,0,0,0,0,0,0,1,1,0,0,0,0,0,0,0,1,1
wi11,111,WARREN,MATH,Mth-Mth&Ec,0,0,0,2,0,2,2,1,3,2,2,4,3,2,5,0,0,0,9,5,14
wi11,111,WARREN,MATH,Mth-SciCom,0,0,0,0,0,0,0,0,0,1,0,1,2,0,2,0,0,0,3,0,3
wi11,111,WARREN,MATH,Mth/ApldSc,0,0,0,1,0,1,0,1,1,0,1,1,1,0,1,0,0,0,2,2,4
wi11,111,WARREN,MATH,Prob&Stats,0,0,0,1,0,1,2,0,2,0,1,1,0,2,2,0,0,0,3,3,6
wi11,111,WARREN,MUS,Mu-CompArt,0,0,0,0,0,0,0,0,0,2,0,2,9,0,9,0,0,0,11,0,11
wi11,111,WARREN,MUS,Music,0,0,0,1,0,1,1,1,2,1,3,4,5,1,6,0,0,0,8,5,13
wi11,111,WARREN,NENG,NanoEng,0,0,0,6,0,6,6,2,8,3,0,3,1,0,1,0,0,0,16,2,18
wi11,111,WARREN,PHIL,Philosophy,0,0,0,0,0,0,1,0,1,6,2,8,15,5,20,0,0,0,22,7,29
wi11,111,WARREN,PHYS,Biophysics,0,0,0,0,0,0,1,0,1,0,1,1,1,0,1,0,0,0,2,1,3
wi11,111,WARREN,PHYS,Phys/Astro,0,0,0,0,1,1,1,0,1,2,0,2,2,0,2,0,0,0,5,1,6
wi11,111,WARREN,PHYS,Phys/Comp,0,0,0,0,0,0,1,0,1,0,0,0,1,0,1,0,0,0,2,0,2
wi11,111,WARREN,PHYS,Phys/Mtrls,0,0,0,0,0,0,0,0,0,0,0,0,1,0,1,0,0,0,1,0,1
wi11,111,WARREN,PHYS,Physics,0,0,0,3,0,3,1,2,3,5,0,5,2,1,3,0,0,0,11,3,14
wi11,111,WARREN,POLI,Polit Sci,0,0,0,2,7,9,10,6,16,21,16,37,22,23,45,0,0,0,55,52,107
wi11,111,WARREN,POLI,PolSc-Amer,0,0,0,1,2,3,2,1,3,3,1,4,4,2,6,0,0,0,10,6,16
wi11,111,WARREN,POLI,PolSc-Comp,0,0,0,0,1,1,0,0,0,1,0,1,1,1,2,0,0,0,2,2,4
wi11,111,WARREN,POLI,PolSc-Intl,0,0,0,5,3,8,4,5,9,14,14,28,15,7,22,0,0,0,38,29,67
wi11,111,WARREN,POLI,PolSc-PLaw,0,0,0,1,5,6,1,7,8,8,7,15,6,6,12,0,0,0,16,25,41
wi11,111,WARREN,POLI,PolSc-PPol,0,0,0,0,0,0,1,0,1,1,2,3,0,1,1,0,0,0,2,3,5
wi11,111,WARREN,POLI,PolSc-Thry,0,0,0,0,0,0,0,0,0,1,0,1,1,2,3,0,0,0,2,2,4
wi11,111,WARREN,PSYC,Psychology,0,0,0,9,9,18,10,27,37,16,53,69,29,72,101,0,0,0,64,161,225
wi11,111,WARREN,RELI,Relig/Stu,0,0,0,0,0,0,0,1,1,0,1,1,0,0,0,0,0,0,0,2,2
wi11,111,WARREN,SE,Engin Sci,0,0,0,3,1,4,1,0,1,1,0,1,0,0,0,0,0,0,5,1,6
wi11,111,WARREN,SE,Struct Eng,0,0,0,19,6,25,23,7,30,25,11,36,54,22,76,0,0,0,121,46,167
wi11,111,WARREN,SIO,Earth Sci,0,0,0,0,0,0,1,1,2,0,1,1,2,1,3,0,0,0,3,3,6
wi11,111,WARREN,SIO,ErSc-Geoch,0,0,0,0,0,0,1,0,1,0,0,0,0,1,1,0,0,0,1,1,2
wi11,111,WARREN,SOC,SocCulCom,0,0,0,0,1,1,0,0,0,0,0,0,0,0,0,0,0,0,0,1,1
wi11,111,WARREN,SOC,SocIntlStu,0,0,0,0,0,0,0,0,0,1,0,1,1,1,2,0,0,0,2,1,3
wi11,111,WARREN,SOC,Sociology,0,0,0,0,2,2,1,2,3,4,9,13,3,13,16,0,0,0,8,26,34
wi11,111,WARREN,SOC,SocLawSoc,0,0,0,0,0,0,1,1,2,2,2,4,1,1,2,0,0,0,4,4,8
wi11,111,WARREN,SOC,SocSciMed,0,0,0,0,1,1,0,0,0,0,1,1,0,0,0,0,0,0,0,2,2
wi11,111,WARREN,SOC,SocSolneq,0,0,0,0,0,0,0,0,0,0,1,1,1,2,3,0,0,0,1,3,4
wi11,111,WARREN,THEA,Dance,0,0,0,0,0,0,0,0,0,0,1,1,1,0,1,0,0,0,1,1,2
wi11,111,WARREN,THEA,Theatre,0,0,0,2,0,2,0,0,0,1,2,3,1,0,1,0,0,0,4,2,6
wi11,111,WARREN,TWS,ThirdWldSt,0,0,0,0,0,0,0,0,0,0,1,1,0,0,0,0,0,0,0,1,1
wi11,111,WARREN,UNAF,IntcampVis,0,0,0,0,0,0,0,1,1,0,1,1,0,1,1,0,0,0,0,3,3
wi11,111,WARREN,UNAF,Limited St,0,0,0,0,0,0,0,0,0,0,0,0,0,0,0,2,2,4,2,2,4
wi11,111,WARREN,UNAF,UndecHumAr,0,0,0,0,1,1,1,0,1,0,0,0,0,0,0,0,0,0,1,1,2
wi11,111,WARREN,UNAF,Undeclared,0,0,0,20,27,47,16,16,32,3,2,5,0,0,0,0,0,0,39,45,84
wi11,111,WARREN,UNAF,UndecPhysS,0,0,0,3,4,7,2,2,4,0,0,0,0,0,0,0,0,0,5,6,11
wi11,111,WARREN,UNAF,UndecSocSc,0,0,0,1,2,3,1,3,4,0,0,0,0,0,0,0,0,0,2,5,7
wi11,111,WARREN,USP,Urb Stu&Pl,0,0,0,0,0,0,1,1,2,5,6,11,5,5,10,0,0,0,11,12,23
wi11,111,WARREN,VIS,Art Hst/Cr,0,0,0,0,0,0,0,0,0,0,0,0,2,2,4,0,0,0,2,2,4
wi11,111,WARREN,VIS,Media,0,0,0,0,1,1,0,2,2,7,5,12,7,6,13,0,0,0,14,14,28
wi11,111,WARREN,VIS,Studio VA,0,0,0,2,1,3,1,0,1,1,3,4,1,5,6,0,0,0,5,9,14
wi11,111,WARREN,VIS,VA-CompArt,0,0,0,0,1,1,0,0,0,1,0,1,1,0,1,0,0,0,2,1,3
sp14,142,MARSHALL,ANTH,Anth-Arch,0,0,0,0,0,0,0,0,0,0,0,0,1,0,1,0,0,0,1,0,1
sp14,142,MARSHALL,ANTH,Anth-Biol,0,0,0,0,1,1,0,0,0,0,2,2,0,5,5,0,0,0,0,8,8
sp14,142,MARSHALL,ANTH,Anth-Soci,0,0,0,0,0,0,0,0,0,0,4,4,1,5,6,0,0,0,1,9,10
sp14,142,MARSHALL,BENG,Bioen:Binf,0,0,0,1,0,1,1,3,4,3,1,4,2,5,7,0,0,0,7,9,16
sp14,142,MARSHALL,BENG,Bioeng:PM,0,0,0,0,0,0,0,0,0,0,0,0,0,1,1,0,0,0,0,1,1
sp14,142,MARSHALL,BENG,BioengBioS,0,0,0,0,0,0,8,2,10,0,0,0,0,0,0,0,0,0,8,2,10
sp14,142,MARSHALL,BENG,BioengBiot,0,0,0,0,0,0,0,1,1,6,1,7,9,7,16,0,0,0,15,9,24
sp14,142,MARSHALL,BENG,Bioengin,0,0,0,1,0,1,0,1,1,3,2,5,5,5,10,0,0,0,9,8,17
sp14,142,MARSHALL,BIOL,Bioc/CellB,0,0,0,4,6,10,18,22,40,22,47,69,29,41,70,0,0,0,73,116,189
sp14,142,MARSHALL,BIOL,BiolBioinf,0,0,0,0,0,0,0,2,2,3,1,4,0,0,0,0,0,0,3,3,6
sp14,142,MARSHALL,BIOL,Ec/Beh/Evo,0,0,0,0,0,0,0,0,0,2,0,2,2,4,6,0,0,0,4,4,8
sp14,142,MARSHALL,BIOL,Genl Biol,0,0,0,2,9,11,8,22,30,10,32,42,33,53,86,0,0,0,53,116,169
sp14,142,MARSHALL,BIOL,Human Bio,0,0,0,4,7,11,22,52,74,30,43,73,38,49,87,0,0,0,94,151,245
sp14,142,MARSHALL,BIOL,Microbiol,0,0,0,1,1,2,1,3,4,4,3,7,4,5,9,0,0,0,10,12,22
sp14,142,MARSHALL,BIOL,Molec Biol,0,0,0,0,0,0,4,2,6,5,3,8,3,2,5,0,0,0,12,7,19
sp14,142,MARSHALL,BIOL,PhyslNeuro,0,0,0,2,2,4,16,30,46,17,23,40,13,25,38,0,0,0,48,80,128
sp14,142,MARSHALL,CENG,Chem Engin,0,0,0,4,1,5,17,5,22,14,12,26,31,17,48,0,0,0,66,35,101
sp14,142,MARSHALL,CGS,CritGendSt,0,0,0,0,0,0,0,0,0,0,0,0,0,1,1,0,0,0,0,1,1
sp14,142,MARSHALL,CHEM,Bioch/Chem,0,0,0,2,0,2,6,3,9,1,8,9,11,18,29,0,0,0,20,29,49
sp14,142,MARSHALL,CHEM,Bioinform,0,0,0,1,0,1,0,0,0,0,0,0,1,0,1,0,0,0,2,0,2
sp14,142,MARSHALL,CHEM,Chem Phys,0,0,0,0,0,0,0,0,0,1,0,1,0,1,1,0,0,0,1,1,2
sp14,142,MARSHALL,CHEM,Chemistry,0,0,0,1,2,3,1,3,4,4,4,8,3,7,10,0,0,0,9,16,25
sp14,142,MARSHALL,CHEM,Envir Chem,0,0,0,0,0,0,0,1,1,0,0,0,0,1,1,0,0,0,0,2,2
sp14,142,MARSHALL,CHEM,MolecSynth,0,0,0,0,0,0,0,0,0,0,0,0,1,0,1,0,0,0,1,0,1
sp14,142,MARSHALL,CHEM,Pharm Chem,0,0,0,0,2,2,4,6,10,5,5,10,10,15,25,0,0,0,19,28,47
sp14,142,MARSHALL,CLAS,Classic St,0,0,0,0,0,0,0,0,0,0,1,1,0,0,0,0,0,0,0,1,1
sp14,142,MARSHALL,COGS,Cog Sci,0,0,0,0,0,0,4,4,8,2,4,6,4,5,9,0,0,0,10,13,23
sp14,142,MARSHALL,COGS,CogSc/ClAs,0,0,0,0,0,0,1,1,2,0,3,3,0,1,1,0,0,0,1,5,6
sp14,142,MARSHALL,COGS,CogSc/Comp,0,0,0,1,0,1,0,0,0,0,0,0,2,0,2,0,0,0,3,0,3
sp14,142,MARSHALL,COGS,CogSc/HCI,0,0,0,0,0,0,1,1,2,2,5,7,1,8,9,0,0,0,4,14,18
sp14,142,MARSHALL,COGS,CogSc/HCog,0,0,0,0,0,0,0,0,0,2,3,5,0,2,2,0,0,0,2,5,7
sp14,142,MARSHALL,COGS,CogSc/Neur,0,0,0,0,0,0,0,1,1,2,5,7,7,15,22,0,0,0,9,21,30
sp14,142,MARSHALL,COMM,Communic,0,0,0,0,4,4,1,18,19,18,37,55,13,69,82,0,0,0,32,128,160
sp14,142,MARSHALL,CSE,Comp Sci,0,0,0,0,0,0,14,4,18,50,12,62,79,20,99,0,0,0,143,36,179
sp14,142,MARSHALL,CSE,CompEngCSE,0,0,0,1,0,1,5,0,5,12,0,12,16,4,20,0,0,0,34,4,38
sp14,142,MARSHALL,CSE,CompScBinf,0,0,0,1,2,3,7,5,12,1,1,2,4,2,6,0,0,0,13,10,23
sp14,142,MARSHALL,ECE,CompEngECE,0,0,0,3,1,4,3,2,5,8,0,8,4,1,5,0,0,0,18,4,22
sp14,142,MARSHALL,ECE,Electr Eng,0,0,0,3,1,4,20,5,25,32,4,36,43,11,54,0,0,0,98,21,119
sp14,142,MARSHALL,ECON,Ec-Mth&Ecn,0,0,0,2,2,4,5,8,13,9,6,15,9,5,14,0,0,0,25,21,46
sp14,142,MARSHALL,ECON,Econ-MgtSc,0,0,0,3,8,11,10,14,24,22,25,47,51,40,91,0,0,0,86,87,173
sp14,142,MARSHALL,ECON,Economics,0,0,0,6,11,17,27,16,43,62,51,113,77,65,142,0,0,0,172,143,315
sp14,142,MARSHALL,ESYS,EnvSys(EB),0,0,0,0,0,0,2,2,4,0,1,1,3,10,13,0,0,0,5,13,18
sp14,142,MARSHALL,ESYS,EnvSys(EC),0,0,0,0,0,0,0,0,0,1,2,3,2,1,3,0,0,0,3,3,6
sp14,142,MARSHALL,ESYS,EnvSys(EP),0,0,0,0,1,1,0,1,1,1,2,3,1,3,4,0,0,0,2,7,9
sp14,142,MARSHALL,ESYS,EnvSys(ES),0,0,0,0,0,0,0,0,0,0,0,0,0,1,1,0,0,0,0,1,1
sp14,142,MARSHALL,ETHN,Ethnic St,0,0,0,0,0,0,0,1,1,0,0,0,2,6,8,0,0,0,2,7,9
sp14,142,MARSHALL,FPMU,Public Hlt,0,0,0,0,1,1,3,12,15,3,14,17,0,10,10,0,0,0,6,37,43
sp14,142,MARSHALL,HDP,Human Dev,0,0,0,0,0,0,0,0,0,0,9,9,4,41,45,0,0,0,4,50,54
sp14,142,MARSHALL,HDP,Pr-HumnDev,0,0,0,0,2,2,0,9,9,0,7,7,0,2,2,0,0,0,0,20,20
sp14,142,MARSHALL,HIST,History,0,0,0,0,0,0,1,2,3,2,1,3,11,7,18,0,0,0,14,10,24
sp14,142,MARSHALL,INTL,Int-5yrEC,0,0,0,0,0,0,0,0,0,0,0,0,1,2,3,0,0,0,1,2,3
sp14,142,MARSHALL,INTL,Int-5yrPS,0,0,0,0,0,0,0,0,0,0,0,0,1,0,1,0,0,0,1,0,1
sp14,142,MARSHALL,INTL,IntSt-Anth,0,0,0,0,0,0,0,0,0,0,0,0,1,2,3,0,0,0,1,2,3
sp14,142,MARSHALL,INTL,IntSt-Econ,0,0,0,2,0,2,0,2,2,1,2,3,5,18,23,0,0,0,8,22,30
sp14,142,MARSHALL,INTL,IntSt-Hist,0,0,0,0,0,0,0,0,0,0,0,0,0,1,1,0,0,0,0,1,1
sp14,142,MARSHALL,INTL,IntSt-Ling,0,0,0,0,0,0,0,0,0,0,0,0,0,2,2,0,0,0,0,2,2
sp14,142,MARSHALL,INTL,IntSt-PolS,0,0,0,1,2,3,1,4,5,0,4,4,6,15,21,0,0,0,8,25,33
sp14,142,MARSHALL,INTL,IntSt-Soc,0,0,0,1,0,1,0,1,1,0,3,3,2,3,5,0,0,0,3,7,10
sp14,142,MARSHALL,JAPN,JapaneseSt,0,0,0,0,0,0,0,0,0,1,0,1,0,1,1,0,0,0,1,1,2
sp14,142,MARSHALL,LATI,LatinAm St,0,0,0,0,0,0,0,0,0,0,1,1,0,0,0,0,0,0,0,1,1
sp14,142,MARSHALL,LING,Lang Stu,0,0,0,0,0,0,0,0,0,1,0,1,1,0,1,0,0,0,2,0,2
sp14,142,MARSHALL,LING,Ling-CogLn,0,0,0,0,0,0,1,1,2,0,2,2,0,0,0,0,0,0,1,3,4
sp14,142,MARSHALL,LING,Ling-LSoc,0,0,0,0,0,0,0,0,0,0,1,1,0,2,2,0,0,0,0,3,3
sp14,142,MARSHALL,LING,Linguistcs,0,0,0,0,0,0,0,0,0,0,2,2,3,1,4,0,0,0,3,3,6
sp14,142,MARSHALL,LIT,Ital Lit,0,0,0,0,0,0,0,0,0,0,0,0,1,0,1,0,0,0,1,0,1
sp14,142,MARSHALL,LIT,Lit/Compos,0,0,0,0,0,0,0,0,0,0,1,1,0,0,0,0,0,0,0,1,1
sp14,142,MARSHALL,LIT,Lit/CultSt,0,0,0,0,0,0,0,0,0,0,0,0,0,1,1,0,0,0,0,1,1
sp14,142,MARSHALL,LIT,Lit/Engl,0,0,0,1,0,1,0,0,0,1,1,2,3,5,8,0,0,0,5,6,11
sp14,142,MARSHALL,LIT,Lit/World,0,0,0,0,0,0,0,0,0,0,1,1,0,2,2,0,0,0,0,3,3
sp14,142,MARSHALL,LIT,Lit/Writng,0,0,0,1,0,1,3,4,7,2,2,4,0,4,4,0,0,0,6,10,16
sp14,142,MARSHALL,MAE,Aerosp Eng,0,0,0,0,0,0,3,0,3,1,0,1,18,6,24,0,0,0,22,6,28
sp14,142,MARSHALL,MAE,Engin Sci,0,0,0,0,0,0,0,0,0,0,0,0,1,0,1,0,0,0,1,0,1
sp14,142,MARSHALL,MAE,Envir Eng,0,0,0,1,0,1,7,6,13,4,2,6,8,4,12,0,0,0,20,12,32
sp14,142,MARSHALL,MAE,Mech Engin,0,0,0,1,0,1,1,0,1,3,0,3,23,6,29,0,0,0,28,6,34
sp14,142,MARSHALL,MATH,Appld Math,0,0,0,0,2,2,3,8,11,4,1,5,6,6,12,0,0,0,13,17,30
sp14,142,MARSHALL,MATH,Math/SecEd,0,0,0,0,1,1,3,0,3,1,0,1,1,1,2,0,0,0,5,2,7
sp14,142,MARSHALL,MATH,Mathematcs,0,0,0,2,1,3,3,2,5,0,2,2,3,6,9,0,0,0,8,11,19
sp14,142,MARSHALL,MATH,Mth-CompSc,0,0,0,5,1,6,3,3,6,0,1,1,2,1,3,0,0,0,10,6,16
sp14,142,MARSHALL,MATH,Mth-Mth&Ec,0,0,0,1,1,2,4,3,7,4,5,9,5,8,13,0,0,0,14,17,31
sp14,142,MARSHALL,MATH,Mth/ApldSc,0,0,0,0,0,0,0,1,1,0,0,0,1,0,1,0,0,0,1,1,2
sp14,142,MARSHALL,MATH,Prob&Stats,0,0,0,0,0,0,1,4,5,1,1,2,2,2,4,0,0,0,4,7,11
sp14,142,MARSHALL,MUS,Mu-CompArt,0,0,0,0,0,0,0,0,0,1,0,1,0,0,0,0,0,0,1,0,1
sp14,142,MARSHALL,MUS,Music,0,0,0,1,0,1,0,0,0,0,0,0,1,1,2,0,0,0,2,1,3
sp14,142,MARSHALL,MUS,Music Hum,0,0,0,0,0,0,0,1,1,0,0,0,1,0,1,0,0,0,1,1,2
sp14,142,MARSHALL,NENG,NanoEng,0,0,0,2,0,2,11,3,14,12,3,15,11,2,13,0,0,0,36,8,44
sp14,142,MARSHALL,PHIL,Philosophy,0,0,0,0,0,0,0,1,1,2,0,2,5,3,8,0,0,0,7,4,11
sp14,142,MARSHALL,PHYS,Biophysics,0,0,0,0,0,0,1,0,1,2,0,2,1,0,1,0,0,0,4,0,4
sp14,142,MARSHALL,PHYS,GenPys/SEd,0,0,0,0,0,0,0,0,0,0,0,0,1,1,2,0,0,0,1,1,2
sp14,142,MARSHALL,PHYS,Phys/Astro,0,0,0,3,0,3,1,0,1,0,0,0,1,0,1,0,0,0,5,0,5
sp14,142,MARSHALL,PHYS,Phys/Mtrls,0,0,0,0,0,0,0,0,0,0,0,0,1,0,1,0,0,0,1,0,1
sp14,142,MARSHALL,PHYS,Physics,0,0,0,0,0,0,3,2,5,1,0,1,4,2,6,0,0,0,8,4,12
sp14,142,MARSHALL,POLI,Polit Sci,0,0,0,0,3,3,5,4,9,11,11,22,16,14,30,0,0,0,32,32,64
sp14,142,MARSHALL,POLI,PolSc-Amer,0,0,0,0,0,0,0,0,0,3,1,4,4,6,10,0,0,0,7,7,14
sp14,142,MARSHALL,POLI,PolSc-Comp,0,0,0,0,0,0,0,0,0,0,0,0,1,3,4,0,0,0,1,3,4
sp14,142,MARSHALL,POLI,PolSc-Intl,0,0,0,0,2,2,2,4,6,3,5,8,14,8,22,0,0,0,19,19,38
sp14,142,MARSHALL,POLI,PolSc-PLaw,0,0,0,0,1,1,1,4,5,5,3,8,8,8,16,0,0,0,14,16,30
sp14,142,MARSHALL,POLI,PolSc-PPol,0,0,0,0,0,0,0,2,2,2,1,3,2,1,3,0,0,0,4,4,8
sp14,142,MARSHALL,POLI,PolSc-Thry,0,0,0,0,0,0,0,1,1,2,0,2,2,2,4,0,0,0,4,3,7
sp14,142,MARSHALL,PSYC,Psychology,0,0,0,1,8,9,10,22,32,18,48,66,31,87,118,0,0,0,60,165,225
sp14,142,MARSHALL,SE,Engin Sci,0,0,0,0,0,0,0,0,0,1,0,1,0,0,0,0,0,0,1,0,1
sp14,142,MARSHALL,SE,Struct Eng,0,0,0,4,2,6,8,1,9,18,3,21,34,9,43,0,0,0,64,15,79
sp14,142,MARSHALL,SIO,Earth Sci,0,0,0,0,0,0,0,2,2,0,0,0,1,1,2,0,0,0,1,3,4
sp14,142,MARSHALL,SIO,Marine Bio,0,0,0,0,1,1,1,5,6,0,4,4,1,0,1,0,0,0,2,10,12
sp14,142,MARSHALL,SOC,SocAmSt,0,0,0,0,0,0,0,0,0,0,1,1,0,0,0,0,0,0,0,1,1
sp14,142,MARSHALL,SOC,SocCulCom,0,0,0,0,0,0,0,0,0,1,1,2,0,1,1,0,0,0,1,2,3
sp14,142,MARSHALL,SOC,SocEconSoc,0,0,0,0,0,0,0,0,0,0,0,0,1,1,2,0,0,0,1,1,2
sp14,142,MARSHALL,SOC,SocIntlStu,0,0,0,0,0,0,0,0,0,0,1,1,1,1,2,0,0,0,1,2,3
sp14,142,MARSHALL,SOC,Sociology,0,0,0,1,2,3,0,1,1,6,6,12,12,16,28,0,0,0,19,25,44
sp14,142,MARSHALL,SOC,SocLawSoc,0,0,0,0,0,0,0,2,2,1,1,2,3,6,9,0,0,0,4,9,13
sp14,142,MARSHALL,SOC,SocSciMed,0,0,0,0,0,0,0,0,0,0,0,0,4,3,7,0,0,0,4,3,7
sp14,142,MARSHALL,SOC,SocSolneq,0,0,0,0,0,0,0,1,1,0,4,4,0,4,4,0,0,0,0,9,9
sp14,142,MARSHALL,THEA,Dance,0,0,0,0,0,0,0,0,0,0,0,0,1,1,2,0,0,0,1,1,2
sp14,142,MARSHALL,THEA,Theatre,0,0,0,0,0,0,0,0,0,0,1,1,2,4,6,0,0,0,2,5,7
sp14,142,MARSHALL,UNAF,Limited St,0,0,0,0,0,0,0,0,0,0,0,0,0,0,0,1,0,1,1,0,1
sp14,142,MARSHALL,UNAF,Undeclared,0,0,0,6,5,11,13,11,24,1,0,1,0,0,0,0,0,0,20,16,36
sp14,142,MARSHALL,UNAF,UndecPhysS,0,0,0,0,0,0,1,1,2,0,0,0,0,0,0,0,0,0,1,1,2
sp14,142,MARSHALL,UNAF,UndecSocSc,0,0,0,0,0,0,4,2,6,0,0,0,0,0,0,0,0,0,4,2,6
sp14,142,MARSHALL,USP,Urb Stu&Pl,0,0,0,0,0,0,1,1,2,2,3,5,10,5,15,0,0,0,13,9,22
sp14,142,MARSHALL,VIS,Art Hst/Cr,0,0,0,0,0,0,0,0,0,0,3,3,0,0,0,0,0,0,0,3,3
sp14,142,MARSHALL,VIS,Media,0,0,0,0,1,1,0,2,2,0,5,5,12,3,15,0,0,0,12,11,23
sp14,142,MARSHALL,VIS,Studio VA,0,0,0,0,2,2,1,0,1,0,0,0,1,4,5,0,0,0,2,6,8
sp14,142,MARSHALL,VIS,VA-CompArt,0,0,0,0,0,0,2,4,6,1,1,2,3,1,4,0,0,0,6,6,12
sp14,142,MUIR,ANTH,Anth-Arch,0,0,0,0,0,0,0,0,0,1,2,3,3,6,9,0,0,0,4,8,12
sp14,142,MUIR,ANTH,Anth-Biol,0,0,0,0,0,0,0,1,1,0,7,7,2,10,12,0,0,0,2,18,20
sp14,142,MUIR,ANTH,Anth-Soci,0,0,0,0,0,0,0,1,1,1,2,3,1,5,6,0,0,0,2,8,10
sp14,142,MUIR,BENG,Bioen:Binf,0,0,0,0,2,2,3,3,6,3,1,4,5,1,6,0,0,0,11,7,18
sp14,142,MUIR,BENG,Bioeng:PM,0,0,0,0,0,0,0,0,0,0,0,0,1,0,1,0,0,0,1,0,1
sp14,142,MUIR,BENG,BioengBioS,0,0,0,1,0,1,2,0,2,0,2,2,0,0,0,0,0,0,3,2,5
sp14,142,MUIR,BENG,BioengBiot,0,0,0,0,0,0,4,5,9,0,2,2,10,8,18,0,0,0,14,15,29
sp14,142,MUIR,BENG,Bioengin,0,0,0,0,0,0,3,2,5,10,2,12,10,7,17,0,0,0,23,11,34
sp14,142,MUIR,BIOL,Bioc/CellB,0,0,0,4,7,11,18,28,46,18,28,46,41,35,76,0,0,0,81,98,179
sp14,142,MUIR,BIOL,BiolBioinf,0,0,0,0,0,0,0,0,0,2,0,2,1,0,1,0,0,0,3,0,3
sp14,142,MUIR,BIOL,Ec/Beh/Evo,0,0,0,0,1,1,1,5,6,3,5,8,5,18,23,0,0,0,9,29,38
sp14,142,MUIR,BIOL,Genl Biol,0,0,0,3,20,23,21,24,45,13,28,41,40,58,98,0,0,0,77,130,207
sp14,142,MUIR,BIOL,Human Bio,0,0,0,5,20,25,23,62,85,17,48,65,40,62,102,0,0,0,85,192,277
sp14,142,MUIR,BIOL,Microbiol,0,0,0,0,0,0,4,5,9,3,0,3,3,4,7,0,0,0,10,9,19
sp14,142,MUIR,BIOL,Molec Biol,0,0,0,1,0,1,4,5,9,4,5,9,6,9,15,0,0,0,15,19,34
sp14,142,MUIR,BIOL,PhyslNeuro,0,0,0,1,6,7,14,32,46,16,22,38,28,25,53,0,0,0,59,85,144
sp14,142,MUIR,CENG,Chem Engin,0,0,0,5,4,9,16,8,24,11,8,19,21,17,38,0,0,0,53,37,90
sp14,142,MUIR,CGS,CritGendSt,0,0,0,0,0,0,1,1,2,0,3,3,0,2,2,0,0,0,1,6,7
sp14,142,MUIR,CHEM,Bioch/Chem,0,0,0,0,1,1,2,7,9,5,8,13,15,19,34,0,0,0,22,35,57
sp14,142,MUIR,CHEM,Bioinform,0,0,0,0,0,0,1,0,1,0,0,0,1,0,1,0,0,0,2,0,2
sp14,142,MUIR,CHEM,Chem Educ,0,0,0,0,0,0,0,1,1,0,0,0,0,0,0,0,0,0,0,1,1
sp14,142,MUIR,CHEM,Chem Phys,0,0,0,1,0,1,1,0,1,0,0,0,0,0,0,0,0,0,2,0,2
sp14,142,MUIR,CHEM,Chemistry,0,0,0,0,0,0,2,2,4,3,2,5,8,3,11,0,0,0,13,7,20
sp14,142,MUIR,CHEM,Envir Chem,0,0,0,0,0,0,0,0,0,1,2,3,0,0,0,0,0,0,1,2,3
sp14,142,MUIR,CHEM,MolecSynth,0,0,0,1,0,1,0,0,0,2,0,2,1,1,2,0,0,0,4,1,5
sp14,142,MUIR,CHEM,Pharm Chem,0,0,0,1,1,2,1,7,8,4,10,14,23,15,38,0,0,0,29,33,62
sp14,142,MUIR,CHIN,Chinese St,0,0,0,0,0,0,0,0,0,0,0,0,1,2,3,0,0,0,1,2,3
sp14,142,MUIR,COGS,Cog Sci,0,0,0,0,4,4,5,4,9,2,9,11,4,9,13,0,0,0,11,26,37
sp14,142,MUIR,COGS,CogSc/ClAs,0,0,0,0,0,0,0,1,1,0,1,1,1,8,9,0,0,0,1,10,11
sp14,142,MUIR,COGS,CogSc/Comp,0,0,0,0,0,0,0,0,0,0,0,0,3,1,4,0,0,0,3,1,4
sp14,142,MUIR,COGS,CogSc/HCI,0,0,0,0,0,0,2,0,2,2,5,7,5,11,16,0,0,0,9,16,25
sp14,142,MUIR,COGS,CogSc/HCog,0,0,0,0,0,0,0,2,2,0,1,1,0,5,5,0,0,0,0,8,8
sp14,142,MUIR,COGS,CogSc/Neur,0,0,0,1,1,2,3,1,4,3,7,10,17,20,37,0,0,0,24,29,53
sp14,142,MUIR,COMM,Communic,0,0,0,2,8,10,6,12,18,13,29,42,14,43,57,0,0,0,35,92,127
sp14,142,MUIR,CSE,Comp Sci,0,0,0,0,0,0,15,10,25,53,13,66,90,21,111,0,0,0,158,44,202
sp14,142,MUIR,CSE,CompEngCSE,0,0,0,0,0,0,4,1,5,13,1,14,16,0,16,0,0,0,33,2,35
sp14,142,MUIR,CSE,CompScBinf,0,0,0,0,1,1,2,1,3,2,0,2,5,1,6,0,0,0,9,3,12
sp14,142,MUIR,ECE,CompEngECE,0,0,0,0,0,0,5,1,6,4,1,5,3,0,3,0,0,0,12,2,14
sp14,142,MUIR,ECE,Electr Eng,0,0,0,9,3,12,23,2,25,26,2,28,29,9,38,0,0,0,87,16,103
sp14,142,MUIR,ECE,Engin Phys,0,0,0,0,0,0,0,0,0,1,0,1,1,0,1,0,0,0,2,0,2
sp14,142,MUIR,ECE,Pr-EngPhys,0,0,0,0,0,0,1,0,1,1,0,1,0,0,0,0,0,0,2,0,2
sp14,142,MUIR,ECON,Ec-Mth&Ecn,0,0,0,2,1,3,5,2,7,4,2,6,9,5,14,0,0,0,20,10,30
sp14,142,MUIR,ECON,Econ-MgtSc,0,0,0,4,1,5,10,7,17,19,22,41,31,31,62,0,0,0,64,61,125
sp14,142,MUIR,ECON,Economics,0,0,0,8,3,11,13,8,21,33,38,71,55,37,92,0,0,0,109,86,195
sp14,142,MUIR,ESYS,EnvSys(EB),0,0,0,0,2,2,1,1,2,5,3,8,6,17,23,0,0,0,12,23,35
sp14,142,MUIR,ESYS,EnvSys(EC),0,0,0,0,0,0,0,0,0,1,0,1,1,1,2,0,0,0,2,1,3
sp14,142,MUIR,ESYS,EnvSys(EP),0,0,0,0,1,1,2,0,2,0,0,0,1,3,4,0,0,0,3,4,7
sp14,142,MUIR,ESYS,EnvSys(ES),0,0,0,0,0,0,0,0,0,2,0,2,2,2,4,0,0,0,4,2,6
sp14,142,MUIR,ETHN,Ethnic St,0,0,0,0,1,1,0,1,1,0,1,1,4,0,4,0,0,0,4,3,7
sp14,142,MUIR,FPMU,Public Hlt,0,0,0,0,2,2,4,9,13,2,9,11,0,10,10,0,0,0,6,30,36
sp14,142,MUIR,HDP,Human Dev,0,0,0,0,0,0,0,0,0,1,7,8,8,30,38,0,0,0,9,37,46
sp14,142,MUIR,HDP,Pr-HumnDev,0,0,0,0,2,2,0,9,9,0,8,8,1,2,3,0,0,0,1,21,22
sp14,142,MUIR,HIST,History,0,0,0,1,0,1,3,3,6,5,4,9,7,5,12,0,0,0,16,12,28
sp14,142,MUIR,INTD,Muir Sp Pr,0,0,0,0,0,0,0,0,0,0,0,0,0,1,1,0,0,0,0,1,1
sp14,142,MUIR,INTL,Int-5yrPS,0,0,0,0,0,0,0,0,0,0,0,0,0,1,1,0,0,0,0,1,1
sp14,142,MUIR,INTL,IntSt-Anth,0,0,0,0,0,0,0,1,1,0,0,0,0,1,1,0,0,0,0,2,2
sp14,142,MUIR,INTL,IntSt-Econ,0,0,0,0,2,2,2,5,7,3,7,10,2,6,8,0,0,0,7,20,27
sp14,142,MUIR,INTL,IntSt-Hist,0,0,0,0,0,0,0,0,0,0,0,0,1,0,1,0,0,0,1,0,1
sp14,142,MUIR,INTL,IntSt-Ling,0,0,0,0,0,0,0,0,0,0,0,0,0,1,1,0,0,0,0,1,1
sp14,142,MUIR,INTL,IntSt-PolS,0,0,0,0,0,0,0,1,1,4,5,9,5,10,15,0,0,0,9,16,25
sp14,142,MUIR,INTL,IntSt-Soc,0,0,0,0,1,1,0,2,2,2,4,6,1,6,7,0,0,0,3,13,16
sp14,142,MUIR,ITAL,Italian St,0,0,0,0,0,0,0,1,1,0,0,0,0,0,0,0,0,0,0,1,1
sp14,142,MUIR,JAPN,JapaneseSt,0,0,0,0,0,0,0,1,1,0,2,2,2,0,2,0,0,0,2,3,5
sp14,142,MUIR,LING,Lang Stu,0,0,0,0,1,1,1,0,1,2,0,2,0,2,2,0,0,0,3,3,6
sp14,142,MUIR,LING,Ling-CogLn,0,0,0,0,0,0,0,0,0,4,2,6,1,6,7,0,0,0,5,8,13
sp14,142,MUIR,LING,Linguistcs,0,0,0,0,0,0,0,0,0,0,4,4,3,2,5,0,0,0,3,6,9
sp14,142,MUIR,LIT,Lit/CultSt,0,0,0,0,0,0,0,0,0,0,0,0,0,1,1,0,0,0,0,1,1
sp14,142,MUIR,LIT,Lit/Engl,0,0,0,0,2,2,0,3,3,0,3,3,2,9,11,0,0,0,2,17,19
sp14,142,MUIR,LIT,Lit/World,0,0,0,0,0,0,0,0,0,0,0,0,1,1,2,0,0,0,1,1,2
sp14,142,MUIR,LIT,Lit/Writng,0,0,0,0,1,1,3,5,8,3,6,9,5,12,17,0,0,0,11,24,35
sp14,142,MUIR,LIT,Spanish Lt,0,0,0,0,0,0,0,0,0,0,1,1,1,6,7,0,0,0,1,7,8
sp14,142,MUIR,MAE,Aerosp Eng,0,0,0,0,0,0,4,1,5,5,0,5,16,5,21,0,0,0,25,6,31
sp14,142,MUIR,MAE,Engin Sci,0,0,0,0,0,0,0,0,0,0,0,0,1,1,2,0,0,0,1,1,2
sp14,142,MUIR,MAE,Envir Eng,0,0,0,5,2,7,2,8,10,8,5,13,11,13,24,0,0,0,26,28,54
sp14,142,MUIR,MAE,Mech Engin,0,0,0,1,0,1,9,0,9,8,5,13,23,2,25,0,0,0,41,7,48
sp14,142,MUIR,MATH,Appld Math,0,0,0,0,3,3,3,3,6,7,1,8,2,4,6,0,0,0,12,11,23
sp14,142,MUIR,MATH,Math/SecEd,0,0,0,0,1,1,0,0,0,2,2,4,1,6,7,0,0,0,3,9,12
sp14,142,MUIR,MATH,Mathematcs,0,0,0,0,1,1,5,3,8,9,3,12,7,1,8,0,0,0,21,8,29
sp14,142,MUIR,MATH,Mth-CompSc,0,0,0,0,1,1,2,1,3,1,0,1,3,1,4,0,0,0,6,3,9
sp14,142,MUIR,MATH,Mth-Mth&Ec,0,0,0,0,1,1,3,1,4,5,3,8,8,2,10,0,0,0,16,7,23
sp14,142,MUIR,MATH,Mth-SciCom,0,0,0,0,0,0,0,1,1,0,0,0,0,0,0,0,0,0,0,1,1
sp14,142,MUIR,MATH,Prob&Stats,0,0,0,0,0,0,1,1,2,2,2,4,0,2,2,0,0,0,3,5,8
sp14,142,MUIR,MUS,Mu-CompArt,0,0,0,1,0,1,0,0,0,3,2,5,5,1,6,0,0,0,9,3,12
sp14,142,MUIR,MUS,Music,0,0,0,0,1,1,2,0,2,0,2,2,3,1,4,0,0,0,5,4,9
sp14,142,MUIR,MUS,Music Hum,0,0,0,0,0,0,0,0,0,0,0,0,2,1,3,0,0,0,2,1,3
sp14,142,MUIR,NENG,NanoEng,0,0,0,0,0,0,9,4,13,8,2,10,17,5,22,0,0,0,34,11,45
sp14,142,MUIR,PHIL,Philosophy,0,0,0,0,0,0,0,1,1,2,0,2,4,2,6,0,0,0,6,3,9
sp14,142,MUIR,PHYS,Biophysics,0,0,0,2,0,2,0,2,2,0,1,1,2,0,2,0,0,0,4,3,7
sp14,142,MUIR,PHYS,Phys/Astro,0,0,0,1,0,1,0,1,1,1,0,1,2,0,2,0,0,0,4,1,5
sp14,142,MUIR,PHYS,Phys/Comp,0,0,0,0,0,0,1,0,1,0,0,0,2,0,2,0,0,0,3,0,3
sp14,142,MUIR,PHYS,Phys/Mtrls,0,0,0,0,0,0,0,0,0,0,0,0,2,0,2,0,0,0,2,0,2
sp14,142,MUIR,PHYS,Physics,0,0,0,0,0,0,5,2,7,5,0,5,6,1,7,0,0,0,16,3,19
sp14,142,MUIR,POLI,Polit Sci,0,0,0,0,4,4,0,7,7,11,6,17,14,13,27,0,0,0,25,30,55
sp14,142,MUIR,POLI,PolSc-Amer,0,0,0,0,0,0,0,0,0,2,4,6,7,2,9,0,0,0,9,6,15
sp14,142,MUIR,POLI,PolSc-Comp,0,0,0,0,0,0,1,0,1,2,0,2,0,0,0,0,0,0,3,0,3
sp14,142,MUIR,POLI,PolSc-Intl,0,0,0,0,0,0,0,3,3,9,4,13,8,12,20,0,0,0,17,19,36
sp14,142,MUIR,POLI,PolSc-PLaw,0,0,0,0,1,1,2,5,7,5,2,7,5,5,10,0,0,0,12,13,25
sp14,142,MUIR,POLI,PolSc-PPol,0,0,0,0,0,0,0,2,2,0,3,3,3,1,4,0,0,0,3,6,9
sp14,142,MUIR,POLI,PolSc-Thry,0,0,0,0,1,1,0,0,0,0,1,1,1,0,1,0,0,0,1,2,3
sp14,142,MUIR,PSYC,Psychology,0,0,0,2,10,12,12,33,45,17,60,77,39,96,135,0,0,0,70,199,269
sp14,142,MUIR,RUSS,Russ&SovSt,0,0,0,0,0,0,0,0,0,0,0,0,0,2,2,0,0,0,0,2,2
sp14,142,MUIR,SE,Struct Eng,0,0,0,7,1,8,12,9,21,16,8,24,34,12,46,0,0,0,69,30,99
sp14,142,MUIR,SIO,Earth Sci,0,0,0,2,0,2,1,1,2,0,1,1,6,1,7,0,0,0,9,3,12
sp14,142,MUIR,SIO,Marine Bio,0,0,0,3,5,8,2,4,6,3,7,10,2,9,11,0,0,0,10,25,35
sp14,142,MUIR,SOC,SocCulCom,0,0,0,0,0,0,0,0,0,0,2,2,0,3,3,0,0,0,0,5,5
sp14,142,MUIR,SOC,SocEconSoc,0,0,0,0,1,1,0,0,0,0,2,2,0,1,1,0,0,0,0,4,4
sp14,142,MUIR,SOC,SocIntlStu,0,0,0,0,0,0,0,0,0,0,1,1,0,1,1,0,0,0,0,2,2
sp14,142,MUIR,SOC,Sociology,0,0,0,0,4,4,0,0,0,4,9,13,3,14,17,0,0,0,7,27,34
sp14,142,MUIR,SOC,SocLawSoc,0,0,0,0,0,0,0,3,3,1,4,5,2,6,8,0,0,0,3,13,16
sp14,142,MUIR,SOC,SocSciMed,0,0,0,0,0,0,0,0,0,0,0,0,1,2,3,0,0,0,1,2,3
sp14,142,MUIR,SOC,SocSolneq,0,0,0,0,0,0,0,1,1,0,5,5,0,1,1,0,0,0,0,7,7
sp14,142,MUIR,THEA,Dance,0,0,0,0,0,0,0,0,0,0,1,1,0,2,2,0,0,0,0,3,3
sp14,142,MUIR,THEA,Theatre,0,0,0,0,3,3,0,4,4,2,5,7,4,6,10,0,0,0,6,18,24
sp14,142,MUIR,TWS,ThirdWldSt,0,0,0,0,1,1,0,0,0,0,0,0,0,0,0,0,0,0,0,1,1
sp14,142,MUIR,UNAF,UndecHumAr,0,0,0,0,1,1,2,1,3,0,0,0,0,0,0,0,0,0,2,2,4
sp14,142,MUIR,UNAF,Undeclared,0,0,0,11,13,24,14,13,27,1,1,2,0,0,0,0,0,0,26,27,53
sp14,142,MUIR,UNAF,UndecPhysS,0,0,0,1,0,1,3,3,6,0,0,0,0,0,0,0,0,0,4,3,7
sp14,142,MUIR,UNAF,UndecSocSc,0,0,0,1,5,6,5,3,8,0,0,0,0,0,0,0,0,0,6,8,14
sp14,142,MUIR,USP,Urb Stu&Pl,0,0,0,1,0,1,0,3,3,3,3,6,9,7,16,0,0,0,13,13,26
sp14,142,MUIR,VIS,Art Hst/Cr,0,0,0,0,0,0,0,0,0,0,1,1,2,2,4,0,0,0,2,3,5
sp14,142,MUIR,VIS,Media,0,0,0,0,0,0,1,2,3,3,3,6,15,10,25,0,0,0,19,15,34
sp14,142,MUIR,VIS,Studio VA,0,0,0,0,1,1,0,1,1,0,2,2,0,7,7,0,0,0,0,11,11
sp14,142,MUIR,VIS,VA-CompArt,0,0,0,0,0,0,0,0,0,0,2,2,5,3,8,0,0,0,5,5,10
sp14,142,REVELLE,ANTH,Anth-Arch,0,0,0,0,0,0,0,1,1,0,0,0,0,2,2,0,0,0,0,3,3
sp14,142,REVELLE,ANTH,Anth-Biol,0,0,0,0,0,0,0,1,1,0,3,3,2,2,4,0,0,0,2,6,8
sp14,142,REVELLE,ANTH,Anth-Soci,0,0,0,0,0,0,0,2,2,0,0,0,0,2,2,0,0,0,0,4,4
sp14,142,REVELLE,BENG,Bioen:Binf,0,0,0,0,0,0,10,4,14,3,1,4,5,6,11,0,0,0,18,11,29
sp14,142,REVELLE,BENG,BioengBioS,0,0,0,3,0,3,5,3,8,2,0,2,1,0,1,0,0,0,11,3,14
sp14,142,REVELLE,BENG,BioengBiot,0,0,0,1,0,1,1,1,2,12,4,16,21,8,29,0,0,0,35,13,48
sp14,142,REVELLE,BENG,Bioengin,0,0,0,1,0,1,4,1,5,5,4,9,12,10,22,0,0,0,22,15,37
sp14,142,REVELLE,BIOL,Bioc/CellB,0,0,0,3,2,5,24,43,67,33,45,78,43,47,90,0,0,0,103,137,240
sp14,142,REVELLE,BIOL,BiolBioinf,0,0,0,0,0,0,1,0,1,0,3,3,1,0,1,0,0,0,2,3,5
sp14,142,REVELLE,BIOL,Ec/Beh/Evo,0,0,0,0,1,1,1,0,1,1,2,3,3,6,9,0,0,0,5,9,14
sp14,142,REVELLE,BIOL,Genl Biol,0,0,0,2,5,7,18,24,42,25,34,59,35,53,88,0,0,0,80,116,196
sp14,142,REVELLE,BIOL,Human Bio,0,0,0,9,22,31,28,75,103,43,55,98,36,73,109,0,0,0,116,225,341
sp14,142,REVELLE,BIOL,Microbiol,0,0,0,1,0,1,4,9,13,6,6,12,7,6,13,0,0,0,18,21,39
sp14,142,REVELLE,BIOL,Molec Biol,0,0,0,1,1,2,5,6,11,12,6,18,4,7,11,0,0,0,22,20,42
sp14,142,REVELLE,BIOL,PhyslNeuro,0,0,0,6,4,10,17,30,47,25,28,53,33,36,69,0,0,0,81,98,179
sp14,142,REVELLE,CENG,Chem Engin,0,0,0,9,3,12,25,12,37,34,12,46,50,19,69,0,0,0,118,46,164
sp14,142,REVELLE,CGS,CritGendSt,0,0,0,0,0,0,0,0,0,1,0,1,1,1,2,0,0,0,2,1,3
sp14,142,REVELLE,CHEM,Bioch/Chem,0,0,0,1,2,3,4,9,13,9,3,12,27,20,47,0,0,0,41,34,75
sp14,142,REVELLE,CHEM,Bioinform,0,0,0,0,0,0,0,0,0,1,0,1,0,1,1,0,0,0,1,1,2
sp14,142,REVELLE,CHEM,Chem Educ,0,0,0,0,0,0,0,0,0,0,1,1,0,0,0,0,0,0,0,1,1
sp14,142,REVELLE,CHEM,Chem Phys,0,0,0,0,0,0,0,0,0,3,0,3,0,1,1,0,0,0,3,1,4
sp14,142,REVELLE,CHEM,Chemistry,0,0,0,3,1,4,5,4,9,9,5,14,9,6,15,0,0,0,26,16,42
sp14,142,REVELLE,CHEM,Envir Chem,0,0,0,0,0,0,1,1,2,1,0,1,1,3,4,0,0,0,3,4,7
sp14,142,REVELLE,CHEM,MolecSynth,0,0,0,0,1,1,0,0,0,1,0,1,0,0,0,0,0,0,1,1,2
sp14,142,REVELLE,CHEM,Pharm Chem,0,0,0,2,3,5,6,8,14,7,13,20,23,33,56,0,0,0,38,57,95
sp14,142,REVELLE,CLAS,Classic St,0,0,0,0,0,0,0,0,0,0,0,0,1,0,1,0,0,0,1,0,1
sp14,142,REVELLE,COGS,Cog Sci,0,0,0,0,2,2,2,6,8,1,6,7,8,7,15,0,0,0,11,21,32
sp14,142,REVELLE,COGS,CogSc/ClAs,0,0,0,0,0,0,0,0,0,1,2,3,2,4,6,0,0,0,3,6,9
sp14,142,REVELLE,COGS,CogSc/Comp,0,0,0,0,0,0,0,0,0,0,0,0,0,1,1,0,0,0,0,1,1
sp14,142,REVELLE,COGS,CogSc/HCI,0,0,0,0,0,0,2,0,2,2,6,8,4,7,11,0,0,0,8,13,21
sp14,142,REVELLE,COGS,CogSc/HCog,0,0,0,0,0,0,0,2,2,0,0,0,1,2,3,0,0,0,1,4,5
sp14,142,REVELLE,COGS,CogSc/Neur,0,0,0,0,1,1,0,5,5,2,3,5,10,20,30,0,0,0,12,29,41
sp14,142,REVELLE,COMM,Communic,0,0,0,0,1,1,1,4,5,8,8,16,6,10,16,0,0,0,15,23,38
sp14,142,REVELLE,CSE,Comp Sci,0,0,0,1,0,1,17,2,19,66,10,76,100,16,116,0,0,0,184,28,212
sp14,142,REVELLE,CSE,CompEngCSE,0,0,0,0,0,0,4,0,4,8,1,9,17,3,20,0,0,0,29,4,33
sp14,142,REVELLE,CSE,CompScBinf,0,0,0,1,0,1,8,4,12,1,0,1,5,2,7,0,0,0,15,6,21
sp14,142,REVELLE,ECE,CompEngECE,0,0,0,2,0,2,6,2,8,7,1,8,6,0,6,0,0,0,21,3,24
sp14,142,REVELLE,ECE,Electr Eng,0,0,0,7,6,13,23,8,31,25,4,29,66,3,69,0,0,0,121,21,142
sp14,142,REVELLE,ECE,Engin Phys,0,0,0,0,0,0,1,0,1,1,0,1,5,0,5,0,0,0,7,0,7
sp14,142,REVELLE,ECE,Pr-EngPhys,0,0,0,0,0,0,1,0,1,3,0,3,0,0,0,0,0,0,4,0,4
sp14,142,REVELLE,ECON,Ec-Mth&Ecn,0,0,0,3,2,5,2,3,5,6,3,9,9,3,12,0,0,0,20,11,31
sp14,142,REVELLE,ECON,Econ-MgtSc,0,0,0,4,2,6,5,8,13,19,9,28,27,13,40,0,0,0,55,32,87
sp14,142,REVELLE,ECON,Economics,0,0,0,5,2,7,14,9,23,39,15,54,42,28,70,0,0,0,100,54,154
sp14,142,REVELLE,ESYS,EnvSys(EB),0,0,0,0,0,0,0,2,2,0,2,2,8,10,18,0,0,0,8,14,22
sp14,142,REVELLE,ESYS,EnvSys(EC),0,0,0,0,0,0,0,0,0,1,0,1,1,1,2,0,0,0,2,1,3
sp14,142,REVELLE,ESYS,EnvSys(EP),0,0,0,0,0,0,0,0,0,0,0,0,0,1,1,0,0,0,0,1,1
sp14,142,REVELLE,ESYS,EnvSys(ES),0,0,0,0,0,0,0,0,0,1,1,2,2,0,2,0,0,0,3,1,4
sp14,142,REVELLE,ETHN,Ethnic St,0,0,0,0,0,0,0,0,0,0,3,3,2,4,6,0,0,0,2,7,9
sp14,142,REVELLE,FPMU,Public Hlt,0,0,0,0,2,2,2,11,13,3,14,17,1,11,12,0,0,0,6,38,44
sp14,142,REVELLE,HDP,Human Dev,0,0,0,0,0,0,0,0,0,0,2,2,0,20,20,0,0,0,0,22,22
sp14,142,REVELLE,HDP,Pr-HumnDev,0,0,0,0,2,2,1,3,4,1,5,6,0,0,0,0,0,0,2,10,12
sp14,142,REVELLE,HIST,History,0,0,0,0,0,0,1,2,3,1,3,4,3,2,5,0,0,0,5,7,12
sp14,142,REVELLE,INTL,Int-5yrPS,0,0,0,0,0,0,0,0,0,0,0,0,0,1,1,0,0,0,0,1,1
sp14,142,REVELLE,INTL,IntSt-Anth,0,0,0,0,0,0,0,0,0,0,0,0,1,0,1,0,0,0,1,0,1
sp14,142,REVELLE,INTL,IntSt-Econ,0,0,0,1,1,2,1,0,1,4,4,8,3,4,7,0,0,0,9,9,18
sp14,142,REVELLE,INTL,IntSt-Hist,0,0,0,0,0,0,0,0,0,0,1,1,0,0,0,0,0,0,0,1,1
sp14,142,REVELLE,INTL,IntSt-Ling,0,0,0,0,0,0,0,0,0,0,0,0,0,1,1,0,0,0,0,1,1
sp14,142,REVELLE,INTL,IntSt-PolS,0,0,0,0,1,1,1,1,2,1,2,3,3,7,10,0,0,0,5,11,16
sp14,142,REVELLE,INTL,IntSt-Soc,0,0,0,0,0,0,0,1,1,0,2,2,0,1,1,0,0,0,0,4,4
sp14,142,REVELLE,JAPN,JapaneseSt,0,0,0,0,0,0,0,0,0,1,0,1,0,0,0,0,0,0,1,0,1
sp14,142,REVELLE,LING,Ling-CogLn,0,0,0,0,0,0,0,0,0,1,0,1,0,1,1,0,0,0,1,1,2
sp14,142,REVELLE,LING,Linguistcs,0,0,0,0,0,0,1,0,1,1,4,5,3,1,4,0,0,0,5,5,10
sp14,142,REVELLE,LIT,Lit/Compos,0,0,0,0,0,0,0,0,0,0,0,0,1,1,2,0,0,0,1,1,2
sp14,142,REVELLE,LIT,Lit/CultSt,0,0,0,0,0,0,0,0,0,0,1,1,0,0,0,0,0,0,0,1,1
sp14,142,REVELLE,LIT,Lit/Engl,0,0,0,0,1,1,2,0,2,0,0,0,2,2,4,0,0,0,4,3,7
sp14,142,REVELLE,LIT,Lit/World,0,0,0,0,0,0,0,1,1,1,0,1,0,2,2,0,0,0,1,3,4
sp14,142,REVELLE,LIT,Lit/Writng,0,0,0,0,0,0,1,0,1,0,3,3,2,8,10,0,0,0,3,11,14
sp14,142,REVELLE,LIT,Spanish Lt,0,0,0,0,0,0,0,0,0,0,1,1,1,1,2,0,0,0,1,2,3
sp14,142,REVELLE,MAE,Aerosp Eng,0,0,0,0,0,0,12,4,16,14,0,14,21,7,28,0,0,0,47,11,58
sp14,142,REVELLE,MAE,Engin Sci,0,0,0,0,0,0,0,0,0,0,0,0,5,2,7,0,0,0,5,2,7
sp14,142,REVELLE,MAE,Envir Eng,0,0,0,1,0,1,8,8,16,8,1,9,19,4,23,0,0,0,36,13,49
sp14,142,REVELLE,MAE,Mech Engin,0,0,0,1,0,1,7,3,10,15,1,16,34,5,39,0,0,0,57,9,66
sp14,142,REVELLE,MATH,Appld Math,0,0,0,0,1,1,8,6,14,6,6,12,8,4,12,0,0,0,22,17,39
sp14,142,REVELLE,MATH,Math/SecEd,0,0,0,0,0,0,0,0,0,1,0,1,1,0,1,0,0,0,2,0,2
sp14,142,REVELLE,MATH,Mathematcs,0,0,0,0,2,2,3,3,6,2,2,4,3,5,8,0,0,0,8,12,20
sp14,142,REVELLE,MATH,Mth-CompSc,0,0,0,1,0,1,1,0,1,1,1,2,2,3,5,0,0,0,5,4,9
sp14,142,REVELLE,MATH,Mth-Mth&Ec,0,0,0,0,3,3,2,2,4,0,5,5,3,1,4,0,0,0,5,11,16
sp14,142,REVELLE,MATH,Mth-SciCom,0,0,0,0,0,0,0,0,0,0,0,0,0,1,1,0,0,0,0,1,1
sp14,142,REVELLE,MATH,Mth/ApldSc,0,0,0,0,3,3,3,0,3,1,0,1,1,1,2,0,0,0,5,4,9
sp14,142,REVELLE,MATH,Pr-Math CS,0,0,0,1,0,1,0,0,0,0,0,0,0,0,0,0,0,0,1,0,1
sp14,142,REVELLE,MATH,Prob&Stats,0,0,0,0,1,1,2,3,5,2,3,5,5,3,8,0,0,0,9,10,19
sp14,142,REVELLE,MUS,Mu-CompArt,0,0,0,0,0,0,2,0,2,0,0,0,2,0,2,0,0,0,4,0,4
sp14,142,REVELLE,MUS,Music,0,0,0,1,0,1,1,0,1,0,0,0,1,2,3,0,0,0,3,2,5
sp14,142,REVELLE,NENG,NanoEng,0,0,0,1,0,1,12,4,16,12,2,14,33,11,44,0,0,0,58,17,75
sp14,142,REVELLE,PHIL,Philosophy,0,0,0,0,0,0,0,1,1,1,0,1,4,1,5,0,0,0,5,2,7
sp14,142,REVELLE,PHYS,Biophysics,0,0,0,1,0,1,2,1,3,1,2,3,1,2,3,0,0,0,5,5,10
sp14,142,REVELLE,PHYS,GenPys/SEd,0,0,0,0,0,0,0,0,0,0,0,0,1,0,1,0,0,0,1,0,1
sp14,142,REVELLE,PHYS,Phy/ErthSc,0,0,0,0,0,0,0,0,0,0,0,0,1,0,1,0,0,0,1,0,1
sp14,142,REVELLE,PHYS,Phys/Astro,0,0,0,2,0,2,5,1,6,4,1,5,6,4,10,0,0,0,17,6,23
sp14,142,REVELLE,PHYS,Phys/Comp,0,0,0,1,0,1,0,0,0,1,0,1,1,0,1,0,0,0,3,0,3
sp14,142,REVELLE,PHYS,Phys/Mtrls,0,0,0,0,1,1,0,0,0,0,0,0,1,0,1,0,0,0,1,1,2
sp14,142,REVELLE,PHYS,Physics,0,0,0,1,1,2,9,3,12,8,2,10,12,6,18,0,0,0,30,12,42
sp14,142,REVELLE,POLI,Polit Sci,0,0,0,0,0,0,2,0,2,0,3,3,8,10,18,0,0,0,10,13,23
sp14,142,REVELLE,POLI,PolSc-Amer,0,0,0,0,0,0,1,0,1,1,0,1,1,2,3,0,0,0,3,2,5
sp14,142,REVELLE,POLI,PolSc-Comp,0,0,0,0,0,0,0,0,0,0,0,0,1,0,1,0,0,0,1,0,1
sp14,142,REVELLE,POLI,PolSc-Intl,0,0,0,0,1,1,2,2,4,1,2,3,5,2,7,0,0,0,8,7,15
sp14,142,REVELLE,POLI,PolSc-PLaw,0,0,0,0,0,0,1,0,1,0,2,2,2,5,7,0,0,0,3,7,10
sp14,142,REVELLE,POLI,PolSc-PPol,0,0,0,0,0,0,0,0,0,0,0,0,1,1,2,0,0,0,1,1,2
sp14,142,REVELLE,POLI,PolSc-Thry,0,0,0,0,0,0,0,0,0,0,0,0,0,1,1,0,0,0,0,1,1
sp14,142,REVELLE,PSYC,Psychology,0,0,0,0,2,2,6,15,21,12,33,45,27,76,103,0,0,0,45,126,171
sp14,142,REVELLE,RELI,Relig/Stu,0,0,0,0,0,0,0,0,0,0,0,0,0,1,1,0,0,0,0,1,1
sp14,142,REVELLE,RUSS,Russ&SovSt,0,0,0,0,0,0,0,0,0,0,0,0,1,0,1,0,0,0,1,0,1
sp14,142,REVELLE,SE,Struct Eng,0,0,0,3,1,4,19,7,26,29,8,37,35,10,45,0,0,0,86,26,112
sp14,142,REVELLE,SIO,Earth Sci,0,0,0,0,0,0,0,1,1,2,1,3,2,3,5,0,0,0,4,5,9
sp14,142,REVELLE,SIO,Marine Bio,0,0,0,2,3,5,2,7,9,3,7,10,3,5,8,0,0,0,10,22,32
sp14,142,REVELLE,SOC,SocEconSoc,0,0,0,0,0,0,1,0,1,0,1,1,0,0,0,0,0,0,1,1,2
sp14,142,REVELLE,SOC,SocIntlStu,0,0,0,0,0,0,0,0,0,0,0,0,0,1,1,0,0,0,0,1,1
sp14,142,REVELLE,SOC,Sociology,0,0,0,0,1,1,0,1,1,2,1,3,3,4,7,0,0,0,5,7,12
sp14,142,REVELLE,SOC,SocLawSoc,0,0,0,0,0,0,0,1,1,0,2,2,1,1,2,0,0,0,1,4,5
sp14,142,REVELLE,SOC,SocSciMed,0,0,0,0,0,0,0,0,0,0,1,1,1,3,4,0,0,0,1,4,5
sp14,142,REVELLE,SOC,SocSolneq,0,0,0,0,0,0,0,0,0,0,1,1,0,1,1,0,0,0,0,2,2
sp14,142,REVELLE,THEA,Dance,0,0,0,0,1,1,0,1,1,0,0,0,0,0,0,0,0,0,0,2,2
sp14,142,REVELLE,THEA,Theatre,0,0,0,0,0,0,0,2,2,0,3,3,1,0,1,0,0,0,1,5,6
sp14,142,REVELLE,UNAF,Limited St,0,0,0,0,0,0,0,0,0,0,0,0,0,0,0,1,2,3,1,2,3
sp14,142,REVELLE,UNAF,Spec-Emply,0,0,0,0,0,0,0,0,0,0,0,0,0,0,0,2,2,4,2,2,4
sp14,142,REVELLE,UNAF,UndecHumAr,0,0,0,0,0,0,0,1,1,0,0,0,0,0,0,0,0,0,0,1,1
sp14,142,REVELLE,UNAF,Undeclared,0,0,0,5,6,11,15,10,25,1,1,2,0,0,0,0,0,0,21,17,38
sp14,142,REVELLE,UNAF,UndecPhysS,0,0,0,0,0,0,2,2,4,0,0,0,0,0,0,0,0,0,2,2,4
sp14,142,REVELLE,UNAF,UndecSocSc,0,0,0,1,0,1,2,1,3,0,0,0,0,0,0,0,0,0,3,1,4
sp14,142,REVELLE,USP,Urb Stu&Pl,0,0,0,0,0,0,0,1,1,0,0,0,0,1,1,0,0,0,0,2,2
sp14,142,REVELLE,VIS,Art Hst/Cr,0,0,0,0,0,0,0,0,0,0,1,1,0,0,0,0,0,0,0,1,1
sp14,142,REVELLE,VIS,Media,0,0,0,0,0,0,0,3,3,1,1,2,3,2,5,0,0,0,4,6,10
sp14,142,REVELLE,VIS,Studio VA,0,0,0,0,0,0,0,0,0,0,0,0,1,1,2,0,0,0,1,1,2
sp14,142,REVELLE,VIS,VA-CompArt,0,0,0,0,1,1,1,2,3,1,0,1,4,3,7,0,0,0,6,6,12
sp14,142,ROOSEVELT,ANTH,Anth-Arch,0,0,0,0,0,0,0,0,0,2,3,5,2,5,7,0,0,0,4,8,12
sp14,142,ROOSEVELT,ANTH,Anth-Biol,0,0,0,0,1,1,0,1,1,0,3,3,1,5,6,0,0,0,1,10,11
sp14,142,ROOSEVELT,ANTH,Anth-Soci,0,0,0,0,0,0,2,5,7,1,6,7,4,10,14,0,0,0,7,21,28
sp14,142,ROOSEVELT,BENG,Bioen:Binf,0,0,0,2,0,2,4,3,7,4,2,6,1,3,4,0,0,0,11,8,19
sp14,142,ROOSEVELT,BENG,BioengBioS,0,0,0,2,1,3,0,3,3,0,0,0,0,0,0,0,0,0,2,4,6
sp14,142,ROOSEVELT,BENG,BioengBiot,0,0,0,0,0,0,1,0,1,0,3,3,4,3,7,0,0,0,5,6,11
sp14,142,ROOSEVELT,BENG,Bioengin,0,0,0,0,0,0,0,0,0,2,0,2,5,3,8,0,0,0,7,3,10
sp14,142,ROOSEVELT,BIOL,Bioc/CellB,0,0,0,5,11,16,15,20,35,21,23,44,32,33,65,0,0,0,73,87,160
sp14,142,ROOSEVELT,BIOL,BiolBioinf,0,0,0,0,0,0,0,0,0,0,0,0,0,1,1,0,0,0,0,1,1
sp14,142,ROOSEVELT,BIOL,Ec/Beh/Evo,0,0,0,0,1,1,0,2,2,1,2,3,5,7,12,0,0,0,6,12,18
sp14,142,ROOSEVELT,BIOL,Genl Biol,0,0,0,2,9,11,6,24,30,14,21,35,23,30,53,0,0,0,45,84,129
sp14,142,ROOSEVELT,BIOL,Human Bio,0,0,0,5,18,23,26,53,79,12,30,42,30,53,83,0,0,0,73,154,227
sp14,142,ROOSEVELT,BIOL,Microbiol,0,0,0,0,0,0,1,2,3,3,2,5,2,4,6,0,0,0,6,8,14
sp14,142,ROOSEVELT,BIOL,Molec Biol,0,0,0,0,1,1,1,4,5,3,3,6,2,2,4,0,0,0,6,10,16
sp14,142,ROOSEVELT,BIOL,PhyslNeuro,0,0,0,1,5,6,13,25,38,12,19,31,11,22,33,0,0,0,37,71,108
sp14,142,ROOSEVELT,CENG,Chem Engin,0,0,0,3,3,6,3,3,6,10,4,14,24,7,31,0,0,0,40,17,57
sp14,142,ROOSEVELT,CHEM,Bioch/Chem,0,0,0,1,2,3,4,5,9,4,3,7,15,11,26,0,0,0,24,21,45
sp14,142,ROOSEVELT,CHEM,Chem Phys,0,0,0,0,0,0,1,0,1,0,0,0,0,0,0,0,0,0,1,0,1
sp14,142,ROOSEVELT,CHEM,Chemistry,0,0,0,1,1,2,3,2,5,2,5,7,2,2,4,0,0,0,8,10,18
sp14,142,ROOSEVELT,CHEM,Envir Chem,0,0,0,0,0,0,0,0,0,1,0,1,2,2,4,0,0,0,3,2,5
sp14,142,ROOSEVELT,CHEM,MolecSynth,0,0,0,0,0,0,0,1,1,0,0,0,0,1,1,0,0,0,0,2,2
sp14,142,ROOSEVELT,CHEM,Pharm Chem,0,0,0,2,3,5,4,1,5,3,5,8,13,17,30,0,0,0,22,26,48
sp14,142,ROOSEVELT,CHIN,Chinese St,0,0,0,0,0,0,0,0,0,0,0,0,0,1,1,0,0,0,0,1,1
sp14,142,ROOSEVELT,CLAS,Classic St,0,0,0,0,0,0,0,1,1,1,0,1,0,1,1,0,0,0,1,2,3
sp14,142,ROOSEVELT,COGS,Cog Sci,0,0,0,0,1,1,2,6,8,2,4,6,2,6,8,0,0,0,6,17,23
sp14,142,ROOSEVELT,COGS,CogSc/ClAs,0,0,0,0,1,1,0,0,0,0,2,2,0,3,3,0,0,0,0,6,6
sp14,142,ROOSEVELT,COGS,CogSc/Comp,0,0,0,0,0,0,0,0,0,0,1,1,1,1,2,0,0,0,1,2,3
sp14,142,ROOSEVELT,COGS,CogSc/HCI,0,0,0,1,0,1,0,0,0,2,3,5,3,7,10,0,0,0,6,10,16
sp14,142,ROOSEVELT,COGS,CogSc/HCog,0,0,0,0,0,0,0,0,0,0,2,2,2,1,3,0,0,0,2,3,5
sp14,142,ROOSEVELT,COGS,CogSc/Neur,0,0,0,1,0,1,0,2,2,2,3,5,3,19,22,0,0,0,6,24,30
sp14,142,ROOSEVELT,COMM,Communic,0,0,0,2,6,8,2,17,19,12,29,41,6,48,54,0,0,0,22,100,122
sp14,142,ROOSEVELT,CSE,Comp Sci,0,0,0,0,0,0,4,7,11,32,9,41,58,7,65,0,0,0,94,23,117
sp14,142,ROOSEVELT,CSE,CompEngCSE,0,0,0,0,0,0,4,1,5,5,1,6,12,0,12,0,0,0,21,2,23
sp14,142,ROOSEVELT,CSE,CompScBinf,0,0,0,0,1,1,2,0,2,3,0,3,2,2,4,0,0,0,7,3,10
sp14,142,ROOSEVELT,ECE,CompEngECE,0,0,0,3,1,4,8,0,8,3,0,3,2,0,2,0,0,0,16,1,17
sp14,142,ROOSEVELT,ECE,Electr Eng,0,0,0,11,1,12,16,8,24,33,5,38,34,8,42,0,0,0,94,22,116
sp14,142,ROOSEVELT,ECE,EleEng&Soc,0,0,0,0,0,0,2,0,2,0,0,0,0,0,0,0,0,0,2,0,2
sp14,142,ROOSEVELT,ECE,Engin Phys,0,0,0,0,0,0,1,0,1,0,0,0,1,0,1,0,0,0,2,0,2
sp14,142,ROOSEVELT,ECE,Pr-EngPhys,0,0,0,0,0,0,1,0,1,0,0,0,0,0,0,0,0,0,1,0,1
sp14,142,ROOSEVELT,ECON,Ec-Mth&Ecn,0,0,0,3,4,7,7,3,10,1,2,3,6,6,12,0,0,0,17,15,32
sp14,142,ROOSEVELT,ECON,Econ-MgtSc,0,0,0,5,0,5,10,13,23,28,15,43,33,32,65,0,0,0,76,60,136
sp14,142,ROOSEVELT,ECON,Economics,0,0,0,12,7,19,23,23,46,49,36,85,57,49,106,0,0,0,141,115,256
sp14,142,ROOSEVELT,ESYS,EnvSys(EB),0,0,0,0,1,1,0,2,2,1,3,4,3,7,10,0,0,0,4,13,17
sp14,142,ROOSEVELT,ESYS,EnvSys(EC),0,0,0,0,1,1,0,0,0,0,0,0,1,5,6,0,0,0,1,6,7
sp14,142,ROOSEVELT,ESYS,EnvSys(EP),0,0,0,2,0,2,1,1,2,0,2,2,1,1,2,0,0,0,4,4,8
sp14,142,ROOSEVELT,ESYS,EnvSys(ES),0,0,0,0,0,0,1,3,4,1,1,2,1,3,4,0,0,0,3,7,10
sp14,142,ROOSEVELT,ETHN,Ethnic St,0,0,0,0,0,0,0,0,0,1,0,1,0,3,3,0,0,0,1,3,4
sp14,142,ROOSEVELT,FPMU,Public Hlt,0,0,0,0,5,5,5,14,19,3,12,15,0,10,10,0,0,0,8,41,49
sp14,142,ROOSEVELT,GMST,German Stu,0,0,0,0,0,0,0,0,0,0,0,0,1,0,1,0,0,0,1,0,1
sp14,142,ROOSEVELT,HDP,Human Dev,0,0,0,0,0,0,0,1,1,0,4,4,1,26,27,0,0,0,1,31,32
sp14,142,ROOSEVELT,HDP,Pr-HumnDev,0,0,0,0,2,2,0,9,9,1,6,7,1,1,2,0,0,0,2,18,20
sp14,142,ROOSEVELT,HIST,History,0,0,0,0,2,2,5,10,15,6,11,17,18,18,36,0,0,0,29,41,70
sp14,142,ROOSEVELT,INTD,Roos IndSt,0,0,0,0,0,0,0,0,0,0,0,0,0,1,1,0,0,0,0,1,1
sp14,142,ROOSEVELT,INTL,Int-5yrEC,0,0,0,0,0,0,0,0,0,0,0,0,0,2,2,0,0,0,0,2,2
sp14,142,ROOSEVELT,INTL,Int-5yrPS,0,0,0,0,0,0,0,0,0,0,0,0,1,1,2,0,0,0,1,1,2
sp14,142,ROOSEVELT,INTL,IntSt-Anth,0,0,0,0,0,0,0,0,0,0,1,1,0,5,5,0,0,0,0,6,6
sp14,142,ROOSEVELT,INTL,IntSt-Econ,0,0,0,2,2,4,8,7,15,5,7,12,9,20,29,0,0,0,24,36,60
sp14,142,ROOSEVELT,INTL,IntSt-Hist,0,0,0,0,0,0,0,0,0,1,2,3,1,5,6,0,0,0,2,7,9
sp14,142,ROOSEVELT,INTL,IntSt-Ling,0,0,0,1,0,1,0,2,2,2,3,5,0,2,2,0,0,0,3,7,10
sp14,142,ROOSEVELT,INTL,IntSt-Lit,0,0,0,0,0,0,1,2,3,0,0,0,0,1,1,0,0,0,1,3,4
sp14,142,ROOSEVELT,INTL,IntSt-PolS,0,0,0,0,1,1,5,15,20,9,19,28,14,35,49,0,0,0,28,70,98
sp14,142,ROOSEVELT,INTL,IntSt-Soc,0,0,0,2,2,4,3,7,10,2,12,14,2,5,7,0,0,0,9,26,35
sp14,142,ROOSEVELT,JAPN,JapaneseSt,0,0,0,0,0,0,1,1,2,0,1,1,2,1,3,0,0,0,3,3,6
sp14,142,ROOSEVELT,LATI,LatinAm St,0,0,0,0,0,0,0,1,1,0,0,0,0,1,1,0,0,0,0,2,2
sp14,142,ROOSEVELT,LING,Lang Stu,0,0,0,0,1,1,0,3,3,1,1,2,1,0,1,0,0,0,2,5,7
sp14,142,ROOSEVELT,LING,Ling-CogLn,0,0,0,0,0,0,0,3,3,0,3,3,0,4,4,0,0,0,0,10,10
sp14,142,ROOSEVELT,LING,Ling-LSoc,0,0,0,0,0,0,0,1,1,1,1,2,1,1,2,0,0,0,2,3,5
sp14,142,ROOSEVELT,LING,Linguistcs,0,0,0,0,0,0,1,2,3,0,4,4,1,2,3,0,0,0,2,8,10
sp14,142,ROOSEVELT,LIT,Lit/Compos,0,0,0,0,0,0,0,1,1,0,0,0,0,0,0,0,0,0,0,1,1
sp14,142,ROOSEVELT,LIT,Lit/CultSt,0,0,0,0,0,0,0,1,1,0,1,1,1,1,2,0,0,0,1,3,4
sp14,142,ROOSEVELT,LIT,Lit/Engl,0,0,0,0,1,1,2,2,4,0,3,3,0,7,7,0,0,0,2,13,15
sp14,142,ROOSEVELT,LIT,Lit/World,0,0,0,0,0,0,0,0,0,1,4,5,0,1,1,0,0,0,1,5,6
sp14,142,ROOSEVELT,LIT,Lit/Writng,0,0,0,0,0,0,1,0,1,1,5,6,3,16,19,0,0,0,5,21,26
sp14,142,ROOSEVELT,LIT,Spanish Lt,0,0,0,0,1,1,0,1,1,0,0,0,1,2,3,0,0,0,1,4,5
sp14,142,ROOSEVELT,MAE,Aerosp Eng,0,0,0,0,1,1,0,0,0,2,0,2,16,3,19,0,0,0,18,4,22
sp14,142,ROOSEVELT,MAE,Engin Sci,0,0,0,0,0,0,0,0,0,0,0,0,5,0,5,0,0,0,5,0,5
sp14,142,ROOSEVELT,MAE,Envir Eng,0,0,0,5,0,5,4,3,7,3,6,9,11,3,14,0,0,0,23,12,35
sp14,142,ROOSEVELT,MAE,Mech Engin,0,0,0,0,1,1,0,1,1,0,0,0,15,2,17,0,0,0,15,4,19
sp14,142,ROOSEVELT,MATH,Appld Math,0,0,0,3,5,8,5,4,9,1,4,5,5,1,6,0,0,0,14,14,28
sp14,142,ROOSEVELT,MATH,Math/SecEd,0,0,0,0,0,0,0,3,3,0,1,1,1,1,2,0,0,0,1,5,6
sp14,142,ROOSEVELT,MATH,Mathematcs,0,0,0,2,1,3,2,3,5,1,1,2,2,3,5,0,0,0,7,8,15
sp14,142,ROOSEVELT,MATH,Mth-CompSc,0,0,0,2,1,3,3,0,3,0,0,0,1,3,4,0,0,0,6,4,10
sp14,142,ROOSEVELT,MATH,Mth-Mth&Ec,0,0,0,2,3,5,8,5,13,5,3,8,1,8,9,0,0,0,16,19,35
sp14,142,ROOSEVELT,MATH,Mth/ApldSc,0,0,0,0,0,0,3,0,3,0,0,0,0,0,0,0,0,0,3,0,3
sp14,142,ROOSEVELT,MATH,Prob&Stats,0,0,0,1,0,1,0,0,0,1,0,1,0,0,0,0,0,0,2,0,2
sp14,142,ROOSEVELT,MUS,Mu-CompArt,0,0,0,0,0,0,0,0,0,0,0,0,2,1,3,0,0,0,2,1,3
sp14,142,ROOSEVELT,MUS,Music,0,0,0,0,1,1,0,0,0,2,1,3,1,1,2,0,0,0,3,3,6
sp14,142,ROOSEVELT,MUS,Music Hum,0,0,0,0,0,0,0,0,0,0,0,0,0,2,2,0,0,0,0,2,2
sp14,142,ROOSEVELT,NENG,NanoEng,0,0,0,1,0,1,5,3,8,4,2,6,18,7,25,0,0,0,28,12,40
sp14,142,ROOSEVELT,PHIL,Philosophy,0,0,0,0,0,0,0,2,2,2,0,2,3,1,4,0,0,0,5,3,8
sp14,142,ROOSEVELT,PHYS,Biophysics,0,0,0,0,0,0,0,0,0,0,0,0,2,1,3,0,0,0,2,1,3
sp14,142,ROOSEVELT,PHYS,Gen Physcs,0,0,0,1,0,1,0,0,0,0,0,0,0,0,0,0,0,0,1,0,1
sp14,142,ROOSEVELT,PHYS,Phys/Astro,0,0,0,1,0,1,0,0,0,0,0,0,0,1,1,0,0,0,1,1,2
sp14,142,ROOSEVELT,PHYS,Phys/Comp,0,0,0,0,0,0,0,0,0,0,0,0,1,0,1,0,0,0,1,0,1
sp14,142,ROOSEVELT,PHYS,Phys/Mtrls,0,0,0,0,0,0,0,0,0,0,0,0,1,0,1,0,0,0,1,0,1
sp14,142,ROOSEVELT,PHYS,Physics,0,0,0,1,0,1,4,1,5,3,0,3,1,2,3,0,0,0,9,3,12
sp14,142,ROOSEVELT,POLI,Polit Sci,0,0,0,3,3,6,5,13,18,10,14,24,19,29,48,0,0,0,37,59,96
sp14,142,ROOSEVELT,POLI,PolSc-Amer,0,0,0,0,0,0,1,1,2,2,5,7,2,2,4,0,0,0,5,8,13
sp14,142,ROOSEVELT,POLI,PolSc-Comp,0,0,0,0,0,0,0,1,1,2,0,2,1,2,3,0,0,0,3,3,6
sp14,142,ROOSEVELT,POLI,PolSc-Intl,0,0,0,1,2,3,6,10,16,13,9,22,22,26,48,0,0,0,42,47,89
sp14,142,ROOSEVELT,POLI,PolSc-PLaw,0,0,0,0,2,2,4,7,11,1,8,9,7,5,12,0,0,0,12,22,34
sp14,142,ROOSEVELT,POLI,PolSc-PPol,0,0,0,1,0,1,2,1,3,3,1,4,2,2,4,0,0,0,8,4,12
sp14,142,ROOSEVELT,POLI,PolSc-Thry,0,0,0,0,0,0,0,1,1,1,2,3,1,0,1,0,0,0,2,3,5
sp14,142,ROOSEVELT,PSYC,Psychology,0,0,0,4,20,24,5,23,28,10,42,52,24,77,101,0,0,0,43,162,205
sp14,142,ROOSEVELT,RELI,Relig/Stu,0,0,0,0,0,0,0,0,0,0,0,0,0,1,1,0,0,0,0,1,1
sp14,142,ROOSEVELT,SE,Engin Sci,0,0,0,0,0,0,0,0,0,0,1,1,0,0,0,0,0,0,0,1,1
sp14,142,ROOSEVELT,SE,Struct Eng,0,0,0,5,2,7,11,1,12,12,6,18,25,8,33,0,0,0,53,17,70
sp14,142,ROOSEVELT,SIO,Earth Sci,0,0,0,0,0,0,0,0,0,1,6,7,1,0,1,0,0,0,2,6,8
sp14,142,ROOSEVELT,SIO,Marine Bio,0,0,0,0,2,2,2,7,9,3,1,4,4,7,11,0,0,0,9,17,26
sp14,142,ROOSEVELT,SOC,SocCulCom,0,0,0,0,0,0,0,0,0,0,0,0,0,2,2,0,0,0,0,2,2
sp14,142,ROOSEVELT,SOC,SocEconSoc,0,0,0,0,1,1,0,1,1,1,1,2,0,2,2,0,0,0,1,5,6
sp14,142,ROOSEVELT,SOC,SocIntlStu,0,0,0,0,0,0,0,0,0,0,0,0,0,1,1,0,0,0,0,1,1
sp14,142,ROOSEVELT,SOC,Sociology,0,0,0,0,1,1,2,2,4,3,10,13,2,11,13,0,0,0,7,24,31
sp14,142,ROOSEVELT,SOC,SocLawSoc,0,0,0,0,0,0,0,1,1,2,1,3,2,5,7,0,0,0,4,7,11
sp14,142,ROOSEVELT,SOC,SocSciMed,0,0,0,0,0,0,1,0,1,0,1,1,0,2,2,0,0,0,1,3,4
sp14,142,ROOSEVELT,SOC,SocSolneq,0,0,0,0,0,0,0,0,0,0,1,1,0,3,3,0,0,0,0,4,4
sp14,142,ROOSEVELT,THEA,Theatre,0,0,0,0,1,1,1,0,1,1,2,3,1,6,7,0,0,0,3,9,12
sp14,142,ROOSEVELT,TWS,ThirdWldSt,0,0,0,0,0,0,0,0,0,0,1,1,0,0,0,0,0,0,0,1,1
sp14,142,ROOSEVELT,UNAF,UndecHumAr,0,0,0,0,2,2,1,2,3,0,0,0,0,0,0,0,0,0,1,4,5
sp14,142,ROOSEVELT,UNAF,Undeclared,0,0,0,9,9,18,20,20,40,1,3,4,0,0,0,0,0,0,30,32,62
sp14,142,ROOSEVELT,UNAF,UndecPhysS,0,0,0,1,1,2,3,3,6,0,0,0,0,0,0,0,0,0,4,4,8
sp14,142,ROOSEVELT,UNAF,UndecSocSc,0,0,0,0,3,3,3,1,4,0,0,0,0,0,0,0,0,0,3,4,7
sp14,142,ROOSEVELT,USP,Urb Stu&Pl,0,0,0,0,0,0,1,1,2,0,0,0,5,8,13,0,0,0,6,9,15
sp14,142,ROOSEVELT,VIS,Art Hst/Cr,0,0,0,0,0,0,0,1,1,0,2,2,0,5,5,0,0,0,0,8,8
sp14,142,ROOSEVELT,VIS,Media,0,0,0,0,3,3,0,0,0,3,2,5,7,4,11,0,0,0,10,9,19
sp14,142,ROOSEVELT,VIS,Studio VA,0,0,0,1,0,1,0,0,0,2,3,5,1,3,4,0,0,0,4,6,10
sp14,142,ROOSEVELT,VIS,VA-CompArt,0,0,0,0,0,0,2,2,4,0,3,3,1,1,2,0,0,0,3,6,9
sp14,142,SIXTH,ANTH,Anth-Arch,0,0,0,0,0,0,0,0,0,1,1,2,0,1,1,0,0,0,1,2,3
sp14,142,SIXTH,ANTH,Anth-Biol,0,0,0,0,0,0,0,0,0,0,0,0,0,2,2,0,0,0,0,2,2
sp14,142,SIXTH,ANTH,Anth-Soci,0,0,0,0,0,0,0,0,0,1,3,4,1,2,3,0,0,0,2,5,7
sp14,142,SIXTH,BENG,Bioen:Binf,0,0,0,0,1,1,3,4,7,1,7,8,7,2,9,0,0,0,11,14,25
sp14,142,SIXTH,BENG,Bioeng:PM,0,0,0,0,0,0,0,0,0,0,0,0,1,0,1,0,0,0,1,0,1
sp14,142,SIXTH,BENG,BioengBioS,0,0,0,0,1,1,6,5,11,1,0,1,0,0,0,0,0,0,7,6,13
sp14,142,SIXTH,BENG,BioengBiot,0,0,0,1,0,1,1,1,2,2,4,6,11,7,18,0,0,0,15,12,27
sp14,142,SIXTH,BENG,Bioengin,0,0,0,0,1,1,3,0,3,1,1,2,11,8,19,0,0,0,15,10,25
sp14,142,SIXTH,BIOL,Bioc/CellB,0,0,0,5,4,9,22,15,37,21,22,43,32,36,68,0,0,0,80,77,157
sp14,142,SIXTH,BIOL,BiolBioinf,0,0,0,0,0,0,1,1,2,1,0,1,0,1,1,0,0,0,2,2,4
sp14,142,SIXTH,BIOL,Ec/Beh/Evo,0,0,0,0,0,0,2,1,3,1,5,6,2,6,8,0,0,0,5,12,17
sp14,142,SIXTH,BIOL,Genl Biol,0,0,0,1,5,6,9,18,27,12,19,31,24,29,53,0,0,0,46,71,117
sp14,142,SIXTH,BIOL,Human Bio,0,0,0,8,13,21,22,25,47,30,30,60,39,33,72,0,0,0,99,101,200
sp14,142,SIXTH,BIOL,Microbiol,0,0,0,0,1,1,2,2,4,1,5,6,2,3,5,0,0,0,5,11,16
sp14,142,SIXTH,BIOL,Molec Biol,0,0,0,0,1,1,3,3,6,5,2,7,3,5,8,0,0,0,11,11,22
sp14,142,SIXTH,BIOL,PhyslNeuro,0,0,0,3,1,4,16,18,34,13,10,23,15,16,31,0,0,0,47,45,92
sp14,142,SIXTH,CENG,Chem Engin,0,0,0,7,4,11,18,8,26,16,5,21,20,11,31,0,0,0,61,28,89
sp14,142,SIXTH,CGS,CritGendSt,0,0,0,0,0,0,0,0,0,1,1,2,0,0,0,0,0,0,1,1,2
sp14,142,SIXTH,CHEM,Bioch/Chem,0,0,0,4,3,7,3,6,9,3,3,6,27,13,40,0,0,0,37,25,62
sp14,142,SIXTH,CHEM,Bioinform,0,0,0,0,1,1,1,0,1,0,0,0,0,0,0,0,0,0,1,1,2
sp14,142,SIXTH,CHEM,Chem Educ,0,0,0,0,0,0,0,0,0,1,0,1,0,0,0,0,0,0,1,0,1
sp14,142,SIXTH,CHEM,Chem Phys,0,0,0,0,0,0,0,0,0,0,0,0,1,0,1,0,0,0,1,0,1
sp14,142,SIXTH,CHEM,Chemistry,0,0,0,1,2,3,1,1,2,1,3,4,7,3,10,0,0,0,10,9,19
sp14,142,SIXTH,CHEM,Envir Chem,0,0,0,0,0,0,0,0,0,0,1,1,1,3,4,0,0,0,1,4,5
sp14,142,SIXTH,CHEM,MolecSynth,0,0,0,0,0,0,0,0,0,1,0,1,0,1,1,0,0,0,1,1,2
sp14,142,SIXTH,CHEM,Pharm Chem,0,0,0,0,6,6,5,15,20,3,5,8,20,11,31,0,0,0,28,37,65
sp14,142,SIXTH,CHIN,Chinese St,0,0,0,0,0,0,0,0,0,0,0,0,1,0,1,0,0,0,1,0,1
sp14,142,SIXTH,COGS,Cog Sci,0,0,0,0,2,2,3,3,6,4,2,6,7,2,9,0,0,0,14,9,23
sp14,142,SIXTH,COGS,CogSc/ClAs,0,0,0,0,0,0,0,0,0,0,1,1,0,0,0,0,0,0,0,1,1
sp14,142,SIXTH,COGS,CogSc/Comp,0,0,0,0,0,0,0,1,1,0,0,0,1,1,2,0,0,0,1,2,3
sp14,142,SIXTH,COGS,CogSc/HCI,0,0,0,0,0,0,1,1,2,1,4,5,8,13,21,0,0,0,10,18,28
sp14,142,SIXTH,COGS,CogSc/HCog,0,0,0,0,0,0,0,0,0,0,1,1,0,1,1,0,0,0,0,2,2
sp14,142,SIXTH,COGS,CogSc/Neur,0,0,0,0,0,0,1,2,3,3,1,4,10,18,28,0,0,0,14,21,35
sp14,142,SIXTH,COMM,Communic,0,0,0,3,2,5,6,17,23,16,43,59,17,44,61,0,0,0,42,106,148
sp14,142,SIXTH,CSE,Comp Sci,0,0,0,0,0,0,29,6,35,105,28,133,114,26,140,0,0,0,248,60,308
sp14,142,SIXTH,CSE,CompEngCSE,0,0,0,2,0,2,12,3,15,20,0,20,27,2,29,0,0,0,61,5,66
sp14,142,SIXTH,CSE,CompScBinf,0,0,0,3,0,3,5,2,7,2,2,4,2,3,5,0,0,0,12,7,19
sp14,142,SIXTH,ECE,CompEngECE,0,0,0,5,0,5,11,0,11,6,0,6,3,0,3,0,0,0,25,0,25
sp14,142,SIXTH,ECE,Electr Eng,0,0,0,24,2,26,44,3,47,43,4,47,64,6,70,0,0,0,175,15,190
sp14,142,SIXTH,ECE,Engin Phys,0,0,0,0,0,0,0,0,0,0,0,0,1,0,1,0,0,0,1,0,1
sp14,142,SIXTH,ECE,Pr-EngPhys,0,0,0,0,0,0,1,0,1,1,0,1,0,0,0,0,0,0,2,0,2
sp14,142,SIXTH,ECON,Ec-Mth&Ecn,0,0,0,4,2,6,5,2,7,4,4,8,5,0,5,0,0,0,18,8,26
sp14,142,SIXTH,ECON,Econ-MgtSc,0,0,0,8,1,9,13,9,22,15,12,27,47,32,79,0,0,0,83,54,137
sp14,142,SIXTH,ECON,Economics,0,0,0,7,4,11,20,7,27,37,22,59,54,32,86,0,0,0,118,65,183
sp14,142,SIXTH,ESYS,EnvSys(EB),0,0,0,0,0,0,0,0,0,0,3,3,4,15,19,0,0,0,4,18,22
sp14,142,SIXTH,ESYS,EnvSys(EC),0,0,0,0,0,0,0,0,0,0,1,1,1,0,1,0,0,0,1,1,2
sp14,142,SIXTH,ESYS,EnvSys(EP),0,0,0,0,0,0,0,0,0,0,1,1,0,4,4,0,0,0,0,5,5
sp14,142,SIXTH,ESYS,EnvSys(ES),0,0,0,0,0,0,1,1,2,1,1,2,1,2,3,0,0,0,3,4,7
sp14,142,SIXTH,ETHN,Ethnic St,0,0,0,0,1,1,0,1,1,0,0,0,3,0,3,0,0,0,3,2,5
sp14,142,SIXTH,FPMU,Public Hlt,0,0,0,0,4,4,1,8,9,1,9,10,2,4,6,0,0,0,4,25,29
sp14,142,SIXTH,HDP,Human Dev,0,0,0,0,0,0,0,0,0,1,5,6,3,26,29,0,0,0,4,31,35
sp14,142,SIXTH,HDP,Pr-HumnDev,0,0,0,0,3,3,0,9,9,0,6,6,0,4,4,0,0,0,0,22,22
sp14,142,SIXTH,HIST,History,0,0,0,0,0,0,1,0,1,3,1,4,7,5,12,0,0,0,11,6,17
sp14,142,SIXTH,INTL,IntSt-Anth,0,0,0,0,0,0,0,1,1,0,0,0,0,0,0,0,0,0,0,1,1
sp14,142,SIXTH,INTL,IntSt-Econ,0,0,0,0,3,3,5,1,6,3,2,5,4,8,12,0,0,0,12,14,26
sp14,142,SIXTH,INTL,IntSt-Hist,0,0,0,0,0,0,0,0,0,1,0,1,0,1,1,0,0,0,1,1,2
sp14,142,SIXTH,INTL,IntSt-Ling,0,0,0,0,0,0,0,0,0,0,0,0,0,1,1,0,0,0,0,1,1
sp14,142,SIXTH,INTL,IntSt-Lit,0,0,0,0,0,0,0,0,0,0,0,0,0,1,1,0,0,0,0,1,1
sp14,142,SIXTH,INTL,IntSt-PolS,0,0,0,0,0,0,0,1,1,1,4,5,1,9,10,0,0,0,2,14,16
sp14,142,SIXTH,INTL,IntSt-Soc,0,0,0,0,1,1,1,1,2,0,1,1,1,1,2,0,0,0,2,4,6
sp14,142,SIXTH,ITAL,Italian St,0,0,0,0,0,0,0,0,0,0,1,1,0,0,0,0,0,0,0,1,1
sp14,142,SIXTH,JAPN,JapaneseSt,0,0,0,0,0,0,0,0,0,0,0,0,0,1,1,0,0,0,0,1,1
sp14,142,SIXTH,LATI,LatinAm St,0,0,0,0,0,0,0,0,0,1,0,1,0,0,0,0,0,0,1,0,1
sp14,142,SIXTH,LING,Lang Stu,0,0,0,0,0,0,1,0,1,0,1,1,0,1,1,0,0,0,1,2,3
sp14,142,SIXTH,LING,Ling-CogLn,0,0,0,0,0,0,0,0,0,1,2,3,1,1,2,0,0,0,2,3,5
sp14,142,SIXTH,LING,Ling-LSoc,0,0,0,0,0,0,0,0,0,0,0,0,1,2,3,0,0,0,1,2,3
sp14,142,SIXTH,LING,Linguistcs,0,0,0,0,0,0,0,2,2,1,0,1,0,4,4,0,0,0,1,6,7
sp14,142,SIXTH,LIT,Lit/CultSt,0,0,0,0,0,0,0,0,0,0,0,0,0,1,1,0,0,0,0,1,1
sp14,142,SIXTH,LIT,Lit/Engl,0,0,0,0,0,0,0,0,0,1,2,3,0,4,4,0,0,0,1,6,7
sp14,142,SIXTH,LIT,Lit/Writng,0,0,0,0,1,1,2,4,6,1,2,3,2,4,6,0,0,0,5,11,16
sp14,142,SIXTH,LIT,Spanish Lt,0,0,0,0,0,0,0,0,0,0,0,0,0,1,1,0,0,0,0,1,1
sp14,142,SIXTH,MAE,Aerosp Eng,0,0,0,0,0,0,2,2,4,5,2,7,16,1,17,0,0,0,23,5,28
sp14,142,SIXTH,MAE,Engin Sci,0,0,0,0,0,0,0,0,0,0,0,0,4,0,4,0,0,0,4,0,4
sp14,142,SIXTH,MAE,Envir Eng,0,0,0,3,0,3,10,3,13,8,5,13,11,12,23,0,0,0,32,20,52
sp14,142,SIXTH,MAE,Mech Engin,0,0,0,0,0,0,10,1,11,7,3,10,36,7,43,0,0,0,53,11,64
sp14,142,SIXTH,MATH,Appld Math,0,0,0,1,3,4,6,3,9,5,3,8,4,5,9,0,0,0,16,14,30
sp14,142,SIXTH,MATH,Math/SecEd,0,0,0,0,0,0,0,0,0,0,0,0,0,1,1,0,0,0,0,1,1
sp14,142,SIXTH,MATH,Mathematcs,0,0,0,4,1,5,1,2,3,4,0,4,2,2,4,0,0,0,11,5,16
sp14,142,SIXTH,MATH,Mth-CompSc,0,0,0,1,1,2,10,3,13,3,1,4,3,2,5,0,0,0,17,7,24
sp14,142,SIXTH,MATH,Mth-Mth&Ec,0,0,0,0,0,0,5,1,6,2,3,5,6,3,9,0,0,0,13,7,20
sp14,142,SIXTH,MATH,Mth-SciCom,0,0,0,0,0,0,1,0,1,0,0,0,0,0,0,0,0,0,1,0,1
sp14,142,SIXTH,MATH,Mth/ApldSc,0,0,0,0,1,1,1,1,2,0,0,0,0,1,1,0,0,0,1,3,4
sp14,142,SIXTH,MATH,Prob&Stats,0,0,0,0,1,1,0,0,0,1,3,4,1,1,2,0,0,0,2,5,7
sp14,142,SIXTH,MUS,Mu-CompArt,0,0,0,0,0,0,0,1,1,9,1,10,10,0,10,0,0,0,19,2,21
sp14,142,SIXTH,MUS,Music,0,0,0,0,0,0,0,0,0,1,1,2,6,4,10,0,0,0,7,5,12
sp14,142,SIXTH,NENG,NanoEng,0,0,0,3,0,3,11,5,16,15,2,17,22,5,27,0,0,0,51,12,63
sp14,142,SIXTH,PHIL,Philosophy,0,0,0,0,0,0,0,2,2,0,0,0,2,2,4,0,0,0,2,4,6
sp14,142,SIXTH,PHYS,Biophysics,0,0,0,0,0,0,0,0,0,1,0,1,4,0,4,0,0,0,5,0,5
sp14,142,SIXTH,PHYS,Gen Physcs,0,0,0,0,0,0,1,0,1,0,0,0,0,0,0,0,0,0,1,0,1
sp14,142,SIXTH,PHYS,GenPys/SEd,0,0,0,0,0,0,1,0,1,0,0,0,0,0,0,0,0,0,1,0,1
sp14,142,SIXTH,PHYS,Phy/ErthSc,0,0,0,0,0,0,0,0,0,1,0,1,1,0,1,0,0,0,2,0,2
sp14,142,SIXTH,PHYS,Phys/Astro,0,0,0,0,0,0,0,2,2,3,1,4,1,1,2,0,0,0,4,4,8
sp14,142,SIXTH,PHYS,Phys/Comp,0,0,0,0,0,0,1,0,1,0,0,0,2,0,2,0,0,0,3,0,3
sp14,142,SIXTH,PHYS,Phys/Mtrls,0,0,0,1,0,1,1,0,1,1,0,1,0,0,0,0,0,0,3,0,3
sp14,142,SIXTH,PHYS,Physics,0,0,0,1,0,1,6,1,7,2,0,2,6,0,6,0,0,0,15,1,16
sp14,142,SIXTH,POLI,Polit Sci,0,0,0,3,0,3,1,3,4,6,6,12,8,8,16,0,0,0,18,17,35
sp14,142,SIXTH,POLI,PolSc-Amer,0,0,0,0,0,0,1,1,2,1,1,2,4,2,6,0,0,0,6,4,10
sp14,142,SIXTH,POLI,PolSc-Comp,0,0,0,0,0,0,0,0,0,0,0,0,0,1,1,0,0,0,0,1,1
sp14,142,SIXTH,POLI,PolSc-Intl,0,0,0,0,0,0,2,2,4,1,6,7,7,3,10,0,0,0,10,11,21
sp14,142,SIXTH,POLI,PolSc-PLaw,0,0,0,0,0,0,0,2,2,0,0,0,5,2,7,0,0,0,5,4,9
sp14,142,SIXTH,POLI,PolSc-PPol,0,0,0,0,0,0,0,0,0,0,0,0,2,2,4,0,0,0,2,2,4
sp14,142,SIXTH,POLI,PolSc-Thry,0,0,0,0,0,0,0,0,0,0,0,0,0,1,1,0,0,0,0,1,1
sp14,142,SIXTH,PSYC,Psychology,0,0,0,3,5,8,6,17,23,15,38,53,27,64,91,0,0,0,51,124,175
sp14,142,SIXTH,SE,Engin Sci,0,0,0,2,0,2,1,0,1,0,0,0,0,0,0,0,0,0,3,0,3
sp14,142,SIXTH,SE,Struct Eng,0,0,0,8,1,9,28,13,41,28,7,35,48,11,59,0,0,0,112,32,144
sp14,142,SIXTH,SIO,Earth Sci,0,0,0,0,0,0,0,0,0,0,1,1,1,2,3,0,0,0,1,3,4
sp14,142,SIXTH,SIO,Marine Bio,0,0,0,0,1,1,1,6,7,0,4,4,3,3,6,0,0,0,4,14,18
sp14,142,SIXTH,SOC,SocCulCom,0,0,0,0,0,0,0,0,0,0,1,1,0,2,2,0,0,0,0,3,3
sp14,142,SIXTH,SOC,SocEconSoc,0,0,0,0,0,0,1,0,1,0,1,1,1,0,1,0,0,0,2,1,3
sp14,142,SIXTH,SOC,SocIntlStu,0,0,0,1,0,1,0,0,0,0,0,0,0,2,2,0,0,0,1,2,3
sp14,142,SIXTH,SOC,Sociology,0,0,0,2,1,3,0,0,0,1,7,8,3,7,10,0,0,0,6,15,21
sp14,142,SIXTH,SOC,SocLawSoc,0,0,0,0,0,0,0,0,0,1,3,4,1,2,3,0,0,0,2,5,7
sp14,142,SIXTH,SOC,SocSciMed,0,0,0,0,0,0,0,0,0,0,0,0,1,1,2,0,0,0,1,1,2
sp14,142,SIXTH,SOC,SocSolneq,0,0,0,0,0,0,0,0,0,0,0,0,0,4,4,0,0,0,0,4,4
sp14,142,SIXTH,THEA,Dance,0,0,0,0,0,0,0,1,1,0,1,1,0,0,0,0,0,0,0,2,2
sp14,142,SIXTH,THEA,Theatre,0,0,0,0,2,2,0,5,5,3,4,7,7,9,16,0,0,0,10,20,30
sp14,142,SIXTH,UNAF,UndecHumAr,0,0,0,1,0,1,0,0,0,0,0,0,0,0,0,0,0,0,1,0,1
sp14,142,SIXTH,UNAF,Undeclared,0,0,0,19,13,32,33,19,52,2,0,2,0,0,0,0,0,0,54,32,86
sp14,142,SIXTH,UNAF,UndecPhysS,0,0,0,2,2,4,3,0,3,0,0,0,0,0,0,0,0,0,5,2,7
sp14,142,SIXTH,UNAF,UndecSocSc,0,0,0,0,3,3,3,2,5,0,0,0,0,0,0,0,0,0,3,5,8
sp14,142,SIXTH,USP,Urb Stu&Pl,0,0,0,0,0,0,0,1,1,3,7,10,2,9,11,0,0,0,5,17,22
sp14,142,SIXTH,VIS,Art Hst/Cr,0,0,0,0,1,1,0,0,0,0,2,2,0,6,6,0,0,0,0,9,9
sp14,142,SIXTH,VIS,Media,0,0,0,4,4,8,9,6,15,6,16,22,18,10,28,0,0,0,37,36,73
sp14,142,SIXTH,VIS,Studio VA,0,0,0,0,1,1,1,4,5,3,3,6,1,17,18,0,0,0,5,25,30
sp14,142,SIXTH,VIS,VA-CompArt,0,0,0,0,3,3,0,13,13,0,3,3,10,7,17,0,0,0,10,26,36
sp14,142,WARREN,ANTH,Anth-Arch,0,0,0,0,0,0,0,1,1,1,1,2,0,1,1,0,0,0,1,3,4
sp14,142,WARREN,ANTH,Anth-Biol,0,0,0,0,0,0,0,0,0,0,1,1,0,4,4,0,0,0,0,5,5
sp14,142,WARREN,ANTH,Anth-Soci,0,0,0,0,0,0,0,0,0,0,1,1,1,1,2,0,0,0,1,2,3
sp14,142,WARREN,BENG,Bioen:Binf,0,0,0,1,1,2,3,9,12,6,3,9,4,7,11,0,0,0,14,20,34
sp14,142,WARREN,BENG,BioengBioS,0,0,0,1,1,2,8,0,8,2,0,2,0,0,0,0,0,0,11,1,12
sp14,142,WARREN,BENG,BioengBiot,0,0,0,0,0,0,6,6,12,7,11,18,27,23,50,0,0,0,40,40,80
sp14,142,WARREN,BENG,Bioengin,0,0,0,0,0,0,3,4,7,8,4,12,25,15,40,0,0,0,36,23,59
sp14,142,WARREN,BIOL,Bioc/CellB,0,0,0,2,5,7,14,17,31,23,24,47,42,36,78,0,0,0,81,82,163
sp14,142,WARREN,BIOL,BiolBioinf,0,0,0,0,0,0,1,0,1,1,1,2,0,0,0,0,0,0,2,1,3
sp14,142,WARREN,BIOL,Ec/Beh/Evo,0,0,0,0,0,0,2,3,5,2,1,3,2,11,13,0,0,0,6,15,21
sp14,142,WARREN,BIOL,Genl Biol,0,0,0,3,3,6,3,12,15,10,18,28,35,40,75,0,0,0,51,73,124
sp14,142,WARREN,BIOL,Human Bio,0,0,0,1,10,11,20,31,51,22,37,59,38,43,81,0,0,0,81,121,202
sp14,142,WARREN,BIOL,Microbiol,0,0,0,0,0,0,1,1,2,1,1,2,4,9,13,0,0,0,6,11,17
sp14,142,WARREN,BIOL,Molec Biol,0,0,0,0,0,0,2,1,3,2,2,4,9,6,15,0,0,0,13,9,22
sp14,142,WARREN,BIOL,PhyslNeuro,0,0,0,1,2,3,9,18,27,20,9,29,13,21,34,0,0,0,43,50,93
sp14,142,WARREN,CENG,Chem Engin,0,0,0,6,4,10,22,9,31,31,12,43,62,34,96,0,0,0,121,59,180
sp14,142,WARREN,CGS,CritGendSt,0,0,0,0,0,0,0,0,0,1,0,1,0,0,0,0,0,0,1,0,1
sp14,142,WARREN,CHEM,Bioch/Chem,0,0,0,1,0,1,4,2,6,3,5,8,20,20,40,0,0,0,28,27,55
sp14,142,WARREN,CHEM,Chem Phys,0,0,0,0,0,0,1,0,1,0,0,0,0,1,1,0,0,0,1,1,2
sp14,142,WARREN,CHEM,Chemistry,0,0,0,0,2,2,1,4,5,2,4,6,5,11,16,0,0,0,8,21,29
sp14,142,WARREN,CHEM,Envir Chem,0,0,0,0,0,0,0,0,0,1,0,1,0,2,2,0,0,0,1,2,3
sp14,142,WARREN,CHEM,MolecSynth,0,0,0,0,0,0,0,0,0,0,0,0,2,0,2,0,0,0,2,0,2
sp14,142,WARREN,CHEM,Pharm Chem,0,0,0,1,0,1,1,2,3,1,9,10,19,24,43,0,0,0,22,35,57
sp14,142,WARREN,CHIN,Chinese St,0,0,0,0,0,0,0,0,0,0,2,2,0,0,0,0,0,0,0,2,2
sp14,142,WARREN,COGS,Cog Sci,0,0,0,0,0,0,0,5,5,2,3,5,8,4,12,0,0,0,10,12,22
sp14,142,WARREN,COGS,CogSc/ClAs,0,0,0,0,0,0,1,0,1,0,1,1,0,3,3,0,0,0,1,4,5
sp14,142,WARREN,COGS,CogSc/Comp,0,0,0,0,0,0,0,1,1,0,0,0,2,1,3,0,0,0,2,2,4
sp14,142,WARREN,COGS,CogSc/HCI,0,0,0,0,0,0,0,3,3,2,2,4,5,2,7,0,0,0,7,7,14
sp14,142,WARREN,COGS,CogSc/HCog,0,0,0,0,0,0,1,0,1,1,0,1,0,2,2,0,0,0,2,2,4
sp14,142,WARREN,COGS,CogSc/Neur,0,0,0,0,1,1,0,1,1,0,3,3,8,20,28,0,0,0,8,25,33
sp14,142,WARREN,COMM,Communic,0,0,0,1,5,6,3,5,8,9,21,30,12,28,40,0,0,0,25,59,84
sp14,142,WARREN,CSE,Comp Sci,0,0,0,6,1,7,46,7,53,116,24,140,183,32,215,0,0,0,351,64,415
sp14,142,WARREN,CSE,CompEngCSE,0,0,0,4,0,4,13,2,15,25,4,29,47,6,53,0,0,0,89,12,101
sp14,142,WARREN,CSE,CompScBinf,0,0,0,0,0,0,16,4,20,1,1,2,10,7,17,0,0,0,27,12,39
sp14,142,WARREN,ECE,CompEngECE,0,0,0,7,0,7,16,2,18,10,1,11,13,0,13,0,0,0,46,3,49
sp14,142,WARREN,ECE,Electr Eng,0,0,0,15,5,20,50,21,71,63,12,75,100,13,113,0,0,0,228,51,279
sp14,142,WARREN,ECE,EleEng&Soc,0,0,0,0,0,0,0,1,1,0,0,0,0,0,0,0,0,0,0,1,1
sp14,142,WARREN,ECE,Engin Phys,0,0,0,0,0,0,3,0,3,2,0,2,0,0,0,0,0,0,5,0,5
sp14,142,WARREN,ECE,Pr-EngPhys,0,0,0,1,0,1,1,0,1,0,0,0,1,0,1,0,0,0,3,0,3
sp14,142,WARREN,ECON,Ec-Mth&Ecn,0,0,0,2,1,3,4,3,7,4,2,6,3,0,3,0,0,0,13,6,19
sp14,142,WARREN,ECON,Econ-MgtSc,0,0,0,3,3,6,17,10,27,33,11,44,37,26,63,0,0,0,90,50,140
sp14,142,WARREN,ECON,Economics,0,0,0,7,3,10,24,10,34,50,24,74,56,45,101,0,0,0,137,82,219
sp14,142,WARREN,ESYS,EnvSys(EB),0,0,0,0,0,0,0,1,1,1,1,2,3,5,8,0,0,0,4,7,11
sp14,142,WARREN,ESYS,EnvSys(EP),0,0,0,1,0,1,0,0,0,0,0,0,1,1,2,0,0,0,2,1,3
sp14,142,WARREN,ESYS,EnvSys(ES),0,0,0,0,0,0,0,0,0,0,0,0,1,0,1,0,0,0,1,0,1
sp14,142,WARREN,ETHN,Ethnic St,0,0,0,0,0,0,1,1,2,1,1,2,0,3,3,0,0,0,2,5,7
sp14,142,WARREN,FPMU,Public Hlt,0,0,0,0,0,0,1,4,5,1,8,9,2,3,5,0,0,0,4,15,19
sp14,142,WARREN,HDP,Human Dev,0,0,0,0,0,0,0,0,0,1,4,5,4,19,23,0,0,0,5,23,28
sp14,142,WARREN,HDP,Pr-HumnDev,0,0,0,0,0,0,0,3,3,1,3,4,1,2,3,0,0,0,2,8,10
sp14,142,WARREN,HIST,History,0,0,0,0,0,0,0,0,0,4,1,5,8,2,10,0,0,0,12,3,15
sp14,142,WARREN,INTD,Wa Ind St,0,0,0,0,0,0,0,0,0,0,0,0,0,2,2,0,0,0,0,2,2
sp14,142,WARREN,INTL,IntSt-Econ,0,0,0,0,1,1,0,1,1,2,1,3,0,10,10,0,0,0,2,13,15
sp14,142,WARREN,INTL,IntSt-Hist,0,0,0,0,0,0,0,0,0,0,0,0,0,1,1,0,0,0,0,1,1
sp14,142,WARREN,INTL,IntSt-Ling,0,0,0,0,1,1,0,0,0,0,0,0,0,2,2,0,0,0,0,3,3
sp14,142,WARREN,INTL,IntSt-PolS,0,0,0,0,0,0,0,1,1,1,2,3,5,0,5,0,0,0,6,3,9
sp14,142,WARREN,INTL,IntSt-Soc,0,0,0,0,0,0,0,3,3,0,1,1,0,1,1,0,0,0,0,5,5
sp14,142,WARREN,JAPN,JapaneseSt,0,0,0,0,0,0,0,0,0,0,0,0,1,0,1,0,0,0,1,0,1
sp14,142,WARREN,JUDA,Judaic Stu,0,0,0,0,0,0,0,0,0,1,0,1,1,0,1,0,0,0,2,0,2
sp14,142,WARREN,LING,Lang Stu,0,0,0,0,0,0,0,0,0,0,0,0,0,1,1,0,0,0,0,1,1
sp14,142,WARREN,LING,Ling-CogLn,0,0,0,0,0,0,0,1,1,0,0,0,1,2,3,0,0,0,1,3,4
sp14,142,WARREN,LING,Ling-LSoc,0,0,0,0,0,0,1,0,1,0,1,1,0,0,0,0,0,0,1,1,2
sp14,142,WARREN,LING,Linguistcs,0,0,0,0,0,0,0,0,0,0,0,0,2,2,4,0,0,0,2,2,4
sp14,142,WARREN,LIT,Lit/Engl,0,0,0,0,0,0,1,0,1,0,5,5,0,2,2,0,0,0,1,7,8
sp14,142,WARREN,LIT,Lit/Writng,0,0,0,0,1,1,0,1,1,4,6,10,3,7,10,0,0,0,7,15,22
sp14,142,WARREN,LIT,Spanish Lt,0,0,0,0,0,0,0,1,1,1,1,2,0,0,0,0,0,0,1,2,3
sp14,142,WARREN,MAE,Aerosp Eng,0,0,0,1,0,1,17,3,20,18,4,22,33,7,40,0,0,0,69,14,83
sp14,142,WARREN,MAE,Engin Sci,0,0,0,0,0,0,0,0,0,2,0,2,8,1,9,0,0,0,10,1,11
sp14,142,WARREN,MAE,Envir Eng,0,0,0,4,0,4,14,6,20,10,4,14,16,16,32,0,0,0,44,26,70
sp14,142,WARREN,MAE,Mech Engin,0,0,0,1,0,1,20,5,25,31,4,35,56,14,70,0,0,0,108,23,131
sp14,142,WARREN,MATH,Appld Math,0,0,0,2,2,4,7,5,12,3,3,6,10,7,17,0,0,0,22,17,39
sp14,142,WARREN,MATH,Math/SecEd,0,0,0,1,0,1,0,1,1,0,4,4,1,2,3,0,0,0,2,7,9
sp14,142,WARREN,MATH,Mathematcs,0,0,0,0,3,3,3,1,4,2,2,4,6,5,11,0,0,0,11,11,22
sp14,142,WARREN,MATH,Mth-CompSc,0,0,0,4,1,5,5,2,7,1,2,3,6,2,8,0,0,0,16,7,23
sp14,142,WARREN,MATH,Mth-Mth&Ec,0,0,0,1,4,5,6,6,12,5,3,8,6,7,13,0,0,0,18,20,38
sp14,142,WARREN,MATH,Mth/ApldSc,0,0,0,0,0,0,1,0,1,0,0,0,1,4,5,0,0,0,2,4,6
sp14,142,WARREN,MATH,Prob&Stats,0,0,0,1,0,1,1,2,3,0,4,4,7,0,7,0,0,0,9,6,15
sp14,142,WARREN,MUS,Mu-CompArt,0,0,0,0,0,0,0,1,1,2,0,2,3,1,4,0,0,0,5,2,7
sp14,142,WARREN,MUS,Music,0,0,0,0,0,0,0,0,0,0,0,0,2,1,3,0,0,0,2,1,3
sp14,142,WARREN,NENG,NanoEng,0,0,0,1,0,1,18,3,21,16,1,17,38,10,48,0,0,0,73,14,87
sp14,142,WARREN,PHIL,Philosophy,0,0,0,0,0,0,0,2,2,2,0,2,8,3,11,0,0,0,10,5,15
sp14,142,WARREN,PHYS,Biophysics,0,0,0,0,0,0,1,1,2,1,1,2,1,2,3,0,0,0,3,4,7
sp14,142,WARREN,PHYS,GenPys/SEd,0,0,0,0,0,0,0,1,1,0,0,0,0,0,0,0,0,0,0,1,1
sp14,142,WARREN,PHYS,Phys/Astro,0,0,0,1,0,1,0,1,1,1,1,2,3,1,4,0,0,0,5,3,8
sp14,142,WARREN,PHYS,Phys/Comp,0,0,0,0,0,0,0,0,0,0,0,0,1,1,2,0,0,0,1,1,2
sp14,142,WARREN,PHYS,Physics,0,0,0,0,0,0,3,0,3,2,0,2,5,2,7,0,0,0,10,2,12
sp14,142,WARREN,POLI,Polit Sci,0,0,0,1,0,1,3,4,7,8,7,15,25,22,47,0,0,0,37,33,70
sp14,142,WARREN,POLI,PolSc-Amer,0,0,0,0,0,0,2,0,2,1,2,3,9,6,15,0,0,0,12,8,20
sp14,142,WARREN,POLI,PolSc-Comp,0,0,0,0,0,0,0,0,0,0,1,1,0,1,1,0,0,0,0,2,2
sp14,142,WARREN,POLI,PolSc-Intl,0,0,0,0,2,2,4,2,6,6,4,10,8,2,10,0,0,0,18,10,28
sp14,142,WARREN,POLI,PolSc-PLaw,0,0,0,1,1,2,2,1,3,6,6,12,5,4,9,0,0,0,14,12,26
sp14,142,WARREN,POLI,PolSc-PPol,0,0,0,0,0,0,0,0,0,2,2,4,3,3,6,0,0,0,5,5,10
sp14,142,WARREN,POLI,PolSc-Thry,0,0,0,0,0,0,0,0,0,0,0,0,3,0,3,0,0,0,3,0,3
sp14,142,WARREN,PSYC,Psychology,0,0,0,2,5,7,4,17,21,14,36,50,32,60,92,0,0,0,52,118,170
sp14,142,WARREN,RELI,Relig/Stu,0,0,0,0,0,0,0,0,0,0,0,0,1,1,2,0,0,0,1,1,2
sp14,142,WARREN,SE,Engin Sci,0,0,0,0,0,0,1,2,3,0,0,0,0,0,0,0,0,0,1,2,3
sp14,142,WARREN,SE,Struct Eng,0,0,0,13,4,17,31,12,43,36,12,48,77,22,99,0,0,0,157,50,207
sp14,142,WARREN,SIO,Earth Sci,0,0,0,0,0,0,0,0,0,2,0,2,2,2,4,0,0,0,4,2,6
sp14,142,WARREN,SIO,Marine Bio,0,0,0,0,1,1,1,0,1,0,2,2,2,3,5,0,0,0,3,6,9
sp14,142,WARREN,SOC,SocAmSt,0,0,0,0,0,0,0,0,0,0,0,0,0,1,1,0,0,0,0,1,1
sp14,142,WARREN,SOC,SocCulCom,0,0,0,0,0,0,0,0,0,0,0,0,0,1,1,0,0,0,0,1,1
sp14,142,WARREN,SOC,SocEconSoc,0,0,0,0,0,0,0,0,0,1,1,2,0,0,0,0,0,0,1,1,2
sp14,142,WARREN,SOC,Sociology,0,0,0,0,0,0,0,1,1,1,5,6,7,8,15,0,0,0,8,14,22
sp14,142,WARREN,SOC,SocLawSoc,0,0,0,0,0,0,0,0,0,3,3,6,1,5,6,0,0,0,4,8,12
sp14,142,WARREN,SOC,SocSciMed,0,0,0,0,0,0,0,0,0,0,0,0,0,1,1,0,0,0,0,1,1
sp14,142,WARREN,SOC,SocSolneq,0,0,0,0,0,0,0,0,0,0,1,1,0,2,2,0,0,0,0,3,3
sp14,142,WARREN,THEA,Theatre,0,0,0,0,0,0,1,0,1,0,0,0,4,3,7,0,0,0,5,3,8
sp14,142,WARREN,UNAF,IntcampVis,0,0,0,0,1,1,0,0,0,0,1,1,1,0,1,0,0,0,1,2,3
sp14,142,WARREN,UNAF,Limited St,0,0,0,0,0,0,0,0,0,0,0,0,0,0,0,2,0,2,2,0,2
sp14,142,WARREN,UNAF,Undeclared,0,0,0,12,6,18,14,10,24,0,2,2,0,0,0,0,0,0,26,18,44
sp14,142,WARREN,UNAF,UndecPhysS,0,0,0,1,0,1,0,0,0,0,0,0,0,0,0,0,0,0,1,0,1
sp14,142,WARREN,UNAF,UndecSocSc,0,0,0,0,0,0,1,1,2,0,0,0,0,0,0,0,0,0,1,1,2
sp14,142,WARREN,USP,Urb Stu&Pl,0,0,0,0,0,0,1,1,2,2,0,2,4,2,6,0,0,0,7,3,10
sp14,142,WARREN,VIS,Art Hst/Cr,0,0,0,0,0,0,0,0,0,0,0,0,1,0,1,0,0,0,1,0,1
sp14,142,WARREN,VIS,Media,0,0,0,0,0,0,0,3,3,5,1,6,2,4,6,0,0,0,7,8,15
sp14,142,WARREN,VIS,Studio VA,0,0,0,0,0,0,0,1,1,0,0,0,1,2,3,0,0,0,1,3,4
sp14,142,WARREN,VIS,VA-CompArt,0,0,0,1,0,1,1,0,1,1,2,3,1,0,1,0,0,0,4,2,6
sp13,132,MARSHALL,ANTH,Anth-Arch,0,0,0,0,0,0,0,0,0,0,0,0,2,2,4,0,0,0,2,2,4
sp13,132,MARSHALL,ANTH,Anth-Biol,0,0,0,0,0,0,0,0,0,0,3,3,3,8,11,0,0,0,3,11,14
sp13,132,MARSHALL,ANTH,Anth-Soci,0,0,0,0,1,1,0,1,1,0,1,1,0,6,6,0,0,0,0,9,9
sp13,132,MARSHALL,BENG,Bioen:Binf,0,0,0,1,0,1,1,1,2,1,2,3,3,3,6,0,0,0,6,6,12
sp13,132,MARSHALL,BENG,Bioeng:PM,0,0,0,0,0,0,0,0,0,0,0,0,3,4,7,0,0,0,3,4,7
sp13,132,MARSHALL,BENG,BioengBiot,0,0,0,0,1,1,5,1,6,3,3,6,16,11,27,0,0,0,24,16,40
sp13,132,MARSHALL,BENG,Bioengin,0,0,0,0,0,0,0,1,1,3,5,8,4,3,7,0,0,0,7,9,16
sp13,132,MARSHALL,BIOL,Bioc/CellB,0,0,0,0,4,4,15,26,41,18,20,38,30,36,66,0,0,0,63,86,149
sp13,132,MARSHALL,BIOL,BiolBioinf,0,0,0,0,1,1,1,0,1,0,0,0,0,0,0,0,0,0,1,1,2
sp13,132,MARSHALL,BIOL,Ec/Beh/Evo,0,0,0,0,0,0,1,0,1,2,0,2,2,4,6,0,0,0,5,4,9
sp13,132,MARSHALL,BIOL,Genl Biol,0,0,0,1,5,6,6,17,23,10,13,23,31,67,98,0,0,0,48,102,150
sp13,132,MARSHALL,BIOL,Human Bio,0,0,0,0,11,11,17,43,60,18,30,48,38,65,103,0,0,0,73,149,222
sp13,132,MARSHALL,BIOL,Microbiol,0,0,0,1,0,1,2,4,6,1,5,6,6,10,16,0,0,0,10,19,29
sp13,132,MARSHALL,BIOL,Molec Biol,0,0,0,1,0,1,6,2,8,1,0,1,3,2,5,0,0,0,11,4,15
sp13,132,MARSHALL,BIOL,PhyslNeuro,0,0,0,1,7,8,14,16,30,6,11,17,28,21,49,0,0,0,49,55,104
sp13,132,MARSHALL,CENG,Chem Engin,0,0,0,2,2,4,8,9,17,11,10,21,28,11,39,0,0,0,49,32,81
sp13,132,MARSHALL,CGS,CritGendSt,0,0,0,0,0,0,0,0,0,0,1,1,0,1,1,0,0,0,0,2,2
sp13,132,MARSHALL,CHEM,Bioch/Chem,0,0,0,0,3,3,2,6,8,8,8,16,16,32,48,0,0,0,26,49,75
sp13,132,MARSHALL,CHEM,Bioinform,0,0,0,0,0,0,0,0,0,0,0,0,2,0,2,0,0,0,2,0,2
sp13,132,MARSHALL,CHEM,Chem Phys,0,0,0,0,0,0,0,0,0,0,0,0,1,0,1,0,0,0,1,0,1
sp13,132,MARSHALL,CHEM,Chemistry,0,0,0,1,2,3,2,3,5,5,4,9,11,7,18,0,0,0,19,16,35
sp13,132,MARSHALL,CHEM,Envir Chem,0,0,0,0,1,1,0,1,1,0,0,0,1,1,2,0,0,0,1,3,4
sp13,132,MARSHALL,CHEM,MolecSynth,0,0,0,0,0,0,0,0,0,0,0,0,1,0,1,0,0,0,1,0,1
sp13,132,MARSHALL,CHEM,Pharm Chem,0,0,0,0,4,4,3,8,11,3,7,10,15,22,37,0,0,0,21,41,62
sp13,132,MARSHALL,CHIN,Chinese St,0,0,0,0,0,0,0,0,0,0,0,0,1,0,1,0,0,0,1,0,1
sp13,132,MARSHALL,COGS,Cog Sci,0,0,0,2,0,2,4,8,12,3,3,6,4,6,10,0,0,0,13,17,30
sp13,132,MARSHALL,COGS,CogSc/ClAs,0,0,0,0,0,0,0,1,1,0,1,1,1,4,5,0,0,0,1,6,7
sp13,132,MARSHALL,COGS,CogSc/Comp,0,0,0,0,0,0,0,0,0,1,0,1,2,0,2,0,0,0,3,0,3
sp13,132,MARSHALL,COGS,CogSc/HCI,0,0,0,1,0,1,1,3,4,1,3,4,5,8,13,0,0,0,8,14,22
sp13,132,MARSHALL,COGS,CogSc/HCog,0,0,0,0,0,0,1,3,4,0,1,1,1,1,2,0,0,0,2,5,7
sp13,132,MARSHALL,COGS,CogSc/Neur,0,0,0,0,1,1,1,2,3,0,5,5,9,19,28,0,0,0,10,27,37
sp13,132,MARSHALL,COMM,Communic,0,0,0,2,7,9,1,17,18,8,48,56,20,65,85,0,0,0,31,137,168
sp13,132,MARSHALL,CSE,Comp Sci,0,0,0,13,0,13,30,6,36,37,7,44,47,16,63,0,0,0,127,29,156
sp13,132,MARSHALL,CSE,CompEngCSE,0,0,0,2,0,2,11,0,11,10,3,13,13,1,14,0,0,0,36,4,40
sp13,132,MARSHALL,CSE,CompScBinf,0,0,0,0,0,0,1,1,2,1,0,1,4,1,5,0,0,0,6,2,8
sp13,132,MARSHALL,ECE,CompEngECE,0,0,0,1,0,1,6,0,6,3,0,3,2,1,3,0,0,0,12,1,13
sp13,132,MARSHALL,ECE,Electr Eng,0,0,0,5,1,6,11,5,16,16,3,19,35,5,40,0,0,0,67,14,81
sp13,132,MARSHALL,ECE,EleEng&Soc,0,0,0,0,0,0,0,0,0,0,0,0,1,0,1,0,0,0,1,0,1
sp13,132,MARSHALL,ECON,Ec-Mth&Ecn,0,0,0,2,1,3,5,3,8,8,3,11,9,6,15,0,0,0,24,13,37
sp13,132,MARSHALL,ECON,Econ-MgtSc,0,0,0,3,7,10,7,11,18,31,21,52,58,39,97,0,0,0,99,78,177
sp13,132,MARSHALL,ECON,Economics,0,0,0,14,8,22,13,6,19,51,58,109,81,58,139,0,0,0,159,130,289
sp13,132,MARSHALL,ESYS,EnvSys(EB),0,0,0,0,1,1,1,1,2,0,3,3,6,20,26,0,0,0,7,25,32
sp13,132,MARSHALL,ESYS,EnvSys(EC),0,0,0,0,0,0,1,0,1,0,0,0,3,1,4,0,0,0,4,1,5
sp13,132,MARSHALL,ESYS,EnvSys(EP),0,0,0,0,0,0,1,2,3,1,1,2,1,3,4,0,0,0,3,6,9
sp13,132,MARSHALL,ESYS,EnvSys(ES),0,0,0,0,1,1,0,0,0,0,0,0,1,1,2,0,0,0,1,2,3
sp13,132,MARSHALL,ETHN,Ethnic St,0,0,0,0,0,0,0,0,0,1,2,3,3,5,8,0,0,0,4,7,11
sp13,132,MARSHALL,HDP,Human Dev,0,0,0,0,0,0,0,2,2,2,8,10,6,35,41,0,0,0,8,45,53
sp13,132,MARSHALL,HDP,Pr-HumnDev,0,0,0,0,6,6,0,9,9,0,14,14,1,5,6,0,0,0,1,34,35
sp13,132,MARSHALL,HIST,History,0,0,0,0,1,1,1,0,1,9,5,14,17,16,33,0,0,0,27,22,49
sp13,132,MARSHALL,INTL,Int-5yrEC,0,0,0,0,0,0,0,0,0,0,0,0,0,1,1,0,0,0,0,1,1
sp13,132,MARSHALL,INTL,IntSt-Anth,0,0,0,0,0,0,0,0,0,1,1,2,0,2,2,0,0,0,1,3,4
sp13,132,MARSHALL,INTL,IntSt-Econ,0,0,0,0,0,0,2,2,4,1,15,16,10,10,20,0,0,0,13,27,40
sp13,132,MARSHALL,INTL,IntSt-Hist,0,0,0,0,0,0,0,1,1,0,0,0,0,2,2,0,0,0,0,3,3
sp13,132,MARSHALL,INTL,IntSt-Ling,0,0,0,0,1,1,0,0,0,0,1,1,1,1,2,0,0,0,1,3,4
sp13,132,MARSHALL,INTL,IntSt-PolS,0,0,0,1,0,1,0,4,4,2,6,8,6,19,25,0,0,0,9,29,38
sp13,132,MARSHALL,INTL,IntSt-Soc,0,0,0,0,2,2,0,1,1,3,2,5,2,7,9,0,0,0,5,12,17
sp13,132,MARSHALL,JAPN,JapaneseSt,0,0,0,0,0,0,0,0,0,0,0,0,0,1,1,0,0,0,0,1,1
sp13,132,MARSHALL,JUDA,Judaic Stu,0,0,0,0,1,1,0,0,0,0,0,0,0,0,0,0,0,0,0,1,1
sp13,132,MARSHALL,LATI,LatinAm St,0,0,0,0,0,0,0,1,1,0,1,1,0,0,0,0,0,0,0,2,2
sp13,132,MARSHALL,LING,Lang Stu,0,0,0,0,0,0,0,0,0,0,0,0,0,1,1,0,0,0,0,1,1
sp13,132,MARSHALL,LING,Ling-CogLn,0,0,0,0,1,1,0,1,1,0,0,0,0,1,1,0,0,0,0,3,3
sp13,132,MARSHALL,LING,Ling-LSoc,0,0,0,0,0,0,0,1,1,0,0,0,0,3,3,0,0,0,0,4,4
sp13,132,MARSHALL,LING,Linguistcs,0,0,0,0,0,0,0,0,0,1,2,3,3,4,7,0,0,0,4,6,10
sp13,132,MARSHALL,LIT,Ital Lit,0,0,0,0,0,0,0,0,0,1,0,1,0,0,0,0,0,0,1,0,1
sp13,132,MARSHALL,LIT,Lit/Compos,0,0,0,0,0,0,0,1,1,0,0,0,0,0,0,0,0,0,0,1,1
sp13,132,MARSHALL,LIT,Lit/CultSt,0,0,0,0,0,0,0,0,0,0,0,0,0,1,1,0,0,0,0,1,1
sp13,132,MARSHALL,LIT,Lit/Engl,0,0,0,0,0,0,0,2,2,2,3,5,4,4,8,0,0,0,6,9,15
sp13,132,MARSHALL,LIT,Lit/World,0,0,0,0,0,0,0,0,0,1,1,2,0,0,0,0,0,0,1,1,2
sp13,132,MARSHALL,LIT,Lit/Writng,0,0,0,2,1,3,0,1,1,0,1,1,4,7,11,0,0,0,6,10,16
sp13,132,MARSHALL,LIT,Spanish Lt,0,0,0,0,0,0,0,0,0,0,0,0,1,2,3,0,0,0,1,2,3
sp13,132,MARSHALL,MAE,Aerosp Eng,0,0,0,0,0,0,3,0,3,3,0,3,18,6,24,0,0,0,24,6,30
sp13,132,MARSHALL,MAE,Engin Sci,0,0,0,0,0,0,0,0,0,0,0,0,1,0,1,0,0,0,1,0,1
sp13,132,MARSHALL,MAE,Envir Eng,0,0,0,0,2,2,7,2,9,6,1,7,7,4,11,0,0,0,20,9,29
sp13,132,MARSHALL,MAE,Mech Engin,0,0,0,0,0,0,1,0,1,11,2,13,29,8,37,0,0,0,41,10,51
sp13,132,MARSHALL,MATH,Appld Math,0,0,0,0,1,1,3,2,5,5,5,10,0,5,5,0,0,0,8,13,21
sp13,132,MARSHALL,MATH,Math/SecEd,0,0,0,0,0,0,0,0,0,0,1,1,3,2,5,0,0,0,3,3,6
sp13,132,MARSHALL,MATH,Mathematcs,0,0,0,2,3,5,2,1,3,1,5,6,6,6,12,0,0,0,11,15,26
sp13,132,MARSHALL,MATH,Mth-CompSc,0,0,0,0,0,0,0,0,0,0,1,1,3,1,4,0,0,0,3,2,5
sp13,132,MARSHALL,MATH,Mth-Mth&Ec,0,0,0,2,2,4,3,4,7,2,2,4,9,7,16,0,0,0,16,15,31
sp13,132,MARSHALL,MATH,Mth/ApldSc,0,0,0,0,0,0,0,0,0,0,0,0,2,0,2,0,0,0,2,0,2
sp13,132,MARSHALL,MATH,Prob&Stats,0,0,0,0,1,1,2,0,2,0,1,1,2,2,4,0,0,0,4,4,8
sp13,132,MARSHALL,MUS,Mu-CompArt,0,0,0,0,0,0,0,0,0,0,0,0,0,1,1,0,0,0,0,1,1
sp13,132,MARSHALL,MUS,Music,0,0,0,0,0,0,0,0,0,1,0,1,5,2,7,0,0,0,6,2,8
sp13,132,MARSHALL,NENG,NanoEng,0,0,0,0,1,1,9,2,11,6,2,8,10,1,11,0,0,0,25,6,31
sp13,132,MARSHALL,PHIL,Philosophy,0,0,0,0,0,0,1,0,1,1,1,2,7,2,9,0,0,0,9,3,12
sp13,132,MARSHALL,PHYS,Biophysics,0,0,0,0,0,0,0,0,0,0,0,0,2,1,3,0,0,0,2,1,3
sp13,132,MARSHALL,PHYS,GenPys/SEd,0,0,0,0,0,0,0,0,0,1,1,2,0,0,0,0,0,0,1,1,2
sp13,132,MARSHALL,PHYS,Phys/Astro,0,0,0,1,0,1,0,0,0,1,0,1,2,0,2,0,0,0,4,0,4
sp13,132,MARSHALL,PHYS,Physics,0,0,0,0,2,2,1,0,1,2,0,2,4,3,7,0,0,0,7,5,12
sp13,132,MARSHALL,POLI,Polit Sci,0,0,0,0,0,0,6,5,11,12,9,21,25,19,44,0,0,0,43,33,76
sp13,132,MARSHALL,POLI,PolSc-Amer,0,0,0,0,0,0,0,1,1,3,3,6,6,6,12,0,0,0,9,10,19
sp13,132,MARSHALL,POLI,PolSc-Comp,0,0,0,0,0,0,0,0,0,1,1,2,2,3,5,0,0,0,3,4,7
sp13,132,MARSHALL,POLI,PolSc-Intl,0,0,0,1,0,1,1,4,5,5,3,8,14,16,30,0,0,0,21,23,44
sp13,132,MARSHALL,POLI,PolSc-PLaw,0,0,0,0,1,1,5,7,12,3,6,9,8,3,11,0,0,0,16,17,33
sp13,132,MARSHALL,POLI,PolSc-PPol,0,0,0,0,0,0,2,0,2,3,0,3,1,2,3,0,0,0,6,2,8
sp13,132,MARSHALL,POLI,PolSc-Thry,0,0,0,0,0,0,0,0,0,1,1,2,2,1,3,0,0,0,3,2,5
sp13,132,MARSHALL,PSYC,Psychology,0,0,0,1,12,13,6,31,37,14,50,64,48,104,152,0,0,0,69,197,266
sp13,132,MARSHALL,SE,Engin Sci,0,0,0,0,0,0,1,0,1,1,0,1,0,0,0,0,0,0,2,0,2
sp13,132,MARSHALL,SE,Struct Eng,0,0,0,2,1,3,8,4,12,10,9,19,39,9,48,0,0,0,59,23,82
sp13,132,MARSHALL,SIO,Earth Sci,0,0,0,0,0,0,0,0,0,0,0,0,2,2,4,0,0,0,2,2,4
sp13,132,MARSHALL,SIO,Marine Bio,0,0,0,0,2,2,1,3,4,0,0,0,1,3,4,0,0,0,2,8,10
sp13,132,MARSHALL,SOC,SocAmSt,0,0,0,0,0,0,0,0,0,0,1,1,0,0,0,0,0,0,0,1,1
sp13,132,MARSHALL,SOC,SocCulCom,0,0,0,0,0,0,0,1,1,0,0,0,0,3,3,0,0,0,0,4,4
sp13,132,MARSHALL,SOC,SocEconSoc,0,0,0,0,0,0,0,0,0,1,0,1,1,4,5,0,0,0,2,4,6
sp13,132,MARSHALL,SOC,SocIntlStu,0,0,0,0,0,0,0,0,0,0,0,0,3,0,3,0,0,0,3,0,3
sp13,132,MARSHALL,SOC,Sociology,0,0,0,0,1,1,2,0,2,9,12,21,7,24,31,0,0,0,18,37,55
sp13,132,MARSHALL,SOC,SocLawSoc,0,0,0,0,0,0,0,0,0,0,3,3,2,8,10,0,0,0,2,11,13
sp13,132,MARSHALL,SOC,SocSciMed,0,0,0,0,0,0,0,1,1,3,2,5,5,4,9,0,0,0,8,7,15
sp13,132,MARSHALL,SOC,SocSolneq,0,0,0,0,0,0,0,0,0,1,1,2,0,6,6,0,0,0,1,7,8
sp13,132,MARSHALL,THEA,Dance,0,0,0,0,0,0,0,0,0,0,0,0,1,2,3,0,0,0,1,2,3
sp13,132,MARSHALL,THEA,Theatre,0,0,0,0,2,2,0,0,0,1,2,3,4,4,8,0,0,0,5,8,13
sp13,132,MARSHALL,TWS,ThirdWldSt,0,0,0,0,0,0,0,1,1,0,0,0,0,0,0,0,0,0,0,1,1
sp13,132,MARSHALL,UNAF,UndecHumAr,0,0,0,0,1,1,0,1,1,0,0,0,0,0,0,0,0,0,0,2,2
sp13,132,MARSHALL,UNAF,Undeclared,0,0,0,7,3,10,1,9,10,0,0,0,0,0,0,0,0,0,8,12,20
sp13,132,MARSHALL,UNAF,UndecPhysS,0,0,0,1,0,1,2,0,2,0,0,0,0,0,0,0,0,0,3,0,3
sp13,132,MARSHALL,UNAF,UndecSocSc,0,0,0,1,1,2,2,2,4,0,0,0,0,0,0,0,0,0,3,3,6
sp13,132,MARSHALL,USP,Urb Stu&Pl,0,0,0,0,0,0,2,1,3,5,4,9,9,9,18,0,0,0,16,14,30
sp13,132,MARSHALL,VIS,Art Hst/Cr,0,0,0,0,1,1,0,2,2,0,0,0,0,2,2,0,0,0,0,5,5
sp13,132,MARSHALL,VIS,Media,0,0,0,1,0,1,0,1,1,9,0,9,9,3,12,0,0,0,19,4,23
sp13,132,MARSHALL,VIS,Studio VA,0,0,0,1,0,1,0,0,0,1,0,1,0,8,8,0,0,0,2,8,10
sp13,132,MARSHALL,VIS,VA-CompArt,0,0,0,0,1,1,1,0,1,1,1,2,2,2,4,0,0,0,4,4,8
sp13,132,MUIR,ANTH,Anth-Arch,0,0,0,0,0,0,0,0,0,2,5,7,1,3,4,0,0,0,3,8,11
sp13,132,MUIR,ANTH,Anth-Biol,0,0,0,0,1,1,0,2,2,1,4,5,0,4,4,0,0,0,1,11,12
sp13,132,MUIR,ANTH,Anth-Soci,0,0,0,0,1,1,1,2,3,1,2,3,3,8,11,0,0,0,5,13,18
sp13,132,MUIR,BENG,Bioen:Binf,0,0,0,0,1,1,4,1,5,2,0,2,2,1,3,0,0,0,8,3,11
sp13,132,MUIR,BENG,Bioeng:PM,0,0,0,0,0,0,0,0,0,0,0,0,4,1,5,0,0,0,4,1,5
sp13,132,MUIR,BENG,BioengBiot,0,0,0,0,0,0,2,0,2,4,4,8,9,7,16,0,0,0,15,11,26
sp13,132,MUIR,BENG,Bioengin,0,0,0,0,1,1,5,0,5,2,6,8,10,5,15,0,0,0,17,12,29
sp13,132,MUIR,BENG,Pr-BioenPM,0,0,0,0,0,0,0,0,0,0,0,0,1,0,1,0,0,0,1,0,1
sp13,132,MUIR,BIOL,Bioc/CellB,0,0,0,3,3,6,10,17,27,15,13,28,36,32,68,0,0,0,64,65,129
sp13,132,MUIR,BIOL,BiolBioinf,0,0,0,0,0,0,2,1,3,0,1,1,0,2,2,0,0,0,2,4,6
sp13,132,MUIR,BIOL,Ec/Beh/Evo,0,0,0,1,0,1,2,3,5,3,4,7,3,20,23,0,0,0,9,27,36
sp13,132,MUIR,BIOL,Genl Biol,0,0,0,4,7,11,11,26,37,14,22,36,32,59,91,0,0,0,61,114,175
sp13,132,MUIR,BIOL,Human Bio,0,0,0,1,16,17,17,48,65,22,31,53,40,56,96,0,0,0,80,151,231
sp13,132,MUIR,BIOL,Microbiol,0,0,0,1,0,1,2,0,2,0,3,3,5,5,10,0,0,0,8,8,16
sp13,132,MUIR,BIOL,Molec Biol,0,0,0,2,0,2,6,6,12,5,6,11,9,6,15,0,0,0,22,18,40
sp13,132,MUIR,BIOL,PhyslNeuro,0,0,0,0,5,5,14,19,33,8,13,21,35,28,63,0,0,0,57,65,122
sp13,132,MUIR,CENG,Chem Engin,0,0,0,4,1,5,4,4,8,14,7,21,20,12,32,0,0,0,42,24,66
sp13,132,MUIR,CGS,CritGendSt,0,0,0,0,0,0,0,1,1,0,3,3,0,0,0,0,0,0,0,4,4
sp13,132,MUIR,CHEM,Bioch/Chem,0,0,0,1,0,1,4,7,11,3,9,12,27,22,49,0,0,0,35,38,73
sp13,132,MUIR,CHEM,Bioinform,0,0,0,0,0,0,1,0,1,0,0,0,0,0,0,0,0,0,1,0,1
sp13,132,MUIR,CHEM,Chem Educ,0,0,0,0,0,0,0,0,0,0,0,0,0,1,1,0,0,0,0,1,1
sp13,132,MUIR,CHEM,Chemistry,0,0,0,1,0,1,1,1,2,4,1,5,9,7,16,0,0,0,15,9,24
sp13,132,MUIR,CHEM,Envir Chem,0,0,0,0,0,0,3,2,5,0,0,0,2,1,3,0,0,0,5,3,8
sp13,132,MUIR,CHEM,MolecSynth,0,0,0,0,0,0,0,0,0,0,1,1,1,0,1,0,0,0,1,1,2
sp13,132,MUIR,CHEM,Pharm Chem,0,0,0,0,1,1,2,7,9,9,8,17,22,25,47,0,0,0,33,41,74
sp13,132,MUIR,CHIN,Chinese St,0,0,0,0,1,1,0,0,0,0,1,1,1,1,2,0,0,0,1,3,4
sp13,132,MUIR,COGS,Cog Sci,0,0,0,1,3,4,4,7,11,6,7,13,5,7,12,0,0,0,16,24,40
sp13,132,MUIR,COGS,CogSc/ClAs,0,0,0,0,1,1,0,1,1,0,1,1,0,9,9,0,0,0,0,12,12
sp13,132,MUIR,COGS,CogSc/Comp,0,0,0,0,0,0,0,1,1,0,2,2,3,0,3,0,0,0,3,3,6
sp13,132,MUIR,COGS,CogSc/HCI,0,0,0,0,0,0,0,0,0,4,4,8,7,10,17,0,0,0,11,14,25
sp13,132,MUIR,COGS,CogSc/HCog,0,0,0,0,0,0,0,1,1,0,1,1,1,4,5,0,0,0,1,6,7
sp13,132,MUIR,COGS,CogSc/Neur,0,0,0,1,0,1,2,4,6,2,6,8,18,29,47,0,0,0,23,39,62
sp13,132,MUIR,COMM,Communic,0,0,0,1,8,9,2,12,14,9,28,37,17,47,64,0,0,0,29,95,124
sp13,132,MUIR,CSE,Comp Sci,0,0,0,8,4,12,30,9,39,34,10,44,60,18,78,0,0,0,132,41,173
sp13,132,MUIR,CSE,CompEngCSE,0,0,0,1,0,1,9,1,10,8,0,8,16,1,17,0,0,0,34,2,36
sp13,132,MUIR,CSE,CompScBinf,0,0,0,0,0,0,0,0,0,3,1,4,4,1,5,0,0,0,7,2,9
sp13,132,MUIR,ECE,CompEngECE,0,0,0,1,0,1,5,0,5,2,0,2,3,0,3,0,0,0,11,0,11
sp13,132,MUIR,ECE,Electr Eng,0,0,0,5,0,5,13,1,14,11,3,14,31,8,39,0,0,0,60,12,72
sp13,132,MUIR,ECE,Engin Phys,0,0,0,1,0,1,1,0,1,0,0,0,1,0,1,0,0,0,3,0,3
sp13,132,MUIR,ECON,Ec-Mth&Ecn,0,0,0,0,1,1,6,3,9,3,3,6,9,2,11,0,0,0,18,9,27
sp13,132,MUIR,ECON,Econ-MgtSc,0,0,0,3,2,5,13,14,27,13,15,28,48,40,88,0,0,0,77,71,148
sp13,132,MUIR,ECON,Economics,0,0,0,8,7,15,12,11,23,31,29,60,72,30,102,0,0,0,123,77,200
sp13,132,MUIR,ESYS,EnvSys(EB),0,0,0,1,0,1,4,6,10,2,4,6,9,27,36,0,0,0,16,37,53
sp13,132,MUIR,ESYS,EnvSys(EC),0,0,0,0,0,0,0,2,2,0,0,0,1,1,2,0,0,0,1,3,4
sp13,132,MUIR,ESYS,EnvSys(EP),0,0,0,0,0,0,0,1,1,1,0,1,0,6,6,0,0,0,1,7,8
sp13,132,MUIR,ESYS,EnvSys(ES),0,0,0,0,0,0,1,0,1,1,0,1,2,2,4,0,0,0,4,2,6
sp13,132,MUIR,ETHN,Ethnic St,0,0,0,0,0,0,0,1,1,2,0,2,2,5,7,0,0,0,4,6,10
sp13,132,MUIR,HDP,Human Dev,0,0,0,0,0,0,0,1,1,3,9,12,7,35,42,0,0,0,10,45,55
sp13,132,MUIR,HDP,Pr-HumnDev,0,0,0,0,4,4,1,11,12,0,3,3,3,3,6,0,0,0,4,21,25
sp13,132,MUIR,HIST,History,0,0,0,1,0,1,3,1,4,4,3,7,10,8,18,0,0,0,18,12,30
sp13,132,MUIR,INTD,Muir Sp Pr,0,0,0,0,0,0,0,0,0,0,0,0,0,1,1,0,0,0,0,1,1
sp13,132,MUIR,INTL,IntSt-Anth,0,0,0,0,1,1,0,0,0,0,0,0,0,1,1,0,0,0,0,2,2
sp13,132,MUIR,INTL,IntSt-Econ,0,0,0,0,1,1,4,2,6,1,4,5,6,15,21,0,0,0,11,22,33
sp13,132,MUIR,INTL,IntSt-Hist,0,0,0,0,0,0,0,0,0,1,0,1,1,0,1,0,0,0,2,0,2
sp13,132,MUIR,INTL,IntSt-Ling,0,0,0,0,0,0,0,0,0,0,1,1,0,1,1,0,0,0,0,2,2
sp13,132,MUIR,INTL,IntSt-Lit,0,0,0,0,0,0,0,0,0,0,0,0,0,1,1,0,0,0,0,1,1
sp13,132,MUIR,INTL,IntSt-PolS,0,0,0,0,0,0,1,4,5,2,9,11,4,9,13,0,0,0,7,22,29
sp13,132,MUIR,INTL,IntSt-Soc,0,0,0,0,0,0,2,3,5,0,3,3,1,6,7,0,0,0,3,12,15
sp13,132,MUIR,ITAL,Italian St,0,0,0,0,1,1,0,0,0,0,0,0,0,0,0,0,0,0,0,1,1
sp13,132,MUIR,JAPN,JapaneseSt,0,0,0,0,0,0,0,1,1,0,0,0,3,1,4,0,0,0,3,2,5
sp13,132,MUIR,LATI,LatinAm St,0,0,0,0,0,0,0,0,0,0,0,0,1,0,1,0,0,0,1,0,1
sp13,132,MUIR,LING,Lang Stu,0,0,0,0,0,0,0,0,0,0,0,0,0,1,1,0,0,0,0,1,1
sp13,132,MUIR,LING,Ling-CogLn,0,0,0,0,0,0,2,0,2,0,3,3,1,3,4,0,0,0,3,6,9
sp13,132,MUIR,LING,Ling-LSoc,0,0,0,0,0,0,0,0,0,0,0,0,1,3,4,0,0,0,1,3,4
sp13,132,MUIR,LING,Linguistcs,0,0,0,0,0,0,0,1,1,1,2,3,7,2,9,0,0,0,8,5,13
sp13,132,MUIR,LIT,Lit/Compos,0,0,0,0,0,0,0,0,0,1,0,1,0,1,1,0,0,0,1,1,2
sp13,132,MUIR,LIT,Lit/CultSt,0,0,0,0,1,1,0,0,0,0,1,1,0,0,0,0,0,0,0,2,2
sp13,132,MUIR,LIT,Lit/Engl,0,0,0,0,0,0,0,0,0,0,5,5,5,11,16,0,0,0,5,16,21
sp13,132,MUIR,LIT,Lit/World,0,0,0,0,0,0,0,0,0,0,0,0,0,2,2,0,0,0,0,2,2
sp13,132,MUIR,LIT,Lit/Writng,0,0,0,0,2,2,1,5,6,2,6,8,7,9,16,0,0,0,10,22,32
sp13,132,MUIR,LIT,Pre-Lit/Wr,0,0,0,0,0,0,0,0,0,0,0,0,1,0,1,0,0,0,1,0,1
sp13,132,MUIR,LIT,Spanish Lt,0,0,0,0,0,0,0,1,1,1,1,2,0,4,4,0,0,0,1,6,7
sp13,132,MUIR,MAE,Aerosp Eng,0,0,0,0,0,0,6,0,6,6,0,6,19,6,25,0,0,0,31,6,37
sp13,132,MUIR,MAE,Engin Sci,0,0,0,0,0,0,1,0,1,0,0,0,3,1,4,0,0,0,4,1,5
sp13,132,MUIR,MAE,Envir Eng,0,0,0,0,0,0,11,3,14,4,5,9,15,10,25,0,0,0,30,18,48
sp13,132,MUIR,MAE,Mech Engin,0,0,0,0,0,0,7,3,10,6,0,6,26,4,30,0,0,0,39,7,46
sp13,132,MUIR,MATH,Appld Math,0,0,0,0,1,1,4,3,7,2,2,4,1,7,8,0,0,0,7,13,20
sp13,132,MUIR,MATH,Math/SecEd,0,0,0,0,0,0,1,1,2,1,4,5,0,2,2,0,0,0,2,7,9
sp13,132,MUIR,MATH,Mathematcs,0,0,0,0,0,0,3,3,6,4,3,7,10,0,10,0,0,0,17,6,23
sp13,132,MUIR,MATH,Mth-CompSc,0,0,0,0,0,0,2,0,2,1,0,1,0,1,1,0,0,0,3,1,4
sp13,132,MUIR,MATH,Mth-Mth&Ec,0,0,0,0,0,0,5,1,6,2,1,3,8,3,11,0,0,0,15,5,20
sp13,132,MUIR,MATH,Mth/ApldSc,0,0,0,0,0,0,0,0,0,0,0,0,1,0,1,0,0,0,1,0,1
sp13,132,MUIR,MATH,Prob&Stats,0,0,0,1,0,1,2,0,2,0,0,0,4,0,4,0,0,0,7,0,7
sp13,132,MUIR,MUS,Mu-CompArt,0,0,0,0,0,0,0,1,1,2,0,2,3,1,4,0,0,0,5,2,7
sp13,132,MUIR,MUS,Music,0,0,0,1,0,1,1,1,2,3,2,5,0,1,1,0,0,0,5,4,9
sp13,132,MUIR,MUS,Music Hum,0,0,0,0,0,0,0,0,0,2,0,2,0,0,0,0,0,0,2,0,2
sp13,132,MUIR,NENG,NanoEng,0,0,0,1,2,3,6,1,7,6,2,8,11,5,16,0,0,0,24,10,34
sp13,132,MUIR,PHIL,Philosophy,0,0,0,0,0,0,0,0,0,2,0,2,10,5,15,0,0,0,12,5,17
sp13,132,MUIR,PHYS,Biophysics,0,0,0,0,0,0,0,0,0,1,0,1,4,1,5,0,0,0,5,1,6
sp13,132,MUIR,PHYS,Phys/Astro,0,0,0,0,3,3,1,0,1,0,0,0,5,0,5,0,0,0,6,3,9
sp13,132,MUIR,PHYS,Physics,0,0,0,0,1,1,3,0,3,3,0,3,8,0,8,0,0,0,14,1,15
sp13,132,MUIR,POLI,Polit Sci,0,0,0,0,0,0,1,4,5,9,7,16,31,23,54,0,0,0,41,34,75
sp13,132,MUIR,POLI,PolSc-Amer,0,0,0,0,0,0,1,1,2,1,1,2,4,5,9,0,0,0,6,7,13
sp13,132,MUIR,POLI,PolSc-Intl,0,0,0,1,1,2,0,2,2,5,4,9,8,11,19,0,0,0,14,18,32
sp13,132,MUIR,POLI,PolSc-PLaw,0,0,0,0,0,0,2,3,5,5,3,8,5,5,10,0,0,0,12,11,23
sp13,132,MUIR,POLI,PolSc-PPol,0,0,0,0,0,0,0,2,2,0,1,1,1,0,1,0,0,0,1,3,4
sp13,132,MUIR,POLI,PolSc-Thry,0,0,0,0,0,0,1,0,1,0,0,0,1,0,1,0,0,0,2,0,2
sp13,132,MUIR,PSYC,Psychology,0,0,0,4,12,16,9,35,44,15,66,81,39,121,160,0,0,0,67,234,301
sp13,132,MUIR,RELI,Relig/Stu,0,0,0,0,0,0,0,0,0,0,0,0,1,1,2,0,0,0,1,1,2
sp13,132,MUIR,RUSS,Russ&SovSt,0,0,0,0,0,0,0,0,0,0,0,0,0,1,1,0,0,0,0,1,1
sp13,132,MUIR,SE,Engin Sci,0,0,0,0,0,0,0,0,0,0,0,0,1,0,1,0,0,0,1,0,1
sp13,132,MUIR,SE,Struct Eng,0,0,0,5,5,10,9,4,13,15,7,22,32,9,41,0,0,0,61,25,86
sp13,132,MUIR,SIO,Earth Sci,0,0,0,0,0,0,0,0,0,1,1,2,4,2,6,0,0,0,5,3,8
sp13,132,MUIR,SIO,Marine Bio,0,0,0,1,0,1,1,7,8,2,7,9,3,2,5,0,0,0,7,16,23
sp13,132,MUIR,SOC,SocAmSt,0,0,0,0,0,0,0,0,0,0,1,1,0,0,0,0,0,0,0,1,1
sp13,132,MUIR,SOC,SocCulCom,0,0,0,0,0,0,0,0,0,0,2,2,3,1,4,0,0,0,3,3,6
sp13,132,MUIR,SOC,SocEconSoc,0,0,0,0,1,1,0,0,0,0,1,1,1,0,1,0,0,0,1,2,3
sp13,132,MUIR,SOC,SocIntlStu,0,0,0,0,1,1,0,0,0,0,0,0,1,1,2,0,0,0,1,2,3
sp13,132,MUIR,SOC,Sociology,0,0,0,0,0,0,2,1,3,4,11,15,9,26,35,0,0,0,15,38,53
sp13,132,MUIR,SOC,SocLawSoc,0,0,0,0,0,0,0,4,4,1,4,5,2,6,8,0,0,0,3,14,17
sp13,132,MUIR,SOC,SocSciMed,0,0,0,0,0,0,0,0,0,0,1,1,1,4,5,0,0,0,1,5,6
sp13,132,MUIR,SOC,SocSolneq,0,0,0,0,0,0,0,3,3,0,0,0,0,3,3,0,0,0,0,6,6
sp13,132,MUIR,THEA,Dance,0,0,0,0,0,0,0,1,1,0,1,1,0,3,3,0,0,0,0,5,5
sp13,132,MUIR,THEA,Theatre,0,0,0,0,1,1,1,2,3,1,3,4,6,8,14,0,0,0,8,14,22
sp13,132,MUIR,TWS,ThirdWldSt,0,0,0,0,0,0,0,0,0,0,0,0,0,1,1,0,0,0,0,1,1
sp13,132,MUIR,UNAF,UndecHumAr,0,0,0,1,3,4,1,0,1,0,0,0,0,0,0,0,0,0,2,3,5
sp13,132,MUIR,UNAF,Undeclared,0,0,0,10,16,26,11,19,30,1,1,2,0,0,0,0,0,0,22,36,58
sp13,132,MUIR,UNAF,UndecPhysS,0,0,0,0,0,0,0,3,3,0,0,0,0,0,0,0,0,0,0,3,3
sp13,132,MUIR,UNAF,UndecSocSc,0,0,0,0,1,1,0,5,5,0,0,0,0,0,0,0,0,0,0,6,6
sp13,132,MUIR,USP,Urb Stu&Pl,0,0,0,0,2,2,1,2,3,4,4,8,11,8,19,0,0,0,16,16,32
sp13,132,MUIR,VIS,Art Hst/Cr,0,0,0,0,0,0,0,0,0,1,2,3,0,3,3,0,0,0,1,5,6
sp13,132,MUIR,VIS,Media,0,0,0,1,0,1,0,2,2,4,4,8,17,13,30,0,0,0,22,19,41
sp13,132,MUIR,VIS,Studio VA,0,0,0,0,1,1,0,0,0,0,2,2,3,6,9,0,0,0,3,9,12
sp13,132,MUIR,VIS,VA-CompArt,0,0,0,0,0,0,2,1,3,2,2,4,1,4,5,0,0,0,5,7,12
sp13,132,REVELLE,ANTH,Anth-Arch,0,0,0,0,0,0,0,0,0,0,1,1,0,1,1,0,0,0,0,2,2
sp13,132,REVELLE,ANTH,Anth-Biol,0,0,0,0,1,1,0,2,2,1,2,3,2,1,3,0,0,0,3,6,9
sp13,132,REVELLE,ANTH,Anth-Soci,0,0,0,0,0,0,0,0,0,0,2,2,0,1,1,0,0,0,0,3,3
sp13,132,REVELLE,BENG,Bioen:Binf,0,0,0,1,1,2,3,1,4,3,6,9,6,3,9,0,0,0,13,11,24
sp13,132,REVELLE,BENG,Bioeng:PM,0,0,0,0,0,0,0,0,0,0,0,0,2,2,4,0,0,0,2,2,4
sp13,132,REVELLE,BENG,BioengBiot,0,0,0,1,0,1,6,1,7,10,6,16,23,12,35,0,0,0,40,19,59
sp13,132,REVELLE,BENG,Bioengin,0,0,0,1,1,2,6,5,11,5,7,12,10,7,17,0,0,0,22,20,42
sp13,132,REVELLE,BIOL,Bioc/CellB,0,0,0,1,0,1,20,26,46,17,19,36,54,47,101,0,0,0,92,92,184
sp13,132,REVELLE,BIOL,BiolBioinf,0,0,0,1,0,1,0,1,1,1,0,1,2,0,2,0,0,0,4,1,5
sp13,132,REVELLE,BIOL,Ec/Beh/Evo,0,0,0,1,0,1,2,2,4,2,3,5,4,7,11,0,0,0,9,12,21
sp13,132,REVELLE,BIOL,Genl Biol,0,0,0,9,10,19,17,22,39,13,12,25,40,83,123,0,0,0,79,127,206
sp13,132,REVELLE,BIOL,Human Bio,0,0,0,4,16,20,41,64,105,17,31,48,58,87,145,0,0,0,120,198,318
sp13,132,REVELLE,BIOL,Microbiol,0,0,0,0,1,1,5,5,10,3,3,6,6,7,13,0,0,0,14,16,30
sp13,132,REVELLE,BIOL,Molec Biol,0,0,0,0,1,1,7,5,12,2,4,6,4,11,15,0,0,0,13,21,34
sp13,132,REVELLE,BIOL,PhyslNeuro,0,0,0,3,5,8,15,24,39,12,19,31,23,41,64,0,0,0,53,89,142
sp13,132,REVELLE,CENG,Chem Engin,0,0,0,5,4,9,24,8,32,19,8,27,32,16,48,0,0,0,80,36,116
sp13,132,REVELLE,CGS,CritGendSt,0,0,0,0,0,0,0,0,0,0,0,0,1,0,1,0,0,0,1,0,1
sp13,132,REVELLE,CHEM,Bioch/Chem,0,0,0,0,1,1,12,10,22,13,12,25,25,22,47,0,0,0,50,45,95
sp13,132,REVELLE,CHEM,Bioinform,0,0,0,0,0,0,0,0,0,0,1,1,0,1,1,0,0,0,0,2,2
sp13,132,REVELLE,CHEM,Chem Educ,0,0,0,0,0,0,0,0,0,0,0,0,0,2,2,0,0,0,0,2,2
sp13,132,REVELLE,CHEM,Chem Phys,0,0,0,0,0,0,2,0,2,0,1,1,0,1,1,0,0,0,2,2,4
sp13,132,REVELLE,CHEM,Chemistry,0,0,0,2,2,4,4,5,9,5,2,7,11,10,21,0,0,0,22,19,41
sp13,132,REVELLE,CHEM,Envir Chem,0,0,0,0,0,0,1,2,3,0,1,1,0,4,4,0,0,0,1,7,8
sp13,132,REVELLE,CHEM,Pharm Chem,0,0,0,1,3,4,7,11,18,10,10,20,24,51,75,0,0,0,42,75,117
sp13,132,REVELLE,CLAS,Classic St,0,0,0,0,0,0,0,0,0,0,0,0,1,1,2,0,0,0,1,1,2
sp13,132,REVELLE,COGS,Cog Sci,0,0,0,0,0,0,1,8,9,1,6,7,8,10,18,0,0,0,10,24,34
sp13,132,REVELLE,COGS,CogSc/ClAs,0,0,0,0,0,0,0,2,2,0,1,1,1,6,7,0,0,0,1,9,10
sp13,132,REVELLE,COGS,CogSc/Comp,0,0,0,0,0,0,0,0,0,0,0,0,1,1,2,0,0,0,1,1,2
sp13,132,REVELLE,COGS,CogSc/HCI,0,0,0,0,1,1,0,1,1,2,0,2,5,4,9,0,0,0,7,6,13
sp13,132,REVELLE,COGS,CogSc/HCog,0,0,0,0,0,0,0,1,1,0,2,2,1,1,2,0,0,0,1,4,5
sp13,132,REVELLE,COGS,CogSc/Neur,0,0,0,1,3,4,1,5,6,1,5,6,11,32,43,0,0,0,14,45,59
sp13,132,REVELLE,COMM,Communic,0,0,0,1,0,1,2,2,4,1,5,6,12,14,26,0,0,0,16,21,37
sp13,132,REVELLE,CSE,Comp Sci,0,0,0,10,3,13,43,4,47,35,5,40,81,11,92,0,0,0,169,23,192
sp13,132,REVELLE,CSE,CompEngCSE,0,0,0,3,1,4,9,2,11,6,2,8,12,2,14,0,0,0,30,7,37
sp13,132,REVELLE,CSE,CompScBinf,0,0,0,0,1,1,1,1,2,1,0,1,6,4,10,0,0,0,8,6,14
sp13,132,REVELLE,ECE,CompEngECE,0,0,0,1,0,1,4,1,5,0,1,1,8,0,8,0,0,0,13,2,15
sp13,132,REVELLE,ECE,Electr Eng,0,0,0,8,2,10,24,4,28,26,0,26,42,6,48,0,0,0,100,12,112
sp13,132,REVELLE,ECE,EleEng&Soc,0,0,0,0,0,0,0,0,0,0,0,0,1,0,1,0,0,0,1,0,1
sp13,132,REVELLE,ECE,Engin Phys,0,0,0,0,0,0,0,0,0,2,0,2,3,0,3,0,0,0,5,0,5
sp13,132,REVELLE,ECE,Pr-EngPhys,0,0,0,0,0,0,3,0,3,0,0,0,0,0,0,0,0,0,3,0,3
sp13,132,REVELLE,ECON,Ec-Mth&Ecn,0,0,0,0,0,0,3,2,5,4,2,6,8,2,10,0,0,0,15,6,21
sp13,132,REVELLE,ECON,Econ-MgtSc,0,0,0,4,5,9,10,5,15,9,2,11,42,17,59,0,0,0,65,29,94
sp13,132,REVELLE,ECON,Economics,0,0,0,4,9,13,13,13,26,19,16,35,51,29,80,0,0,0,87,67,154
sp13,132,REVELLE,ESYS,EnvSys(EB),0,0,0,0,1,1,2,2,4,2,2,4,8,21,29,0,0,0,12,26,38
sp13,132,REVELLE,ESYS,EnvSys(EC),0,0,0,0,0,0,1,0,1,0,0,0,2,2,4,0,0,0,3,2,5
sp13,132,REVELLE,ESYS,EnvSys(EP),0,0,0,0,0,0,0,1,1,0,0,0,0,1,1,0,0,0,0,2,2
sp13,132,REVELLE,ESYS,EnvSys(ES),0,0,0,0,1,1,1,1,2,0,1,1,4,0,4,0,0,0,5,3,8
sp13,132,REVELLE,ETHN,Ethnic St,0,0,0,0,0,0,0,1,1,0,1,1,3,2,5,0,0,0,3,4,7
sp13,132,REVELLE,GMST,German Stu,0,0,0,0,0,0,0,0,0,0,0,0,1,0,1,0,0,0,1,0,1
sp13,132,REVELLE,HDP,Human Dev,0,0,0,0,0,0,1,0,1,0,2,2,0,16,16,0,0,0,1,18,19
sp13,132,REVELLE,HDP,Pr-HumnDev,0,0,0,1,2,3,1,2,3,1,6,7,0,7,7,0,0,0,3,17,20
sp13,132,REVELLE,HIST,History,0,0,0,0,1,1,1,2,3,0,1,1,8,6,14,0,0,0,9,10,19
sp13,132,REVELLE,INTD,Rev Ind Mj,0,0,0,0,0,0,0,0,0,0,0,0,0,1,1,0,0,0,0,1,1
sp13,132,REVELLE,INTL,Int-5yrEC,0,0,0,0,0,0,0,0,0,0,0,0,0,1,1,0,0,0,0,1,1
sp13,132,REVELLE,INTL,Int-5yrPS,0,0,0,0,0,0,0,0,0,0,0,0,0,1,1,0,0,0,0,1,1
sp13,132,REVELLE,INTL,IntSt-Anth,0,0,0,0,0,0,0,0,0,0,0,0,2,0,2,0,0,0,2,0,2
sp13,132,REVELLE,INTL,IntSt-Econ,0,0,0,2,0,2,1,0,1,0,2,2,4,4,8,0,0,0,7,6,13
sp13,132,REVELLE,INTL,IntSt-Hist,0,0,0,0,0,0,0,1,1,0,0,0,1,2,3,0,0,0,1,3,4
sp13,132,REVELLE,INTL,IntSt-Ling,0,0,0,0,0,0,1,1,2,0,1,1,0,0,0,0,0,0,1,2,3
sp13,132,REVELLE,INTL,IntSt-PolS,0,0,0,0,1,1,3,1,4,1,2,3,4,8,12,0,0,0,8,12,20
sp13,132,REVELLE,INTL,IntSt-Soc,0,0,0,0,0,0,0,2,2,0,0,0,0,4,4,0,0,0,0,6,6
sp13,132,REVELLE,JAPN,JapaneseSt,0,0,0,0,0,0,0,0,0,0,0,0,1,1,2,0,0,0,1,1,2
sp13,132,REVELLE,LING,Ling-CogLn,0,0,0,0,0,0,0,0,0,0,1,1,0,2,2,0,0,0,0,3,3
sp13,132,REVELLE,LING,Ling-LSoc,0,0,0,0,0,0,0,0,0,0,0,0,0,1,1,0,0,0,0,1,1
sp13,132,REVELLE,LING,Linguistcs,0,0,0,0,0,0,1,1,2,0,1,1,2,2,4,0,0,0,3,4,7
sp13,132,REVELLE,LIT,Ital Lit,0,0,0,0,0,0,0,0,0,0,0,0,0,1,1,0,0,0,0,1,1
sp13,132,REVELLE,LIT,Lit/Compos,0,0,0,0,0,0,0,0,0,0,1,1,1,0,1,0,0,0,1,1,2
sp13,132,REVELLE,LIT,Lit/CultSt,0,0,0,0,0,0,0,1,1,0,0,0,0,0,0,0,0,0,0,1,1
sp13,132,REVELLE,LIT,Lit/Engl,0,0,0,0,0,0,1,0,1,0,0,0,3,1,4,0,0,0,4,1,5
sp13,132,REVELLE,LIT,Lit/World,0,0,0,0,0,0,0,0,0,0,1,1,1,0,1,0,0,0,1,1,2
sp13,132,REVELLE,LIT,Lit/Writng,0,0,0,0,1,1,0,1,1,1,1,2,1,10,11,0,0,0,2,13,15
sp13,132,REVELLE,LIT,Spanish Lt,0,0,0,0,0,0,1,1,2,1,1,2,0,1,1,0,0,0,2,3,5
sp13,132,REVELLE,MAE,Aerosp Eng,0,0,0,1,1,2,13,3,16,9,3,12,18,5,23,0,0,0,41,12,53
sp13,132,REVELLE,MAE,Engin Sci,0,0,0,0,0,0,0,0,0,1,1,2,5,2,7,0,0,0,6,3,9
sp13,132,REVELLE,MAE,Envir Eng,0,0,0,1,1,2,4,2,6,6,6,12,17,2,19,0,0,0,28,11,39
sp13,132,REVELLE,MAE,Mech Engin,0,0,0,0,0,0,7,1,8,10,1,11,38,8,46,0,0,0,55,10,65
sp13,132,REVELLE,MATH,Appld Math,0,0,0,3,4,7,5,3,8,4,2,6,7,4,11,0,0,0,19,13,32
sp13,132,REVELLE,MATH,Math/SecEd,0,0,0,0,1,1,1,0,1,0,0,0,1,0,1,0,0,0,2,1,3
sp13,132,REVELLE,MATH,Mathematcs,0,0,0,1,1,2,3,3,6,3,3,6,4,4,8,0,0,0,11,11,22
sp13,132,REVELLE,MATH,Mth-CompSc,0,0,0,0,0,0,1,0,1,0,0,0,2,2,4,0,0,0,3,2,5
sp13,132,REVELLE,MATH,Mth-Mth&Ec,0,0,0,1,2,3,1,6,7,0,1,1,5,1,6,0,0,0,7,10,17
sp13,132,REVELLE,MATH,Mth-SciCom,0,0,0,0,0,0,0,0,0,0,0,0,0,1,1,0,0,0,0,1,1
sp13,132,REVELLE,MATH,Mth/ApldSc,0,0,0,1,1,2,1,0,1,0,0,0,0,2,2,0,0,0,2,3,5
sp13,132,REVELLE,MATH,Prob&Stats,0,0,0,0,0,0,2,0,2,2,1,3,3,2,5,0,0,0,7,3,10
sp13,132,REVELLE,MUS,Mu-CompArt,0,0,0,1,0,1,0,0,0,1,0,1,5,0,5,0,0,0,7,0,7
sp13,132,REVELLE,MUS,Music,0,0,0,1,1,2,1,1,2,0,1,1,4,1,5,0,0,0,6,4,10
sp13,132,REVELLE,NENG,NanoEng,0,0,0,2,0,2,13,3,16,14,4,18,24,8,32,0,0,0,53,15,68
sp13,132,REVELLE,PHIL,Philosophy,0,0,0,0,1,1,0,0,0,4,2,6,3,0,3,0,0,0,7,3,10
sp13,132,REVELLE,PHYS,Biophysics,0,0,0,1,0,1,1,2,3,3,0,3,3,2,5,0,0,0,8,4,12
sp13,132,REVELLE,PHYS,GenPys/SEd,0,0,0,0,0,0,0,0,0,0,0,0,1,0,1,0,0,0,1,0,1
sp13,132,REVELLE,PHYS,Phy/ErthSc,0,0,0,0,0,0,0,0,0,0,0,0,1,0,1,0,0,0,1,0,1
sp13,132,REVELLE,PHYS,Phys/Astro,0,0,0,0,0,0,1,1,2,2,2,4,5,3,8,0,0,0,8,6,14
sp13,132,REVELLE,PHYS,Phys/Comp,0,0,0,0,0,0,1,0,1,0,0,0,0,0,0,0,0,0,1,0,1
sp13,132,REVELLE,PHYS,Phys/Mtrls,0,0,0,0,0,0,0,0,0,1,1,2,1,0,1,0,0,0,2,1,3
sp13,132,REVELLE,PHYS,Physics,0,0,0,1,0,1,1,0,1,4,1,5,9,2,11,0,0,0,15,3,18
sp13,132,REVELLE,POLI,Polit Sci,0,0,0,0,0,0,1,2,3,6,4,10,7,13,20,0,0,0,14,19,33
sp13,132,REVELLE,POLI,PolSc-Amer,0,0,0,0,0,0,1,0,1,3,0,3,4,3,7,0,0,0,8,3,11
sp13,132,REVELLE,POLI,PolSc-Comp,0,0,0,0,0,0,0,0,0,0,0,0,0,1,1,0,0,0,0,1,1
sp13,132,REVELLE,POLI,PolSc-Intl,0,0,0,0,1,1,2,1,3,1,2,3,5,3,8,0,0,0,8,7,15
sp13,132,REVELLE,POLI,PolSc-PLaw,0,0,0,1,0,1,0,2,2,0,2,2,2,3,5,0,0,0,3,7,10
sp13,132,REVELLE,POLI,PolSc-PPol,0,0,0,0,0,0,0,0,0,1,1,2,0,1,1,0,0,0,1,2,3
sp13,132,REVELLE,POLI,PolSc-Thry,0,0,0,0,0,0,0,0,0,0,0,0,0,1,1,0,0,0,0,1,1
sp13,132,REVELLE,PSYC,Psychology,0,0,0,5,1,6,9,20,29,11,32,43,40,76,116,0,0,0,65,129,194
sp13,132,REVELLE,RELI,Relig/Stu,0,0,0,0,0,0,0,0,0,0,1,1,0,0,0,0,0,0,0,1,1
sp13,132,REVELLE,RUSS,Russ&SovSt,0,0,0,0,0,0,0,0,0,0,0,0,1,0,1,0,0,0,1,0,1
sp13,132,REVELLE,SE,Engin Sci,0,0,0,1,0,1,1,0,1,0,0,0,0,0,0,0,0,0,2,0,2
sp13,132,REVELLE,SE,Struct Eng,0,0,0,4,4,8,13,5,18,19,2,21,30,8,38,0,0,0,66,19,85
sp13,132,REVELLE,SIO,Earth Sci,0,0,0,0,0,0,2,1,3,1,1,2,1,3,4,0,0,0,4,5,9
sp13,132,REVELLE,SIO,Marine Bio,0,0,0,1,2,3,1,5,6,1,4,5,2,0,2,0,0,0,5,11,16
sp13,132,REVELLE,SOC,SocCulCom,0,0,0,0,0,0,0,0,0,0,0,0,0,1,1,0,0,0,0,1,1
sp13,132,REVELLE,SOC,SocEconSoc,0,0,0,1,0,1,0,0,0,0,0,0,0,1,1,0,0,0,1,1,2
sp13,132,REVELLE,SOC,Sociology,0,0,0,0,0,0,0,1,1,1,4,5,4,2,6,0,0,0,5,7,12
sp13,132,REVELLE,SOC,SocLawSoc,0,0,0,0,0,0,0,3,3,0,1,1,1,2,3,0,0,0,1,6,7
sp13,132,REVELLE,SOC,SocSciMed,0,0,0,0,0,0,0,2,2,0,4,4,1,2,3,0,0,0,1,8,9
sp13,132,REVELLE,SOC,SocSolneq,0,0,0,0,0,0,0,0,0,0,0,0,0,1,1,0,0,0,0,1,1
sp13,132,REVELLE,THEA,Dance,0,0,0,0,1,1,0,0,0,0,0,0,0,0,0,0,0,0,0,1,1
sp13,132,REVELLE,THEA,Theatre,0,0,0,0,0,0,0,4,4,0,0,0,1,2,3,0,0,0,1,6,7
sp13,132,REVELLE,TWS,ThirdWldSt,0,0,0,0,0,0,0,0,0,0,0,0,0,1,1,0,0,0,0,1,1
sp13,132,REVELLE,UNAF,Limited St,0,0,0,0,0,0,0,0,0,0,0,0,0,0,0,9,6,15,9,6,15
sp13,132,REVELLE,UNAF,Spec-Emply,0,0,0,0,0,0,0,0,0,0,0,0,0,0,0,0,5,5,0,5,5
sp13,132,REVELLE,UNAF,UndecHumAr,0,0,0,0,0,0,0,3,3,0,0,0,0,0,0,0,0,0,0,3,3
sp13,132,REVELLE,UNAF,Undeclared,0,0,0,1,7,8,13,7,20,3,0,3,0,0,0,0,0,0,17,14,31
sp13,132,REVELLE,UNAF,UndecPhysS,0,0,0,1,3,4,7,3,10,0,0,0,0,0,0,0,0,0,8,6,14
sp13,132,REVELLE,UNAF,UndecSocSc,0,0,0,1,0,1,2,2,4,0,0,0,0,0,0,0,0,0,3,2,5
sp13,132,REVELLE,USP,Urb Stu&Pl,0,0,0,0,0,0,0,1,1,1,0,1,3,1,4,0,0,0,4,2,6
sp13,132,REVELLE,VIS,Art Hst/Cr,0,0,0,0,0,0,0,1,1,0,0,0,0,0,0,0,0,0,0,1,1
sp13,132,REVELLE,VIS,Media,0,0,0,0,0,0,0,0,0,1,1,2,3,2,5,0,0,0,4,3,7
sp13,132,REVELLE,VIS,Studio VA,0,0,0,0,0,0,0,0,0,1,1,2,1,3,4,0,0,0,2,4,6
sp13,132,REVELLE,VIS,VA-CompArt,0,0,0,2,0,2,0,0,0,1,1,2,3,5,8,0,0,0,6,6,12
sp13,132,ROOSEVELT,ANTH,Anth-Arch,0,0,0,0,0,0,1,2,3,1,3,4,0,3,3,0,0,0,2,8,10
sp13,132,ROOSEVELT,ANTH,Anth-Biol,0,0,0,0,0,0,0,1,1,1,3,4,0,4,4,0,0,0,1,8,9
sp13,132,ROOSEVELT,ANTH,Anth-Soci,0,0,0,0,2,2,0,3,3,2,5,7,6,10,16,0,0,0,8,20,28
sp13,132,ROOSEVELT,BENG,Bioen:Binf,0,0,0,0,1,1,2,3,5,1,1,2,3,2,5,0,0,0,6,7,13
sp13,132,ROOSEVELT,BENG,Bioeng:PM,0,0,0,0,0,0,0,0,0,0,0,0,6,0,6,0,0,0,6,0,6
sp13,132,ROOSEVELT,BENG,BioengBiot,0,0,0,0,0,0,0,1,1,2,3,5,10,4,14,0,0,0,12,8,20
sp13,132,ROOSEVELT,BENG,Bioengin,0,0,0,0,0,0,0,1,1,3,2,5,4,4,8,0,0,0,7,7,14
sp13,132,ROOSEVELT,BIOL,Bioc/CellB,0,0,0,4,2,6,10,12,22,11,11,22,19,28,47,0,0,0,44,53,97
sp13,132,ROOSEVELT,BIOL,BiolBioinf,0,0,0,0,0,0,1,0,1,0,0,0,0,0,0,0,0,0,1,0,1
sp13,132,ROOSEVELT,BIOL,Ec/Beh/Evo,0,0,0,1,0,1,1,2,3,1,4,5,3,5,8,0,0,0,6,11,17
sp13,132,ROOSEVELT,BIOL,Genl Biol,0,0,0,0,5,5,8,21,29,4,10,14,36,39,75,0,0,0,48,75,123
sp13,132,ROOSEVELT,BIOL,Human Bio,0,0,0,0,9,9,15,23,38,20,29,49,33,55,88,0,0,0,68,116,184
sp13,132,ROOSEVELT,BIOL,Microbiol,0,0,0,1,0,1,2,2,4,2,3,5,1,6,7,0,0,0,6,11,17
sp13,132,ROOSEVELT,BIOL,Molec Biol,0,0,0,0,3,3,3,0,3,1,1,2,2,4,6,0,0,0,6,8,14
sp13,132,ROOSEVELT,BIOL,PhyslNeuro,0,0,0,1,3,4,4,14,18,5,13,18,12,14,26,0,0,0,22,44,66
sp13,132,ROOSEVELT,CENG,Chem Engin,0,0,0,0,0,0,8,3,11,5,5,10,20,3,23,0,0,0,33,11,44
sp13,132,ROOSEVELT,CGS,CritGendSt,0,0,0,0,0,0,0,0,0,0,0,0,0,1,1,0,0,0,0,1,1
sp13,132,ROOSEVELT,CHEM,Bioch/Chem,0,0,0,2,0,2,3,4,7,7,5,12,17,23,40,0,0,0,29,32,61
sp13,132,ROOSEVELT,CHEM,Chem Educ,0,0,0,0,1,1,0,0,0,0,0,0,0,0,0,0,0,0,0,1,1
sp13,132,ROOSEVELT,CHEM,Chem Phys,0,0,0,0,0,0,0,0,0,0,0,0,0,1,1,0,0,0,0,1,1
sp13,132,ROOSEVELT,CHEM,Chemistry,0,0,0,1,5,6,1,2,3,5,1,6,3,1,4,0,0,0,10,9,19
sp13,132,ROOSEVELT,CHEM,Chm/ErthSc,0,0,0,0,0,0,0,1,1,0,0,0,0,0,0,0,0,0,0,1,1
sp13,132,ROOSEVELT,CHEM,Envir Chem,0,0,0,1,0,1,0,2,2,1,0,1,4,0,4,0,0,0,6,2,8
sp13,132,ROOSEVELT,CHEM,MolecSynth,0,0,0,0,0,0,0,0,0,0,0,0,0,2,2,0,0,0,0,2,2
sp13,132,ROOSEVELT,CHEM,Pharm Chem,0,0,0,0,1,1,8,10,18,5,6,11,10,19,29,0,0,0,23,36,59
sp13,132,ROOSEVELT,CHIN,Chinese St,0,0,0,0,0,0,0,0,0,0,0,0,0,4,4,0,0,0,0,4,4
sp13,132,ROOSEVELT,CLAS,Classic St,0,0,0,0,1,1,1,0,1,1,0,1,0,1,1,0,0,0,2,2,4
sp13,132,ROOSEVELT,COGS,Cog Sci,0,0,0,0,3,3,2,8,10,1,6,7,1,5,6,0,0,0,4,22,26
sp13,132,ROOSEVELT,COGS,CogSc/ClAs,0,0,0,0,1,1,0,1,1,0,1,1,0,5,5,0,0,0,0,8,8
sp13,132,ROOSEVELT,COGS,CogSc/Comp,0,0,0,0,0,0,0,0,0,0,1,1,1,0,1,0,0,0,1,1,2
sp13,132,ROOSEVELT,COGS,CogSc/HCI,0,0,0,0,0,0,1,0,1,2,4,6,2,6,8,0,0,0,5,10,15
sp13,132,ROOSEVELT,COGS,CogSc/HCog,0,0,0,0,0,0,0,1,1,2,0,2,2,1,3,0,0,0,4,2,6
sp13,132,ROOSEVELT,COGS,CogSc/Neur,0,0,0,0,0,0,0,5,5,3,6,9,9,24,33,0,0,0,12,35,47
sp13,132,ROOSEVELT,COMM,Communic,0,0,0,3,6,9,2,13,15,3,34,37,12,59,71,0,0,0,20,112,132
sp13,132,ROOSEVELT,CSE,Comp Sci,0,0,0,7,4,11,22,7,29,31,4,35,43,8,51,0,0,0,103,23,126
sp13,132,ROOSEVELT,CSE,CompEngCSE,0,0,0,6,1,7,7,1,8,6,0,6,6,1,7,0,0,0,25,3,28
sp13,132,ROOSEVELT,CSE,CompScBinf,0,0,0,1,0,1,0,0,0,2,0,2,0,0,0,0,0,0,3,0,3
sp13,132,ROOSEVELT,ECE,CompEngECE,0,0,0,1,0,1,1,0,1,0,1,1,2,0,2,0,0,0,4,1,5
sp13,132,ROOSEVELT,ECE,Electr Eng,0,0,0,4,2,6,14,4,18,16,2,18,22,8,30,0,0,0,56,16,72
sp13,132,ROOSEVELT,ECE,Engin Phys,0,0,0,1,0,1,0,0,0,1,0,1,1,0,1,0,0,0,3,0,3
sp13,132,ROOSEVELT,ECON,Ec-Mth&Ecn,0,0,0,3,2,5,4,2,6,2,3,5,12,2,14,0,0,0,21,9,30
sp13,132,ROOSEVELT,ECON,Econ-MgtSc,0,0,0,7,5,12,8,9,17,18,14,32,39,27,66,0,0,0,72,55,127
sp13,132,ROOSEVELT,ECON,Economics,0,0,0,13,4,17,20,15,35,40,26,66,64,47,111,0,0,0,137,92,229
sp13,132,ROOSEVELT,ESYS,EnvSys(EB),0,0,0,0,1,1,1,2,3,2,2,4,4,16,20,0,0,0,7,21,28
sp13,132,ROOSEVELT,ESYS,EnvSys(EC),0,0,0,0,0,0,0,0,0,0,3,3,2,4,6,0,0,0,2,7,9
sp13,132,ROOSEVELT,ESYS,EnvSys(EP),0,0,0,0,0,0,0,1,1,1,0,1,0,1,1,0,0,0,1,2,3
sp13,132,ROOSEVELT,ESYS,EnvSys(ES),0,0,0,0,1,1,0,1,1,0,2,2,1,3,4,0,0,0,1,7,8
sp13,132,ROOSEVELT,ETHN,Ethnic St,0,0,0,0,0,0,0,0,0,0,1,1,2,1,3,0,0,0,2,2,4
sp13,132,ROOSEVELT,GMST,German Stu,0,0,0,0,0,0,0,0,0,1,0,1,0,0,0,0,0,0,1,0,1
sp13,132,ROOSEVELT,HDP,Human Dev,0,0,0,0,0,0,0,2,2,0,7,7,5,26,31,0,0,0,5,35,40
sp13,132,ROOSEVELT,HDP,Pr-HumnDev,0,0,0,0,4,4,0,9,9,0,11,11,0,1,1,0,0,0,0,25,25
sp13,132,ROOSEVELT,HIST,History,0,0,0,2,4,6,3,10,13,7,11,18,19,18,37,0,0,0,31,43,74
sp13,132,ROOSEVELT,INTL,Int-5yrEC,0,0,0,0,0,0,0,0,0,0,0,0,0,1,1,0,0,0,0,1,1
sp13,132,ROOSEVELT,INTL,Int-5yrPS,0,0,0,0,0,0,0,0,0,0,0,0,1,1,2,0,0,0,1,1,2
sp13,132,ROOSEVELT,INTL,IntSt-Anth,0,0,0,0,0,0,0,0,0,0,3,3,0,2,2,0,0,0,0,5,5
sp13,132,ROOSEVELT,INTL,IntSt-Econ,0,0,0,4,4,8,1,7,8,5,9,14,6,21,27,0,0,0,16,41,57
sp13,132,ROOSEVELT,INTL,IntSt-Hist,0,0,0,0,0,0,0,0,0,1,3,4,3,8,11,0,0,0,4,11,15
sp13,132,ROOSEVELT,INTL,IntSt-Ling,0,0,0,0,3,3,2,5,7,0,0,0,1,5,6,0,0,0,3,13,16
sp13,132,ROOSEVELT,INTL,IntSt-Lit,0,0,0,0,0,0,0,0,0,0,0,0,0,1,1,0,0,0,0,1,1
sp13,132,ROOSEVELT,INTL,IntSt-PolS,0,0,0,0,6,6,8,11,19,2,22,24,20,41,61,0,0,0,30,80,110
sp13,132,ROOSEVELT,INTL,IntSt-Soc,0,0,0,2,2,4,0,7,7,2,5,7,3,11,14,0,0,0,7,25,32
sp13,132,ROOSEVELT,ITAL,Italian St,0,0,0,0,0,0,0,0,0,1,0,1,0,0,0,0,0,0,1,0,1
sp13,132,ROOSEVELT,JAPN,JapaneseSt,0,0,0,0,1,1,0,0,0,1,1,2,3,0,3,0,0,0,4,2,6
sp13,132,ROOSEVELT,LATI,LatinAm St,0,0,0,0,0,0,0,0,0,0,0,0,0,2,2,0,0,0,0,2,2
sp13,132,ROOSEVELT,LING,Lang Stu,0,0,0,0,0,0,0,0,0,0,1,1,1,1,2,0,0,0,1,2,3
sp13,132,ROOSEVELT,LING,Ling-CogLn,0,0,0,0,0,0,0,4,4,0,0,0,0,4,4,0,0,0,0,8,8
sp13,132,ROOSEVELT,LING,Ling-LSoc,0,0,0,0,0,0,0,1,1,2,0,2,1,4,5,0,0,0,3,5,8
sp13,132,ROOSEVELT,LING,Linguistcs,0,0,0,0,0,0,0,1,1,1,3,4,0,2,2,0,0,0,1,6,7
sp13,132,ROOSEVELT,LIT,Lit/CultSt,0,0,0,0,0,0,0,1,1,0,1,1,1,1,2,0,0,0,1,3,4
sp13,132,ROOSEVELT,LIT,Lit/Engl,0,0,0,1,1,2,0,0,0,1,3,4,2,7,9,0,0,0,4,11,15
sp13,132,ROOSEVELT,LIT,Lit/World,0,0,0,0,0,0,1,2,3,0,2,2,0,0,0,0,0,0,1,4,5
sp13,132,ROOSEVELT,LIT,Lit/Writng,0,0,0,1,1,2,2,3,5,0,9,9,5,17,22,0,0,0,8,30,38
sp13,132,ROOSEVELT,LIT,Spanish Lt,0,0,0,0,0,0,0,1,1,0,1,1,2,1,3,0,0,0,2,3,5
sp13,132,ROOSEVELT,MAE,Aerosp Eng,0,0,0,0,0,0,3,0,3,4,0,4,12,3,15,0,0,0,19,3,22
sp13,132,ROOSEVELT,MAE,Engin Sci,0,0,0,0,0,0,0,0,0,1,0,1,3,0,3,0,0,0,4,0,4
sp13,132,ROOSEVELT,MAE,Envir Eng,0,0,0,0,1,1,3,8,11,3,1,4,10,4,14,0,0,0,16,14,30
sp13,132,ROOSEVELT,MAE,Mech Engin,0,0,0,0,0,0,0,1,1,4,1,5,28,4,32,0,0,0,32,6,38
sp13,132,ROOSEVELT,MATH,Appld Math,0,0,0,3,1,4,2,4,6,0,2,2,1,1,2,0,0,0,6,8,14
sp13,132,ROOSEVELT,MATH,Math/SecEd,0,0,0,0,0,0,0,1,1,1,1,2,1,2,3,0,0,0,2,4,6
sp13,132,ROOSEVELT,MATH,Mathematcs,0,0,0,0,0,0,1,1,2,3,0,3,4,3,7,0,0,0,8,4,12
sp13,132,ROOSEVELT,MATH,Mth-CompSc,0,0,0,0,0,0,0,0,0,0,1,1,2,2,4,0,0,0,2,3,5
sp13,132,ROOSEVELT,MATH,Mth-Mth&Ec,0,0,0,2,3,5,4,1,5,0,7,7,1,5,6,0,0,0,7,16,23
sp13,132,ROOSEVELT,MATH,Mth/ApldSc,0,0,0,1,1,2,0,0,0,0,0,0,1,0,1,0,0,0,2,1,3
sp13,132,ROOSEVELT,MATH,Prob&Stats,0,0,0,0,0,0,0,0,0,0,0,0,0,1,1,0,0,0,0,1,1
sp13,132,ROOSEVELT,MUS,Mu-CompArt,0,0,0,0,0,0,0,0,0,0,0,0,1,2,3,0,0,0,1,2,3
sp13,132,ROOSEVELT,MUS,Music,0,0,0,1,1,2,0,0,0,0,0,0,1,2,3,0,0,0,2,3,5
sp13,132,ROOSEVELT,MUS,Music Hum,0,0,0,0,0,0,0,0,0,0,0,0,0,1,1,0,0,0,0,1,1
sp13,132,ROOSEVELT,NENG,NanoEng,0,0,0,1,2,3,5,3,8,5,3,8,17,4,21,0,0,0,28,12,40
sp13,132,ROOSEVELT,PHIL,Philosophy,0,0,0,0,0,0,0,0,0,1,0,1,4,3,7,0,0,0,5,3,8
sp13,132,ROOSEVELT,PHYS,Biophysics,0,0,0,0,0,0,0,1,1,1,0,1,3,1,4,0,0,0,4,2,6
sp13,132,ROOSEVELT,PHYS,Phy/ErthSc,0,0,0,0,0,0,0,0,0,0,0,0,0,1,1,0,0,0,0,1,1
sp13,132,ROOSEVELT,PHYS,Phys/Astro,0,0,0,0,0,0,2,0,2,1,0,1,0,1,1,0,0,0,3,1,4
sp13,132,ROOSEVELT,PHYS,Phys/Comp,0,0,0,0,0,0,0,0,0,0,0,0,1,0,1,0,0,0,1,0,1
sp13,132,ROOSEVELT,PHYS,Phys/Mtrls,0,0,0,0,0,0,0,0,0,0,0,0,1,0,1,0,0,0,1,0,1
sp13,132,ROOSEVELT,PHYS,Physics,0,0,0,0,0,0,2,0,2,0,1,1,1,2,3,0,0,0,3,3,6
sp13,132,ROOSEVELT,POLI,Polit Sci,0,0,0,1,4,5,5,6,11,8,14,22,27,31,58,0,0,0,41,55,96
sp13,132,ROOSEVELT,POLI,PolSc-Amer,0,0,0,0,0,0,0,2,2,1,1,2,5,5,10,0,0,0,6,8,14
sp13,132,ROOSEVELT,POLI,PolSc-Comp,0,0,0,0,0,0,0,0,0,0,0,0,1,1,2,0,0,0,1,1,2
sp13,132,ROOSEVELT,POLI,PolSc-Intl,0,0,0,4,3,7,5,10,15,7,14,21,29,32,61,0,0,0,45,59,104
sp13,132,ROOSEVELT,POLI,PolSc-PLaw,0,0,0,1,5,6,2,5,7,6,6,12,5,11,16,0,0,0,14,27,41
sp13,132,ROOSEVELT,POLI,PolSc-PPol,0,0,0,1,0,1,2,1,3,0,1,1,2,2,4,0,0,0,5,4,9
sp13,132,ROOSEVELT,POLI,PolSc-Thry,0,0,0,0,0,0,2,0,2,0,0,0,3,0,3,0,0,0,5,0,5
sp13,132,ROOSEVELT,PSYC,Psychology,0,0,0,2,11,13,8,24,32,13,41,54,30,96,126,0,0,0,53,172,225
sp13,132,ROOSEVELT,RELI,Relig/Stu,0,0,0,0,0,0,0,0,0,0,1,1,0,4,4,0,0,0,0,5,5
sp13,132,ROOSEVELT,SE,Engin Sci,0,0,0,0,0,0,0,2,2,1,0,1,1,0,1,0,0,0,2,2,4
sp13,132,ROOSEVELT,SE,Struct Eng,0,0,0,2,1,3,8,6,14,8,3,11,30,5,35,0,0,0,48,15,63
sp13,132,ROOSEVELT,SIO,Earth Sci,0,0,0,0,0,0,0,0,0,1,0,1,1,0,1,0,0,0,2,0,2
sp13,132,ROOSEVELT,SIO,Marine Bio,0,0,0,3,1,4,0,4,4,3,2,5,1,1,2,0,0,0,7,8,15
sp13,132,ROOSEVELT,SOC,SocAmSt,0,0,0,0,0,0,0,0,0,0,0,0,0,2,2,0,0,0,0,2,2
sp13,132,ROOSEVELT,SOC,SocCulCom,0,0,0,0,0,0,0,0,0,0,3,3,1,3,4,0,0,0,1,6,7
sp13,132,ROOSEVELT,SOC,SocEconSoc,0,0,0,0,1,1,0,1,1,0,0,0,0,2,2,0,0,0,0,4,4
sp13,132,ROOSEVELT,SOC,SocIntlStu,0,0,0,0,0,0,0,0,0,0,0,0,1,2,3,0,0,0,1,2,3
sp13,132,ROOSEVELT,SOC,Sociology,0,0,0,0,3,3,1,5,6,1,9,10,8,16,24,0,0,0,10,33,43
sp13,132,ROOSEVELT,SOC,SocLawSoc,0,0,0,0,0,0,0,0,0,1,1,2,2,6,8,0,0,0,3,7,10
sp13,132,ROOSEVELT,SOC,SocSciMed,0,0,0,1,0,1,0,0,0,0,1,1,1,4,5,0,0,0,2,5,7
sp13,132,ROOSEVELT,SOC,SocSolneq,0,0,0,0,0,0,0,1,1,0,0,0,0,2,2,0,0,0,0,3,3
sp13,132,ROOSEVELT,THEA,Dance,0,0,0,0,0,0,0,1,1,0,0,0,0,2,2,0,0,0,0,3,3
sp13,132,ROOSEVELT,THEA,Theatre,0,0,0,0,0,0,0,3,3,1,2,3,1,8,9,0,0,0,2,13,15
sp13,132,ROOSEVELT,TWS,ThirdWldSt,0,0,0,0,0,0,0,0,0,0,1,1,0,2,2,0,0,0,0,3,3
sp13,132,ROOSEVELT,UNAF,UndecHumAr,0,0,0,2,1,3,0,2,2,1,0,1,0,0,0,0,0,0,3,3,6
sp13,132,ROOSEVELT,UNAF,Undeclared,0,0,0,11,11,22,18,9,27,1,0,1,0,0,0,0,0,0,30,20,50
sp13,132,ROOSEVELT,UNAF,UndecPhysS,0,0,0,0,0,0,1,1,2,0,0,0,0,0,0,0,0,0,1,1,2
sp13,132,ROOSEVELT,UNAF,UndecSocSc,0,0,0,1,3,4,1,1,2,0,0,0,0,0,0,0,0,0,2,4,6
sp13,132,ROOSEVELT,USP,Urb Stu&Pl,0,0,0,0,0,0,1,1,2,3,5,8,4,14,18,0,0,0,8,20,28
sp13,132,ROOSEVELT,VIS,Art Hst/Cr,0,0,0,0,0,0,0,1,1,0,2,2,0,3,3,0,0,0,0,6,6
sp13,132,ROOSEVELT,VIS,Media,0,0,0,1,1,2,3,3,6,5,2,7,6,9,15,0,0,0,15,15,30
sp13,132,ROOSEVELT,VIS,Studio VA,0,0,0,0,1,1,2,2,4,0,3,3,1,4,5,0,0,0,3,10,13
sp13,132,ROOSEVELT,VIS,VA-CompArt,0,0,0,0,0,0,0,0,0,1,0,1,0,2,2,0,0,0,1,2,3
sp13,132,SIXTH,ANTH,Anth-Arch,0,0,0,0,0,0,1,0,1,0,0,0,0,2,2,0,0,0,1,2,3
sp13,132,SIXTH,ANTH,Anth-Biol,0,0,0,0,0,0,0,0,0,0,0,0,0,6,6,0,0,0,0,6,6
sp13,132,SIXTH,ANTH,Anth-Soci,0,0,0,0,0,0,1,1,2,1,2,3,1,7,8,0,0,0,3,10,13
sp13,132,SIXTH,BENG,Bioen:Binf,0,0,0,1,0,1,2,4,6,2,0,2,6,4,10,0,0,0,11,8,19
sp13,132,SIXTH,BENG,Bioeng:PM,0,0,0,0,0,0,0,0,0,0,0,0,5,1,6,0,0,0,5,1,6
sp13,132,SIXTH,BENG,BioengBiot,0,0,0,1,0,1,1,4,5,8,4,12,14,7,21,0,0,0,24,15,39
sp13,132,SIXTH,BENG,Bioengin,0,0,0,0,0,0,2,1,3,2,4,6,11,5,16,0,0,0,15,10,25
sp13,132,SIXTH,BIOL,Bioc/CellB,0,0,0,2,1,3,11,14,25,12,21,33,31,28,59,0,0,0,56,64,120
sp13,132,SIXTH,BIOL,BiolBioinf,0,0,0,0,0,0,0,0,0,1,1,2,0,0,0,0,0,0,1,1,2
sp13,132,SIXTH,BIOL,Ec/Beh/Evo,0,0,0,0,0,0,1,1,2,0,3,3,4,3,7,0,0,0,5,7,12
sp13,132,SIXTH,BIOL,Genl Biol,0,0,0,2,5,7,7,13,20,6,12,18,25,30,55,0,0,0,40,60,100
sp13,132,SIXTH,BIOL,Human Bio,0,0,0,5,8,13,17,26,43,21,14,35,40,35,75,0,0,0,83,83,166
sp13,132,SIXTH,BIOL,Microbiol,0,0,0,1,0,1,0,4,4,2,1,3,3,2,5,0,0,0,6,7,13
sp13,132,SIXTH,BIOL,Molec Biol,0,0,0,0,0,0,5,1,6,2,0,2,3,4,7,0,0,0,10,5,15
sp13,132,SIXTH,BIOL,PhyslNeuro,0,0,0,0,3,3,8,6,14,7,3,10,14,19,33,0,0,0,29,31,60
sp13,132,SIXTH,CENG,Chem Engin,0,0,0,3,0,3,14,5,19,9,4,13,19,6,25,0,0,0,45,15,60
sp13,132,SIXTH,CGS,CritGendSt,0,0,0,0,0,0,0,0,0,0,0,0,1,1,2,0,0,0,1,1,2
sp13,132,SIXTH,CHEM,Bioch/Chem,0,0,0,4,2,6,2,2,4,6,10,16,33,17,50,0,0,0,45,31,76
sp13,132,SIXTH,CHEM,Chem Educ,0,0,0,0,0,0,0,0,0,0,0,0,0,1,1,0,0,0,0,1,1
sp13,132,SIXTH,CHEM,Chem Phys,0,0,0,0,0,0,0,0,0,0,0,0,1,0,1,0,0,0,1,0,1
sp13,132,SIXTH,CHEM,Chemistry,0,0,0,1,0,1,1,4,5,6,4,10,4,4,8,0,0,0,12,12,24
sp13,132,SIXTH,CHEM,Envir Chem,0,0,0,0,0,0,0,0,0,0,2,2,1,1,2,0,0,0,1,3,4
sp13,132,SIXTH,CHEM,MolecSynth,0,0,0,0,0,0,0,1,1,0,0,0,1,2,3,0,0,0,1,3,4
sp13,132,SIXTH,CHEM,Pharm Chem,0,0,0,2,5,7,2,6,8,6,6,12,24,19,43,0,0,0,34,36,70
sp13,132,SIXTH,CHIN,Chinese St,0,0,0,0,0,0,1,0,1,0,0,0,2,1,3,0,0,0,3,1,4
sp13,132,SIXTH,COGS,Cog Sci,0,0,0,2,2,4,4,2,6,2,4,6,6,1,7,0,0,0,14,9,23
sp13,132,SIXTH,COGS,CogSc/ClAs,0,0,0,0,0,0,0,1,1,0,0,0,1,3,4,0,0,0,1,4,5
sp13,132,SIXTH,COGS,CogSc/Comp,0,0,0,0,1,1,0,0,0,0,1,1,4,1,5,0,0,0,4,3,7
sp13,132,SIXTH,COGS,CogSc/HCI,0,0,0,0,0,0,0,2,2,2,2,4,9,12,21,0,0,0,11,16,27
sp13,132,SIXTH,COGS,CogSc/HCog,0,0,0,0,0,0,1,0,1,1,0,1,0,2,2,0,0,0,2,2,4
sp13,132,SIXTH,COGS,CogSc/Neur,0,0,0,0,0,0,3,1,4,4,3,7,11,20,31,0,0,0,18,24,42
sp13,132,SIXTH,COMM,Communic,0,0,0,0,12,12,3,19,22,9,32,41,20,70,90,0,0,0,32,133,165
sp13,132,SIXTH,CSE,Comp Sci,0,0,0,14,6,20,60,18,78,56,18,74,96,22,118,0,0,0,226,64,290
sp13,132,SIXTH,CSE,CompEngCSE,0,0,0,7,1,8,25,2,27,14,2,16,18,0,18,0,0,0,64,5,69
sp13,132,SIXTH,CSE,CompScBinf,0,0,0,0,0,0,0,1,1,1,1,2,8,1,9,0,0,0,9,3,12
sp13,132,SIXTH,ECE,CompEngECE,0,0,0,3,0,3,3,0,3,2,0,2,3,0,3,0,0,0,11,0,11
sp13,132,SIXTH,ECE,Electr Eng,0,0,0,11,1,12,34,4,38,19,3,22,42,2,44,0,0,0,106,10,116
sp13,132,SIXTH,ECE,Engin Phys,0,0,0,0,0,0,0,0,0,1,0,1,1,0,1,0,0,0,2,0,2
sp13,132,SIXTH,ECON,Ec-Mth&Ecn,0,0,0,2,3,5,2,2,4,2,1,3,7,3,10,0,0,0,13,9,22
sp13,132,SIXTH,ECON,Econ-MgtSc,0,0,0,6,3,9,4,10,14,27,17,44,34,30,64,0,0,0,71,60,131
sp13,132,SIXTH,ECON,Economics,0,0,0,14,2,16,12,8,20,38,18,56,57,30,87,0,0,0,121,58,179
sp13,132,SIXTH,ESYS,EnvSys(EB),0,0,0,0,1,1,0,3,3,2,3,5,7,25,32,0,0,0,9,32,41
sp13,132,SIXTH,ESYS,EnvSys(EC),0,0,0,0,0,0,0,0,0,0,0,0,3,0,3,0,0,0,3,0,3
sp13,132,SIXTH,ESYS,EnvSys(EP),0,0,0,1,0,1,0,2,2,0,2,2,1,4,5,0,0,0,2,8,10
sp13,132,SIXTH,ESYS,EnvSys(ES),0,0,0,0,1,1,2,1,3,1,2,3,2,1,3,0,0,0,5,5,10
sp13,132,SIXTH,ETHN,Ethnic St,0,0,0,0,0,0,0,0,0,1,0,1,2,5,7,0,0,0,3,5,8
sp13,132,SIXTH,GMST,German Stu,0,0,0,0,0,0,0,0,0,0,0,0,0,1,1,0,0,0,0,1,1
sp13,132,SIXTH,HDP,Human Dev,0,0,0,0,0,0,0,1,1,0,9,9,3,18,21,0,0,0,3,28,31
sp13,132,SIXTH,HDP,Pr-HumnDev,0,0,0,0,4,4,2,6,8,2,12,14,0,4,4,0,0,0,4,26,30
sp13,132,SIXTH,HIST,History,0,0,0,0,0,0,0,0,0,5,4,9,6,6,12,0,0,0,11,10,21
sp13,132,SIXTH,INTL,IntSt-Anth,0,0,0,0,0,0,0,0,0,0,0,0,0,1,1,0,0,0,0,1,1
sp13,132,SIXTH,INTL,IntSt-Econ,0,0,0,2,2,4,3,1,4,3,5,8,8,12,20,0,0,0,16,20,36
sp13,132,SIXTH,INTL,IntSt-Hist,0,0,0,0,0,0,1,1,2,0,1,1,0,1,1,0,0,0,1,3,4
sp13,132,SIXTH,INTL,IntSt-Ling,0,0,0,0,0,0,0,0,0,0,1,1,1,4,5,0,0,0,1,5,6
sp13,132,SIXTH,INTL,IntSt-PolS,0,0,0,0,1,1,1,1,2,1,2,3,5,11,16,0,0,0,7,15,22
sp13,132,SIXTH,INTL,IntSt-Soc,0,0,0,0,2,2,0,0,0,1,1,2,0,5,5,0,0,0,1,8,9
sp13,132,SIXTH,JAPN,JapaneseSt,0,0,0,0,0,0,0,0,0,0,0,0,0,2,2,0,0,0,0,2,2
sp13,132,SIXTH,LING,Lang Stu,0,0,0,0,0,0,0,0,0,0,0,0,0,1,1,0,0,0,0,1,1
sp13,132,SIXTH,LING,Ling-CogLn,0,0,0,0,1,1,0,1,1,0,1,1,2,0,2,0,0,0,2,3,5
sp13,132,SIXTH,LING,Ling-LSoc,0,0,0,0,0,0,0,0,0,0,2,2,0,2,2,0,0,0,0,4,4
sp13,132,SIXTH,LING,Linguistcs,0,0,0,0,0,0,0,2,2,0,1,1,2,4,6,0,0,0,2,7,9
sp13,132,SIXTH,LIT,Lit/CultSt,0,0,0,0,0,0,0,0,0,0,1,1,0,0,0,0,0,0,0,1,1
sp13,132,SIXTH,LIT,Lit/Engl,0,0,0,0,0,0,0,1,1,1,1,2,0,2,2,0,0,0,1,4,5
sp13,132,SIXTH,LIT,Lit/World,0,0,0,0,0,0,0,0,0,0,0,0,0,2,2,0,0,0,0,2,2
sp13,132,SIXTH,LIT,Lit/Writng,0,0,0,1,0,1,0,2,2,2,2,4,0,8,8,0,0,0,3,12,15
sp13,132,SIXTH,LIT,Spanish Lt,0,0,0,0,0,0,0,0,0,0,0,0,0,1,1,0,0,0,0,1,1
sp13,132,SIXTH,MAE,Aerosp Eng,0,0,0,0,0,0,6,2,8,4,1,5,28,6,34,0,0,0,38,9,47
sp13,132,SIXTH,MAE,Engin Sci,0,0,0,0,0,0,1,0,1,3,0,3,6,0,6,0,0,0,10,0,10
sp13,132,SIXTH,MAE,Envir Eng,0,0,0,1,0,1,7,4,11,6,7,13,11,9,20,0,0,0,25,20,45
sp13,132,SIXTH,MAE,Mech Engin,0,0,0,1,1,2,4,1,5,16,4,20,45,4,49,0,0,0,66,10,76
sp13,132,SIXTH,MATH,Appld Math,0,0,0,3,3,6,3,2,5,2,3,5,4,1,5,0,0,0,12,9,21
sp13,132,SIXTH,MATH,Math/SecEd,0,0,0,0,0,0,1,0,1,0,0,0,0,1,1,0,0,0,1,1,2
sp13,132,SIXTH,MATH,Mathematcs,0,0,0,2,0,2,0,1,1,0,1,1,7,3,10,0,0,0,9,5,14
sp13,132,SIXTH,MATH,Mth-CompSc,0,0,0,0,0,0,0,0,0,2,1,3,3,0,3,0,0,0,5,1,6
sp13,132,SIXTH,MATH,Mth-Mth&Ec,0,0,0,5,3,8,2,0,2,2,4,6,5,2,7,0,0,0,14,9,23
sp13,132,SIXTH,MATH,Mth/ApldSc,0,0,0,1,0,1,0,1,1,0,0,0,0,0,0,0,0,0,1,1,2
sp13,132,SIXTH,MATH,Pr-Math CS,0,0,0,0,0,0,0,0,0,0,0,0,1,0,1,0,0,0,1,0,1
sp13,132,SIXTH,MATH,Prob&Stats,0,0,0,0,1,1,1,1,2,1,0,1,2,2,4,0,0,0,4,4,8
sp13,132,SIXTH,MUS,Mu-CompArt,0,0,0,0,0,0,2,0,2,4,0,4,16,1,17,0,0,0,22,1,23
sp13,132,SIXTH,MUS,Music,0,0,0,0,0,0,1,0,1,1,1,2,8,5,13,0,0,0,10,6,16
sp13,132,SIXTH,MUS,Music Hum,0,0,0,0,0,0,0,0,0,0,0,0,0,1,1,0,0,0,0,1,1
sp13,132,SIXTH,NENG,NanoEng,0,0,0,1,2,3,11,1,12,8,1,9,15,4,19,0,0,0,35,8,43
sp13,132,SIXTH,PHIL,Philosophy,0,0,0,0,0,0,0,1,1,2,0,2,2,2,4,0,0,0,4,3,7
sp13,132,SIXTH,PHYS,Biophysics,0,0,0,0,0,0,0,0,0,1,0,1,5,0,5,0,0,0,6,0,6
sp13,132,SIXTH,PHYS,Phy/ErthSc,0,0,0,0,0,0,0,0,0,1,0,1,1,0,1,0,0,0,2,0,2
sp13,132,SIXTH,PHYS,Phys/Astro,0,0,0,0,0,0,0,1,1,0,1,1,1,0,1,0,0,0,1,2,3
sp13,132,SIXTH,PHYS,Phys/Comp,0,0,0,0,0,0,0,0,0,0,0,0,1,0,1,0,0,0,1,0,1
sp13,132,SIXTH,PHYS,Phys/Mtrls,0,0,0,1,0,1,0,0,0,0,0,0,1,0,1,0,0,0,2,0,2
sp13,132,SIXTH,PHYS,Physics,0,0,0,1,0,1,5,0,5,2,0,2,6,0,6,0,0,0,14,0,14
sp13,132,SIXTH,POLI,Polit Sci,0,0,0,2,0,2,3,6,9,5,6,11,15,10,25,0,0,0,25,22,47
sp13,132,SIXTH,POLI,PolSc-Amer,0,0,0,0,0,0,0,0,0,0,2,2,2,3,5,0,0,0,2,5,7
sp13,132,SIXTH,POLI,PolSc-Comp,0,0,0,0,0,0,0,0,0,0,0,0,0,2,2,0,0,0,0,2,2
sp13,132,SIXTH,POLI,PolSc-Intl,0,0,0,0,0,0,0,4,4,4,4,8,8,9,17,0,0,0,12,17,29
sp13,132,SIXTH,POLI,PolSc-PLaw,0,0,0,0,1,1,1,2,3,4,1,5,6,3,9,0,0,0,11,7,18
sp13,132,SIXTH,POLI,PolSc-PPol,0,0,0,0,0,0,0,0,0,1,0,1,1,2,3,0,0,0,2,2,4
sp13,132,SIXTH,POLI,PolSc-Thry,0,0,0,0,0,0,0,0,0,1,0,1,0,1,1,0,0,0,1,1,2
sp13,132,SIXTH,PSYC,Psychology,0,0,0,4,8,12,13,22,35,11,34,45,38,73,111,0,0,0,66,137,203
sp13,132,SIXTH,RELI,Relig/Stu,0,0,0,0,0,0,0,0,0,0,0,0,0,1,1,0,0,0,0,1,1
sp13,132,SIXTH,SE,Struct Eng,0,0,0,10,1,11,17,8,25,16,3,19,46,13,59,0,0,0,89,25,114
sp13,132,SIXTH,SIO,Earth Sci,0,0,0,0,0,0,0,0,0,0,0,0,3,2,5,0,0,0,3,2,5
sp13,132,SIXTH,SIO,ErSc-Geoph,0,0,0,0,0,0,0,0,0,0,0,0,0,1,1,0,0,0,0,1,1
sp13,132,SIXTH,SIO,Marine Bio,0,0,0,0,2,2,2,2,4,1,2,3,0,1,1,0,0,0,3,7,10
sp13,132,SIXTH,SOC,SocCulCom,0,0,0,0,0,0,0,1,1,0,1,1,1,6,7,0,0,0,1,8,9
sp13,132,SIXTH,SOC,SocEconSoc,0,0,0,0,0,0,0,0,0,0,1,1,1,0,1,0,0,0,1,1,2
sp13,132,SIXTH,SOC,SocIntlStu,0,0,0,0,0,0,0,0,0,0,1,1,0,2,2,0,0,0,0,3,3
sp13,132,SIXTH,SOC,Sociology,0,0,0,0,0,0,0,2,2,1,3,4,7,14,21,0,0,0,8,19,27
sp13,132,SIXTH,SOC,SocLawSoc,0,0,0,0,0,0,0,1,1,1,2,3,0,3,3,0,0,0,1,6,7
sp13,132,SIXTH,SOC,SocSciMed,0,0,0,0,0,0,0,1,1,1,0,1,3,4,7,0,0,0,4,5,9
sp13,132,SIXTH,SOC,SocSolneq,0,0,0,0,0,0,0,0,0,0,3,3,0,1,1,0,0,0,0,4,4
sp13,132,SIXTH,THEA,Dance,0,0,0,0,0,0,0,1,1,0,0,0,0,0,0,0,0,0,0,1,1
sp13,132,SIXTH,THEA,Theatre,0,0,0,0,1,1,2,1,3,2,2,4,2,12,14,0,0,0,6,16,22
sp13,132,SIXTH,TWS,ThirdWldSt,0,0,0,0,0,0,0,0,0,0,0,0,0,1,1,0,0,0,0,1,1
sp13,132,SIXTH,UNAF,UndecHumAr,0,0,0,0,1,1,0,3,3,0,0,0,0,0,0,0,0,0,0,4,4
sp13,132,SIXTH,UNAF,Undeclared,0,0,0,15,10,25,9,10,19,4,0,4,0,0,0,0,0,0,28,20,48
sp13,132,SIXTH,UNAF,UndecPhysS,0,0,0,1,1,2,4,2,6,0,0,0,0,0,0,0,0,0,5,3,8
sp13,132,SIXTH,UNAF,UndecSocSc,0,0,0,1,0,1,0,4,4,0,0,0,0,0,0,0,0,0,1,4,5
sp13,132,SIXTH,USP,Urb Stu&Pl,0,0,0,0,0,0,2,4,6,0,5,5,6,8,14,0,0,0,8,17,25
sp13,132,SIXTH,VIS,Art Hst/Cr,0,0,0,0,0,0,0,0,0,0,5,5,1,5,6,0,0,0,1,10,11
sp13,132,SIXTH,VIS,Media,0,0,0,1,1,2,5,7,12,7,10,17,19,17,36,0,0,0,32,35,67
sp13,132,SIXTH,VIS,Studio VA,0,0,0,0,1,1,1,3,4,1,5,6,2,14,16,0,0,0,4,23,27
sp13,132,SIXTH,VIS,VA-CompArt,0,0,0,0,3,3,1,4,5,7,5,12,7,7,14,0,0,0,15,19,34
sp13,132,WARREN,ANTH,Anth-Arch,0,0,0,0,0,0,0,1,1,0,1,1,0,0,0,0,0,0,0,2,2
sp13,132,WARREN,ANTH,Anth-Biol,0,0,0,0,0,0,0,0,0,0,2,2,1,2,3,0,0,0,1,4,5
sp13,132,WARREN,ANTH,Anth-Soci,0,0,0,0,0,0,0,0,0,0,1,1,1,6,7,0,0,0,1,7,8
sp13,132,WARREN,BENG,Bioen:Binf,0,0,0,2,1,3,4,2,6,3,4,7,2,4,6,0,0,0,11,11,22
sp13,132,WARREN,BENG,Bioeng:PM,0,0,0,0,0,0,0,0,0,0,0,0,10,4,14,0,0,0,10,4,14
sp13,132,WARREN,BENG,BioengBiot,0,0,0,0,0,0,6,9,15,11,7,18,37,23,60,0,0,0,54,39,93
sp13,132,WARREN,BENG,Bioengin,0,0,0,1,1,2,3,4,7,11,8,19,26,12,38,0,0,0,41,25,66
sp13,132,WARREN,BIOL,Bioc/CellB,0,0,0,3,0,3,13,16,29,12,16,28,53,33,86,0,0,0,81,65,146
sp13,132,WARREN,BIOL,BiolBioinf,0,0,0,0,0,0,0,0,0,1,0,1,0,0,0,0,0,0,1,0,1
sp13,132,WARREN,BIOL,Ec/Beh/Evo,0,0,0,0,1,1,1,0,1,0,1,1,2,6,8,0,0,0,3,8,11
sp13,132,WARREN,BIOL,Genl Biol,0,0,0,0,4,4,7,17,24,12,17,29,33,42,75,0,0,0,52,80,132
sp13,132,WARREN,BIOL,Human Bio,0,0,0,6,8,14,16,23,39,13,24,37,40,54,94,0,0,0,75,109,184
sp13,132,WARREN,BIOL,Microbiol,0,0,0,0,1,1,2,2,4,1,3,4,4,10,14,0,0,0,7,16,23
sp13,132,WARREN,BIOL,Molec Biol,0,0,0,1,1,2,1,4,5,5,2,7,8,5,13,0,0,0,15,12,27
sp13,132,WARREN,BIOL,PhyslNeuro,0,0,0,1,0,1,11,9,20,6,13,19,26,17,43,0,0,0,44,39,83
sp13,132,WARREN,CENG,Chem Engin,0,0,0,1,3,4,14,9,23,17,17,34,53,19,72,0,0,0,85,48,133
sp13,132,WARREN,CGS,CritGendSt,0,0,0,0,0,0,1,0,1,0,0,0,0,0,0,0,0,0,1,0,1
sp13,132,WARREN,CHEM,Bioch/Chem,0,0,0,2,0,2,5,2,7,9,14,23,32,20,52,0,0,0,48,36,84
sp13,132,WARREN,CHEM,Bioinform,0,0,0,0,0,0,1,0,1,0,0,0,0,0,0,0,0,0,1,0,1
sp13,132,WARREN,CHEM,Chem Phys,0,0,0,0,0,0,0,0,0,0,0,0,0,1,1,0,0,0,0,1,1
sp13,132,WARREN,CHEM,Chemistry,0,0,0,1,2,3,2,2,4,1,4,5,4,10,14,0,0,0,8,18,26
sp13,132,WARREN,CHEM,Envir Chem,0,0,0,0,0,0,0,0,0,0,0,0,1,3,4,0,0,0,1,3,4
sp13,132,WARREN,CHEM,MolecSynth,0,0,0,0,0,0,0,0,0,0,0,0,3,0,3,0,0,0,3,0,3
sp13,132,WARREN,CHEM,Pharm Chem,0,0,0,1,3,4,3,6,9,9,7,16,23,28,51,0,0,0,36,44,80
sp13,132,WARREN,CHIN,Chinese St,0,0,0,0,0,0,0,1,1,0,0,0,0,1,1,0,0,0,0,2,2
sp13,132,WARREN,COGS,Cog Sci,0,0,0,1,0,1,0,5,5,6,3,9,4,2,6,0,0,0,11,10,21
sp13,132,WARREN,COGS,CogSc/ClAs,0,0,0,0,0,0,0,0,0,0,1,1,1,3,4,0,0,0,1,4,5
sp13,132,WARREN,COGS,CogSc/Comp,0,0,0,0,0,0,0,0,0,0,1,1,2,0,2,0,0,0,2,1,3
sp13,132,WARREN,COGS,CogSc/HCI,0,0,0,0,0,0,0,0,0,2,2,4,7,8,15,0,0,0,9,10,19
sp13,132,WARREN,COGS,CogSc/HCog,0,0,0,0,0,0,1,1,2,0,1,1,1,1,2,0,0,0,2,3,5
sp13,132,WARREN,COGS,CogSc/Neur,0,0,0,0,1,1,0,2,2,4,12,16,12,21,33,0,0,0,16,36,52
sp13,132,WARREN,COMM,Communic,0,0,0,1,1,2,3,9,12,8,15,23,8,27,35,0,0,0,20,52,72
sp13,132,WARREN,CSE,Comp Sci,0,0,0,18,4,22,64,20,84,73,11,84,153,29,182,0,0,0,308,64,372
sp13,132,WARREN,CSE,CompEngCSE,0,0,0,4,1,5,20,3,23,21,3,24,38,4,42,0,0,0,83,11,94
sp13,132,WARREN,CSE,CompScBinf,0,0,0,0,0,0,2,2,4,4,0,4,7,6,13,0,0,0,13,8,21
sp13,132,WARREN,ECE,CompEngECE,0,0,0,2,0,2,5,0,5,3,0,3,8,0,8,0,0,0,18,0,18
sp13,132,WARREN,ECE,Electr Eng,0,0,0,7,2,9,35,4,39,43,7,50,77,12,89,0,0,0,162,25,187
sp13,132,WARREN,ECE,Engin Phys,0,0,0,0,0,0,1,0,1,0,0,0,1,0,1,0,0,0,2,0,2
sp13,132,WARREN,ECON,Ec-Mth&Ecn,0,0,0,2,0,2,5,2,7,3,2,5,10,0,10,0,0,0,20,4,24
sp13,132,WARREN,ECON,Econ-MgtSc,0,0,0,4,6,10,14,8,22,14,10,24,42,26,68,0,0,0,74,50,124
sp13,132,WARREN,ECON,Economics,0,0,0,2,6,8,11,7,18,30,27,57,70,34,104,0,0,0,113,74,187
sp13,132,WARREN,ESYS,EnvSys(EB),0,0,0,0,1,1,0,0,0,0,3,3,6,10,16,0,0,0,6,14,20
sp13,132,WARREN,ESYS,EnvSys(EP),0,0,0,0,0,0,0,0,0,1,0,1,0,1,1,0,0,0,1,1,2
sp13,132,WARREN,ESYS,EnvSys(ES),0,0,0,0,0,0,0,1,1,0,0,0,1,0,1,0,0,0,1,1,2
sp13,132,WARREN,ETHN,Ethnic St,0,0,0,0,1,1,1,0,1,0,1,1,0,4,4,0,0,0,1,6,7
sp13,132,WARREN,HDP,Human Dev,0,0,0,0,0,0,1,0,1,2,6,8,1,16,17,0,0,0,4,22,26
sp13,132,WARREN,HDP,Pr-HumnDev,0,0,0,0,0,0,1,8,9,1,4,5,0,3,3,0,0,0,2,15,17
sp13,132,WARREN,HIST,History,0,0,0,0,0,0,1,1,2,5,1,6,11,4,15,0,0,0,17,6,23
sp13,132,WARREN,INTD,Wa Ind St,0,0,0,0,0,0,0,0,0,0,0,0,0,1,1,0,0,0,0,1,1
sp13,132,WARREN,INTL,IntSt-Econ,0,0,0,0,0,0,0,1,1,1,3,4,3,11,14,0,0,0,4,15,19
sp13,132,WARREN,INTL,IntSt-Hist,0,0,0,0,0,0,0,0,0,0,1,1,1,2,3,0,0,0,1,3,4
sp13,132,WARREN,INTL,IntSt-Ling,0,0,0,0,0,0,0,0,0,0,1,1,1,1,2,0,0,0,1,2,3
sp13,132,WARREN,INTL,IntSt-PolS,0,0,0,1,1,2,2,1,3,0,0,0,4,6,10,0,0,0,7,8,15
sp13,132,WARREN,INTL,IntSt-Soc,0,0,0,0,1,1,0,0,0,0,0,0,0,3,3,0,0,0,0,4,4
sp13,132,WARREN,JAPN,JapaneseSt,0,0,0,0,0,0,0,0,0,0,0,0,2,0,2,0,0,0,2,0,2
sp13,132,WARREN,LING,Lang Stu,0,0,0,0,0,0,0,0,0,1,0,1,0,1,1,0,0,0,1,1,2
sp13,132,WARREN,LING,Ling-CogLn,0,0,0,0,0,0,0,0,0,0,1,1,0,0,0,0,0,0,0,1,1
sp13,132,WARREN,LING,Ling-LSoc,0,0,0,0,0,0,0,0,0,0,0,0,1,0,1,0,0,0,1,0,1
sp13,132,WARREN,LING,Linguistcs,0,0,0,0,0,0,0,1,1,1,2,3,1,1,2,0,0,0,2,4,6
sp13,132,WARREN,LIT,Lit/Engl,0,0,0,0,0,0,0,2,2,0,1,1,0,4,4,0,0,0,0,7,7
sp13,132,WARREN,LIT,Lit/World,0,0,0,0,0,0,0,0,0,0,0,0,0,1,1,0,0,0,0,1,1
sp13,132,WARREN,LIT,Lit/Writng,0,0,0,0,0,0,1,3,4,2,2,4,2,7,9,0,0,0,5,12,17
sp13,132,WARREN,LIT,Pre-Lit/Wr,0,0,0,0,0,0,0,0,0,0,0,0,0,1,1,0,0,0,0,1,1
sp13,132,WARREN,LIT,Spanish Lt,0,0,0,0,0,0,1,1,2,0,0,0,1,1,2,0,0,0,2,2,4
sp13,132,WARREN,MAE,Aerosp Eng,0,0,0,3,2,5,15,4,19,10,6,16,39,6,45,0,0,0,67,18,85
sp13,132,WARREN,MAE,Engin Sci,0,0,0,0,0,0,1,0,1,3,1,4,6,1,7,0,0,0,10,2,12
sp13,132,WARREN,MAE,Envir Eng,0,0,0,2,1,3,7,2,9,6,4,10,18,14,32,0,0,0,33,21,54
sp13,132,WARREN,MAE,Mech Engin,0,0,0,1,0,1,24,5,29,18,7,25,83,9,92,0,0,0,126,21,147
sp13,132,WARREN,MATH,Appld Math,0,0,0,2,3,5,3,1,4,5,5,10,7,2,9,0,0,0,17,11,28
sp13,132,WARREN,MATH,Math/SecEd,0,0,0,0,1,1,0,3,3,0,0,0,2,3,5,0,0,0,2,7,9
sp13,132,WARREN,MATH,Mathematcs,0,0,0,1,0,1,0,0,0,1,2,3,6,3,9,0,0,0,8,5,13
sp13,132,WARREN,MATH,Mth-CompSc,0,0,0,0,0,0,0,0,0,0,1,1,4,2,6,0,0,0,4,3,7
sp13,132,WARREN,MATH,Mth-Mth&Ec,0,0,0,3,4,7,0,3,3,4,7,11,6,4,10,0,0,0,13,18,31
sp13,132,WARREN,MATH,Mth/ApldSc,0,0,0,1,0,1,0,0,0,1,0,1,0,2,2,0,0,0,2,2,4
sp13,132,WARREN,MATH,Prob&Stats,0,0,0,1,0,1,0,0,0,2,1,3,2,3,5,0,0,0,5,4,9
sp13,132,WARREN,MUS,Mu-CompArt,0,0,0,0,0,0,0,0,0,2,1,3,2,1,3,0,0,0,4,2,6
sp13,132,WARREN,MUS,Music,0,0,0,0,0,0,0,0,0,1,0,1,4,1,5,0,0,0,5,1,6
sp13,132,WARREN,MUS,Music Hum,0,0,0,0,0,0,0,0,0,0,0,0,1,0,1,0,0,0,1,0,1
sp13,132,WARREN,NENG,NanoEng,0,0,0,3,2,5,13,1,14,14,4,18,27,6,33,0,0,0,57,13,70
sp13,132,WARREN,PHIL,Philosophy,0,0,0,0,0,0,1,0,1,3,1,4,12,2,14,0,0,0,16,3,19
sp13,132,WARREN,PHYS,Biophysics,0,0,0,0,0,0,2,0,2,0,0,0,1,3,4,0,0,0,3,3,6
sp13,132,WARREN,PHYS,Phys/Astro,0,0,0,1,0,1,1,1,2,0,0,0,2,0,2,0,0,0,4,1,5
sp13,132,WARREN,PHYS,Phys/Comp,0,0,0,0,0,0,0,0,0,1,0,1,1,1,2,0,0,0,2,1,3
sp13,132,WARREN,PHYS,Physics,0,0,0,1,0,1,4,0,4,1,1,2,7,3,10,0,0,0,13,4,17
sp13,132,WARREN,POLI,Polit Sci,0,0,0,1,3,4,6,4,10,12,16,28,30,20,50,0,0,0,49,43,92
sp13,132,WARREN,POLI,PolSc-Amer,0,0,0,0,0,0,0,1,1,2,3,5,5,9,14,0,0,0,7,13,20
sp13,132,WARREN,POLI,PolSc-Comp,0,0,0,0,0,0,0,0,0,0,0,0,0,2,2,0,0,0,0,2,2
sp13,132,WARREN,POLI,PolSc-Intl,0,0,0,2,1,3,4,2,6,4,2,6,11,7,18,0,0,0,21,12,33
sp13,132,WARREN,POLI,PolSc-PLaw,0,0,0,1,1,2,1,3,4,6,2,8,4,10,14,0,0,0,12,16,28
sp13,132,WARREN,POLI,PolSc-PPol,0,0,0,0,0,0,1,0,1,3,1,4,2,2,4,0,0,0,6,3,9
sp13,132,WARREN,POLI,PolSc-Thry,0,0,0,0,0,0,0,0,0,2,0,2,2,1,3,0,0,0,4,1,5
sp13,132,WARREN,PSYC,Psychology,0,0,0,1,4,5,6,22,28,21,29,50,28,86,114,0,0,0,56,141,197
sp13,132,WARREN,RELI,Relig/Stu,0,0,0,0,0,0,0,0,0,1,0,1,1,2,3,0,0,0,2,2,4
sp13,132,WARREN,SE,Engin Sci,0,0,0,2,0,2,2,0,2,0,0,0,1,0,1,0,0,0,5,0,5
sp13,132,WARREN,SE,Struct Eng,0,0,0,10,1,11,25,10,35,30,12,42,78,17,95,0,0,0,143,40,183
sp13,132,WARREN,SIO,Earth Sci,0,0,0,0,0,0,1,0,1,1,2,3,4,3,7,0,0,0,6,5,11
sp13,132,WARREN,SIO,Marine Bio,0,0,0,0,0,0,0,1,1,2,0,2,0,1,1,0,0,0,2,2,4
sp13,132,WARREN,SOC,SocCulCom,0,0,0,0,0,0,0,0,0,0,1,1,1,1,2,0,0,0,1,2,3
sp13,132,WARREN,SOC,SocEconSoc,0,0,0,0,0,0,0,0,0,0,1,1,0,1,1,0,0,0,0,2,2
sp13,132,WARREN,SOC,SocIntlStu,0,0,0,0,0,0,0,0,0,0,0,0,0,1,1,0,0,0,0,1,1
sp13,132,WARREN,SOC,Sociology,0,0,0,0,1,1,0,1,1,5,8,13,5,7,12,0,0,0,10,17,27
sp13,132,WARREN,SOC,SocLawSoc,0,0,0,0,0,0,0,1,1,0,3,3,4,2,6,0,0,0,4,6,10
sp13,132,WARREN,SOC,SocSciMed,0,0,0,0,0,0,0,0,0,0,0,0,0,3,3,0,0,0,0,3,3
sp13,132,WARREN,SOC,SocSolneq,0,0,0,0,0,0,0,0,0,0,1,1,0,3,3,0,0,0,0,4,4
sp13,132,WARREN,THEA,Dance,0,0,0,0,0,0,0,0,0,0,0,0,0,1,1,0,0,0,0,1,1
sp13,132,WARREN,THEA,Theatre,0,0,0,0,0,0,0,1,1,0,2,2,4,3,7,0,0,0,4,6,10
sp13,132,WARREN,UNAF,IntcampVis,0,0,0,0,0,0,1,3,4,1,0,1,1,2,3,0,0,0,3,5,8
sp13,132,WARREN,UNAF,Limited St,0,0,0,0,0,0,0,0,0,0,0,0,0,0,0,1,1,2,1,1,2
sp13,132,WARREN,UNAF,UndecHumAr,0,0,0,0,0,0,1,0,1,0,0,0,0,0,0,0,0,0,1,0,1
sp13,132,WARREN,UNAF,Undeclared,0,0,0,7,2,9,11,7,18,0,0,0,0,0,0,0,0,0,18,9,27
sp13,132,WARREN,UNAF,UndecPhysS,0,0,0,0,1,1,0,0,0,1,0,1,0,0,0,0,0,0,1,1,2
sp13,132,WARREN,UNAF,UndecSocSc,0,0,0,2,0,2,0,0,0,0,0,0,0,0,0,0,0,0,2,0,2
sp13,132,WARREN,USP,Urb Stu&Pl,0,0,0,0,0,0,0,0,0,2,1,3,5,5,10,0,0,0,7,6,13
sp13,132,WARREN,VIS,Art Hst/Cr,0,0,0,0,0,0,0,0,0,0,0,0,0,1,1,0,0,0,0,1,1
sp13,132,WARREN,VIS,Media,0,0,0,1,0,1,1,0,1,1,0,1,4,6,10,0,0,0,7,6,13
sp13,132,WARREN,VIS,Studio VA,0,0,0,0,0,0,0,0,0,3,2,5,1,0,1,0,0,0,4,2,6
sp13,132,WARREN,VIS,VA-CompArt,0,0,0,0,0,0,0,0,0,1,1,2,2,0,2,0,0,0,3,1,4
sp07,72,MARSHALL,ANTH,Anth-Arch,0,0,0,0,1,1,0,0,0,0,1,1,2,4,6,0,0,0,2,6,8
sp07,72,MARSHALL,ANTH,Anth-Biol,0,0,0,0,0,0,0,0,0,1,1,2,1,7,8,0,0,0,2,8,10
sp07,72,MARSHALL,ANTH,Anthropol,0,0,0,0,1,1,1,1,2,0,3,3,1,4,5,0,0,0,2,9,11
sp07,72,MARSHALL,BENG,Bioen:Binf,0,0,0,0,0,0,0,0,0,0,0,0,1,1,2,0,0,0,1,1,2
sp07,72,MARSHALL,BENG,Bioeng:PM,0,0,0,0,0,0,0,0,0,7,0,7,16,12,28,0,0,0,23,12,35
sp07,72,MARSHALL,BENG,BioengBiot,0,0,0,0,0,0,0,1,1,6,3,9,6,7,13,0,0,0,12,11,23
sp07,72,MARSHALL,BENG,Bioengin,0,0,0,0,0,0,0,2,2,4,1,5,7,5,12,0,0,0,11,8,19
sp07,72,MARSHALL,BENG,Pr-BioenPM,0,0,0,5,3,8,13,5,18,3,4,7,0,2,2,0,0,0,21,14,35
sp07,72,MARSHALL,BIOL,Anml Physl,0,0,0,0,0,0,0,0,0,1,4,5,16,15,31,0,0,0,17,19,36
sp07,72,MARSHALL,BIOL,Bioc/CellB,0,0,0,3,6,9,3,12,15,18,17,35,51,47,98,0,0,0,75,82,157
sp07,72,MARSHALL,BIOL,Ec/Beh/Evo,0,0,0,1,0,1,0,2,2,1,2,3,0,4,4,0,0,0,2,8,10
sp07,72,MARSHALL,BIOL,Genl Biol,0,0,0,6,8,14,7,16,23,17,19,36,33,64,97,0,0,0,63,107,170
sp07,72,MARSHALL,BIOL,Human Bio,0,0,0,8,18,26,19,32,51,26,39,65,54,64,118,0,0,0,107,153,260
sp07,72,MARSHALL,BIOL,Microbiol,0,0,0,0,0,0,1,2,3,1,0,1,6,6,12,0,0,0,8,8,16
sp07,72,MARSHALL,BIOL,Molec Biol,0,0,0,1,0,1,1,2,3,2,3,5,7,9,16,0,0,0,11,14,25
sp07,72,MARSHALL,BIOL,PhyslNeuro,0,0,0,0,3,3,3,5,8,9,7,16,2,3,5,0,0,0,14,18,32
sp07,72,MARSHALL,CENG,Chem Engin,0,0,0,0,1,1,4,2,6,1,4,5,8,6,14,0,0,0,13,13,26
sp07,72,MARSHALL,CGS,CritGendSt,0,0,0,0,1,1,0,1,1,0,1,1,0,4,4,0,0,0,0,7,7
sp07,72,MARSHALL,CHEM,Bioch/Chem,0,0,0,2,8,10,5,8,13,10,8,18,14,10,24,0,0,0,31,34,65
sp07,72,MARSHALL,CHEM,Chem Educ,0,0,0,0,0,0,0,0,0,0,1,1,0,0,0,0,0,0,0,1,1
sp07,72,MARSHALL,CHEM,Chemistry,0,0,0,0,3,3,3,3,6,5,1,6,0,4,4,0,0,0,8,11,19
sp07,72,MARSHALL,CHEM,Envir Chem,0,0,0,0,0,0,0,1,1,0,0,0,0,0,0,0,0,0,0,1,1
sp07,72,MARSHALL,CHEM,MolecSynth,0,0,0,0,0,0,0,0,0,0,0,0,0,1,1,0,0,0,0,1,1
sp07,72,MARSHALL,CHEM,Pharm Chem,0,0,0,0,7,7,5,9,14,6,5,11,12,19,31,0,0,0,23,40,63
sp07,72,MARSHALL,CHIN,Chinese St,0,0,0,0,0,0,1,0,1,0,0,0,1,1,2,0,0,0,2,1,3
sp07,72,MARSHALL,CLAS,Classic St,0,0,0,0,0,0,0,1,1,0,1,1,0,1,1,0,0,0,0,3,3
sp07,72,MARSHALL,COGS,Cog Sci,0,0,0,1,1,2,3,3,6,4,3,7,8,5,13,0,0,0,16,12,28
sp07,72,MARSHALL,COGS,CogSc/ClAs,0,0,0,0,1,1,0,0,0,0,1,1,0,1,1,0,0,0,0,3,3
sp07,72,MARSHALL,COGS,CogSc/HCI,0,0,0,0,0,0,0,0,0,2,0,2,2,3,5,0,0,0,4,3,7
sp07,72,MARSHALL,COGS,CogSc/HCog,0,0,0,0,0,0,0,0,0,2,1,3,0,0,0,0,0,0,2,1,3
sp07,72,MARSHALL,COGS,CogSc/Neur,0,0,0,0,0,0,2,1,3,2,2,4,2,6,8,0,0,0,6,9,15
sp07,72,MARSHALL,COMM,Communic,0,0,0,0,8,8,7,20,27,11,43,54,19,48,67,0,0,0,37,119,156
sp07,72,MARSHALL,CSE,Comp Sci,0,0,0,1,2,3,5,0,5,5,1,6,26,6,32,0,0,0,37,9,46
sp07,72,MARSHALL,CSE,CompEngCSE,0,0,0,3,0,3,11,0,11,2,0,2,13,1,14,0,0,0,29,1,30
sp07,72,MARSHALL,CSE,CompScBinf,0,0,0,0,0,0,0,0,0,0,0,0,1,1,2,0,0,0,1,1,2
sp07,72,MARSHALL,ECE,CompEngECE,0,0,0,1,0,1,3,0,3,0,0,0,1,0,1,0,0,0,5,0,5
sp07,72,MARSHALL,ECE,Electr Eng,0,0,0,3,1,4,7,1,8,12,2,14,20,5,25,0,0,0,42,9,51
sp07,72,MARSHALL,ECE,Engin Phys,0,0,0,0,0,0,0,0,0,0,0,0,2,0,2,0,0,0,2,0,2
sp07,72,MARSHALL,ECE,Pr-ElecEng,0,0,0,0,0,0,0,0,0,1,0,1,0,0,0,0,0,0,1,0,1
sp07,72,MARSHALL,ECE,Pr-EngPhys,0,0,0,0,0,0,0,0,0,0,1,1,0,0,0,0,0,0,0,1,1
sp07,72,MARSHALL,ECON,Ec-Mth&Ecn,0,0,0,1,1,2,4,2,6,3,2,5,5,4,9,0,0,0,13,9,22
sp07,72,MARSHALL,ECON,Econ-MgtSc,0,0,0,7,3,10,18,13,31,35,21,56,45,32,77,0,0,0,105,69,174
sp07,72,MARSHALL,ECON,Economics,0,0,0,6,6,12,18,19,37,54,30,84,75,38,113,0,0,0,153,93,246
sp07,72,MARSHALL,ERTH,Earth Scis,0,0,0,1,0,1,0,0,0,1,1,2,0,0,0,0,0,0,2,1,3
sp07,72,MARSHALL,ESYS,EnvSys(EB),0,0,0,0,1,1,0,0,0,5,3,8,0,4,4,0,0,0,5,8,13
sp07,72,MARSHALL,ESYS,EnvSys(EC),0,0,0,0,0,0,0,0,0,0,0,0,1,0,1,0,0,0,1,0,1
sp07,72,MARSHALL,ESYS,EnvSys(EP),0,0,0,0,0,0,1,1,2,0,2,2,0,0,0,0,0,0,1,3,4
sp07,72,MARSHALL,ESYS,EnvSys(ES),0,0,0,0,0,0,0,0,0,0,0,0,2,1,3,0,0,0,2,1,3
sp07,72,MARSHALL,ETHN,Ethnic St,0,0,0,0,1,1,0,3,3,2,10,12,0,4,4,0,0,0,2,18,20
sp07,72,MARSHALL,HDP,Human Dev,0,0,0,0,0,0,0,1,1,0,5,5,0,29,29,0,0,0,0,35,35
sp07,72,MARSHALL,HDP,Pr-HumnDev,0,0,0,1,6,7,0,11,11,0,12,12,1,3,4,0,0,0,2,32,34
sp07,72,MARSHALL,HIST,History,0,0,0,2,1,3,3,4,7,11,9,20,24,24,48,0,0,0,40,38,78
sp07,72,MARSHALL,INTD,Mar Ind St,0,0,0,0,0,0,0,0,0,0,0,0,0,1,1,0,0,0,0,1,1
sp07,72,MARSHALL,INTL,IntSt-Anth,0,0,0,0,0,0,0,0,0,0,0,0,0,1,1,0,0,0,0,1,1
sp07,72,MARSHALL,INTL,IntSt-Econ,0,0,0,2,3,5,3,10,13,3,8,11,6,13,19,0,0,0,14,34,48
sp07,72,MARSHALL,INTL,IntSt-Hist,0,0,0,0,0,0,0,1,1,1,0,1,3,0,3,0,0,0,4,1,5
sp07,72,MARSHALL,INTL,IntSt-Ling,0,0,0,0,2,2,0,1,1,0,1,1,1,0,1,0,0,0,1,4,5
sp07,72,MARSHALL,INTL,IntSt-Lit,0,0,0,0,0,0,0,0,0,1,0,1,0,1,1,0,0,0,1,1,2
sp07,72,MARSHALL,INTL,IntSt-PolS,0,0,0,1,1,2,2,5,7,3,7,10,4,11,15,0,0,0,10,24,34
sp07,72,MARSHALL,INTL,IntSt-Soc,0,0,0,0,0,0,0,4,4,0,7,7,1,10,11,0,0,0,1,21,22
sp07,72,MARSHALL,JAPN,JapaneseSt,0,0,0,1,0,1,0,0,0,0,1,1,1,1,2,0,0,0,2,2,4
sp07,72,MARSHALL,JUDA,Judaic Stu,0,0,0,0,0,0,0,0,0,0,0,0,0,1,1,0,0,0,0,1,1
sp07,72,MARSHALL,LATI,LatinAm St,0,0,0,1,1,2,0,0,0,0,0,0,2,4,6,0,0,0,3,5,8
sp07,72,MARSHALL,LING,Lang Stu,0,0,0,0,0,0,0,0,0,0,1,1,0,2,2,0,0,0,0,3,3
sp07,72,MARSHALL,LING,Ling-LSoc,0,0,0,0,0,0,0,0,0,0,1,1,0,1,1,0,0,0,0,2,2
sp07,72,MARSHALL,LING,Linguistcs,0,0,0,0,0,0,0,0,0,1,0,1,2,4,6,0,0,0,3,4,7
sp07,72,MARSHALL,LIT,Lit/Compos,0,0,0,0,0,0,0,1,1,0,0,0,0,0,0,0,0,0,0,1,1
sp07,72,MARSHALL,LIT,Lit/Engl,0,0,0,0,3,3,1,3,4,2,4,6,4,15,19,0,0,0,7,25,32
sp07,72,MARSHALL,LIT,Lit/World,0,0,0,0,1,1,1,1,2,0,2,2,0,1,1,0,0,0,1,5,6
sp07,72,MARSHALL,LIT,Lit/Writng,0,0,0,0,0,0,0,0,0,0,0,0,3,4,7,0,0,0,3,4,7
sp07,72,MARSHALL,LIT,Pre-Lit/Wr,0,0,0,2,0,2,0,5,5,2,2,4,0,1,1,0,0,0,4,8,12
sp07,72,MARSHALL,LIT,Russian Lt,0,0,0,0,0,0,0,0,0,0,0,0,0,1,1,0,0,0,0,1,1
sp07,72,MARSHALL,LIT,Spanish Lt,0,0,0,0,0,0,0,0,0,0,3,3,0,2,2,0,0,0,0,5,5
sp07,72,MARSHALL,MAE,Aerosp Eng,0,0,0,2,0,2,7,1,8,8,0,8,16,1,17,0,0,0,33,2,35
sp07,72,MARSHALL,MAE,Engin Sci,0,0,0,0,0,0,1,0,1,1,1,2,0,0,0,0,0,0,2,1,3
sp07,72,MARSHALL,MAE,Envir Eng,0,0,0,1,0,1,0,0,0,0,0,0,1,1,2,0,0,0,2,1,3
sp07,72,MARSHALL,MAE,Mech Engin,0,0,0,4,1,5,17,1,18,20,1,21,52,5,57,0,0,0,93,8,101
sp07,72,MARSHALL,MATH,Appld Math,0,0,0,1,0,1,2,0,2,2,2,4,2,3,5,0,0,0,7,5,12
sp07,72,MARSHALL,MATH,Math/SecEd,0,0,0,0,0,0,0,0,0,2,2,4,1,3,4,0,0,0,3,5,8
sp07,72,MARSHALL,MATH,Mathematcs,0,0,0,0,0,0,1,4,5,4,0,4,5,2,7,0,0,0,10,6,16
sp07,72,MARSHALL,MATH,Mth-CompSc,0,0,0,0,0,0,0,0,0,0,0,0,3,0,3,0,0,0,3,0,3
sp07,72,MARSHALL,MATH,Mth-Mth&Ec,0,0,0,0,0,0,1,2,3,1,0,1,4,2,6,0,0,0,6,4,10
sp07,72,MARSHALL,MATH,Mth-SciCom,0,0,0,0,0,0,0,1,1,0,0,0,0,0,0,0,0,0,0,1,1
sp07,72,MARSHALL,MATH,Mth/ApldSc,0,0,0,0,0,0,0,1,1,2,0,2,0,2,2,0,0,0,2,3,5
sp07,72,MARSHALL,MATH,Pr-Math CS,0,0,0,1,0,1,0,0,0,1,1,2,1,0,1,0,0,0,3,1,4
sp07,72,MARSHALL,MUS,Mu-CompArt,0,0,0,0,0,0,0,0,0,0,0,0,1,1,2,0,0,0,1,1,2
sp07,72,MARSHALL,MUS,Music,0,0,0,0,1,1,2,2,4,0,1,1,2,1,3,0,0,0,4,5,9
sp07,72,MARSHALL,MUS,Music Hum,0,0,0,0,0,0,0,1,1,0,1,1,0,0,0,0,0,0,0,2,2
sp07,72,MARSHALL,MUS,Pr-MuCmpAr,0,0,0,0,0,0,0,1,1,0,0,0,0,0,0,0,0,0,0,1,1
sp07,72,MARSHALL,PHIL,Philosophy,0,0,0,1,0,1,1,0,1,7,5,12,6,4,10,0,0,0,15,9,24
sp07,72,MARSHALL,PHYS,Gen Physcs,0,0,0,0,0,0,0,0,0,1,0,1,0,0,0,0,0,0,1,0,1
sp07,72,MARSHALL,PHYS,Phys/Astro,0,0,0,0,0,0,1,0,1,1,1,2,3,2,5,0,0,0,5,3,8
sp07,72,MARSHALL,PHYS,Phys/Comp,0,0,0,0,0,0,0,0,0,1,0,1,0,0,0,0,0,0,1,0,1
sp07,72,MARSHALL,PHYS,Phys/Mtrls,0,0,0,0,0,0,0,0,0,0,0,0,2,0,2,0,0,0,2,0,2
sp07,72,MARSHALL,PHYS,Physics,0,0,0,0,0,0,1,0,1,3,1,4,0,0,0,0,0,0,4,1,5
sp07,72,MARSHALL,POLI,Polit Sci,0,0,0,1,2,3,9,12,21,19,18,37,30,34,64,0,0,0,59,66,125
sp07,72,MARSHALL,POLI,PolSc-Amer,0,0,0,2,1,3,1,1,2,3,2,5,3,8,11,0,0,0,9,12,21
sp07,72,MARSHALL,POLI,PolSc-Comp,0,0,0,0,0,0,0,0,0,0,1,1,1,0,1,0,0,0,1,1,2
sp07,72,MARSHALL,POLI,PolSc-Intl,0,0,0,0,4,4,3,6,9,5,9,14,14,16,30,0,0,0,22,35,57
sp07,72,MARSHALL,POLI,PolSc-PLaw,0,0,0,1,4,5,6,5,11,9,8,17,6,6,12,0,0,0,22,23,45
sp07,72,MARSHALL,POLI,PolSc-PPol,0,0,0,0,0,0,0,1,1,1,1,2,5,0,5,0,0,0,6,2,8
sp07,72,MARSHALL,POLI,PolSc-Thry,0,0,0,0,1,1,0,1,1,0,0,0,3,6,9,0,0,0,3,8,11
sp07,72,MARSHALL,PSYC,Psychology,0,0,0,4,12,16,8,29,37,18,53,71,45,97,142,0,0,0,75,191,266
sp07,72,MARSHALL,RELI,Relig/Stu,0,0,0,0,0,0,1,0,1,0,0,0,1,1,2,0,0,0,2,1,3
sp07,72,MARSHALL,SE,Engin Sci,0,0,0,0,0,0,0,1,1,0,0,0,0,0,0,0,0,0,0,1,1
sp07,72,MARSHALL,SE,Struct Eng,0,0,0,3,1,4,3,5,8,11,2,13,25,11,36,0,0,0,42,19,61
sp07,72,MARSHALL,SOC,Sociology,0,0,0,0,4,4,0,12,12,9,17,26,8,45,53,0,0,0,17,78,95
sp07,72,MARSHALL,THEA,Dance,0,0,0,0,0,0,0,0,0,0,0,0,0,5,5,0,0,0,0,5,5
sp07,72,MARSHALL,THEA,Theatre,0,0,0,0,0,0,1,0,1,3,3,6,5,4,9,0,0,0,9,7,16
sp07,72,MARSHALL,TWS,ThirdWldSt,0,0,0,0,0,0,0,1,1,0,0,0,1,0,1,0,0,0,1,1,2
sp07,72,MARSHALL,UNAF,UndecBiolS,0,0,0,8,12,20,11,16,27,1,0,1,0,0,0,0,0,0,20,28,48
sp07,72,MARSHALL,UNAF,UndecHumAr,0,0,0,0,3,3,4,8,12,0,0,0,0,0,0,0,0,0,4,11,15
sp07,72,MARSHALL,UNAF,Undeclared,0,0,0,22,35,57,25,40,65,3,7,10,0,0,0,0,0,0,50,82,132
sp07,72,MARSHALL,UNAF,UndecPhysS,0,0,0,2,1,3,4,3,7,0,0,0,0,0,0,0,0,0,6,4,10
sp07,72,MARSHALL,UNAF,UndecSocSc,0,0,0,3,5,8,7,7,14,1,0,1,0,0,0,0,0,0,11,12,23
sp07,72,MARSHALL,USP,Urb Stu&Pl,0,0,0,0,1,1,3,2,5,4,8,12,10,13,23,0,0,0,17,24,41
sp07,72,MARSHALL,VIS,Art Hst/Cr,0,0,0,0,1,1,0,1,1,0,3,3,0,3,3,0,0,0,0,8,8
sp07,72,MARSHALL,VIS,Media,0,0,0,1,0,1,0,1,1,8,2,10,8,8,16,0,0,0,17,11,28
sp07,72,MARSHALL,VIS,Pr-VACmpAr,0,0,0,0,0,0,0,1,1,0,0,0,1,0,1,0,0,0,1,1,2
sp07,72,MARSHALL,VIS,Studio VA,0,0,0,0,0,0,1,1,2,1,4,5,3,5,8,0,0,0,5,10,15
sp07,72,MARSHALL,VIS,VA-CompArt,0,0,0,0,0,0,0,0,0,0,0,0,1,0,1,0,0,0,1,0,1
sp07,72,MUIR,ANTH,Anth-Arch,0,0,0,1,3,4,0,1,1,0,2,2,2,1,3,0,0,0,3,7,10
sp07,72,MUIR,ANTH,Anth-Biol,0,0,0,1,0,1,0,0,0,1,3,4,2,11,13,0,0,0,4,14,18
sp07,72,MUIR,ANTH,Anthropol,0,0,0,0,0,0,0,0,0,0,5,5,4,8,12,0,0,0,4,13,17
sp07,72,MUIR,BENG,Bioen:Binf,0,0,0,0,0,0,0,0,0,0,0,0,2,0,2,0,0,0,2,0,2
sp07,72,MUIR,BENG,Bioeng:PM,0,0,0,0,0,0,2,0,2,2,4,6,17,7,24,0,0,0,21,11,32
sp07,72,MUIR,BENG,BioengBiot,0,0,0,1,0,1,5,1,6,3,2,5,13,9,22,0,0,0,22,12,34
sp07,72,MUIR,BENG,Bioengin,0,0,0,0,1,1,5,5,10,6,3,9,7,2,9,0,0,0,18,11,29
sp07,72,MUIR,BENG,Pr-BioenBf,0,0,0,0,0,0,0,0,0,0,1,1,0,0,0,0,0,0,0,1,1
sp07,72,MUIR,BENG,Pr-BioenPM,0,0,0,6,3,9,7,7,14,6,2,8,0,1,1,0,0,0,19,13,32
sp07,72,MUIR,BIOL,Anml Physl,0,0,0,0,0,0,0,0,0,0,0,0,8,21,29,0,0,0,8,21,29
sp07,72,MUIR,BIOL,Bioc/CellB,0,0,0,4,7,11,20,19,39,20,29,49,28,44,72,0,0,0,72,99,171
sp07,72,MUIR,BIOL,BiolBioinf,0,0,0,0,0,0,0,0,0,0,0,0,1,0,1,0,0,0,1,0,1
sp07,72,MUIR,BIOL,Ec/Beh/Evo,0,0,0,1,1,2,3,6,9,1,3,4,4,16,20,0,0,0,9,26,35
sp07,72,MUIR,BIOL,Genl Biol,0,0,0,10,13,23,17,20,37,15,27,42,25,48,73,0,0,0,67,108,175
sp07,72,MUIR,BIOL,Human Bio,0,0,0,13,27,40,31,46,77,29,48,77,42,57,99,0,0,0,115,178,293
sp07,72,MUIR,BIOL,Microbiol,0,0,0,0,0,0,3,0,3,3,2,5,5,10,15,0,0,0,11,12,23
sp07,72,MUIR,BIOL,Molec Biol,0,0,0,2,4,6,4,8,12,5,5,10,9,13,22,0,0,0,20,30,50
sp07,72,MUIR,BIOL,PhyslNeuro,0,0,0,1,1,2,7,11,18,5,15,20,4,2,6,0,0,0,17,29,46
sp07,72,MUIR,CENG,Chem Engin,0,0,0,1,0,1,6,2,8,2,0,2,8,3,11,0,0,0,17,5,22
sp07,72,MUIR,CGS,CritGendSt,0,0,0,0,0,0,0,0,0,1,1,2,1,4,5,0,0,0,2,5,7
sp07,72,MUIR,CHEM,Bioch/Chem,0,0,0,4,2,6,9,14,23,20,8,28,24,11,35,0,0,0,57,35,92
sp07,72,MUIR,CHEM,Chem Educ,0,0,0,0,0,0,0,0,0,0,1,1,1,0,1,0,0,0,1,1,2
sp07,72,MUIR,CHEM,Chem Phys,0,0,0,0,0,0,0,0,0,1,0,1,0,1,1,0,0,0,1,1,2
sp07,72,MUIR,CHEM,Chemistry,0,0,0,0,1,1,8,6,14,4,7,11,6,4,10,0,0,0,18,18,36
sp07,72,MUIR,CHEM,Envir Chem,0,0,0,0,0,0,0,0,0,0,0,0,2,1,3,0,0,0,2,1,3
sp07,72,MUIR,CHEM,MolecSynth,0,0,0,0,0,0,1,0,1,0,0,0,0,1,1,0,0,0,1,1,2
sp07,72,MUIR,CHEM,Pharm Chem,0,0,0,6,6,12,9,11,20,3,10,13,8,15,23,0,0,0,26,42,68
sp07,72,MUIR,CHIN,Chinese St,0,0,0,0,0,0,0,0,0,0,2,2,1,0,1,0,0,0,1,2,3
sp07,72,MUIR,CLAS,Classic St,0,0,0,0,0,0,0,1,1,3,1,4,0,0,0,0,0,0,3,2,5
sp07,72,MUIR,COGS,Cog Sci,0,0,0,3,1,4,3,3,6,7,8,15,6,4,10,0,0,0,19,16,35
sp07,72,MUIR,COGS,CogSc/ClAs,0,0,0,0,0,0,0,0,0,0,1,1,2,3,5,0,0,0,2,4,6
sp07,72,MUIR,COGS,CogSc/Comp,0,0,0,0,0,0,0,0,0,0,0,0,0,1,1,0,0,0,0,1,1
sp07,72,MUIR,COGS,CogSc/HCI,0,0,0,0,0,0,1,1,2,1,0,1,4,1,5,0,0,0,6,2,8
sp07,72,MUIR,COGS,CogSc/HCog,0,0,0,0,0,0,0,0,0,3,0,3,0,0,0,0,0,0,3,0,3
sp07,72,MUIR,COGS,CogSc/Neur,0,0,0,0,0,0,1,2,3,2,1,3,2,6,8,0,0,0,5,9,14
sp07,72,MUIR,COMM,Communic,0,0,0,2,17,19,6,13,19,13,44,57,27,41,68,0,0,0,48,115,163
sp07,72,MUIR,CSE,Comp Sci,0,0,0,2,0,2,11,1,12,8,0,8,34,7,41,0,0,0,55,8,63
sp07,72,MUIR,CSE,CompEngCSE,0,0,0,0,0,0,7,0,7,3,0,3,8,0,8,0,0,0,18,0,18
sp07,72,MUIR,CSE,CompScBinf,0,0,0,0,0,0,0,0,0,2,0,2,1,0,1,0,0,0,3,0,3
sp07,72,MUIR,ECE,CompEngECE,0,0,0,0,0,0,3,0,3,3,0,3,5,0,5,0,0,0,11,0,11
sp07,72,MUIR,ECE,Electr Eng,0,0,0,5,1,6,3,3,6,4,2,6,20,2,22,0,0,0,32,8,40
sp07,72,MUIR,ECE,Engin Phys,0,0,0,0,0,0,1,0,1,0,0,0,1,0,1,0,0,0,2,0,2
sp07,72,MUIR,ECE,Pr-EngPhys,0,0,0,0,0,0,1,0,1,0,0,0,0,0,0,0,0,0,1,0,1
sp07,72,MUIR,ECON,Ec-Mth&Ecn,0,0,0,3,0,3,2,2,4,1,0,1,2,3,5,0,0,0,8,5,13
sp07,72,MUIR,ECON,Econ-MgtSc,0,0,0,3,3,6,8,9,17,22,15,37,37,31,68,0,0,0,70,58,128
sp07,72,MUIR,ECON,Economics,0,0,0,11,4,15,13,17,30,52,21,73,66,39,105,0,0,0,142,81,223
sp07,72,MUIR,ERTH,Earth Scis,0,0,0,0,0,0,0,0,0,0,0,0,3,0,3,0,0,0,3,0,3
sp07,72,MUIR,ERTH,ErthSc-Chm,0,0,0,0,1,1,0,0,0,0,0,0,1,0,1,0,0,0,1,1,2
sp07,72,MUIR,ESYS,EnvSys(EB),0,0,0,0,0,0,0,2,2,0,5,5,3,10,13,0,0,0,3,17,20
sp07,72,MUIR,ESYS,EnvSys(EC),0,0,0,0,0,0,0,0,0,0,0,0,2,0,2,0,0,0,2,0,2
sp07,72,MUIR,ESYS,EnvSys(EP),0,0,0,0,2,2,1,1,2,1,1,2,2,3,5,0,0,0,4,7,11
sp07,72,MUIR,ESYS,EnvSys(ES),0,0,0,1,0,1,1,1,2,1,0,1,1,3,4,0,0,0,4,4,8
sp07,72,MUIR,ETHN,Ethnic St,0,0,0,0,0,0,0,3,3,2,4,6,5,7,12,0,0,0,7,14,21
sp07,72,MUIR,GMST,German Stu,0,0,0,0,0,0,0,0,0,1,0,1,0,0,0,0,0,0,1,0,1
sp07,72,MUIR,HDP,Human Dev,0,0,0,0,0,0,0,0,0,0,5,5,1,33,34,0,0,0,1,38,39
sp07,72,MUIR,HDP,Pr-HumnDev,0,0,0,0,3,3,1,5,6,1,9,10,1,5,6,0,0,0,3,22,25
sp07,72,MUIR,HIST,History,0,0,0,1,1,2,4,5,9,11,10,21,32,26,58,0,0,0,48,42,90
sp07,72,MUIR,INTD,Muir Sp Pr,0,0,0,0,0,0,0,0,0,0,0,0,0,1,1,0,0,0,0,1,1
sp07,72,MUIR,INTL,IntSt-Anth,0,0,0,0,1,1,0,1,1,1,3,4,0,2,2,0,0,0,1,7,8
sp07,72,MUIR,INTL,IntSt-Econ,0,0,0,0,4,4,6,3,9,6,12,18,5,11,16,0,0,0,17,30,47
sp07,72,MUIR,INTL,IntSt-Hist,0,0,0,0,0,0,1,1,2,1,1,2,0,3,3,0,0,0,2,5,7
sp07,72,MUIR,INTL,IntSt-Ling,0,0,0,0,0,0,0,0,0,0,1,1,1,1,2,0,0,0,1,2,3
sp07,72,MUIR,INTL,IntSt-Lit,0,0,0,0,0,0,0,0,0,0,2,2,0,2,2,0,0,0,0,4,4
sp07,72,MUIR,INTL,IntSt-PolS,0,0,0,0,0,0,2,2,4,4,11,15,5,19,24,0,0,0,11,32,43
sp07,72,MUIR,INTL,IntSt-Soc,0,0,0,0,0,0,1,1,2,2,16,18,3,5,8,0,0,0,6,22,28
sp07,72,MUIR,JAPN,JapaneseSt,0,0,0,0,0,0,1,0,1,1,2,3,0,1,1,0,0,0,2,3,5
sp07,72,MUIR,JUDA,Judaic Stu,0,0,0,0,0,0,0,0,0,0,0,0,0,1,1,0,0,0,0,1,1
sp07,72,MUIR,LATI,LatinAm St,0,0,0,0,0,0,0,0,0,1,2,3,1,1,2,0,0,0,2,3,5
sp07,72,MUIR,LING,Lang Stu,0,0,0,0,0,0,0,0,0,0,2,2,1,4,5,0,0,0,1,6,7
sp07,72,MUIR,LING,Ling-CogLn,0,0,0,0,0,0,0,1,1,1,0,1,0,3,3,0,0,0,1,4,5
sp07,72,MUIR,LING,Ling-LSoc,0,0,0,0,1,1,0,0,0,0,2,2,0,1,1,0,0,0,0,4,4
sp07,72,MUIR,LING,Linguistcs,0,0,0,0,0,0,0,0,0,0,2,2,1,5,6,0,0,0,1,7,8
sp07,72,MUIR,LIT,French Lit,0,0,0,0,0,0,0,1,1,0,0,0,0,1,1,0,0,0,0,2,2
sp07,72,MUIR,LIT,German Lit,0,0,0,0,0,0,0,1,1,0,0,0,0,0,0,0,0,0,0,1,1
sp07,72,MUIR,LIT,Lit/Compos,0,0,0,0,0,0,0,1,1,1,0,1,1,0,1,0,0,0,2,1,3
sp07,72,MUIR,LIT,Lit/Engl,0,0,0,0,2,2,0,5,5,4,8,12,7,14,21,0,0,0,11,29,40
sp07,72,MUIR,LIT,Lit/World,0,0,0,0,0,0,1,1,2,1,3,4,1,8,9,0,0,0,3,12,15
sp07,72,MUIR,LIT,Lit/Writng,0,0,0,0,0,0,0,0,0,0,3,3,8,17,25,0,0,0,8,20,28
sp07,72,MUIR,LIT,Pre-Lit/Wr,0,0,0,2,6,8,2,7,9,7,12,19,1,4,5,0,0,0,12,29,41
sp07,72,MUIR,LIT,Spanish Lt,0,0,0,0,0,0,0,3,3,2,1,3,0,3,3,0,0,0,2,7,9
sp07,72,MUIR,MAE,Aerosp Eng,0,0,0,7,0,7,3,3,6,6,3,9,19,1,20,0,0,0,35,7,42
sp07,72,MUIR,MAE,Engin Sci,0,0,0,1,0,1,0,0,0,0,0,0,1,0,1,0,0,0,2,0,2
sp07,72,MUIR,MAE,Envir Eng,0,0,0,0,1,1,1,2,3,0,1,1,1,3,4,0,0,0,2,7,9
sp07,72,MUIR,MAE,Mech Engin,0,0,0,2,2,4,20,3,23,20,1,21,43,3,46,0,0,0,85,9,94
sp07,72,MUIR,MATH,Appld Math,0,0,0,0,0,0,2,0,2,6,2,8,0,5,5,0,0,0,8,7,15
sp07,72,MUIR,MATH,Math/SecEd,0,0,0,1,0,1,0,0,0,2,0,2,4,4,8,0,0,0,7,4,11
sp07,72,MUIR,MATH,Mathematcs,0,0,0,3,3,6,4,5,9,4,8,12,10,4,14,0,0,0,21,20,41
sp07,72,MUIR,MATH,Mth-CompSc,0,0,0,0,0,0,0,1,1,0,0,0,4,1,5,0,0,0,4,2,6
sp07,72,MUIR,MATH,Mth-Mth&Ec,0,0,0,0,2,2,1,1,2,2,1,3,4,4,8,0,0,0,7,8,15
sp07,72,MUIR,MATH,Mth/ApldSc,0,0,0,0,2,2,1,1,2,0,0,0,1,1,2,0,0,0,2,4,6
sp07,72,MUIR,MATH,Pr-Math CS,0,0,0,1,0,1,1,0,1,1,0,1,0,0,0,0,0,0,3,0,3
sp07,72,MUIR,MUS,Mu-CompArt,0,0,0,0,0,0,0,0,0,3,0,3,5,0,5,0,0,0,8,0,8
sp07,72,MUIR,MUS,Music,0,0,0,1,1,2,2,1,3,2,2,4,4,5,9,0,0,0,9,9,18
sp07,72,MUIR,MUS,Music Hum,0,0,0,0,0,0,0,0,0,0,0,0,1,0,1,0,0,0,1,0,1
sp07,72,MUIR,MUS,Pr-MuCmpAr,0,0,0,3,0,3,1,2,3,2,2,4,0,0,0,0,0,0,6,4,10
sp07,72,MUIR,PHIL,Philosophy,0,0,0,1,0,1,2,2,4,4,7,11,11,3,14,0,0,0,18,12,30
sp07,72,MUIR,PHYS,Biophysics,0,0,0,1,0,1,3,0,3,1,0,1,5,1,6,0,0,0,10,1,11
sp07,72,MUIR,PHYS,Phy/ErthSc,0,0,0,1,0,1,0,0,0,0,0,0,0,0,0,0,0,0,1,0,1
sp07,72,MUIR,PHYS,Phys/Astro,0,0,0,0,0,0,2,1,3,1,1,2,1,4,5,0,0,0,4,6,10
sp07,72,MUIR,PHYS,Phys/Mtrls,0,0,0,0,0,0,0,0,0,0,0,0,1,0,1,0,0,0,1,0,1
sp07,72,MUIR,PHYS,Physics,0,0,0,0,0,0,1,0,1,1,0,1,8,0,8,0,0,0,10,0,10
sp07,72,MUIR,POLI,Polit Sci,0,0,0,0,5,5,7,6,13,17,14,31,31,22,53,0,0,0,55,47,102
sp07,72,MUIR,POLI,PolSc-Amer,0,0,0,0,1,1,1,1,2,1,4,5,6,4,10,0,0,0,8,10,18
sp07,72,MUIR,POLI,PolSc-Comp,0,0,0,0,0,0,1,0,1,0,0,0,1,3,4,0,0,0,2,3,5
sp07,72,MUIR,POLI,PolSc-Intl,0,0,0,0,3,3,4,4,8,9,3,12,10,11,21,0,0,0,23,21,44
sp07,72,MUIR,POLI,PolSc-PLaw,0,0,0,1,2,3,3,1,4,4,3,7,7,1,8,0,0,0,15,7,22
sp07,72,MUIR,POLI,PolSc-PPol,0,0,0,0,0,0,0,0,0,0,0,0,2,0,2,0,0,0,2,0,2
sp07,72,MUIR,POLI,PolSc-Thry,0,0,0,0,0,0,1,0,1,1,1,2,4,0,4,0,0,0,6,1,7
sp07,72,MUIR,PSYC,Psychology,0,0,0,6,20,26,11,36,47,18,70,88,44,117,161,0,0,0,79,243,322
sp07,72,MUIR,RELI,Relig/Stu,0,0,0,1,0,1,1,0,1,1,2,3,2,2,4,0,0,0,5,4,9
sp07,72,MUIR,RUSS,Russ&SovSt,0,0,0,0,0,0,0,0,0,0,1,1,0,1,1,0,0,0,0,2,2
sp07,72,MUIR,SE,Engin Sci,0,0,0,0,0,0,1,0,1,0,0,0,0,0,0,0,0,0,1,0,1
sp07,72,MUIR,SE,Struct Eng,0,0,0,4,2,6,12,5,17,12,3,15,27,4,31,0,0,0,55,14,69
sp07,72,MUIR,SOC,Sociology,0,0,0,1,3,4,1,7,8,3,19,22,10,29,39,0,0,0,15,58,73
sp07,72,MUIR,THEA,Dance,0,0,0,0,0,0,0,0,0,0,2,2,1,3,4,0,0,0,1,5,6
sp07,72,MUIR,THEA,Theatre,0,0,0,2,3,5,2,5,7,5,7,12,10,16,26,0,0,0,19,31,50
sp07,72,MUIR,TWS,ThirdWldSt,0,0,0,0,0,0,0,1,1,0,0,0,0,2,2,0,0,0,0,3,3
sp07,72,MUIR,UNAF,Limited St,0,0,0,0,0,0,0,0,0,0,0,0,0,0,0,1,0,1,1,0,1
sp07,72,MUIR,UNAF,UndecBiolS,0,0,0,5,12,17,15,19,34,1,2,3,0,0,0,0,0,0,21,33,54
sp07,72,MUIR,UNAF,UndecHumAr,0,0,0,2,5,7,6,13,19,1,0,1,0,0,0,0,0,0,9,18,27
sp07,72,MUIR,UNAF,Undeclared,0,0,0,20,49,69,43,52,95,3,5,8,0,0,0,0,0,0,66,106,172
sp07,72,MUIR,UNAF,UndecPhysS,0,0,0,6,5,11,4,2,6,1,0,1,0,0,0,0,0,0,11,7,18
sp07,72,MUIR,UNAF,UndecSocSc,0,0,0,7,4,11,5,22,27,0,0,0,0,0,0,0,0,0,12,26,38
sp07,72,MUIR,USP,Urb Stu&Pl,0,0,0,0,0,0,2,0,2,7,3,10,5,4,9,0,0,0,14,7,21
sp07,72,MUIR,VIS,Art Hst/Cr,0,0,0,0,1,1,0,1,1,0,3,3,1,12,13,0,0,0,1,17,18
sp07,72,MUIR,VIS,Media,0,0,0,3,4,7,7,4,11,5,8,13,11,8,19,0,0,0,26,24,50
sp07,72,MUIR,VIS,Pr-VACmpAr,0,0,0,2,0,2,3,1,4,1,1,2,0,0,0,0,0,0,6,2,8
sp07,72,MUIR,VIS,Studio VA,0,0,0,0,3,3,0,2,2,2,3,5,6,10,16,0,0,0,8,18,26
sp07,72,MUIR,VIS,VA-CompArt,0,0,0,0,0,0,0,0,0,0,1,1,5,0,5,0,0,0,5,1,6
sp07,72,REVELLE,ANTH,Anth-Arch,0,0,0,0,0,0,0,0,0,0,2,2,2,7,9,0,0,0,2,9,11
sp07,72,REVELLE,ANTH,Anth-Biol,0,0,0,0,0,0,0,0,0,1,5,6,0,4,4,0,0,0,1,9,10
sp07,72,REVELLE,ANTH,Anthropol,0,0,0,0,0,0,0,1,1,0,2,2,0,4,4,0,0,0,0,7,7
sp07,72,REVELLE,BENG,Bioen:Binf,0,0,0,0,0,0,0,0,0,0,0,0,1,0,1,0,0,0,1,0,1
sp07,72,REVELLE,BENG,Bioeng:PM,0,0,0,0,0,0,1,0,1,12,2,14,31,15,46,0,0,0,44,17,61
sp07,72,REVELLE,BENG,BioengBiot,0,0,0,1,0,1,2,2,4,8,2,10,17,6,23,0,0,0,28,10,38
sp07,72,REVELLE,BENG,Bioengin,0,0,0,0,0,0,3,8,11,5,3,8,14,6,20,0,0,0,22,17,39
sp07,72,REVELLE,BENG,Pr-BioenBf,0,0,0,0,0,0,0,0,0,1,0,1,2,0,2,0,0,0,3,0,3
sp07,72,REVELLE,BENG,Pr-BioenPM,0,0,0,1,2,3,16,8,24,4,3,7,1,1,2,0,0,0,22,14,36
sp07,72,REVELLE,BIOL,Anml Physl,0,0,0,0,0,0,0,0,0,1,4,5,12,24,36,0,0,0,13,28,41
sp07,72,REVELLE,BIOL,Bioc/CellB,0,0,0,2,10,12,13,19,32,33,32,65,60,85,145,0,0,0,108,146,254
sp07,72,REVELLE,BIOL,Ec/Beh/Evo,0,0,0,0,0,0,1,0,1,0,4,4,9,2,11,0,0,0,10,6,16
sp07,72,REVELLE,BIOL,Genl Biol,0,0,0,2,16,18,12,28,40,23,32,55,36,89,125,0,0,0,73,165,238
sp07,72,REVELLE,BIOL,Human Bio,0,0,0,10,31,41,40,58,98,50,68,118,59,109,168,0,1,1,159,267,426
sp07,72,REVELLE,BIOL,Microbiol,0,0,0,0,2,2,1,4,5,4,2,6,8,8,16,0,0,0,13,16,29
sp07,72,REVELLE,BIOL,Molec Biol,0,0,0,0,1,1,6,1,7,2,10,12,21,22,43,0,0,0,29,34,63
sp07,72,REVELLE,BIOL,PhyslNeuro,0,0,0,4,4,8,5,13,18,7,17,24,5,7,12,0,0,0,21,41,62
sp07,72,REVELLE,BIOL,Pr-BioBinf,0,0,0,0,0,0,0,0,0,1,0,1,0,0,0,0,0,0,1,0,1
sp07,72,REVELLE,CENG,Chem Engin,0,0,0,1,1,2,8,5,13,4,2,6,9,4,13,0,0,0,22,12,34
sp07,72,REVELLE,CGS,CritGendSt,0,0,0,0,1,1,0,0,0,0,0,0,0,2,2,0,0,0,0,3,3
sp07,72,REVELLE,CHEM,Bioch/Chem,0,0,0,4,6,10,4,11,15,14,15,29,25,28,53,0,0,0,47,60,107
sp07,72,REVELLE,CHEM,Chem Phys,0,0,0,0,0,0,0,1,1,1,0,1,2,0,2,0,0,0,3,1,4
sp07,72,REVELLE,CHEM,Chemistry,0,0,0,2,1,3,6,5,11,8,5,13,10,11,21,0,0,0,26,22,48
sp07,72,REVELLE,CHEM,Envir Chem,0,0,0,0,0,0,0,1,1,0,0,0,1,2,3,0,0,0,1,3,4
sp07,72,REVELLE,CHEM,MolecSynth,0,0,0,1,0,1,1,0,1,0,0,0,3,0,3,0,0,0,5,0,5
sp07,72,REVELLE,CHEM,Pharm Chem,0,0,0,1,11,12,10,16,26,8,23,31,17,17,34,0,0,0,36,67,103
sp07,72,REVELLE,CHIN,Chinese St,0,0,0,0,0,0,0,0,0,0,1,1,1,2,3,0,0,0,1,3,4
sp07,72,REVELLE,CLAS,Classic St,0,0,0,0,0,0,0,0,0,0,0,0,0,1,1,0,0,0,0,1,1
sp07,72,REVELLE,COGS,Cog Sci,0,0,0,0,0,0,4,4,8,2,7,9,8,3,11,0,0,0,14,14,28
sp07,72,REVELLE,COGS,CogSc/ClAs,0,0,0,0,0,0,0,0,0,0,0,0,1,2,3,0,0,0,1,2,3
sp07,72,REVELLE,COGS,CogSc/Clin,0,0,0,0,0,0,0,1,1,0,0,0,0,0,0,0,0,0,0,1,1
sp07,72,REVELLE,COGS,CogSc/Comp,0,0,0,0,0,0,0,0,0,0,0,0,1,0,1,0,0,0,1,0,1
sp07,72,REVELLE,COGS,CogSc/HCI,0,0,0,0,0,0,0,0,0,3,0,3,4,5,9,0,0,0,7,5,12
sp07,72,REVELLE,COGS,CogSc/HCog,0,0,0,0,0,0,0,0,0,0,1,1,1,0,1,0,0,0,1,1,2
sp07,72,REVELLE,COGS,CogSc/Neur,0,0,0,0,0,0,1,1,2,1,4,5,7,4,11,0,0,0,9,9,18
sp07,72,REVELLE,COMM,Communic,0,0,0,0,5,5,2,14,16,1,10,11,4,12,16,0,0,0,7,41,48
sp07,72,REVELLE,CSE,Comp Sci,0,0,0,2,0,2,6,1,7,10,0,10,29,4,33,0,0,0,47,5,52
sp07,72,REVELLE,CSE,CompEngCSE,0,0,0,2,1,3,7,1,8,1,1,2,8,0,8,0,0,0,18,3,21
sp07,72,REVELLE,CSE,CompScBinf,0,0,0,0,0,0,0,0,0,0,0,0,6,0,6,0,0,0,6,0,6
sp07,72,REVELLE,ECE,CompEngECE,0,0,0,1,0,1,0,0,0,2,0,2,2,0,2,0,0,0,5,0,5
sp07,72,REVELLE,ECE,Electr Eng,0,0,0,1,0,1,8,0,8,12,1,13,30,4,34,0,0,0,51,5,56
sp07,72,REVELLE,ECE,Engin Phys,0,0,0,0,0,0,0,0,0,1,0,1,3,0,3,0,0,0,4,0,4
sp07,72,REVELLE,ECE,Pr-ElecEng,0,0,0,0,0,0,1,0,1,0,1,1,0,0,0,0,0,0,1,1,2
sp07,72,REVELLE,ECE,Pr-EngPhys,0,0,0,2,0,2,1,0,1,0,0,0,0,0,0,0,0,0,3,0,3
sp07,72,REVELLE,ECON,Ec-Mth&Ecn,0,0,0,0,1,1,2,1,3,1,5,6,4,1,5,0,0,0,7,8,15
sp07,72,REVELLE,ECON,Econ-MgtSc,0,0,0,3,2,5,4,10,14,17,16,33,42,22,64,0,0,0,66,50,116
sp07,72,REVELLE,ECON,Economics,0,0,0,5,1,6,6,9,15,28,16,44,47,27,74,0,0,0,86,53,139
sp07,72,REVELLE,ERTH,Earth Scis,0,0,0,0,0,0,0,1,1,1,0,1,0,1,1,0,0,0,1,2,3
sp07,72,REVELLE,ERTH,ErthSc-Chm,0,0,0,0,0,0,0,0,0,0,0,0,0,1,1,0,0,0,0,1,1
sp07,72,REVELLE,ERTH,ErthSc-Phy,0,0,0,0,0,0,0,0,0,1,0,1,0,0,0,0,0,0,1,0,1
sp07,72,REVELLE,ESYS,EnvSys(EB),0,0,0,0,0,0,0,2,2,0,2,2,3,1,4,0,0,0,3,5,8
sp07,72,REVELLE,ESYS,EnvSys(EC),0,0,0,0,0,0,0,1,1,0,0,0,1,1,2,0,0,0,1,2,3
sp07,72,REVELLE,ESYS,EnvSys(EP),0,0,0,0,0,0,0,0,0,0,3,3,0,1,1,0,0,0,0,4,4
sp07,72,REVELLE,ESYS,EnvSys(ES),0,0,0,0,0,0,1,1,2,2,0,2,1,0,1,0,0,0,4,1,5
sp07,72,REVELLE,ETHN,Ethnic St,0,0,0,0,1,1,0,0,0,0,1,1,0,6,6,0,0,0,0,8,8
sp07,72,REVELLE,HDP,Human Dev,0,0,0,0,0,0,0,0,0,0,2,2,1,22,23,0,0,0,1,24,25
sp07,72,REVELLE,HDP,Pr-HumnDev,0,0,0,0,1,1,0,3,3,1,9,10,0,4,4,0,0,0,1,17,18
sp07,72,REVELLE,HIST,History,0,0,0,3,1,4,4,1,5,5,1,6,9,3,12,0,0,0,21,6,27
sp07,72,REVELLE,INTD,Rev Ind Mj,0,0,0,0,0,0,0,0,0,0,0,0,2,1,3,0,0,0,2,1,3
sp07,72,REVELLE,INTL,IntSt-Anth,0,0,0,0,0,0,0,0,0,1,3,4,0,1,1,0,0,0,1,4,5
sp07,72,REVELLE,INTL,IntSt-Econ,0,0,0,0,1,1,1,3,4,2,4,6,7,6,13,0,0,0,10,14,24
sp07,72,REVELLE,INTL,IntSt-Hist,0,0,0,0,0,0,0,0,0,0,2,2,2,2,4,0,0,0,2,4,6
sp07,72,REVELLE,INTL,IntSt-Ling,0,0,0,0,0,0,0,3,3,1,3,4,0,2,2,0,0,0,1,8,9
sp07,72,REVELLE,INTL,IntSt-Lit,0,0,0,0,0,0,0,0,0,0,2,2,0,0,0,0,0,0,0,2,2
sp07,72,REVELLE,INTL,IntSt-PolS,0,0,0,0,1,1,1,4,5,0,5,5,2,6,8,0,0,0,3,16,19
sp07,72,REVELLE,INTL,IntSt-Soc,0,0,0,0,0,0,0,3,3,0,0,0,1,3,4,0,0,0,1,6,7
sp07,72,REVELLE,JAPN,JapaneseSt,0,0,0,0,0,0,0,0,0,0,0,0,0,1,1,0,0,0,0,1,1
sp07,72,REVELLE,JUDA,Judaic Stu,0,0,0,0,1,1,0,0,0,0,0,0,0,0,0,0,0,0,0,1,1
sp07,72,REVELLE,LATI,LatinAm St,0,0,0,0,0,0,0,0,0,0,0,0,0,1,1,0,0,0,0,1,1
sp07,72,REVELLE,LING,Lang Stu,0,0,0,0,0,0,0,0,0,0,0,0,0,1,1,0,0,0,0,1,1
sp07,72,REVELLE,LING,Ling-CogLn,0,0,0,0,0,0,1,1,2,0,0,0,0,1,1,0,0,0,1,2,3
sp07,72,REVELLE,LING,Linguistcs,0,0,0,0,0,0,0,0,0,0,0,0,1,6,7,0,0,0,1,6,7
sp07,72,REVELLE,LIT,French Lit,0,0,0,0,0,0,0,0,0,0,0,0,0,2,2,0,0,0,0,2,2
sp07,72,REVELLE,LIT,Ital Lit,0,0,0,0,0,0,0,0,0,0,1,1,0,0,0,0,0,0,0,1,1
sp07,72,REVELLE,LIT,Lit/Compos,0,0,0,0,0,0,0,0,0,0,0,0,0,1,1,0,0,0,0,1,1
sp07,72,REVELLE,LIT,Lit/Engl,0,0,0,0,0,0,0,7,7,2,3,5,1,7,8,0,0,0,3,17,20
sp07,72,REVELLE,LIT,Lit/World,0,0,0,0,1,1,0,0,0,0,0,0,1,4,5,0,0,0,1,5,6
sp07,72,REVELLE,LIT,Lit/Writng,0,0,0,0,0,0,0,0,0,2,2,4,3,5,8,0,0,0,5,7,12
sp07,72,REVELLE,LIT,Pre-Lit/Wr,0,0,0,2,0,2,2,2,4,5,2,7,3,2,5,0,0,0,12,6,18
sp07,72,REVELLE,LIT,Spanish Lt,0,0,0,0,0,0,0,0,0,0,2,2,0,2,2,0,0,0,0,4,4
sp07,72,REVELLE,MAE,Aerosp Eng,0,0,0,2,1,3,10,3,13,12,3,15,23,5,28,0,0,0,47,12,59
sp07,72,REVELLE,MAE,Engin Sci,0,0,0,0,0,0,0,0,0,0,0,0,1,0,1,0,0,0,1,0,1
sp07,72,REVELLE,MAE,Envir Eng,0,0,0,0,0,0,0,0,0,1,2,3,1,1,2,0,0,0,2,3,5
sp07,72,REVELLE,MAE,Mech Engin,0,0,0,5,0,5,15,2,17,17,5,22,50,7,57,0,0,0,87,14,101
sp07,72,REVELLE,MATH,Appld Math,0,0,0,0,0,0,3,2,5,2,0,2,2,0,2,0,0,0,7,2,9
sp07,72,REVELLE,MATH,Math/SecEd,0,0,0,0,3,3,0,1,1,0,1,1,1,2,3,0,0,0,1,7,8
sp07,72,REVELLE,MATH,Mathematcs,0,0,0,1,5,6,6,5,11,5,6,11,11,3,14,0,0,0,23,19,42
sp07,72,REVELLE,MATH,Mth-CompSc,0,0,0,0,0,0,0,0,0,1,1,2,5,0,5,0,0,0,6,1,7
sp07,72,REVELLE,MATH,Mth-Mth&Ec,0,0,0,1,1,2,0,1,1,3,1,4,2,3,5,0,0,0,6,6,12
sp07,72,REVELLE,MATH,Mth/ApldSc,0,0,0,0,0,0,1,1,2,1,0,1,0,1,1,0,0,0,2,2,4
sp07,72,REVELLE,MUS,Mu-CompArt,0,0,0,0,0,0,0,0,0,0,0,0,2,0,2,0,0,0,2,0,2
sp07,72,REVELLE,MUS,Music,0,0,0,1,1,2,1,0,1,2,3,5,4,1,5,0,0,0,8,5,13
sp07,72,REVELLE,MUS,Pr-MuCmpAr,0,0,0,0,0,0,1,0,1,4,0,4,1,0,1,0,0,0,6,0,6
sp07,72,REVELLE,PHIL,Philosophy,0,0,0,0,0,0,2,2,4,3,1,4,2,3,5,0,0,0,7,6,13
sp07,72,REVELLE,PHYS,Biophysics,0,0,0,0,0,0,1,2,3,2,0,2,0,0,0,0,0,0,3,2,5
sp07,72,REVELLE,PHYS,Phys/Astro,0,0,0,1,0,1,1,0,1,1,2,3,3,1,4,0,0,0,6,3,9
sp07,72,REVELLE,PHYS,Phys/Mtrls,0,0,0,0,0,0,0,0,0,0,0,0,2,0,2,0,0,0,2,0,2
sp07,72,REVELLE,PHYS,Physics,0,0,0,1,0,1,2,0,2,4,0,4,12,2,14,0,0,0,19,2,21
sp07,72,REVELLE,POLI,Polit Sci,0,0,0,2,3,5,3,6,9,5,9,14,9,13,22,0,0,0,19,31,50
sp07,72,REVELLE,POLI,PolSc-Amer,0,0,0,1,1,2,0,1,1,1,1,2,1,3,4,0,0,0,3,6,9
sp07,72,REVELLE,POLI,PolSc-Comp,0,0,0,0,0,0,0,0,0,1,0,1,0,0,0,0,0,0,1,0,1
sp07,72,REVELLE,POLI,PolSc-Intl,0,0,0,0,0,0,3,1,4,4,1,5,8,5,13,0,0,0,15,7,22
sp07,72,REVELLE,POLI,PolSc-PLaw,0,0,0,0,2,2,2,1,3,3,2,5,1,3,4,0,0,0,6,8,14
sp07,72,REVELLE,POLI,PolSc-PPol,0,0,0,0,0,0,1,0,1,0,0,0,0,0,0,0,0,0,1,0,1
sp07,72,REVELLE,POLI,PolSc-Thry,0,0,0,0,0,0,0,0,0,0,0,0,1,1,2,0,0,0,1,1,2
sp07,72,REVELLE,PSYC,Psychology,0,0,0,3,13,16,4,23,27,14,56,70,35,81,116,0,0,0,56,173,229
sp07,72,REVELLE,RELI,Relig/Stu,0,0,0,0,0,0,0,0,0,0,0,0,0,1,1,0,0,0,0,1,1
sp07,72,REVELLE,SE,Engin Sci,0,0,0,0,0,0,1,0,1,0,0,0,0,0,0,0,0,0,1,0,1
sp07,72,REVELLE,SE,Struct Eng,0,0,0,3,3,6,10,2,12,9,3,12,21,8,29,0,0,0,43,16,59
sp07,72,REVELLE,SOC,Sociology,0,0,0,0,2,2,0,0,0,1,6,7,2,12,14,0,0,0,3,20,23
sp07,72,REVELLE,THEA,Dance,0,0,0,0,0,0,0,0,0,0,0,0,1,1,2,0,0,0,1,1,2
sp07,72,REVELLE,THEA,Theatre,0,0,0,0,0,0,2,4,6,1,1,2,2,2,4,0,0,0,5,7,12
sp07,72,REVELLE,UNAF,Limited St,0,0,0,0,0,0,0,0,0,0,0,0,0,0,0,3,11,14,3,11,14
sp07,72,REVELLE,UNAF,Spec-Emply,0,0,0,0,0,0,0,0,0,0,0,0,0,0,0,2,3,5,2,3,5
sp07,72,REVELLE,UNAF,UndecBiolS,0,0,0,4,10,14,20,21,41,2,0,2,0,0,0,0,0,0,26,31,57
sp07,72,REVELLE,UNAF,UndecHumAr,0,0,0,1,1,2,4,6,10,0,1,1,0,0,0,0,0,0,5,8,13
sp07,72,REVELLE,UNAF,Undeclared,0,0,0,23,22,45,32,33,65,1,3,4,0,1,1,0,0,0,56,59,115
sp07,72,REVELLE,UNAF,UndecPhysS,0,0,0,1,1,2,2,3,5,1,0,1,0,0,0,0,0,0,4,4,8
sp07,72,REVELLE,UNAF,UndecSocSc,0,0,0,2,2,4,5,4,9,0,2,2,0,0,0,0,0,0,7,8,15
sp07,72,REVELLE,USP,Urb Stu&Pl,0,0,0,0,0,0,0,1,1,3,1,4,1,6,7,0,0,0,4,8,12
sp07,72,REVELLE,VIS,Art Hst/Cr,0,0,0,0,0,0,0,1,1,0,1,1,0,6,6,0,0,0,0,8,8
sp07,72,REVELLE,VIS,Media,0,0,0,1,1,2,1,1,2,2,3,5,8,2,10,0,0,0,12,7,19
sp07,72,REVELLE,VIS,Pr-VACmpAr,0,0,0,0,0,0,0,1,1,1,0,1,0,1,1,0,0,0,1,2,3
sp07,72,REVELLE,VIS,Studio VA,0,0,0,0,3,3,1,0,1,2,1,3,0,4,4,0,0,0,3,8,11
sp07,72,REVELLE,VIS,VA-CompArt,0,0,0,0,0,0,0,0,0,0,0,0,0,3,3,0,0,0,0,3,3
sp07,72,ROOSEVELT,ANTH,Anth-Arch,0,0,0,1,1,2,1,1,2,0,2,2,0,2,2,0,0,0,2,6,8
sp07,72,ROOSEVELT,ANTH,Anth-Biol,0,0,0,0,0,0,0,2,2,3,6,9,2,1,3,0,0,0,5,9,14
sp07,72,ROOSEVELT,ANTH,Anthropol,0,0,0,0,4,4,0,4,4,0,6,6,3,1,4,0,0,0,3,15,18
sp07,72,ROOSEVELT,BENG,Bioen:Binf,0,0,0,0,0,0,0,0,0,0,0,0,2,0,2,0,0,0,2,0,2
sp07,72,ROOSEVELT,BENG,Bioeng:PM,0,0,0,0,0,0,0,0,0,0,1,1,10,2,12,0,0,0,10,3,13
sp07,72,ROOSEVELT,BENG,BioengBiot,0,0,0,0,0,0,0,1,1,2,2,4,4,3,7,0,0,0,6,6,12
sp07,72,ROOSEVELT,BENG,Bioengin,0,0,0,0,0,0,1,0,1,4,0,4,3,3,6,0,0,0,8,3,11
sp07,72,ROOSEVELT,BENG,Pr-BioenPM,0,0,0,1,3,4,9,7,16,2,2,4,0,1,1,0,0,0,12,13,25
sp07,72,ROOSEVELT,BIOL,Anml Physl,0,0,0,0,0,0,0,0,0,0,1,1,9,12,21,0,0,0,9,13,22
sp07,72,ROOSEVELT,BIOL,Bioc/CellB,0,0,0,5,2,7,1,12,13,6,15,21,26,41,67,0,0,0,38,70,108
sp07,72,ROOSEVELT,BIOL,BiolBioinf,0,0,0,0,0,0,0,0,0,0,0,0,1,0,1,0,0,0,1,0,1
sp07,72,ROOSEVELT,BIOL,Ec/Beh/Evo,0,0,0,0,0,0,0,1,1,1,4,5,4,5,9,0,0,0,5,10,15
sp07,72,ROOSEVELT,BIOL,Genl Biol,0,0,0,3,0,3,1,12,13,12,21,33,27,37,64,0,0,0,43,70,113
sp07,72,ROOSEVELT,BIOL,Human Bio,0,0,0,5,13,18,11,31,42,17,27,44,22,47,69,0,0,0,55,118,173
sp07,72,ROOSEVELT,BIOL,Microbiol,0,0,0,0,0,0,1,1,2,2,5,7,2,6,8,0,0,0,5,12,17
sp07,72,ROOSEVELT,BIOL,Molec Biol,0,0,0,0,2,2,2,2,4,5,3,8,6,6,12,0,0,0,13,13,26
sp07,72,ROOSEVELT,BIOL,PhyslNeuro,0,0,0,0,2,2,0,5,5,6,8,14,4,2,6,0,0,0,10,17,27
sp07,72,ROOSEVELT,CENG,Chem Engin,0,0,0,1,2,3,0,0,0,2,1,3,2,5,7,0,0,0,5,8,13
sp07,72,ROOSEVELT,CGS,CritGendSt,0,0,0,0,0,0,0,1,1,0,1,1,0,2,2,0,0,0,0,4,4
sp07,72,ROOSEVELT,CHEM,Bioch/Chem,0,0,0,0,4,4,5,9,14,4,5,9,7,6,13,0,0,0,16,24,40
sp07,72,ROOSEVELT,CHEM,Chem Phys,0,0,0,0,0,0,0,0,0,0,0,0,1,0,1,0,0,0,1,0,1
sp07,72,ROOSEVELT,CHEM,Chemistry,0,0,0,2,1,3,0,3,3,0,2,2,1,2,3,0,0,0,3,8,11
sp07,72,ROOSEVELT,CHEM,Chm/ErthSc,0,0,0,0,1,1,0,0,0,0,0,0,0,0,0,0,0,0,0,1,1
sp07,72,ROOSEVELT,CHEM,Envir Chem,0,0,0,0,0,0,0,0,0,1,1,2,0,0,0,0,0,0,1,1,2
sp07,72,ROOSEVELT,CHEM,MolecSynth,0,0,0,0,0,0,0,0,0,1,0,1,0,0,0,0,0,0,1,0,1
sp07,72,ROOSEVELT,CHEM,Pharm Chem,0,0,0,0,5,5,3,4,7,13,1,14,10,14,24,0,0,0,26,24,50
sp07,72,ROOSEVELT,CHIN,Chinese St,0,0,0,1,0,1,1,1,2,1,0,1,4,2,6,0,0,0,7,3,10
sp07,72,ROOSEVELT,CLAS,Classic St,0,0,0,0,0,0,0,0,0,0,0,0,2,0,2,0,0,0,2,0,2
sp07,72,ROOSEVELT,COGS,Cog Sci,0,0,0,0,1,1,1,3,4,2,6,8,4,7,11,0,0,0,7,17,24
sp07,72,ROOSEVELT,COGS,CogSc/ClAs,0,0,0,0,0,0,0,0,0,0,0,0,0,1,1,0,0,0,0,1,1
sp07,72,ROOSEVELT,COGS,CogSc/Comp,0,0,0,0,0,0,0,0,0,0,0,0,2,1,3,0,0,0,2,1,3
sp07,72,ROOSEVELT,COGS,CogSc/HCI,0,0,0,0,0,0,0,0,0,0,0,0,2,3,5,0,0,0,2,3,5
sp07,72,ROOSEVELT,COGS,CogSc/HCog,0,0,0,0,0,0,0,0,0,0,1,1,1,1,2,0,0,0,1,2,3
sp07,72,ROOSEVELT,COGS,CogSc/Neur,0,0,0,0,0,0,0,0,0,4,1,5,4,4,8,0,0,0,8,5,13
sp07,72,ROOSEVELT,COMM,Communic,0,0,0,1,6,7,2,20,22,14,38,52,4,47,51,0,0,0,21,111,132
sp07,72,ROOSEVELT,CSE,Comp Sci,0,0,0,2,1,3,5,2,7,2,1,3,28,5,33,0,0,0,37,9,46
sp07,72,ROOSEVELT,CSE,CompEngCSE,0,0,0,1,0,1,4,0,4,3,2,5,6,1,7,0,0,0,14,3,17
sp07,72,ROOSEVELT,ECE,CompEngECE,0,0,0,0,0,0,0,0,0,0,1,1,2,0,2,0,0,0,2,1,3
sp07,72,ROOSEVELT,ECE,Electr Eng,0,0,0,0,0,0,8,1,9,6,1,7,21,4,25,0,0,0,35,6,41
sp07,72,ROOSEVELT,ECE,Engin Phys,0,0,0,0,0,0,0,0,0,0,0,0,1,0,1,0,0,0,1,0,1
sp07,72,ROOSEVELT,ECON,Ec-Mth&Ecn,0,0,0,0,1,1,2,0,2,2,0,2,8,1,9,0,0,0,12,2,14
sp07,72,ROOSEVELT,ECON,Econ-MgtSc,0,0,0,3,1,4,11,11,22,29,29,58,35,21,56,0,0,0,78,62,140
sp07,72,ROOSEVELT,ECON,Economics,0,0,0,7,4,11,18,14,32,27,32,59,56,29,85,0,0,0,108,79,187
sp07,72,ROOSEVELT,ERTH,Earth Scis,0,0,0,0,1,1,0,0,0,1,0,1,1,0,1,0,0,0,2,1,3
sp07,72,ROOSEVELT,ERTH,ErthSc-Phy,0,0,0,0,0,0,0,1,1,0,0,0,0,0,0,0,0,0,0,1,1
sp07,72,ROOSEVELT,ESYS,EnvSys(EB),0,0,0,0,1,1,2,0,2,0,4,4,3,6,9,0,0,0,5,11,16
sp07,72,ROOSEVELT,ESYS,EnvSys(EC),0,0,0,0,0,0,0,1,1,1,1,2,0,0,0,0,0,0,1,2,3
sp07,72,ROOSEVELT,ESYS,EnvSys(EP),0,0,0,0,0,0,0,0,0,0,1,1,0,2,2,0,0,0,0,3,3
sp07,72,ROOSEVELT,ESYS,EnvSys(ES),0,0,0,0,0,0,0,2,2,0,0,0,1,0,1,0,0,0,1,2,3
sp07,72,ROOSEVELT,ETHN,Ethnic St,0,0,0,0,1,1,0,0,0,0,5,5,3,5,8,0,0,0,3,11,14
sp07,72,ROOSEVELT,GMST,German Stu,0,0,0,0,0,0,1,1,2,0,0,0,1,1,2,0,0,0,2,2,4
sp07,72,ROOSEVELT,HDP,Human Dev,0,0,0,0,0,0,0,0,0,0,5,5,1,16,17,0,0,0,1,21,22
sp07,72,ROOSEVELT,HDP,Pr-HumnDev,0,0,0,1,4,5,0,9,9,0,7,7,1,5,6,0,0,0,2,25,27
sp07,72,ROOSEVELT,HIST,History,0,0,0,1,1,2,5,8,13,14,16,30,26,27,53,0,0,0,46,52,98
sp07,72,ROOSEVELT,INTL,IntSt-Anth,0,0,0,0,1,1,0,3,3,1,7,8,0,6,6,0,0,0,1,17,18
sp07,72,ROOSEVELT,INTL,IntSt-Econ,0,0,0,2,6,8,9,17,26,7,18,25,6,15,21,0,0,0,24,56,80
sp07,72,ROOSEVELT,INTL,IntSt-Hist,0,0,0,0,1,1,1,2,3,1,7,8,3,11,14,0,0,0,5,21,26
sp07,72,ROOSEVELT,INTL,IntSt-Ling,0,0,0,1,2,3,1,4,5,0,6,6,1,4,5,0,0,0,3,16,19
sp07,72,ROOSEVELT,INTL,IntSt-Lit,0,0,0,0,1,1,0,3,3,0,1,1,0,2,2,0,0,0,0,7,7
sp07,72,ROOSEVELT,INTL,IntSt-PolS,0,0,0,2,3,5,5,17,22,12,17,29,13,35,48,0,0,0,32,72,104
sp07,72,ROOSEVELT,INTL,IntSt-Soc,0,0,0,0,3,3,0,17,17,3,17,20,3,22,25,0,0,0,6,59,65
sp07,72,ROOSEVELT,ITAL,Italian St,0,0,0,0,0,0,0,0,0,0,0,0,0,1,1,0,0,0,0,1,1
sp07,72,ROOSEVELT,JAPN,JapaneseSt,0,0,0,0,0,0,1,2,3,0,0,0,3,4,7,0,0,0,4,6,10
sp07,72,ROOSEVELT,JUDA,Judaic Stu,0,0,0,0,1,1,0,0,0,0,0,0,0,1,1,0,0,0,0,2,2
sp07,72,ROOSEVELT,LATI,LatinAm St,0,0,0,0,0,0,1,1,2,0,0,0,0,3,3,0,0,0,1,4,5
sp07,72,ROOSEVELT,LING,Lang Stu,0,0,0,0,0,0,0,0,0,1,0,1,2,2,4,0,0,0,3,2,5
sp07,72,ROOSEVELT,LING,Ling-CogLn,0,0,0,0,0,0,0,0,0,0,0,0,0,1,1,0,0,0,0,1,1
sp07,72,ROOSEVELT,LING,Ling-LSoc,0,0,0,1,0,1,1,1,2,1,2,3,1,0,1,0,0,0,4,3,7
sp07,72,ROOSEVELT,LING,Linguistcs,0,0,0,0,0,0,0,2,2,3,4,7,1,1,2,0,0,0,4,7,11
sp07,72,ROOSEVELT,LIT,French Lit,0,0,0,0,0,0,0,0,0,0,1,1,0,0,0,0,0,0,0,1,1
sp07,72,ROOSEVELT,LIT,Lit/Compos,0,0,0,0,0,0,0,0,0,0,0,0,0,1,1,0,0,0,0,1,1
sp07,72,ROOSEVELT,LIT,Lit/Engl,0,0,0,0,1,1,3,2,5,2,4,6,5,13,18,0,0,0,10,20,30
sp07,72,ROOSEVELT,LIT,Lit/World,0,0,0,0,0,0,0,1,1,0,2,2,2,3,5,0,0,0,2,6,8
sp07,72,ROOSEVELT,LIT,Lit/Writng,0,0,0,0,0,0,0,0,0,1,1,2,7,14,21,0,0,0,8,15,23
sp07,72,ROOSEVELT,LIT,Pre-Lit/Wr,0,0,0,0,3,3,1,3,4,3,7,10,3,5,8,0,0,0,7,18,25
sp07,72,ROOSEVELT,LIT,Spanish Lt,0,0,0,1,0,1,0,0,0,3,2,5,0,1,1,0,0,0,4,3,7
sp07,72,ROOSEVELT,MAE,Aerosp Eng,0,0,0,2,1,3,2,0,2,3,4,7,16,1,17,0,0,0,23,6,29
sp07,72,ROOSEVELT,MAE,Engin Sci,0,0,0,0,1,1,0,0,0,0,0,0,1,0,1,0,0,0,1,1,2
sp07,72,ROOSEVELT,MAE,Envir Eng,0,0,0,0,0,0,0,2,2,1,0,1,0,0,0,0,0,0,1,2,3
sp07,72,ROOSEVELT,MAE,Mech Engin,0,0,0,0,1,1,8,2,10,13,5,18,30,6,36,0,0,0,51,14,65
sp07,72,ROOSEVELT,MATH,Appld Math,0,0,0,0,0,0,0,0,0,0,0,0,1,1,2,0,0,0,1,1,2
sp07,72,ROOSEVELT,MATH,Math/SecEd,0,0,0,0,0,0,0,4,4,0,1,1,1,3,4,0,0,0,1,8,9
sp07,72,ROOSEVELT,MATH,Mathematcs,0,0,0,1,0,1,2,4,6,4,0,4,3,1,4,0,0,0,10,5,15
sp07,72,ROOSEVELT,MATH,Mth-CompSc,0,0,0,0,0,0,0,0,0,0,0,0,2,0,2,0,0,0,2,0,2
sp07,72,ROOSEVELT,MATH,Mth-Mth&Ec,0,0,0,0,1,1,2,1,3,5,3,8,1,1,2,0,0,0,8,6,14
sp07,72,ROOSEVELT,MATH,Mth/ApldSc,0,0,0,0,0,0,1,0,1,0,2,2,1,1,2,0,0,0,2,3,5
sp07,72,ROOSEVELT,MATH,Pr-Math CS,0,0,0,1,0,1,0,0,0,1,1,2,0,0,0,0,0,0,2,1,3
sp07,72,ROOSEVELT,MUS,Mu-CompArt,0,0,0,0,0,0,0,0,0,2,0,2,1,0,1,0,0,0,3,0,3
sp07,72,ROOSEVELT,MUS,Music,0,0,0,1,1,2,0,1,1,0,4,4,2,3,5,0,0,0,3,9,12
sp07,72,ROOSEVELT,MUS,Pr-MuCmpAr,0,0,0,1,0,1,1,0,1,1,0,1,2,0,2,0,0,0,5,0,5
sp07,72,ROOSEVELT,PHIL,Philosophy,0,0,0,0,1,1,0,3,3,1,1,2,6,1,7,0,0,0,7,6,13
sp07,72,ROOSEVELT,PHYS,Biophysics,0,0,0,0,0,0,1,0,1,0,0,0,1,0,1,0,0,0,2,0,2
sp07,72,ROOSEVELT,PHYS,Phys/Astro,0,0,0,2,0,2,1,1,2,1,0,1,1,1,2,0,0,0,5,2,7
sp07,72,ROOSEVELT,PHYS,Phys/Comp,0,0,0,0,0,0,0,0,0,1,0,1,2,0,2,0,0,0,3,0,3
sp07,72,ROOSEVELT,PHYS,Physics,0,0,0,1,0,1,1,0,1,1,0,1,0,0,0,0,0,0,3,0,3
sp07,72,ROOSEVELT,POLI,Polit Sci,0,0,0,1,6,7,14,6,20,14,18,32,20,37,57,0,0,0,49,67,116
sp07,72,ROOSEVELT,POLI,PolSc-Amer,0,0,0,0,0,0,1,3,4,1,7,8,1,4,5,0,0,0,3,14,17
sp07,72,ROOSEVELT,POLI,PolSc-Comp,0,0,0,0,0,0,0,0,0,0,1,1,1,4,5,0,0,0,1,5,6
sp07,72,ROOSEVELT,POLI,PolSc-Intl,0,0,0,1,5,6,7,21,28,14,13,27,16,29,45,0,0,0,38,68,106
sp07,72,ROOSEVELT,POLI,PolSc-PLaw,0,0,0,0,4,4,5,13,18,5,11,16,3,6,9,0,0,0,13,34,47
sp07,72,ROOSEVELT,POLI,PolSc-PPol,0,0,0,0,0,0,1,3,4,1,0,1,1,1,2,0,0,0,3,4,7
sp07,72,ROOSEVELT,POLI,PolSc-Thry,0,0,0,0,0,0,0,0,0,1,0,1,3,2,5,0,0,0,4,2,6
sp07,72,ROOSEVELT,PSYC,Psychology,0,0,0,1,12,13,7,22,29,13,40,53,20,83,103,0,0,0,41,157,198
sp07,72,ROOSEVELT,RELI,Relig/Stu,0,0,0,0,0,0,0,1,1,0,1,1,2,2,4,0,0,0,2,4,6
sp07,72,ROOSEVELT,RUSS,Russ&SovSt,0,0,0,0,0,0,0,1,1,0,0,0,0,0,0,0,0,0,0,1,1
sp07,72,ROOSEVELT,SE,Engin Sci,0,0,0,0,0,0,0,1,1,0,0,0,0,0,0,0,0,0,0,1,1
sp07,72,ROOSEVELT,SE,Struct Eng,0,0,0,4,1,5,3,2,5,6,1,7,19,11,30,0,0,0,32,15,47
sp07,72,ROOSEVELT,SOC,Sociology,0,0,0,1,4,5,0,2,2,5,18,23,6,22,28,0,0,0,12,46,58
sp07,72,ROOSEVELT,THEA,Dance,0,0,0,0,0,0,0,1,1,0,1,1,0,0,0,0,0,0,0,2,2
sp07,72,ROOSEVELT,THEA,Theatre,0,0,0,0,1,1,1,2,3,0,4,4,4,4,8,0,0,0,5,11,16
sp07,72,ROOSEVELT,TWS,ThirdWldSt,0,0,0,0,0,0,0,0,0,1,0,1,0,1,1,0,0,0,1,1,2
sp07,72,ROOSEVELT,UNAF,UndecBiolS,0,0,0,2,8,10,3,12,15,0,2,2,0,0,0,0,0,0,5,22,27
sp07,72,ROOSEVELT,UNAF,UndecHumAr,0,0,0,1,4,5,3,25,28,0,1,1,0,0,0,0,0,0,4,30,34
sp07,72,ROOSEVELT,UNAF,Undeclared,0,0,0,12,23,35,25,39,64,5,2,7,0,0,0,0,0,0,42,64,106
sp07,72,ROOSEVELT,UNAF,UndecPhysS,0,0,0,0,1,1,3,3,6,0,1,1,0,0,0,0,0,0,3,5,8
sp07,72,ROOSEVELT,UNAF,UndecSocSc,0,0,0,1,8,9,9,6,15,2,0,2,0,0,0,0,0,0,12,14,26
sp07,72,ROOSEVELT,USP,Urb Stu&Pl,0,0,0,0,0,0,1,1,2,5,5,10,2,6,8,0,0,0,8,12,20
sp07,72,ROOSEVELT,VIS,Art Hst/Cr,0,0,0,0,0,0,1,2,3,1,2,3,0,8,8,0,0,0,2,12,14
sp07,72,ROOSEVELT,VIS,Media,0,0,0,1,2,3,1,4,5,6,6,12,8,11,19,0,0,0,16,23,39
sp07,72,ROOSEVELT,VIS,Pr-VACmpAr,0,0,0,0,0,0,1,0,1,1,1,2,0,0,0,0,0,0,2,1,3
sp07,72,ROOSEVELT,VIS,Studio VA,0,0,0,0,4,4,0,3,3,1,0,1,4,3,7,0,0,0,5,10,15
sp07,72,SIXTH,ANTH,Anth-Arch,0,0,0,0,0,0,0,0,0,0,1,1,0,1,1,0,0,0,0,2,2
sp07,72,SIXTH,ANTH,Anth-Biol,0,0,0,0,0,0,0,1,1,1,2,3,0,3,3,0,0,0,1,6,7
sp07,72,SIXTH,ANTH,Anthropol,0,0,0,1,0,1,1,0,1,0,3,3,0,2,2,0,0,0,2,5,7
sp07,72,SIXTH,BENG,Bioen:Binf,0,0,0,0,0,0,0,0,0,0,0,0,2,0,2,0,0,0,2,0,2
sp07,72,SIXTH,BENG,Bioeng:PM,0,0,0,0,0,0,0,0,0,0,0,0,10,4,14,0,0,0,10,4,14
sp07,72,SIXTH,BENG,BioengBiot,0,0,0,0,0,0,3,0,3,2,2,4,11,5,16,0,0,0,16,7,23
sp07,72,SIXTH,BENG,Bioengin,0,0,0,1,1,2,2,1,3,4,1,5,9,3,12,0,0,0,16,6,22
sp07,72,SIXTH,BENG,Pr-BioenPM,0,0,0,2,3,5,9,3,12,5,2,7,0,0,0,0,0,0,16,8,24
sp07,72,SIXTH,BIOL,Anml Physl,0,0,0,0,0,0,0,0,0,1,0,1,10,3,13,0,0,0,11,3,14
sp07,72,SIXTH,BIOL,Bioc/CellB,0,0,0,1,4,5,7,9,16,14,9,23,14,17,31,0,0,0,36,39,75
sp07,72,SIXTH,BIOL,BiolBioinf,0,0,0,0,0,0,0,0,0,0,0,0,1,1,2,0,0,0,1,1,2
sp07,72,SIXTH,BIOL,Ec/Beh/Evo,0,0,0,0,1,1,0,1,1,1,1,2,2,2,4,0,0,0,3,5,8
sp07,72,SIXTH,BIOL,Genl Biol,0,0,0,8,4,12,8,10,18,7,11,18,13,17,30,0,0,0,36,42,78
sp07,72,SIXTH,BIOL,Human Bio,0,0,0,8,10,18,15,24,39,15,12,27,21,18,39,0,0,0,59,64,123
sp07,72,SIXTH,BIOL,Microbiol,0,0,0,0,0,0,0,2,2,1,1,2,3,2,5,0,0,0,4,5,9
sp07,72,SIXTH,BIOL,Molec Biol,0,0,0,0,0,0,1,1,2,4,1,5,4,2,6,0,0,0,9,4,13
sp07,72,SIXTH,BIOL,PhyslNeuro,0,0,0,2,4,6,4,1,5,4,3,7,0,1,1,0,0,0,10,9,19
sp07,72,SIXTH,CENG,Chem Engin,0,0,0,2,2,4,4,2,6,3,0,3,5,1,6,0,0,0,14,5,19
sp07,72,SIXTH,CGS,CritGendSt,0,0,0,0,0,0,0,0,0,0,0,0,0,1,1,0,0,0,0,1,1
sp07,72,SIXTH,CHEM,Bioch/Chem,0,0,0,2,2,4,2,5,7,6,6,12,8,6,14,0,0,0,18,19,37
sp07,72,SIXTH,CHEM,Chem Educ,0,0,0,0,0,0,0,0,0,0,0,0,1,0,1,0,0,0,1,0,1
sp07,72,SIXTH,CHEM,Chem Phys,0,0,0,0,0,0,1,0,1,0,0,0,1,0,1,0,0,0,2,0,2
sp07,72,SIXTH,CHEM,Chemistry,0,0,0,2,1,3,2,2,4,3,2,5,3,3,6,0,0,0,10,8,18
sp07,72,SIXTH,CHEM,Envir Chem,0,0,0,0,0,0,0,0,0,0,0,0,1,1,2,0,0,0,1,1,2
sp07,72,SIXTH,CHEM,MolecSynth,0,0,0,0,0,0,0,0,0,0,0,0,1,1,2,0,0,0,1,1,2
sp07,72,SIXTH,CHEM,Pharm Chem,0,0,0,2,4,6,3,7,10,4,6,10,8,5,13,0,0,0,17,22,39
sp07,72,SIXTH,CHIN,Chinese St,0,0,0,0,0,0,0,0,0,0,0,0,0,2,2,0,0,0,0,2,2
sp07,72,SIXTH,CLAS,Classic St,0,0,0,0,0,0,0,0,0,0,0,0,0,1,1,0,0,0,0,1,1
sp07,72,SIXTH,COGS,Cog Sci,0,0,0,0,2,2,3,1,4,3,2,5,6,3,9,0,0,0,12,8,20
sp07,72,SIXTH,COGS,CogSc/ClAs,0,0,0,0,0,0,0,0,0,0,0,0,2,1,3,0,0,0,2,1,3
sp07,72,SIXTH,COGS,CogSc/Comp,0,0,0,1,0,1,0,0,0,1,0,1,2,0,2,0,0,0,4,0,4
sp07,72,SIXTH,COGS,CogSc/HCI,0,0,0,1,0,1,0,0,0,1,1,2,6,0,6,0,0,0,8,1,9
sp07,72,SIXTH,COGS,CogSc/HCog,0,0,0,0,0,0,0,0,0,1,0,1,1,1,2,0,0,0,2,1,3
sp07,72,SIXTH,COGS,CogSc/Neur,0,0,0,0,0,0,0,3,3,2,1,3,2,4,6,0,0,0,4,8,12
sp07,72,SIXTH,COMM,Communic,0,0,0,3,11,14,6,13,19,14,25,39,11,25,36,0,0,0,34,74,108
sp07,72,SIXTH,CSE,Comp Sci,0,0,0,7,3,10,12,5,17,10,1,11,29,7,36,0,0,0,58,16,74
sp07,72,SIXTH,CSE,CompEngCSE,0,0,0,4,1,5,9,2,11,6,2,8,19,0,19,0,0,0,38,5,43
sp07,72,SIXTH,CSE,CompScBinf,0,0,0,0,0,0,0,0,0,0,0,0,0,1,1,0,0,0,0,1,1
sp07,72,SIXTH,ECE,CompEngECE,0,0,0,2,0,2,3,1,4,2,0,2,1,0,1,0,0,0,8,1,9
sp07,72,SIXTH,ECE,Electr Eng,0,0,0,10,1,11,8,3,11,7,3,10,30,0,30,0,0,0,55,7,62
sp07,72,SIXTH,ECE,Engin Phys,0,0,0,0,0,0,0,0,0,1,0,1,2,0,2,0,0,0,3,0,3
sp07,72,SIXTH,ECE,Pr-EngPhys,0,0,0,0,0,0,1,1,2,2,0,2,1,0,1,0,0,0,4,1,5
sp07,72,SIXTH,ECON,Ec-Mth&Ecn,0,0,0,2,0,2,1,1,2,3,0,3,3,1,4,0,0,0,9,2,11
sp07,72,SIXTH,ECON,Econ-MgtSc,0,0,0,6,4,10,12,6,18,26,9,35,25,21,46,0,0,0,69,40,109
sp07,72,SIXTH,ECON,Economics,0,0,0,8,4,12,17,13,30,27,14,41,33,21,54,0,0,0,85,52,137
sp07,72,SIXTH,ERTH,Earth Scis,0,0,0,0,0,0,0,0,0,1,0,1,0,0,0,0,0,0,1,0,1
sp07,72,SIXTH,ERTH,ErthSc-Phy,0,0,0,0,1,1,0,0,0,0,0,0,0,0,0,0,0,0,0,1,1
sp07,72,SIXTH,ESYS,EnvSys(EB),0,0,0,0,1,1,1,1,2,0,2,2,0,2,2,0,0,0,1,6,7
sp07,72,SIXTH,ESYS,EnvSys(EC),0,0,0,0,0,0,0,0,0,1,0,1,1,0,1,0,0,0,2,0,2
sp07,72,SIXTH,ESYS,EnvSys(EP),0,0,0,0,0,0,0,2,2,1,1,2,1,0,1,0,0,0,2,3,5
sp07,72,SIXTH,ESYS,EnvSys(ES),0,0,0,0,0,0,0,1,1,1,0,1,0,0,0,0,0,0,1,1,2
sp07,72,SIXTH,ETHN,Ethnic St,0,0,0,0,0,0,1,2,3,0,2,2,3,2,5,0,0,0,4,6,10
sp07,72,SIXTH,GMST,German Stu,0,0,0,0,0,0,0,0,0,0,0,0,0,1,1,0,0,0,0,1,1
sp07,72,SIXTH,HDP,Human Dev,0,0,0,0,0,0,0,0,0,0,2,2,0,7,7,0,0,0,0,9,9
sp07,72,SIXTH,HDP,Pr-HumnDev,0,0,0,0,4,4,1,2,3,0,5,5,0,1,1,0,0,0,1,12,13
sp07,72,SIXTH,HIST,History,0,0,0,2,0,2,0,3,3,2,0,2,11,6,17,0,0,0,15,9,24
sp07,72,SIXTH,INTL,IntSt-Anth,0,0,0,0,0,0,1,0,1,1,1,2,1,1,2,0,0,0,3,2,5
sp07,72,SIXTH,INTL,IntSt-Econ,0,0,0,3,2,5,3,3,6,2,3,5,3,11,14,0,0,0,11,19,30
sp07,72,SIXTH,INTL,IntSt-Hist,0,0,0,0,0,0,0,0,0,0,0,0,1,0,1,0,0,0,1,0,1
sp07,72,SIXTH,INTL,IntSt-Ling,0,0,0,0,0,0,1,1,2,0,1,1,1,3,4,0,0,0,2,5,7
sp07,72,SIXTH,INTL,IntSt-PolS,0,0,0,0,2,2,3,3,6,0,1,1,4,7,11,0,0,0,7,13,20
sp07,72,SIXTH,INTL,IntSt-Soc,0,0,0,0,1,1,0,1,1,1,2,3,0,4,4,0,0,0,1,8,9
sp07,72,SIXTH,JAPN,JapaneseSt,0,0,0,2,0,2,0,0,0,1,0,1,2,0,2,0,0,0,5,0,5
sp07,72,SIXTH,JUDA,Judaic Stu,0,0,0,0,0,0,0,0,0,0,0,0,1,0,1,0,0,0,1,0,1
sp07,72,SIXTH,LATI,LatinAm St,0,0,0,0,0,0,0,0,0,0,0,0,0,2,2,0,0,0,0,2,2
sp07,72,SIXTH,LING,Lang Stu,0,0,0,0,0,0,0,1,1,0,0,0,1,2,3,0,0,0,1,3,4
sp07,72,SIXTH,LING,Ling-CogLn,0,0,0,0,0,0,0,0,0,0,0,0,0,1,1,0,0,0,0,1,1
sp07,72,SIXTH,LING,Ling-LSoc,0,0,0,0,0,0,0,0,0,0,0,0,0,1,1,0,0,0,0,1,1
sp07,72,SIXTH,LING,Linguistcs,0,0,0,0,0,0,0,0,0,1,2,3,1,2,3,0,0,0,2,4,6
sp07,72,SIXTH,LIT,Lit/Engl,0,0,0,0,0,0,2,1,3,1,0,1,1,2,3,0,0,0,4,3,7
sp07,72,SIXTH,LIT,Lit/Writng,0,0,0,0,0,0,0,0,0,0,1,1,2,7,9,0,0,0,2,8,10
sp07,72,SIXTH,LIT,Pre-Lit/Wr,0,0,0,1,4,5,2,4,6,1,6,7,1,0,1,0,0,0,5,14,19
sp07,72,SIXTH,LIT,Spanish Lt,0,0,0,0,0,0,0,0,0,1,1,2,0,1,1,0,0,0,1,2,3
sp07,72,SIXTH,MAE,Aerosp Eng,0,0,0,6,0,6,14,2,16,8,1,9,14,6,20,0,0,0,42,9,51
sp07,72,SIXTH,MAE,Engin Sci,0,0,0,0,0,0,0,0,0,0,0,0,2,0,2,0,0,0,2,0,2
sp07,72,SIXTH,MAE,Envir Eng,0,0,0,0,1,1,0,1,1,0,0,0,0,1,1,0,0,0,0,3,3
sp07,72,SIXTH,MAE,Mech Engin,0,0,0,10,2,12,23,5,28,18,3,21,33,4,37,0,0,0,84,14,98
sp07,72,SIXTH,MATH,Appld Math,0,0,0,2,0,2,0,0,0,1,0,1,0,4,4,0,0,0,3,4,7
sp07,72,SIXTH,MATH,Math/SecEd,0,0,0,1,0,1,0,0,0,1,2,3,0,1,1,0,0,0,2,3,5
sp07,72,SIXTH,MATH,Mathematcs,0,0,0,2,1,3,1,1,2,1,1,2,2,3,5,0,0,0,6,6,12
sp07,72,SIXTH,MATH,Mth-CompSc,0,0,0,0,0,0,0,0,0,1,0,1,1,0,1,0,0,0,2,0,2
sp07,72,SIXTH,MATH,Mth-Mth&Ec,0,0,0,1,2,3,0,1,1,0,0,0,1,0,1,0,0,0,2,3,5
sp07,72,SIXTH,MATH,Mth-SciCom,0,0,0,0,0,0,1,0,1,0,0,0,1,0,1,0,0,0,2,0,2
sp07,72,SIXTH,MATH,Mth/ApldSc,0,0,0,0,0,0,0,0,0,0,0,0,1,0,1,0,0,0,1,0,1
sp07,72,SIXTH,MATH,Pr-Math CS,0,0,0,0,0,0,1,0,1,1,0,1,0,0,0,0,0,0,2,0,2
sp07,72,SIXTH,MUS,Mu-CompArt,0,0,0,0,0,0,0,0,0,0,1,1,3,0,3,0,0,0,3,1,4
sp07,72,SIXTH,MUS,Music,0,0,0,0,0,0,0,4,4,0,2,2,4,0,4,0,0,0,4,6,10
sp07,72,SIXTH,MUS,Pr-MuCmpAr,0,0,0,0,1,1,1,1,2,2,1,3,1,0,1,0,0,0,4,3,7
sp07,72,SIXTH,PHIL,Philosophy,0,0,0,0,0,0,0,1,1,3,3,6,6,1,7,0,0,0,9,5,14
sp07,72,SIXTH,PHYS,Biophysics,0,0,0,0,0,0,1,1,2,1,1,2,0,1,1,0,0,0,2,3,5
sp07,72,SIXTH,PHYS,Phy/ErthSc,0,0,0,0,0,0,0,0,0,0,0,0,1,0,1,0,0,0,1,0,1
sp07,72,SIXTH,PHYS,Phys/Astro,0,0,0,1,0,1,0,0,0,0,0,0,3,1,4,0,0,0,4,1,5
sp07,72,SIXTH,PHYS,Phys/Mtrls,0,0,0,0,0,0,0,0,0,2,0,2,0,0,0,0,0,0,2,0,2
sp07,72,SIXTH,PHYS,Physics,0,0,0,1,0,1,5,0,5,1,1,2,6,1,7,0,0,0,13,2,15
sp07,72,SIXTH,POLI,Polit Sci,0,0,0,1,0,1,5,5,10,2,5,7,5,7,12,0,0,0,13,17,30
sp07,72,SIXTH,POLI,PolSc-Amer,0,0,0,1,0,1,1,0,1,1,0,1,0,1,1,0,0,0,3,1,4
sp07,72,SIXTH,POLI,PolSc-Intl,0,0,0,1,1,2,4,3,7,3,6,9,4,3,7,0,0,0,12,13,25
sp07,72,SIXTH,POLI,PolSc-PLaw,0,0,0,1,1,2,2,5,7,3,0,3,3,2,5,0,0,0,9,8,17
sp07,72,SIXTH,POLI,PolSc-PPol,0,0,0,0,0,0,0,1,1,3,0,3,1,0,1,0,0,0,4,1,5
sp07,72,SIXTH,POLI,PolSc-Thry,0,0,0,1,0,1,1,0,1,0,0,0,0,0,0,0,0,0,2,0,2
sp07,72,SIXTH,PSYC,Psychology,0,0,0,3,9,12,7,14,21,9,21,30,16,29,45,0,0,0,35,73,108
sp07,72,SIXTH,RELI,Relig/Stu,0,0,0,0,0,0,0,0,0,1,1,2,0,1,1,0,0,0,1,2,3
sp07,72,SIXTH,SE,Engin Sci,0,0,0,0,1,1,2,0,2,0,0,0,0,0,0,0,0,0,2,1,3
sp07,72,SIXTH,SE,Struct Eng,0,0,0,9,4,13,11,6,17,4,5,9,19,8,27,0,0,0,43,23,66
sp07,72,SIXTH,SOC,Sociology,0,0,0,0,3,3,1,2,3,2,8,10,3,10,13,0,0,0,6,23,29
sp07,72,SIXTH,THEA,Dance,0,0,0,0,0,0,0,3,3,0,2,2,2,1,3,0,0,0,2,6,8
sp07,72,SIXTH,THEA,Theatre,0,0,0,0,3,3,0,4,4,2,4,6,3,7,10,0,0,0,5,18,23
sp07,72,SIXTH,TWS,ThirdWldSt,0,0,0,0,1,1,0,0,0,0,2,2,0,0,0,0,0,0,0,3,3
sp07,72,SIXTH,UNAF,UndecBiolS,0,0,0,1,3,4,13,8,21,1,1,2,0,0,0,0,0,0,15,12,27
sp07,72,SIXTH,UNAF,UndecHumAr,0,0,0,1,7,8,3,7,10,1,0,1,0,0,0,0,0,0,5,14,19
sp07,72,SIXTH,UNAF,Undeclared,0,0,0,20,22,42,28,27,55,3,3,6,0,0,0,0,0,0,51,52,103
sp07,72,SIXTH,UNAF,UndecPhysS,0,0,0,3,1,4,2,1,3,0,0,0,0,0,0,0,0,0,5,2,7
sp07,72,SIXTH,UNAF,UndecSocSc,0,0,0,3,4,7,4,4,8,0,0,0,0,0,0,0,0,0,7,8,15
sp07,72,SIXTH,USP,Urb Stu&Pl,0,0,0,0,0,0,1,2,3,0,3,3,1,7,8,0,0,0,2,12,14
sp07,72,SIXTH,VIS,Art Hst/Cr,0,0,0,0,0,0,0,1,1,1,7,8,1,5,6,0,0,0,2,13,15
sp07,72,SIXTH,VIS,Media,0,0,0,5,6,11,6,9,15,20,7,27,20,14,34,0,0,0,51,36,87
sp07,72,SIXTH,VIS,Pr-VACmpAr,0,0,0,1,0,1,7,4,11,2,2,4,1,0,1,0,0,0,11,6,17
sp07,72,SIXTH,VIS,Studio VA,0,0,0,0,0,0,0,0,0,3,8,11,4,8,12,0,0,0,7,16,23
sp07,72,SIXTH,VIS,VA-CompArt,0,0,0,0,0,0,0,0,0,1,2,3,11,6,17,0,0,0,12,8,20
sp07,72,WARREN,ANTH,Anth-Arch,0,0,0,0,0,0,0,0,0,0,2,2,1,3,4,0,0,0,1,5,6
sp07,72,WARREN,ANTH,Anth-Biol,0,0,0,1,0,1,0,1,1,0,4,4,2,4,6,0,0,0,3,9,12
sp07,72,WARREN,ANTH,Anthropol,0,0,0,0,0,0,0,0,0,2,7,9,3,7,10,0,0,0,5,14,19
sp07,72,WARREN,BENG,Bioen:Binf,0,0,0,0,0,0,0,0,0,0,0,0,3,0,3,0,0,0,3,0,3
sp07,72,WARREN,BENG,Bioeng:PM,0,0,0,0,0,0,0,0,0,3,1,4,19,12,31,0,0,0,22,13,35
sp07,72,WARREN,BENG,BioengBiot,0,0,0,4,2,6,9,2,11,7,4,11,29,16,45,0,0,0,49,24,73
sp07,72,WARREN,BENG,Bioengin,0,0,0,0,2,2,4,5,9,12,6,18,18,8,26,0,0,0,34,21,55
sp07,72,WARREN,BENG,Pr-BioenBf,0,0,0,0,0,0,0,0,0,1,0,1,0,1,1,0,0,0,1,1,2
sp07,72,WARREN,BENG,Pr-BioenPM,0,0,0,5,7,12,23,9,32,10,2,12,4,0,4,0,0,0,42,18,60
sp07,72,WARREN,BIOL,Anml Physl,0,0,0,0,0,0,0,0,0,1,1,2,10,14,24,0,0,0,11,15,26
sp07,72,WARREN,BIOL,Bioc/CellB,0,0,0,2,3,5,11,8,19,22,25,47,48,81,129,0,0,0,83,117,200
sp07,72,WARREN,BIOL,Ec/Beh/Evo,0,0,0,0,1,1,0,0,0,1,2,3,1,8,9,0,0,0,2,11,13
sp07,72,WARREN,BIOL,Genl Biol,0,0,0,4,4,8,7,9,16,32,33,65,50,79,129,0,1,1,93,126,219
sp07,72,WARREN,BIOL,Human Bio,0,0,0,8,12,20,24,46,70,35,54,89,54,81,135,0,0,0,121,193,314
sp07,72,WARREN,BIOL,Microbiol,0,0,0,0,1,1,2,1,3,1,1,2,8,7,15,0,0,0,11,10,21
sp07,72,WARREN,BIOL,Molec Biol,0,0,0,0,0,0,5,5,10,5,6,11,10,9,19,0,0,0,20,20,40
sp07,72,WARREN,BIOL,PhyslNeuro,0,0,0,6,0,6,4,4,8,10,8,18,7,5,12,0,0,0,27,17,44
sp07,72,WARREN,CENG,Chem Engin,0,0,0,1,2,3,7,4,11,8,3,11,16,5,21,0,0,0,32,14,46
sp07,72,WARREN,CHEM,Bioch/Chem,0,0,0,4,5,9,8,8,16,11,20,31,23,25,48,0,0,0,46,58,104
sp07,72,WARREN,CHEM,Chem Educ,0,0,0,0,0,0,0,0,0,1,0,1,0,1,1,0,0,0,1,1,2
sp07,72,WARREN,CHEM,Chem Phys,0,0,0,0,0,0,0,0,0,0,0,0,0,1,1,0,0,0,0,1,1
sp07,72,WARREN,CHEM,Chemistry,0,0,0,1,2,3,7,3,10,3,4,7,9,5,14,0,0,0,20,14,34
sp07,72,WARREN,CHEM,Envir Chem,0,0,0,0,0,0,0,0,0,0,0,0,2,1,3,0,0,0,2,1,3
sp07,72,WARREN,CHEM,MolecSynth,0,0,0,0,0,0,0,0,0,1,0,1,0,2,2,0,0,0,1,2,3
sp07,72,WARREN,CHEM,Pharm Chem,0,0,0,3,5,8,7,8,15,11,17,28,19,31,50,0,0,0,40,61,101
sp07,72,WARREN,CHIN,Chinese St,0,0,0,0,0,0,0,0,0,0,1,1,2,2,4,0,0,0,2,3,5
sp07,72,WARREN,CLAS,Classic St,0,0,0,0,0,0,0,0,0,1,0,1,0,0,0,0,0,0,1,0,1
sp07,72,WARREN,COGS,Cog Sci,0,0,0,0,2,2,1,3,4,0,1,1,8,5,13,0,0,0,9,11,20
sp07,72,WARREN,COGS,CogSc/ClAs,0,0,0,0,1,1,0,0,0,0,0,0,0,0,0,0,0,0,0,1,1
sp07,72,WARREN,COGS,CogSc/Comp,0,0,0,0,0,0,0,0,0,0,0,0,2,0,2,0,0,0,2,0,2
sp07,72,WARREN,COGS,CogSc/HCI,0,0,0,0,0,0,0,0,0,0,0,0,5,3,8,0,0,0,5,3,8
sp07,72,WARREN,COGS,CogSc/HCog,0,0,0,0,0,0,0,0,0,0,1,1,1,1,2,0,0,0,1,2,3
sp07,72,WARREN,COGS,CogSc/Neur,0,0,0,0,0,0,0,1,1,0,0,0,7,5,12,0,0,0,7,6,13
sp07,72,WARREN,COMM,Communic,0,0,0,4,13,17,3,15,18,12,32,44,16,44,60,0,0,0,35,104,139
sp07,72,WARREN,CSE,Comp Sci,0,0,0,7,2,9,20,4,24,17,3,20,61,9,70,0,0,0,105,18,123
sp07,72,WARREN,CSE,CompEngCSE,0,0,0,11,2,13,6,0,6,10,1,11,15,5,20,0,0,0,42,8,50
sp07,72,WARREN,CSE,CompScBinf,0,0,0,0,0,0,0,0,0,0,0,0,6,0,6,0,0,0,6,0,6
sp07,72,WARREN,ECE,CompEngECE,0,0,0,1,0,1,4,0,4,4,0,4,6,2,8,0,0,0,15,2,17
sp07,72,WARREN,ECE,Electr Eng,0,0,0,2,0,2,23,1,24,23,4,27,75,12,87,0,0,0,123,17,140
sp07,72,WARREN,ECE,Engin Phys,0,0,0,0,0,0,0,0,0,1,0,1,1,1,2,0,0,0,2,1,3
sp07,72,WARREN,ECE,Pr-ElecEng,0,0,0,0,0,0,0,0,0,2,0,2,0,0,0,0,0,0,2,0,2
sp07,72,WARREN,ECE,Pr-EngPhys,0,0,0,0,0,0,2,1,3,0,0,0,1,0,1,0,0,0,3,1,4
sp07,72,WARREN,ECON,Ec-Mth&Ecn,0,0,0,0,2,2,3,3,6,0,0,0,8,2,10,0,0,0,11,7,18
sp07,72,WARREN,ECON,Econ-MgtSc,0,0,0,4,3,7,13,15,28,29,23,52,49,37,86,0,0,0,95,78,173
sp07,72,WARREN,ECON,Economics,0,0,0,6,4,10,17,15,32,56,22,78,75,31,106,0,0,0,154,72,226
sp07,72,WARREN,ERTH,Earth Scis,0,0,0,0,0,0,0,0,0,0,0,0,1,0,1,0,0,0,1,0,1
sp07,72,WARREN,ERTH,ErthSc-Phy,0,0,0,0,0,0,0,0,0,0,0,0,1,0,1,0,0,0,1,0,1
sp07,72,WARREN,ESYS,EnvSys(EB),0,0,0,0,0,0,0,0,0,1,1,2,0,2,2,0,0,0,1,3,4
sp07,72,WARREN,ESYS,EnvSys(EC),0,0,0,0,0,0,0,0,0,0,0,0,1,2,3,0,0,0,1,2,3
sp07,72,WARREN,ESYS,EnvSys(EP),0,0,0,0,0,0,0,1,1,0,0,0,0,1,1,0,0,0,0,2,2
sp07,72,WARREN,ESYS,EnvSys(ES),0,0,0,0,0,0,0,0,0,1,1,2,0,3,3,0,0,0,1,4,5
sp07,72,WARREN,ETHN,Ethnic St,0,0,0,0,0,0,0,0,0,0,0,0,2,2,4,0,0,0,2,2,4
sp07,72,WARREN,GMST,German Stu,0,0,0,0,0,0,0,0,0,0,0,0,1,0,1,0,0,0,1,0,1
sp07,72,WARREN,HDP,Human Dev,0,0,0,0,0,0,0,0,0,0,4,4,2,14,16,0,0,0,2,18,20
sp07,72,WARREN,HDP,Pr-HumnDev,0,0,0,0,0,0,0,8,8,1,7,8,2,4,6,0,0,0,3,19,22
sp07,72,WARREN,HIST,History,0,0,0,1,0,1,3,2,5,4,9,13,26,19,45,0,0,0,34,30,64
sp07,72,WARREN,INTD,Wa Ind St,0,0,0,0,0,0,0,0,0,0,1,1,3,0,3,0,0,0,3,1,4
sp07,72,WARREN,INTL,IntSt-Anth,0,0,0,0,0,0,0,0,0,1,0,1,0,0,0,0,0,0,1,0,1
sp07,72,WARREN,INTL,IntSt-Econ,0,0,0,1,2,3,1,5,6,4,5,9,5,8,13,0,0,0,11,20,31
sp07,72,WARREN,INTL,IntSt-Hist,0,0,0,0,0,0,0,0,0,0,3,3,4,5,9,0,0,0,4,8,12
sp07,72,WARREN,INTL,IntSt-Ling,0,0,0,0,0,0,0,0,0,1,0,1,0,1,1,0,0,0,1,1,2
sp07,72,WARREN,INTL,IntSt-PolS,0,0,0,0,1,1,1,3,4,2,6,8,5,6,11,0,0,0,8,16,24
sp07,72,WARREN,INTL,IntSt-Soc,0,0,0,1,0,1,0,3,3,1,3,4,0,1,1,0,0,0,2,7,9
sp07,72,WARREN,JAPN,JapaneseSt,0,0,0,0,0,0,0,0,0,2,2,4,3,1,4,0,0,0,5,3,8
sp07,72,WARREN,LATI,LatinAm St,0,0,0,0,0,0,0,0,0,0,0,0,0,2,2,0,0,0,0,2,2
sp07,72,WARREN,LING,Lang Stu,0,0,0,0,0,0,0,0,0,0,0,0,1,1,2,0,0,0,1,1,2
sp07,72,WARREN,LING,Ling-CogLn,0,0,0,0,0,0,0,0,0,0,0,0,2,1,3,0,0,0,2,1,3
sp07,72,WARREN,LING,Ling-LSoc,0,0,0,0,0,0,0,0,0,0,1,1,0,1,1,0,0,0,0,2,2
sp07,72,WARREN,LING,Linguistcs,0,0,0,0,0,0,0,0,0,1,1,2,1,2,3,0,0,0,2,3,5
sp07,72,WARREN,LIT,Lit/Compos,0,0,0,0,0,0,0,0,0,0,0,0,0,1,1,0,0,0,0,1,1
sp07,72,WARREN,LIT,Lit/Engl,0,0,0,1,0,1,0,1,1,0,5,5,3,6,9,0,0,0,4,12,16
sp07,72,WARREN,LIT,Lit/World,0,0,0,0,0,0,0,1,1,0,1,1,2,2,4,0,0,0,2,4,6
sp07,72,WARREN,LIT,Lit/Writng,0,0,0,0,0,0,0,0,0,0,0,0,3,9,12,0,0,0,3,9,12
sp07,72,WARREN,LIT,Pre-Lit/Wr,0,0,0,0,0,0,2,2,4,1,2,3,0,2,2,0,0,0,3,6,9
sp07,72,WARREN,LIT,Spanish Lt,0,0,0,0,0,0,0,1,1,0,1,1,2,2,4,0,0,0,2,4,6
sp07,72,WARREN,MAE,Aerosp Eng,0,0,0,4,2,6,14,1,15,19,2,21,48,9,57,0,0,0,85,14,99
sp07,72,WARREN,MAE,Engin Sci,0,0,0,0,0,0,1,0,1,0,0,0,3,1,4,0,0,0,4,1,5
sp07,72,WARREN,MAE,Envir Eng,0,0,0,1,1,2,0,0,0,1,1,2,1,1,2,0,0,0,3,3,6
sp07,72,WARREN,MAE,Mech Engin,0,0,0,10,1,11,28,3,31,43,5,48,120,12,132,0,0,0,201,21,222
sp07,72,WARREN,MATH,Appld Math,0,0,0,0,1,1,0,3,3,2,3,5,4,0,4,0,0,0,6,7,13
sp07,72,WARREN,MATH,Math/SecEd,0,0,0,0,0,0,1,2,3,0,3,3,0,5,5,0,0,0,1,10,11
sp07,72,WARREN,MATH,Mathematcs,0,0,0,0,1,1,1,0,1,9,3,12,10,5,15,0,0,0,20,9,29
sp07,72,WARREN,MATH,Mth-CompSc,0,0,0,0,0,0,0,0,0,0,0,0,8,0,8,0,0,0,8,0,8
sp07,72,WARREN,MATH,Mth-Mth&Ec,0,0,0,2,0,2,1,1,2,2,2,4,6,4,10,0,0,0,11,7,18
sp07,72,WARREN,MATH,Mth-SciCom,0,0,0,0,0,0,1,0,1,1,1,2,0,2,2,0,0,0,2,3,5
sp07,72,WARREN,MATH,Mth/ApldSc,0,0,0,0,1,1,0,1,1,0,0,0,1,2,3,0,0,0,1,4,5
sp07,72,WARREN,MATH,Pr-Math CS,0,0,0,0,0,0,2,0,2,2,0,2,1,0,1,0,0,0,5,0,5
sp07,72,WARREN,MATH,Prob&Stats,0,0,0,0,0,0,0,0,0,1,0,1,1,0,1,0,0,0,2,0,2
sp07,72,WARREN,MUS,Mu-CompArt,0,0,0,0,0,0,0,0,0,0,1,1,4,3,7,0,0,0,4,4,8
sp07,72,WARREN,MUS,Music,0,0,0,0,0,0,1,0,1,4,0,4,13,0,13,0,0,0,18,0,18
sp07,72,WARREN,MUS,Music Hum,0,0,0,0,0,0,0,0,0,0,0,0,1,0,1,0,0,0,1,0,1
sp07,72,WARREN,MUS,Pr-MuCmpAr,0,0,0,0,1,1,1,1,2,2,1,3,0,0,0,0,0,0,3,3,6
sp07,72,WARREN,PHIL,Philosophy,0,0,0,1,0,1,1,0,1,6,4,10,10,3,13,0,0,0,18,7,25
sp07,72,WARREN,PHYS,Biophysics,0,0,0,0,0,0,0,1,1,3,0,3,1,0,1,0,0,0,4,1,5
sp07,72,WARREN,PHYS,Gen Physcs,0,0,0,0,0,0,1,0,1,0,0,0,2,0,2,0,0,0,3,0,3
sp07,72,WARREN,PHYS,Phys/Astro,0,0,0,1,0,1,2,0,2,3,0,3,4,2,6,0,0,0,10,2,12
sp07,72,WARREN,PHYS,Phys/Comp,0,0,0,0,0,0,0,0,0,1,0,1,2,0,2,0,0,0,3,0,3
sp07,72,WARREN,PHYS,Physics,0,0,0,2,1,3,2,1,3,8,0,8,6,4,10,0,0,0,18,6,24
sp07,72,WARREN,POLI,Polit Sci,0,0,0,4,2,6,6,8,14,22,18,40,30,20,50,0,0,0,62,48,110
sp07,72,WARREN,POLI,PolSc-Amer,0,0,0,2,1,3,2,0,2,2,4,6,1,5,6,0,0,0,7,10,17
sp07,72,WARREN,POLI,PolSc-Intl,0,0,0,3,1,4,1,8,9,17,4,21,12,9,21,0,0,0,33,22,55
sp07,72,WARREN,POLI,PolSc-PLaw,0,0,0,1,4,5,1,3,4,7,9,16,8,7,15,0,0,0,17,23,40
sp07,72,WARREN,POLI,PolSc-PPol,0,0,0,0,0,0,1,1,2,0,1,1,0,2,2,0,0,0,1,4,5
sp07,72,WARREN,POLI,PolSc-Thry,0,0,0,0,0,0,1,0,1,1,0,1,1,2,3,0,0,0,3,2,5
sp07,72,WARREN,PSYC,Psychology,0,0,0,2,9,11,7,22,29,23,43,66,23,80,103,0,0,0,55,154,209
sp07,72,WARREN,RELI,Relig/Stu,0,0,0,0,0,0,0,0,0,0,0,0,1,1,2,0,0,0,1,1,2
sp07,72,WARREN,SE,Engin Sci,0,0,0,1,0,1,0,1,1,0,0,0,1,0,1,0,0,0,2,1,3
sp07,72,WARREN,SE,Struct Eng,0,0,0,9,4,13,13,10,23,27,8,35,64,27,91,0,0,0,113,49,162
sp07,72,WARREN,SOC,Sociology,0,0,0,0,1,1,1,3,4,6,18,24,8,17,25,0,0,0,15,39,54
sp07,72,WARREN,THEA,Dance,0,0,0,0,0,0,0,1,1,0,0,0,1,4,5,0,0,0,1,5,6
sp07,72,WARREN,THEA,Theatre,0,0,0,0,0,0,0,1,1,2,3,5,3,7,10,0,0,0,5,11,16
sp07,72,WARREN,UNAF,IntcampVis,0,0,0,0,0,0,0,3,3,0,1,1,2,1,3,0,0,0,2,5,7
sp07,72,WARREN,UNAF,Limited St,0,0,0,0,0,0,0,0,0,0,0,0,0,0,0,1,0,1,1,0,1
sp07,72,WARREN,UNAF,UndecBiolS,0,0,0,1,8,9,8,13,21,1,3,4,0,0,0,0,0,0,10,24,34
sp07,72,WARREN,UNAF,UndecHumAr,0,0,0,0,3,3,2,6,8,0,1,1,0,0,0,0,0,0,2,10,12
sp07,72,WARREN,UNAF,Undeclared,0,0,0,23,20,43,20,24,44,7,2,9,0,0,0,0,0,0,50,46,96
sp07,72,WARREN,UNAF,UndecPhysS,0,0,0,1,2,3,2,2,4,0,0,0,0,0,0,0,0,0,3,4,7
sp07,72,WARREN,UNAF,UndecSocSc,0,0,0,3,3,6,2,4,6,0,2,2,0,0,0,0,0,0,5,9,14
sp07,72,WARREN,USP,Urb Stu&Pl,0,0,0,0,0,0,0,2,2,6,9,15,4,4,8,0,0,0,10,15,25
sp07,72,WARREN,VIS,Art Hst/Cr,0,0,0,0,0,0,0,1,1,0,4,4,1,3,4,0,0,0,1,8,9
sp07,72,WARREN,VIS,Media,0,0,0,0,1,1,3,0,3,4,5,9,11,9,20,0,0,0,18,15,33
sp07,72,WARREN,VIS,Pr-VACmpAr,0,0,0,0,0,0,1,0,1,0,3,3,0,0,0,0,0,0,1,3,4
sp07,72,WARREN,VIS,Studio VA,0,0,0,0,2,2,1,0,1,2,6,8,4,4,8,0,0,0,7,12,19
sp07,72,WARREN,VIS,VA-CompArt,0,0,0,0,0,0,1,0,1,0,1,1,0,2,2,0,0,0,1,3,4
fa10,103,MARSHALL,ANTH,Anth-Arch,0,0,0,0,0,0,0,0,0,1,2,3,0,4,4,0,0,0,1,6,7
fa10,103,MARSHALL,ANTH,Anth-Biol,0,0,0,0,0,0,1,1,2,2,6,8,1,2,3,0,0,0,4,9,13
fa10,103,MARSHALL,ANTH,Anth-Soci,1,2,3,0,0,0,0,0,0,4,5,9,2,5,7,0,0,0,7,12,19
fa10,103,MARSHALL,ANTH,Anthropol,0,0,0,0,0,0,0,0,0,0,1,1,0,0,0,0,0,0,0,1,1
fa10,103,MARSHALL,BENG,Bioen:Binf,0,0,0,0,0,0,1,0,1,0,2,2,1,1,2,0,0,0,2,3,5
fa10,103,MARSHALL,BENG,Bioeng:PM,0,0,0,0,0,0,1,0,1,4,2,6,10,2,12,0,0,0,15,4,19
fa10,103,MARSHALL,BENG,BioengBiot,3,3,6,0,0,0,5,2,7,13,2,15,5,4,9,0,0,0,26,11,37
fa10,103,MARSHALL,BENG,Bioengin,1,2,3,0,0,0,4,1,5,0,2,2,2,4,6,0,0,0,7,9,16
fa10,103,MARSHALL,BENG,Pr-BioenPM,0,0,0,0,1,1,3,4,7,0,0,0,0,1,1,0,0,0,3,6,9
fa10,103,MARSHALL,BIOL,Bioc/CellB,5,8,13,1,1,2,2,12,14,21,24,45,43,43,86,0,0,0,72,88,160
fa10,103,MARSHALL,BIOL,BiolBioinf,1,1,2,0,0,0,0,0,0,0,0,0,0,0,0,0,0,0,1,1,2
fa10,103,MARSHALL,BIOL,Ec/Beh/Evo,1,2,3,0,1,1,0,0,0,4,3,7,6,4,10,0,0,0,11,10,21
fa10,103,MARSHALL,BIOL,Genl Biol,5,13,18,0,0,0,3,19,22,24,50,74,36,59,95,0,0,0,68,141,209
fa10,103,MARSHALL,BIOL,Human Bio,12,23,35,0,1,1,11,16,27,47,79,126,38,83,121,0,0,0,108,202,310
fa10,103,MARSHALL,BIOL,Microbiol,1,1,2,0,0,0,1,1,2,4,7,11,2,9,11,0,0,0,8,18,26
fa10,103,MARSHALL,BIOL,Molec Biol,3,1,4,0,0,0,0,1,1,3,5,8,2,4,6,0,0,0,8,11,19
fa10,103,MARSHALL,BIOL,PhyslNeuro,5,2,7,0,0,0,2,4,6,9,26,35,13,31,44,0,0,0,29,63,92
fa10,103,MARSHALL,CENG,Chem Engin,5,3,8,0,0,0,4,2,6,5,6,11,14,6,20,0,0,0,28,17,45
fa10,103,MARSHALL,CGS,CritGendSt,0,0,0,0,0,0,0,0,0,2,0,2,0,3,3,0,0,0,2,3,5
fa10,103,MARSHALL,CHEM,Bioch/Chem,7,14,21,1,0,1,9,11,20,16,23,39,13,12,25,0,0,0,46,60,106
fa10,103,MARSHALL,CHEM,Bioinform,0,1,1,0,0,0,0,1,1,0,0,0,0,0,0,0,0,0,0,2,2
fa10,103,MARSHALL,CHEM,Chemistry,4,4,8,0,0,0,3,7,10,7,7,14,5,7,12,0,0,0,19,25,44
fa10,103,MARSHALL,CHEM,Envir Chem,0,0,0,0,0,0,0,0,0,1,0,1,2,1,3,0,0,0,3,1,4
fa10,103,MARSHALL,CHEM,Pharm Chem,3,7,10,0,2,2,4,8,12,13,8,21,10,12,22,0,0,0,30,37,67
fa10,103,MARSHALL,CHIN,Chinese St,1,0,1,0,0,0,0,0,0,1,0,1,0,2,2,0,0,0,2,2,4
fa10,103,MARSHALL,CLAS,Classic St,0,0,0,0,0,0,0,1,1,0,0,0,0,1,1,0,0,0,0,2,2
fa10,103,MARSHALL,COGS,Cog Sci,3,7,10,0,0,0,3,1,4,5,4,9,4,5,9,0,0,0,15,17,32
fa10,103,MARSHALL,COGS,CogSc/ClAs,0,1,1,0,1,1,0,3,3,0,3,3,0,3,3,0,0,0,0,11,11
fa10,103,MARSHALL,COGS,CogSc/Comp,1,0,1,0,0,0,0,0,0,0,0,0,0,0,0,0,0,0,1,0,1
fa10,103,MARSHALL,COGS,CogSc/HCI,0,0,0,0,0,0,1,0,1,2,0,2,5,1,6,0,0,0,8,1,9
fa10,103,MARSHALL,COGS,CogSc/HCog,0,0,0,0,0,0,0,0,0,0,0,0,1,0,1,0,0,0,1,0,1
fa10,103,MARSHALL,COGS,CogSc/Neur,1,0,1,0,0,0,1,1,2,2,7,9,2,12,14,0,0,0,6,20,26
fa10,103,MARSHALL,COMM,Communic,0,9,9,0,3,3,5,19,24,22,84,106,23,37,60,0,0,0,50,152,202
fa10,103,MARSHALL,CSE,Comp Sci,5,1,6,1,0,1,1,4,5,20,5,25,49,7,56,0,0,0,76,17,93
fa10,103,MARSHALL,CSE,CompEngCSE,6,0,6,0,0,0,0,1,1,6,3,9,7,0,7,0,0,0,19,4,23
fa10,103,MARSHALL,CSE,CompScBinf,0,0,0,0,0,0,0,0,0,0,0,0,2,2,4,0,0,0,2,2,4
fa10,103,MARSHALL,ECE,CompEngECE,1,1,2,0,0,0,0,0,0,2,0,2,1,0,1,0,0,0,4,1,5
fa10,103,MARSHALL,ECE,Electr Eng,5,2,7,2,0,2,5,1,6,19,5,24,26,6,32,0,0,0,57,14,71
fa10,103,MARSHALL,ECE,EleEng&Soc,0,0,0,0,0,0,0,0,0,1,0,1,1,0,1,0,0,0,2,0,2
fa10,103,MARSHALL,ECE,Engin Phys,0,0,0,0,0,0,0,0,0,0,0,0,1,0,1,0,0,0,1,0,1
fa10,103,MARSHALL,ECON,Ec-Mth&Ecn,1,1,2,0,0,0,2,3,5,4,4,8,6,2,8,0,0,0,13,10,23
fa10,103,MARSHALL,ECON,Econ-MgtSc,3,9,12,2,1,3,15,14,29,38,37,75,43,35,78,0,0,0,101,96,197
fa10,103,MARSHALL,ECON,Economics,11,8,19,1,0,1,12,12,24,90,63,153,91,50,141,0,0,0,205,133,338
fa10,103,MARSHALL,ESYS,EnvSys(EB),0,3,3,1,0,1,2,7,9,3,3,6,1,3,4,0,0,0,7,16,23
fa10,103,MARSHALL,ESYS,EnvSys(EC),0,1,1,0,0,0,0,0,0,2,0,2,1,0,1,0,0,0,3,1,4
fa10,103,MARSHALL,ESYS,EnvSys(EP),1,0,1,0,0,0,1,1,2,2,3,5,0,2,2,0,0,0,4,6,10
fa10,103,MARSHALL,ESYS,EnvSys(ES),0,1,1,0,0,0,0,0,0,5,0,5,0,1,1,0,0,0,5,2,7
fa10,103,MARSHALL,ETHN,Ethnic St,0,0,0,0,0,0,1,0,1,3,5,8,4,14,18,0,0,0,8,19,27
fa10,103,MARSHALL,GMST,German Stu,0,0,0,0,0,0,0,0,0,0,0,0,1,0,1,0,0,0,1,0,1
fa10,103,MARSHALL,HDP,Human Dev,0,0,0,0,0,0,0,0,0,0,5,5,2,26,28,0,0,0,2,31,33
fa10,103,MARSHALL,HDP,Pr-HumnDev,1,1,2,1,1,2,0,21,21,0,16,16,1,7,8,0,0,0,3,46,49
fa10,103,MARSHALL,HIST,History,0,3,3,0,0,0,2,2,4,11,9,20,19,11,30,0,0,0,32,25,57
fa10,103,MARSHALL,INTD,Mar Ind St,0,0,0,0,0,0,0,0,0,1,0,1,0,0,0,0,0,0,1,0,1
fa10,103,MARSHALL,INTL,IntSt-Anth,0,3,3,0,0,0,0,2,2,0,2,2,0,3,3,0,0,0,0,10,10
fa10,103,MARSHALL,INTL,IntSt-Econ,3,2,5,0,0,0,1,5,6,18,13,31,7,9,16,0,0,0,29,29,58
fa10,103,MARSHALL,INTL,IntSt-Hist,1,0,1,0,0,0,0,0,0,0,1,1,1,1,2,0,0,0,2,2,4
fa10,103,MARSHALL,INTL,IntSt-Ling,0,2,2,0,0,0,0,1,1,0,1,1,0,2,2,0,0,0,0,6,6
fa10,103,MARSHALL,INTL,IntSt-Lit,0,0,0,0,0,0,0,0,0,0,1,1,0,0,0,0,0,0,0,1,1
fa10,103,MARSHALL,INTL,IntSt-PolS,3,5,8,0,0,0,0,4,4,3,11,14,9,10,19,0,0,0,15,30,45
fa10,103,MARSHALL,INTL,IntSt-Soc,1,3,4,0,0,0,1,4,5,0,10,10,3,9,12,0,0,0,5,26,31
fa10,103,MARSHALL,ITAL,Italian St,1,0,1,0,0,0,0,0,0,0,0,0,0,0,0,0,0,0,1,0,1
fa10,103,MARSHALL,LATI,LatinAm St,0,0,0,0,0,0,0,0,0,0,2,2,0,2,2,0,0,0,0,4,4
fa10,103,MARSHALL,LING,Lang Stu,0,0,0,0,0,0,0,0,0,1,3,4,0,3,3,0,0,0,1,6,7
fa10,103,MARSHALL,LING,Ling-CogLn,0,1,1,0,0,0,0,0,0,1,0,1,1,0,1,0,0,0,2,1,3
fa10,103,MARSHALL,LING,Ling-LSoc,0,1,1,0,0,0,0,0,0,0,2,2,0,0,0,0,0,0,0,3,3
fa10,103,MARSHALL,LING,Linguistcs,0,1,1,0,0,0,0,1,1,1,3,4,0,3,3,0,0,0,1,8,9
fa10,103,MARSHALL,LIT,Lit/Compos,0,1,1,0,0,0,0,0,0,0,0,0,0,0,0,0,0,0,0,1,1
fa10,103,MARSHALL,LIT,Lit/CultSt,0,0,0,0,0,0,0,0,0,0,2,2,0,0,0,0,0,0,0,2,2
fa10,103,MARSHALL,LIT,Lit/Engl,1,4,5,1,0,1,1,1,2,2,7,9,2,3,5,0,0,0,7,15,22
fa10,103,MARSHALL,LIT,Lit/World,0,0,0,0,0,0,0,0,0,0,3,3,0,2,2,0,0,0,0,5,5
fa10,103,MARSHALL,LIT,Lit/Writng,0,3,3,0,0,0,0,1,1,2,5,7,7,7,14,0,0,0,9,16,25
fa10,103,MARSHALL,LIT,Pre-Lit/Wr,0,0,0,0,0,0,0,1,1,3,2,5,2,2,4,0,0,0,5,5,10
fa10,103,MARSHALL,LIT,Spanish Lt,0,1,1,0,0,0,0,0,0,0,1,1,0,1,1,0,0,0,0,3,3
fa10,103,MARSHALL,MAE,Aerosp Eng,5,4,9,1,0,1,5,0,5,6,3,9,17,5,22,0,0,0,34,12,46
fa10,103,MARSHALL,MAE,Engin Sci,1,0,1,0,1,1,0,0,0,2,0,2,0,0,0,0,0,0,3,1,4
fa10,103,MARSHALL,MAE,Envir Eng,3,5,8,0,0,0,1,0,1,2,2,4,2,1,3,0,0,0,8,8,16
fa10,103,MARSHALL,MAE,Mech Engin,5,3,8,1,0,1,6,3,9,29,2,31,51,5,56,0,0,0,92,13,105
fa10,103,MARSHALL,MATH,Appld Math,1,2,3,0,0,0,1,1,2,2,1,3,0,0,0,0,0,0,4,4,8
fa10,103,MARSHALL,MATH,Math/SecEd,0,1,1,1,0,1,3,0,3,0,2,2,1,1,2,0,0,0,5,4,9
fa10,103,MARSHALL,MATH,Mathematcs,2,5,7,0,0,0,0,1,1,2,3,5,11,6,17,0,0,0,15,15,30
fa10,103,MARSHALL,MATH,Mth-CompSc,0,0,0,0,0,0,0,0,0,1,1,2,1,3,4,0,0,0,2,4,6
fa10,103,MARSHALL,MATH,Mth-Mth&Ec,1,0,1,0,0,0,0,2,2,3,1,4,6,2,8,0,0,0,10,5,15
fa10,103,MARSHALL,MATH,Mth-SciCom,0,0,0,0,0,0,0,0,0,1,1,2,0,0,0,0,0,0,1,1,2
fa10,103,MARSHALL,MATH,Mth/ApldSc,1,1,2,0,0,0,0,0,0,0,0,0,0,0,0,0,0,0,1,1,2
fa10,103,MARSHALL,MATH,Pr-Math CS,0,1,1,0,0,0,1,1,2,0,0,0,0,0,0,0,0,0,1,2,3
fa10,103,MARSHALL,MATH,Prob&Stats,0,2,2,0,0,0,1,0,1,0,2,2,2,1,3,0,0,0,3,5,8
fa10,103,MARSHALL,MUS,Mu-CompArt,0,0,0,0,0,0,1,0,1,1,1,2,4,1,5,0,0,0,6,2,8
fa10,103,MARSHALL,MUS,Music,2,0,2,0,0,0,1,0,1,3,3,6,2,3,5,0,0,0,8,6,14
fa10,103,MARSHALL,NENG,NanoEng,1,2,3,0,0,0,0,0,0,1,1,2,0,0,0,0,0,0,2,3,5
fa10,103,MARSHALL,PHIL,Philosophy,1,0,1,1,0,1,0,1,1,4,5,9,8,3,11,0,0,0,14,9,23
fa10,103,MARSHALL,PHYS,Biophysics,1,0,1,0,0,0,0,0,0,3,0,3,0,1,1,0,0,0,4,1,5
fa10,103,MARSHALL,PHYS,Phy/ErthSc,0,0,0,0,0,0,0,0,0,0,0,0,1,0,1,0,0,0,1,0,1
fa10,103,MARSHALL,PHYS,Phys/Astro,1,1,2,0,0,0,0,1,1,0,1,1,1,1,2,0,0,0,2,4,6
fa10,103,MARSHALL,PHYS,Phys/Comp,1,0,1,0,0,0,0,0,0,0,0,0,0,0,0,0,0,0,1,0,1
fa10,103,MARSHALL,PHYS,Phys/Mtrls,0,0,0,0,0,0,0,0,0,0,0,0,0,1,1,0,0,0,0,1,1
fa10,103,MARSHALL,PHYS,Physics,2,0,2,0,0,0,3,0,3,2,1,3,1,0,1,0,0,0,8,1,9
fa10,103,MARSHALL,POLI,Polit Sci,9,5,14,0,0,0,4,3,7,26,22,48,26,27,53,0,0,0,65,57,122
fa10,103,MARSHALL,POLI,PolSc-Amer,0,2,2,0,0,0,0,2,2,2,2,4,5,2,7,0,0,0,7,8,15
fa10,103,MARSHALL,POLI,PolSc-Comp,0,0,0,0,0,0,0,0,0,0,2,2,0,1,1,0,0,0,0,3,3
fa10,103,MARSHALL,POLI,PolSc-Intl,2,3,5,1,0,1,3,3,6,15,15,30,17,16,33,0,0,0,38,37,75
fa10,103,MARSHALL,POLI,PolSc-PLaw,5,1,6,1,1,2,2,2,4,8,4,12,7,5,12,0,0,0,23,13,36
fa10,103,MARSHALL,POLI,PolSc-PPol,0,0,0,0,0,0,0,0,0,2,0,2,0,3,3,0,0,0,2,3,5
fa10,103,MARSHALL,POLI,PolSc-Thry,1,0,1,0,0,0,1,0,1,2,2,4,2,2,4,0,0,0,6,4,10
fa10,103,MARSHALL,PSYC,Psychology,10,19,29,1,4,5,9,35,44,37,60,97,27,71,98,0,0,0,84,189,273
fa10,103,MARSHALL,RELI,Relig/Stu,0,0,0,0,0,0,0,0,0,0,0,0,0,2,2,0,0,0,0,2,2
fa10,103,MARSHALL,SE,Struct Eng,12,5,17,0,0,0,5,4,9,18,9,27,17,12,29,0,0,0,52,30,82
fa10,103,MARSHALL,SIO,Earth Sci,1,0,1,0,0,0,0,0,0,1,0,1,0,1,1,0,0,0,2,1,3
fa10,103,MARSHALL,SIO,ErSc-Geol,0,0,0,0,0,0,1,0,1,0,0,0,0,1,1,0,0,0,1,1,2
fa10,103,MARSHALL,SOC,SocCulCom,0,0,0,0,0,0,0,0,0,0,4,4,1,1,2,0,0,0,1,5,6
fa10,103,MARSHALL,SOC,SocEconSoc,0,0,0,0,0,0,1,0,1,0,1,1,0,2,2,0,0,0,1,3,4
fa10,103,MARSHALL,SOC,SocIntlStu,0,0,0,0,0,0,0,0,0,1,0,1,0,0,0,0,0,0,1,0,1
fa10,103,MARSHALL,SOC,Sociology,2,3,5,0,1,1,1,4,5,12,25,37,7,18,25,0,0,0,22,51,73
fa10,103,MARSHALL,SOC,SocLawSoc,0,0,0,0,0,0,1,0,1,3,3,6,3,4,7,0,0,0,7,7,14
fa10,103,MARSHALL,SOC,SocSciMed,0,1,1,0,0,0,0,0,0,1,2,3,0,1,1,0,0,0,1,4,5
fa10,103,MARSHALL,SOC,SocSolneq,0,0,0,0,0,0,0,2,2,0,0,0,0,4,4,0,0,0,0,6,6
fa10,103,MARSHALL,THEA,Dance,0,0,0,0,0,0,0,0,0,0,1,1,0,2,2,0,0,0,0,3,3
fa10,103,MARSHALL,THEA,Theatre,1,1,2,0,0,0,1,0,1,1,4,5,1,2,3,0,0,0,4,7,11
fa10,103,MARSHALL,TWS,ThirdWldSt,0,0,0,0,0,0,0,1,1,0,0,0,0,0,0,0,0,0,0,1,1
fa10,103,MARSHALL,UNAF,UndecHumAr,2,4,6,0,0,0,0,1,1,0,0,0,0,0,0,0,0,0,2,5,7
fa10,103,MARSHALL,UNAF,Undeclared,26,38,64,5,4,9,10,25,35,3,6,9,0,0,0,0,0,0,44,73,117
fa10,103,MARSHALL,UNAF,UndecPhysS,4,7,11,0,0,0,1,2,3,0,0,0,0,0,0,0,0,0,5,9,14
fa10,103,MARSHALL,UNAF,UndecSocSc,2,8,10,0,0,0,1,3,4,0,1,1,0,0,0,0,0,0,3,12,15
fa10,103,MARSHALL,USP,Urb Stu&Pl,0,0,0,0,0,0,1,4,5,4,9,13,4,10,14,0,0,0,9,23,32
fa10,103,MARSHALL,VIS,Art Hst/Cr,0,0,0,0,0,0,0,0,0,1,4,5,0,6,6,0,0,0,1,10,11
fa10,103,MARSHALL,VIS,Media,3,4,7,0,0,0,1,2,3,7,6,13,10,7,17,0,0,0,21,19,40
fa10,103,MARSHALL,VIS,Studio VA,0,0,0,0,0,0,0,1,1,0,4,4,5,5,10,0,0,0,5,10,15
fa10,103,MARSHALL,VIS,VA-CompArt,0,2,2,0,0,0,0,2,2,1,0,1,2,2,4,0,0,0,3,6,9
fa10,103,MUIR,ANTH,Anth-Arch,1,2,3,0,0,0,0,0,0,2,3,5,2,2,4,0,0,0,5,7,12
fa10,103,MUIR,ANTH,Anth-Biol,0,0,0,0,0,0,1,0,1,0,4,4,5,8,13,0,0,0,6,12,18
fa10,103,MUIR,ANTH,Anth-Soci,0,2,2,0,0,0,1,2,3,3,13,16,1,3,4,0,0,0,5,20,25
fa10,103,MUIR,BENG,Bioen:Binf,2,1,3,0,0,0,0,0,0,2,0,2,0,0,0,0,0,0,4,1,5
fa10,103,MUIR,BENG,Bioeng:PM,0,0,0,0,0,0,0,0,0,0,1,1,6,2,8,0,0,0,6,3,9
fa10,103,MUIR,BENG,BioengBiot,5,0,5,0,0,0,1,2,3,8,5,13,7,6,13,0,0,0,21,13,34
fa10,103,MUIR,BENG,Bioengin,6,3,9,0,0,0,0,3,3,7,1,8,19,4,23,0,0,0,32,11,43
fa10,103,MUIR,BENG,Pr-BioenPM,0,0,0,1,1,2,2,1,3,4,1,5,1,0,1,0,0,0,8,3,11
fa10,103,MUIR,BIOL,Bioc/CellB,8,10,18,0,0,0,5,4,9,20,27,47,56,52,108,0,0,0,89,93,182
fa10,103,MUIR,BIOL,Ec/Beh/Evo,1,3,4,0,1,1,0,2,2,3,6,9,5,20,25,0,0,0,9,32,41
fa10,103,MUIR,BIOL,Genl Biol,11,28,39,0,1,1,5,13,18,26,57,83,38,65,103,0,0,0,80,164,244
fa10,103,MUIR,BIOL,Human Bio,27,35,62,0,0,0,11,31,42,41,61,102,60,65,125,0,0,0,139,192,331
fa10,103,MUIR,BIOL,Microbiol,2,2,4,0,0,0,1,3,4,5,3,8,6,5,11,0,0,0,14,13,27
fa10,103,MUIR,BIOL,Molec Biol,2,6,8,0,1,1,2,0,2,7,4,11,7,10,17,0,0,0,18,21,39
fa10,103,MUIR,BIOL,PhyslNeuro,12,12,24,0,0,0,3,8,11,17,20,37,25,28,53,0,0,0,57,68,125
fa10,103,MUIR,CENG,Chem Engin,4,3,7,0,0,0,1,0,1,7,4,11,13,9,22,0,0,0,25,16,41
fa10,103,MUIR,CGS,CritGendSt,1,0,1,0,0,0,0,1,1,0,1,1,0,2,2,0,0,0,1,4,5
fa10,103,MUIR,CHEM,Bioch/Chem,19,16,35,1,1,2,6,8,14,13,16,29,13,18,31,0,0,0,52,59,111
fa10,103,MUIR,CHEM,Chem Educ,0,0,0,0,0,0,0,1,1,0,0,0,0,0,0,0,0,0,0,1,1
fa10,103,MUIR,CHEM,Chem Phys,0,0,0,0,0,0,0,0,0,2,0,2,0,0,0,0,0,0,2,0,2
fa10,103,MUIR,CHEM,Chemistry,6,5,11,1,0,1,1,2,3,7,7,14,11,5,16,0,0,0,26,19,45
fa10,103,MUIR,CHEM,Envir Chem,0,0,0,0,0,0,0,1,1,2,0,2,1,1,2,0,0,0,3,2,5
fa10,103,MUIR,CHEM,MolecSynth,0,0,0,0,0,0,0,0,0,0,1,1,0,0,0,0,0,0,0,1,1
fa10,103,MUIR,CHEM,Pharm Chem,10,8,18,0,0,0,6,6,12,8,11,19,16,9,25,0,0,0,40,34,74
fa10,103,MUIR,CHIN,Chinese St,1,2,3,0,0,0,0,0,0,0,0,0,4,1,5,0,0,0,5,3,8
fa10,103,MUIR,CLAS,Classic St,0,0,0,0,0,0,0,0,0,0,2,2,0,1,1,0,0,0,0,3,3
fa10,103,MUIR,COGS,Cog Sci,6,4,10,0,0,0,5,2,7,6,3,9,11,9,20,0,0,0,28,18,46
fa10,103,MUIR,COGS,CogSc/ClAs,0,0,0,0,0,0,0,3,3,0,0,0,0,3,3,0,0,0,0,6,6
fa10,103,MUIR,COGS,CogSc/Comp,0,0,0,0,0,0,0,0,0,2,0,2,2,0,2,0,0,0,4,0,4
fa10,103,MUIR,COGS,CogSc/HCI,0,0,0,0,0,0,1,1,2,0,2,2,5,2,7,0,0,0,6,5,11
fa10,103,MUIR,COGS,CogSc/HCog,0,0,0,0,1,1,0,0,0,1,2,3,1,2,3,0,0,0,2,5,7
fa10,103,MUIR,COGS,CogSc/Neur,2,3,5,1,0,1,2,8,10,5,2,7,11,13,24,0,0,0,21,26,47
fa10,103,MUIR,COMM,Communic,1,8,9,0,2,2,4,10,14,18,62,80,10,45,55,0,0,0,33,127,160
fa10,103,MUIR,CSE,Comp Sci,9,4,13,2,0,2,11,1,12,24,3,27,34,12,46,0,0,0,80,20,100
fa10,103,MUIR,CSE,CompEngCSE,7,0,7,0,0,0,5,1,6,4,1,5,6,1,7,0,0,0,22,3,25
fa10,103,MUIR,CSE,CompScBinf,0,0,0,0,0,0,3,0,3,0,0,0,2,1,3,0,0,0,5,1,6
fa10,103,MUIR,CSE,Pr-Comp Sc,0,0,0,0,0,0,0,0,0,0,0,0,1,0,1,0,0,0,1,0,1
fa10,103,MUIR,ECE,CompEngECE,1,2,3,0,0,0,1,1,2,1,0,1,1,0,1,0,0,0,4,3,7
fa10,103,MUIR,ECE,Electr Eng,8,1,9,1,0,1,4,1,5,12,2,14,13,3,16,0,0,0,38,7,45
fa10,103,MUIR,ECE,Engin Phys,0,1,1,0,0,0,0,0,0,1,0,1,0,0,0,0,0,0,1,1,2
fa10,103,MUIR,ECE,Pr-EngPhys,2,0,2,0,0,0,0,0,0,0,0,0,0,0,0,0,0,0,2,0,2
fa10,103,MUIR,ECON,Ec-Mth&Ecn,2,2,4,0,0,0,1,3,4,3,2,5,5,2,7,0,0,0,11,9,20
fa10,103,MUIR,ECON,Econ-MgtSc,10,8,18,2,1,3,13,8,21,36,19,55,38,20,58,0,0,0,99,56,155
fa10,103,MUIR,ECON,Economics,22,16,38,1,0,1,14,9,23,75,38,113,68,39,107,0,0,0,180,102,282
fa10,103,MUIR,ESYS,EnvSys(EB),1,7,8,2,0,2,3,7,10,4,7,11,6,9,15,0,0,0,16,30,46
fa10,103,MUIR,ESYS,EnvSys(EC),0,1,1,0,0,0,0,1,1,0,0,0,0,1,1,0,0,0,0,3,3
fa10,103,MUIR,ESYS,EnvSys(EP),0,3,3,0,0,0,0,0,0,0,0,0,2,3,5,0,0,0,2,6,8
fa10,103,MUIR,ESYS,EnvSys(ES),1,2,3,0,0,0,0,0,0,1,3,4,0,0,0,0,0,0,2,5,7
fa10,103,MUIR,ETHN,Ethnic St,0,0,0,0,0,0,1,1,2,0,5,5,2,6,8,0,0,0,3,12,15
fa10,103,MUIR,GMST,German Stu,0,0,0,0,0,0,0,0,0,0,0,0,0,1,1,0,0,0,0,1,1
fa10,103,MUIR,HDP,Human Dev,0,0,0,0,0,0,0,0,0,1,6,7,1,13,14,0,0,0,2,19,21
fa10,103,MUIR,HDP,Pr-HumnDev,1,3,4,0,1,1,3,11,14,1,14,15,0,1,1,0,0,0,5,30,35
fa10,103,MUIR,HIST,History,3,5,8,0,0,0,2,5,7,10,13,23,19,10,29,0,0,0,34,33,67
fa10,103,MUIR,INTD,Muir Sp Pr,0,0,0,0,0,0,0,0,0,0,0,0,0,2,2,0,0,0,0,2,2
fa10,103,MUIR,INTL,IntSt-Anth,0,0,0,0,0,0,0,0,0,0,0,0,1,0,1,0,0,0,1,0,1
fa10,103,MUIR,INTL,IntSt-Econ,2,8,10,0,0,0,1,6,7,7,9,16,7,13,20,0,0,0,17,36,53
fa10,103,MUIR,INTL,IntSt-Hist,0,0,0,0,0,0,0,0,0,0,0,0,1,3,4,0,0,0,1,3,4
fa10,103,MUIR,INTL,IntSt-Ling,0,0,0,0,0,0,0,1,1,0,0,0,0,1,1,0,0,0,0,2,2
fa10,103,MUIR,INTL,IntSt-Lit,0,1,1,0,0,0,0,0,0,0,2,2,1,2,3,0,0,0,1,5,6
fa10,103,MUIR,INTL,IntSt-PolS,1,1,2,0,0,0,0,3,3,1,8,9,2,11,13,0,0,0,4,23,27
fa10,103,MUIR,INTL,IntSt-Soc,1,2,3,0,0,0,0,2,2,0,8,8,5,4,9,0,0,0,6,16,22
fa10,103,MUIR,JAPN,JapaneseSt,1,1,2,0,0,0,0,0,0,1,1,2,4,4,8,0,0,0,6,6,12
fa10,103,MUIR,JUDA,Judaic Stu,0,2,2,0,0,0,0,0,0,0,0,0,0,0,0,0,0,0,0,2,2
fa10,103,MUIR,LATI,LatinAm St,0,1,1,0,0,0,0,1,1,0,1,1,0,0,0,0,0,0,0,3,3
fa10,103,MUIR,LING,Lang Stu,1,1,2,0,0,0,0,0,0,0,1,1,2,3,5,0,0,0,3,5,8
fa10,103,MUIR,LING,Ling-CogLn,0,0,0,0,0,0,0,0,0,1,1,2,0,2,2,0,0,0,1,3,4
fa10,103,MUIR,LING,Linguistcs,1,0,1,0,0,0,0,1,1,3,3,6,2,6,8,0,0,0,6,10,16
fa10,103,MUIR,LIT,French Lit,0,0,0,0,0,0,0,0,0,0,0,0,0,1,1,0,0,0,0,1,1
fa10,103,MUIR,LIT,Lit/Compos,0,0,0,0,0,0,0,0,0,0,1,1,0,0,0,0,0,0,0,1,1
fa10,103,MUIR,LIT,Lit/CultSt,0,1,1,0,0,0,0,0,0,0,1,1,0,2,2,0,0,0,0,4,4
fa10,103,MUIR,LIT,Lit/Engl,0,7,7,0,0,0,2,3,5,3,5,8,6,12,18,0,0,0,11,27,38
fa10,103,MUIR,LIT,Lit/World,0,0,0,0,0,0,0,1,1,0,2,2,0,5,5,0,0,0,0,8,8
fa10,103,MUIR,LIT,Lit/Writng,1,5,6,0,0,0,0,1,1,1,4,5,6,9,15,0,0,0,8,19,27
fa10,103,MUIR,LIT,Pre-Lit/Wr,0,0,0,0,0,0,1,3,4,3,5,8,2,2,4,0,0,0,6,10,16
fa10,103,MUIR,LIT,Spanish Lt,1,2,3,1,0,1,0,0,0,0,2,2,0,4,4,0,0,0,2,8,10
fa10,103,MUIR,MAE,Aerosp Eng,8,6,14,0,0,0,5,2,7,13,1,14,13,2,15,0,0,0,39,11,50
fa10,103,MUIR,MAE,Engin Sci,2,0,2,0,0,0,0,0,0,1,0,1,1,0,1,0,0,0,4,0,4
fa10,103,MUIR,MAE,Envir Eng,3,9,12,0,0,0,2,2,4,5,2,7,6,7,13,0,0,0,16,20,36
fa10,103,MUIR,MAE,Mech Engin,7,0,7,1,0,1,7,1,8,14,2,16,49,5,54,0,0,0,78,8,86
fa10,103,MUIR,MATH,Appld Math,3,0,3,0,0,0,0,1,1,1,1,2,3,2,5,0,0,0,7,4,11
fa10,103,MUIR,MATH,Math/SecEd,0,5,5,0,0,0,0,1,1,2,0,2,2,1,3,0,0,0,4,7,11
fa10,103,MUIR,MATH,Mathematcs,8,3,11,0,0,0,1,1,2,7,6,13,6,2,8,0,0,0,22,12,34
fa10,103,MUIR,MATH,Mth-CompSc,0,0,0,0,0,0,0,1,1,0,0,0,1,0,1,0,0,0,1,1,2
fa10,103,MUIR,MATH,Mth-Mth&Ec,2,0,2,0,1,1,0,0,0,5,0,5,4,1,5,0,0,0,11,2,13
fa10,103,MUIR,MATH,Mth-SciCom,0,0,0,0,0,0,0,0,0,0,0,0,1,0,1,0,0,0,1,0,1
fa10,103,MUIR,MATH,Mth/ApldSc,3,1,4,0,0,0,0,0,0,0,0,0,1,2,3,0,0,0,4,3,7
fa10,103,MUIR,MATH,Pr-Math CS,1,0,1,0,0,0,0,0,0,1,0,1,0,0,0,0,0,0,2,0,2
fa10,103,MUIR,MATH,Prob&Stats,0,0,0,0,0,0,1,0,1,2,0,2,2,0,2,0,0,0,5,0,5
fa10,103,MUIR,MUS,Mu-CompArt,1,0,1,0,0,0,1,0,1,6,0,6,6,1,7,0,0,0,14,1,15
fa10,103,MUIR,MUS,Music,1,0,1,1,0,1,1,1,2,0,2,2,6,4,10,0,0,0,9,7,16
fa10,103,MUIR,MUS,Music Hum,0,0,0,0,0,0,0,0,0,1,0,1,0,2,2,0,0,0,1,2,3
fa10,103,MUIR,NENG,NanoEng,4,0,4,0,0,0,0,1,1,1,0,1,0,0,0,0,0,0,5,1,6
fa10,103,MUIR,PHIL,Philosophy,3,1,4,0,0,0,0,1,1,2,2,4,5,4,9,0,0,0,10,8,18
fa10,103,MUIR,PHYS,Biophysics,7,0,7,0,0,0,0,0,0,3,0,3,2,0,2,0,0,0,12,0,12
fa10,103,MUIR,PHYS,Phy/ErthSc,0,0,0,0,0,0,0,0,0,0,1,1,0,0,0,0,0,0,0,1,1
fa10,103,MUIR,PHYS,Phys/Astro,1,0,1,0,0,0,2,0,2,2,1,3,2,2,4,0,0,0,7,3,10
fa10,103,MUIR,PHYS,Phys/Comp,0,0,0,0,0,0,0,0,0,1,0,1,0,0,0,0,0,0,1,0,1
fa10,103,MUIR,PHYS,Physics,0,1,1,0,0,0,0,0,0,3,0,3,4,2,6,0,0,0,7,3,10
fa10,103,MUIR,POLI,Polit Sci,9,6,15,0,0,0,3,2,5,13,20,33,20,26,46,0,0,0,45,54,99
fa10,103,MUIR,POLI,PolSc-Amer,2,1,3,1,0,1,0,2,2,2,0,2,2,4,6,0,0,0,7,7,14
fa10,103,MUIR,POLI,PolSc-Comp,1,0,1,0,0,0,0,0,0,0,0,0,2,0,2,0,0,0,3,0,3
fa10,103,MUIR,POLI,PolSc-Intl,1,4,5,0,1,1,6,6,12,12,8,20,15,7,22,0,0,0,34,26,60
fa10,103,MUIR,POLI,PolSc-PLaw,5,2,7,0,1,1,3,3,6,8,2,10,6,3,9,0,0,0,22,11,33
fa10,103,MUIR,POLI,PolSc-PPol,1,1,2,0,0,0,0,0,0,2,0,2,2,1,3,0,0,0,5,2,7
fa10,103,MUIR,POLI,PolSc-Thry,0,0,0,0,0,0,0,0,0,0,0,0,2,0,2,0,0,0,2,0,2
fa10,103,MUIR,PSYC,Psychology,16,34,50,1,1,2,7,36,43,36,68,104,26,82,108,0,0,0,86,221,307
fa10,103,MUIR,RELI,Relig/Stu,0,0,0,0,0,0,0,0,0,1,1,2,1,1,2,0,0,0,2,2,4
fa10,103,MUIR,RUSS,Russ&SovSt,0,1,1,0,0,0,0,0,0,1,0,1,0,0,0,0,0,0,1,1,2
fa10,103,MUIR,SE,Engin Sci,1,0,1,0,0,0,0,0,0,0,0,0,0,0,0,0,0,0,1,0,1
fa10,103,MUIR,SE,Struct Eng,7,2,9,2,0,2,9,4,13,18,3,21,20,10,30,0,0,0,56,19,75
fa10,103,MUIR,SIO,Earth Sci,0,1,1,0,0,0,0,0,0,3,0,3,0,0,0,0,0,0,3,1,4
fa10,103,MUIR,SIO,ErSc-Geol,0,0,0,0,0,0,0,0,0,2,0,2,2,0,2,0,0,0,4,0,4
fa10,103,MUIR,SOC,SocAmSt,0,0,0,0,0,0,0,0,0,0,0,0,0,1,1,0,0,0,0,1,1
fa10,103,MUIR,SOC,SocCulCom,0,0,0,0,0,0,0,1,1,1,0,1,1,0,1,0,0,0,2,1,3
fa10,103,MUIR,SOC,SocEconSoc,0,0,0,0,0,0,0,0,0,1,0,1,0,0,0,0,0,0,1,0,1
fa10,103,MUIR,SOC,SocIntlStu,0,0,0,0,0,0,0,0,0,0,0,0,0,2,2,0,0,0,0,2,2
fa10,103,MUIR,SOC,Sociology,2,7,9,0,3,3,3,2,5,11,28,39,3,17,20,0,0,0,19,57,76
fa10,103,MUIR,SOC,SocLawSoc,0,0,0,0,0,0,1,0,1,0,0,0,1,3,4,0,0,0,2,3,5
fa10,103,MUIR,SOC,SocSciMed,0,0,0,0,0,0,1,1,2,1,4,5,1,2,3,0,0,0,3,7,10
fa10,103,MUIR,SOC,SocSolneq,1,0,1,0,0,0,0,0,0,0,0,0,0,4,4,0,0,0,1,4,5
fa10,103,MUIR,THEA,Dance,0,1,1,0,0,0,0,0,0,0,0,0,2,2,4,0,0,0,2,3,5
fa10,103,MUIR,THEA,Theatre,1,2,3,0,0,0,2,2,4,1,6,7,2,10,12,0,0,0,6,20,26
fa10,103,MUIR,UNAF,Limited St,0,0,0,0,0,0,0,0,0,0,0,0,0,0,0,1,0,1,1,0,1
fa10,103,MUIR,UNAF,UndecBiolS,0,0,0,0,0,0,0,1,1,0,0,0,0,0,0,0,0,0,0,1,1
fa10,103,MUIR,UNAF,UndecHumAr,1,4,5,0,0,0,1,2,3,0,0,0,0,0,0,0,0,0,2,6,8
fa10,103,MUIR,UNAF,Undeclared,62,80,142,2,8,10,16,14,30,2,2,4,0,0,0,0,0,0,82,104,186
fa10,103,MUIR,UNAF,UndecPhysS,5,9,14,1,0,1,1,1,2,0,0,0,0,0,0,0,0,0,7,10,17
fa10,103,MUIR,UNAF,UndecSocSc,7,10,17,0,1,1,0,2,2,0,2,2,0,0,0,0,0,0,7,15,22
fa10,103,MUIR,USP,Urb Stu&Pl,0,1,1,0,0,0,2,2,4,5,4,9,7,9,16,0,0,0,14,16,30
fa10,103,MUIR,VIS,Art Hst/Cr,0,1,1,0,0,0,0,1,1,1,2,3,0,8,8,0,0,0,1,12,13
fa10,103,MUIR,VIS,Media,5,2,7,0,1,1,0,5,5,4,13,17,14,6,20,0,0,0,23,27,50
fa10,103,MUIR,VIS,Studio VA,0,4,4,0,0,0,0,1,1,4,5,9,0,6,6,0,0,0,4,16,20
fa10,103,MUIR,VIS,VA-CompArt,1,0,1,0,0,0,0,2,2,6,1,7,3,2,5,0,0,0,10,5,15
fa10,103,REVELLE,ANTH,Anth-Arch,0,0,0,0,0,0,0,0,0,1,1,2,0,1,1,0,0,0,1,2,3
fa10,103,REVELLE,ANTH,Anth-Biol,0,1,1,0,0,0,0,1,1,0,6,6,2,2,4,0,0,0,2,10,12
fa10,103,REVELLE,ANTH,Anth-Soci,0,1,1,0,0,0,0,1,1,1,5,6,2,6,8,0,0,0,3,13,16
fa10,103,REVELLE,BENG,Bioen:Binf,3,1,4,0,0,0,2,0,2,1,1,2,2,2,4,0,0,0,8,4,12
fa10,103,REVELLE,BENG,Bioeng:PM,0,0,0,0,0,0,0,0,0,1,0,1,24,8,32,0,0,0,25,8,33
fa10,103,REVELLE,BENG,BioengBiot,12,4,16,1,0,1,6,2,8,9,5,14,14,8,22,0,0,0,42,19,61
fa10,103,REVELLE,BENG,Bioengin,2,5,7,0,1,1,4,2,6,10,3,13,11,12,23,0,0,0,27,23,50
fa10,103,REVELLE,BENG,Pr-BioenPM,0,0,0,1,0,1,3,2,5,5,5,10,0,0,0,0,0,0,9,7,16
fa10,103,REVELLE,BIOL,Bioc/CellB,12,11,23,0,0,0,7,9,16,32,33,65,99,75,174,0,0,0,150,128,278
fa10,103,REVELLE,BIOL,BiolBioinf,0,0,0,0,0,0,0,0,0,3,0,3,1,0,1,0,0,0,4,0,4
fa10,103,REVELLE,BIOL,Ec/Beh/Evo,1,4,5,0,0,0,2,1,3,3,3,6,5,11,16,0,0,0,11,19,30
fa10,103,REVELLE,BIOL,Genl Biol,11,27,38,0,0,0,9,15,24,24,45,69,43,79,122,0,0,0,87,166,253
fa10,103,REVELLE,BIOL,Human Bio,13,40,53,0,2,2,20,32,52,64,83,147,78,121,199,0,0,0,175,278,453
fa10,103,REVELLE,BIOL,Microbiol,3,1,4,0,0,0,2,2,4,2,9,11,9,10,19,0,0,0,16,22,38
fa10,103,REVELLE,BIOL,Molec Biol,0,4,4,0,0,0,4,1,5,7,5,12,23,16,39,0,0,0,34,26,60
fa10,103,REVELLE,BIOL,PhyslNeuro,10,16,26,0,0,0,5,6,11,15,24,39,42,39,81,0,0,0,72,85,157
fa10,103,REVELLE,CENG,Chem Engin,10,3,13,0,0,0,5,5,10,13,2,15,22,7,29,0,0,0,50,17,67
fa10,103,REVELLE,CGS,CritGendSt,0,0,0,0,0,0,0,0,0,0,0,0,1,0,1,0,0,0,1,0,1
fa10,103,REVELLE,CHEM,Bioch/Chem,17,23,40,1,1,2,8,15,23,15,13,28,17,24,41,0,0,0,58,76,134
fa10,103,REVELLE,CHEM,Bioinform,0,0,0,0,0,0,0,0,0,0,0,0,1,0,1,0,0,0,1,0,1
fa10,103,REVELLE,CHEM,Chem Phys,0,0,0,0,0,0,0,0,0,0,0,0,1,0,1,0,0,0,1,0,1
fa10,103,REVELLE,CHEM,Chemistry,5,5,10,0,0,0,4,3,7,5,8,13,7,9,16,0,0,0,21,25,46
fa10,103,REVELLE,CHEM,Envir Chem,0,0,0,0,0,0,1,0,1,1,0,1,1,0,1,0,0,0,3,0,3
fa10,103,REVELLE,CHEM,MolecSynth,1,1,2,0,0,0,0,0,0,1,0,1,3,0,3,0,0,0,5,1,6
fa10,103,REVELLE,CHEM,Pharm Chem,8,18,26,0,1,1,4,18,22,16,27,43,19,18,37,0,0,0,47,82,129
fa10,103,REVELLE,CHIN,Chinese St,1,1,2,0,0,0,0,0,0,0,0,0,2,0,2,0,0,0,3,1,4
fa10,103,REVELLE,CLAS,Classic St,1,0,1,0,0,0,0,0,0,0,1,1,0,0,0,0,0,0,1,1,2
fa10,103,REVELLE,COGS,Cog Sci,6,8,14,0,1,1,1,1,2,5,2,7,3,5,8,0,0,0,15,17,32
fa10,103,REVELLE,COGS,CogSc/ClAs,0,0,0,0,0,0,0,2,2,1,2,3,0,2,2,0,0,0,1,6,7
fa10,103,REVELLE,COGS,CogSc/Comp,0,0,0,0,0,0,0,0,0,0,0,0,1,0,1,0,0,0,1,0,1
fa10,103,REVELLE,COGS,CogSc/HCI,0,0,0,0,0,0,0,0,0,1,1,2,1,1,2,0,0,0,2,2,4
fa10,103,REVELLE,COGS,CogSc/HCog,0,0,0,0,0,0,0,3,3,1,1,2,1,0,1,0,0,0,2,4,6
fa10,103,REVELLE,COGS,CogSc/Neur,0,1,1,0,1,1,2,11,13,1,1,2,5,5,10,0,0,0,8,19,27
fa10,103,REVELLE,COMM,Communic,1,3,4,0,1,1,6,6,12,7,17,24,9,15,24,0,0,0,23,42,65
fa10,103,REVELLE,CSE,Comp Sci,12,2,14,0,0,0,12,1,13,19,4,23,37,4,41,0,0,0,80,11,91
fa10,103,REVELLE,CSE,CompEngCSE,7,1,8,1,0,1,6,1,7,5,1,6,7,0,7,0,0,0,26,3,29
fa10,103,REVELLE,CSE,CompScBinf,0,0,0,0,0,0,0,0,0,1,0,1,1,0,1,0,0,0,2,0,2
fa10,103,REVELLE,ECE,CompEngECE,6,1,7,0,0,0,2,0,2,3,0,3,1,0,1,0,0,0,12,1,13
fa10,103,REVELLE,ECE,Electr Eng,8,0,8,0,0,0,8,0,8,12,4,16,29,5,34,0,0,0,57,9,66
fa10,103,REVELLE,ECE,Engin Phys,2,0,2,0,0,0,0,0,0,0,0,0,1,0,1,0,0,0,3,0,3
fa10,103,REVELLE,ECON,Ec-Mth&Ecn,2,2,4,0,0,0,1,0,1,5,3,8,6,1,7,0,0,0,14,6,20
fa10,103,REVELLE,ECON,Econ-MgtSc,1,2,3,0,0,0,9,5,14,19,6,25,28,12,40,0,0,0,57,25,82
fa10,103,REVELLE,ECON,Economics,8,3,11,0,0,0,12,6,18,41,19,60,37,25,62,0,0,0,98,53,151
fa10,103,REVELLE,ESYS,EnvSys(EB),0,1,1,0,1,1,1,4,5,1,1,2,4,3,7,0,0,0,6,10,16
fa10,103,REVELLE,ESYS,EnvSys(EC),0,0,0,0,0,0,0,2,2,1,0,1,1,0,1,0,0,0,2,2,4
fa10,103,REVELLE,ESYS,EnvSys(EP),0,1,1,0,0,0,1,1,2,0,1,1,0,1,1,0,0,0,1,4,5
fa10,103,REVELLE,ESYS,EnvSys(ES),0,1,1,0,0,0,1,0,1,0,2,2,1,1,2,0,0,0,2,4,6
fa10,103,REVELLE,ETHN,Ethnic St,0,0,0,0,0,0,0,2,2,1,2,3,5,2,7,0,0,0,6,6,12
fa10,103,REVELLE,HDP,Human Dev,0,0,0,0,0,0,0,0,0,0,6,6,1,9,10,0,0,0,1,15,16
fa10,103,REVELLE,HDP,Pr-HumnDev,0,0,0,0,1,1,0,3,3,1,3,4,0,2,2,0,0,0,1,9,10
fa10,103,REVELLE,HIST,History,1,0,1,0,0,0,4,3,7,3,3,6,5,8,13,0,0,0,13,14,27
fa10,103,REVELLE,INTL,IntSt-Anth,0,0,0,0,0,0,1,0,1,0,0,0,0,1,1,0,0,0,1,1,2
fa10,103,REVELLE,INTL,IntSt-Econ,0,2,2,0,0,0,2,4,6,5,2,7,6,1,7,0,0,0,13,9,22
fa10,103,REVELLE,INTL,IntSt-Hist,0,1,1,0,0,0,0,1,1,0,0,0,0,1,1,0,0,0,0,3,3
fa10,103,REVELLE,INTL,IntSt-Ling,0,0,0,0,0,0,0,0,0,1,2,3,0,2,2,0,0,0,1,4,5
fa10,103,REVELLE,INTL,IntSt-Lit,0,0,0,0,0,0,0,0,0,0,0,0,0,1,1,0,0,0,0,1,1
fa10,103,REVELLE,INTL,IntSt-PolS,0,1,1,0,0,0,0,4,4,6,1,7,0,8,8,0,0,0,6,14,20
fa10,103,REVELLE,INTL,IntSt-Soc,0,1,1,0,0,0,0,1,1,0,3,3,2,2,4,0,0,0,2,7,9
fa10,103,REVELLE,JAPN,JapaneseSt,0,0,0,0,0,0,1,0,1,1,1,2,0,0,0,0,0,0,2,1,3
fa10,103,REVELLE,JUDA,Judaic Stu,0,0,0,0,0,0,0,0,0,1,0,1,0,0,0,0,0,0,1,0,1
fa10,103,REVELLE,LING,Lang Stu,0,0,0,0,0,0,1,0,1,1,1,2,0,0,0,0,0,0,2,1,3
fa10,103,REVELLE,LING,Ling-CogLn,0,0,0,0,0,0,1,0,1,0,3,3,0,2,2,0,0,0,1,5,6
fa10,103,REVELLE,LING,Linguistcs,0,2,2,0,1,1,0,1,1,0,2,2,1,2,3,0,0,0,1,8,9
fa10,103,REVELLE,LIT,Ital Lit,0,0,0,0,0,0,0,0,0,0,0,0,0,3,3,0,0,0,0,3,3
fa10,103,REVELLE,LIT,Lit/Compos,0,1,1,0,0,0,0,0,0,1,1,2,0,0,0,0,0,0,1,2,3
fa10,103,REVELLE,LIT,Lit/Engl,0,0,0,0,0,0,0,2,2,1,1,2,0,3,3,0,0,0,1,6,7
fa10,103,REVELLE,LIT,Lit/World,0,0,0,0,0,0,0,0,0,2,0,2,2,4,6,0,0,0,4,4,8
fa10,103,REVELLE,LIT,Lit/Writng,1,2,3,0,0,0,0,1,1,1,1,2,2,2,4,0,0,0,4,6,10
fa10,103,REVELLE,LIT,Pre-Lit/Wr,0,0,0,0,0,0,0,2,2,0,0,0,4,2,6,0,0,0,4,4,8
fa10,103,REVELLE,LIT,Spanish Lt,0,0,0,0,1,1,0,0,0,0,0,0,0,3,3,0,0,0,0,4,4
fa10,103,REVELLE,MAE,Aerosp Eng,9,2,11,0,0,0,3,1,4,8,2,10,16,4,20,0,0,0,36,9,45
fa10,103,REVELLE,MAE,Engin Sci,4,1,5,0,0,0,1,0,1,1,1,2,2,1,3,0,0,0,8,3,11
fa10,103,REVELLE,MAE,Envir Eng,6,2,8,1,0,1,2,2,4,0,2,2,1,0,1,0,0,0,10,6,16
fa10,103,REVELLE,MAE,Mech Engin,11,3,14,0,0,0,5,2,7,20,1,21,39,11,50,0,0,0,75,17,92
fa10,103,REVELLE,MATH,Appld Math,3,3,6,0,0,0,1,0,1,1,0,1,2,1,3,0,0,0,7,4,11
fa10,103,REVELLE,MATH,Math/SecEd,0,0,0,0,0,0,0,0,0,3,0,3,0,1,1,0,0,0,3,1,4
fa10,103,REVELLE,MATH,Mathematcs,3,3,6,0,0,0,3,3,6,1,3,4,7,10,17,0,0,0,14,19,33
fa10,103,REVELLE,MATH,Mth-CompSc,0,0,0,0,0,0,0,0,0,0,0,0,1,0,1,0,0,0,1,0,1
fa10,103,REVELLE,MATH,Mth-Mth&Ec,2,2,4,0,0,0,1,1,2,2,1,3,7,0,7,0,0,0,12,4,16
fa10,103,REVELLE,MATH,Mth-SciCom,0,1,1,0,0,0,0,0,0,0,1,1,0,1,1,0,0,0,0,3,3
fa10,103,REVELLE,MATH,Mth/ApldSc,1,2,3,0,0,0,0,0,0,0,0,0,0,1,1,0,0,0,1,3,4
fa10,103,REVELLE,MATH,Prob&Stats,0,1,1,0,0,0,0,0,0,2,0,2,2,1,3,0,0,0,4,2,6
fa10,103,REVELLE,MUS,Mu-CompArt,0,0,0,0,0,0,0,0,0,1,0,1,4,1,5,0,0,0,5,1,6
fa10,103,REVELLE,MUS,Music,0,1,1,0,0,0,1,0,1,2,0,2,6,1,7,0,0,0,9,2,11
fa10,103,REVELLE,MUS,Music Hum,0,0,0,0,0,0,0,0,0,1,0,1,0,0,0,0,0,0,1,0,1
fa10,103,REVELLE,NENG,NanoEng,11,4,15,0,0,0,2,0,2,1,2,3,0,0,0,0,0,0,14,6,20
fa10,103,REVELLE,PHIL,Philosophy,0,0,0,0,0,0,2,0,2,5,1,6,4,1,5,0,0,0,11,2,13
fa10,103,REVELLE,PHYS,Biophysics,0,1,1,1,0,1,0,1,1,0,0,0,1,1,2,0,0,0,2,3,5
fa10,103,REVELLE,PHYS,GenPys/SEd,1,0,1,0,0,0,0,0,0,0,0,0,0,0,0,0,0,0,1,0,1
fa10,103,REVELLE,PHYS,Phy/ErthSc,0,0,0,0,0,0,0,0,0,1,0,1,1,0,1,0,0,0,2,0,2
fa10,103,REVELLE,PHYS,Phys/Astro,2,0,2,0,0,0,0,0,0,3,1,4,4,2,6,0,0,0,9,3,12
fa10,103,REVELLE,PHYS,Phys/Comp,0,0,0,0,0,0,2,1,3,0,0,0,0,0,0,0,0,0,2,1,3
fa10,103,REVELLE,PHYS,Phys/Mtrls,0,1,1,0,0,0,1,0,1,1,0,1,0,0,0,0,0,0,2,1,3
fa10,103,REVELLE,PHYS,Physics,8,1,9,0,0,0,2,0,2,4,1,5,10,2,12,0,0,0,24,4,28
fa10,103,REVELLE,POLI,Polit Sci,0,2,2,1,0,1,1,5,6,12,6,18,10,7,17,0,0,0,24,20,44
fa10,103,REVELLE,POLI,PolSc-Amer,1,0,1,0,0,0,1,1,2,1,1,2,0,3,3,0,0,0,3,5,8
fa10,103,REVELLE,POLI,PolSc-Comp,0,0,0,0,1,1,0,0,0,0,0,0,0,1,1,0,0,0,0,2,2
fa10,103,REVELLE,POLI,PolSc-Intl,1,1,2,0,0,0,0,2,2,6,7,13,8,4,12,0,0,0,15,14,29
fa10,103,REVELLE,POLI,PolSc-PLaw,1,1,2,1,0,1,0,1,1,5,3,8,3,3,6,0,0,0,10,8,18
fa10,103,REVELLE,POLI,PolSc-PPol,2,1,3,0,0,0,0,0,0,0,0,0,0,4,4,0,0,0,2,5,7
fa10,103,REVELLE,POLI,PolSc-Thry,1,0,1,0,0,0,0,0,0,0,0,0,0,1,1,0,0,0,1,1,2
fa10,103,REVELLE,PSYC,Psychology,9,21,30,0,1,1,9,29,38,20,52,72,26,65,91,0,0,0,64,168,232
fa10,103,REVELLE,RELI,Relig/Stu,0,0,0,0,0,0,0,0,0,0,0,0,1,0,1,0,0,0,1,0,1
fa10,103,REVELLE,SE,Struct Eng,10,1,11,0,1,1,4,3,7,12,2,14,22,12,34,0,0,0,48,19,67
fa10,103,REVELLE,SIO,Earth Sci,0,1,1,0,0,0,0,0,0,3,0,3,2,0,2,0,0,0,5,1,6
fa10,103,REVELLE,SIO,ErSc-Geoch,0,0,0,0,0,0,0,0,0,0,0,0,0,1,1,0,0,0,0,1,1
fa10,103,REVELLE,SIO,ErSc-Geol,0,0,0,0,0,0,0,0,0,1,0,1,1,1,2,0,0,0,2,1,3
fa10,103,REVELLE,SOC,SocCulCom,0,0,0,0,0,0,0,0,0,0,0,0,1,1,2,0,0,0,1,1,2
fa10,103,REVELLE,SOC,SocEconSoc,0,0,0,0,0,0,0,0,0,0,1,1,2,0,2,0,0,0,2,1,3
fa10,103,REVELLE,SOC,Sociology,1,2,3,0,0,0,0,3,3,2,8,10,4,5,9,0,0,0,7,18,25
fa10,103,REVELLE,SOC,SocLawSoc,0,0,0,0,0,0,0,0,0,0,2,2,2,1,3,0,0,0,2,3,5
fa10,103,REVELLE,SOC,SocSciMed,0,0,0,0,0,0,0,0,0,0,3,3,0,0,0,0,0,0,0,3,3
fa10,103,REVELLE,SOC,SocSolneq,0,0,0,0,0,0,0,0,0,0,0,0,0,1,1,0,0,0,0,1,1
fa10,103,REVELLE,THEA,Dance,1,1,2,0,0,0,0,0,0,0,0,0,0,1,1,0,0,0,1,2,3
fa10,103,REVELLE,THEA,Theatre,2,0,2,0,0,0,0,0,0,0,4,4,1,2,3,0,0,0,3,6,9
fa10,103,REVELLE,TWS,ThirdWldSt,0,0,0,0,0,0,0,0,0,0,1,1,0,0,0,0,0,0,0,1,1
fa10,103,REVELLE,UNAF,Limited St,0,0,0,0,0,0,0,0,0,0,0,0,0,0,0,6,5,11,6,5,11
fa10,103,REVELLE,UNAF,Spec-Emply,0,0,0,0,0,0,0,0,0,0,0,0,0,0,0,3,3,6,3,3,6
fa10,103,REVELLE,UNAF,UndecBiolS,0,0,0,0,0,0,0,0,0,1,0,1,0,0,0,0,0,0,1,0,1
fa10,103,REVELLE,UNAF,UndecHumAr,0,3,3,0,0,0,0,4,4,0,0,0,0,0,0,0,0,0,0,7,7
fa10,103,REVELLE,UNAF,Undeclared,41,61,102,1,2,3,10,27,37,2,3,5,0,0,0,0,0,0,54,93,147
fa10,103,REVELLE,UNAF,UndecPhysS,6,7,13,0,0,0,2,5,7,1,0,1,0,0,0,0,0,0,9,12,21
fa10,103,REVELLE,UNAF,UndecSocSc,0,3,3,0,1,1,3,0,3,1,0,1,0,0,0,0,0,0,4,4,8
fa10,103,REVELLE,USP,Urb Stu&Pl,0,0,0,0,0,0,2,0,2,1,3,4,0,1,1,0,0,0,3,4,7
fa10,103,REVELLE,VIS,Art Hst/Cr,0,0,0,0,0,0,0,1,1,0,1,1,0,2,2,0,0,0,0,4,4
fa10,103,REVELLE,VIS,Media,0,0,0,0,0,0,1,0,1,0,3,3,3,5,8,0,0,0,4,8,12
fa10,103,REVELLE,VIS,Studio VA,0,0,0,0,0,0,0,0,0,1,0,1,1,4,5,0,0,0,2,4,6
fa10,103,REVELLE,VIS,VA-CompArt,0,0,0,0,0,0,0,1,1,0,1,1,4,2,6,0,0,0,4,4,8
fa10,103,ROOSEVELT,ANTH,Anth-Arch,2,1,3,0,0,0,0,2,2,0,4,4,3,4,7,0,0,0,5,11,16
fa10,103,ROOSEVELT,ANTH,Anth-Biol,0,0,0,0,0,0,0,1,1,1,4,5,2,5,7,0,0,0,3,10,13
fa10,103,ROOSEVELT,ANTH,Anth-Soci,0,3,3,0,0,0,0,4,4,0,6,6,2,4,6,0,0,0,2,17,19
fa10,103,ROOSEVELT,BENG,Bioen:Binf,0,0,0,0,0,0,0,0,0,0,1,1,0,1,1,0,0,0,0,2,2
fa10,103,ROOSEVELT,BENG,Bioeng:PM,0,0,0,0,0,0,1,0,1,4,1,5,6,5,11,0,0,0,11,6,17
fa10,103,ROOSEVELT,BENG,BioengBiot,1,1,2,0,0,0,5,1,6,6,4,10,7,2,9,0,0,0,19,8,27
fa10,103,ROOSEVELT,BENG,Bioengin,1,1,2,0,0,0,2,1,3,3,1,4,4,8,12,0,0,0,10,11,21
fa10,103,ROOSEVELT,BENG,Pr-BioenPM,0,0,0,0,1,1,2,0,2,4,0,4,0,1,1,0,0,0,6,2,8
fa10,103,ROOSEVELT,BIOL,Bioc/CellB,3,6,9,0,0,0,1,3,4,8,12,20,24,34,58,0,0,0,36,55,91
fa10,103,ROOSEVELT,BIOL,Ec/Beh/Evo,1,0,1,0,0,0,2,3,5,1,7,8,1,9,10,0,0,0,5,19,24
fa10,103,ROOSEVELT,BIOL,Genl Biol,8,13,21,0,0,0,4,4,8,12,24,36,27,58,85,0,0,0,51,99,150
fa10,103,ROOSEVELT,BIOL,Human Bio,9,26,35,1,2,3,14,19,33,24,55,79,42,66,108,0,0,0,90,168,258
fa10,103,ROOSEVELT,BIOL,Microbiol,0,1,1,0,0,0,1,0,1,2,4,6,4,2,6,0,0,0,7,7,14
fa10,103,ROOSEVELT,BIOL,Molec Biol,2,2,4,0,0,0,1,0,1,2,4,6,5,9,14,0,0,0,10,15,25
fa10,103,ROOSEVELT,BIOL,PhyslNeuro,4,4,8,0,1,1,3,3,6,11,9,20,13,24,37,0,0,0,31,41,72
fa10,103,ROOSEVELT,CENG,Chem Engin,2,2,4,1,0,1,3,0,3,2,5,7,3,2,5,0,0,0,11,9,20
fa10,103,ROOSEVELT,CGS,CritGendSt,0,0,0,0,0,0,0,0,0,0,0,0,0,1,1,0,0,0,0,1,1
fa10,103,ROOSEVELT,CHEM,Bioch/Chem,8,14,22,0,1,1,11,10,21,7,6,13,12,6,18,0,0,0,38,37,75
fa10,103,ROOSEVELT,CHEM,Bioinform,0,0,0,0,0,0,1,0,1,0,0,0,0,0,0,0,0,0,1,0,1
fa10,103,ROOSEVELT,CHEM,Chemistry,0,5,5,1,0,1,2,1,3,6,1,7,4,3,7,0,0,0,13,10,23
fa10,103,ROOSEVELT,CHEM,Envir Chem,0,0,0,0,0,0,1,1,2,2,0,2,0,0,0,0,0,0,3,1,4
fa10,103,ROOSEVELT,CHEM,Pharm Chem,7,6,13,0,1,1,1,7,8,8,11,19,3,4,7,0,0,0,19,29,48
fa10,103,ROOSEVELT,CHIN,Chinese St,0,2,2,0,0,0,1,2,3,0,0,0,1,3,4,0,0,0,2,7,9
fa10,103,ROOSEVELT,CLAS,Classic St,1,0,1,0,0,0,0,1,1,0,0,0,0,0,0,0,0,0,1,1,2
fa10,103,ROOSEVELT,COGS,Cog Sci,1,3,4,0,0,0,3,4,7,4,6,10,6,6,12,0,0,0,14,19,33
fa10,103,ROOSEVELT,COGS,CogSc/ClAs,0,0,0,0,0,0,0,1,1,0,1,1,1,0,1,0,0,0,1,2,3
fa10,103,ROOSEVELT,COGS,CogSc/HCI,0,0,0,0,0,0,0,2,2,1,1,2,7,3,10,0,0,0,8,6,14
fa10,103,ROOSEVELT,COGS,CogSc/HCog,1,1,2,0,0,0,1,1,2,0,1,1,1,0,1,0,0,0,3,3,6
fa10,103,ROOSEVELT,COGS,CogSc/Neur,1,3,4,1,0,1,3,4,7,2,5,7,3,12,15,0,0,0,10,24,34
fa10,103,ROOSEVELT,COMM,Communic,1,13,14,0,0,0,5,26,31,25,45,70,18,57,75,0,0,0,49,141,190
fa10,103,ROOSEVELT,CSE,Comp Sci,2,2,4,0,0,0,6,4,10,22,5,27,20,4,24,0,0,0,50,15,65
fa10,103,ROOSEVELT,CSE,CompEngCSE,9,1,10,1,0,1,3,0,3,3,1,4,5,0,5,0,0,0,21,2,23
fa10,103,ROOSEVELT,CSE,CompScBinf,0,0,0,0,0,0,0,0,0,0,2,2,0,0,0,0,0,0,0,2,2
fa10,103,ROOSEVELT,ECE,CompEngECE,0,0,0,0,0,0,0,0,0,3,0,3,0,0,0,0,0,0,3,0,3
fa10,103,ROOSEVELT,ECE,Electr Eng,5,3,8,0,0,0,3,0,3,11,1,12,14,3,17,0,0,0,33,7,40
fa10,103,ROOSEVELT,ECE,Pr-EngPhys,0,0,0,0,0,0,1,0,1,0,0,0,0,0,0,0,0,0,1,0,1
fa10,103,ROOSEVELT,ECON,Ec-Mth&Ecn,4,6,10,0,0,0,0,0,0,4,2,6,11,3,14,0,0,0,19,11,30
fa10,103,ROOSEVELT,ECON,Econ-MgtSc,5,7,12,1,0,1,11,7,18,20,18,38,44,28,72,0,0,0,81,60,141
fa10,103,ROOSEVELT,ECON,Economics,10,18,28,1,1,2,21,15,36,62,41,103,61,31,92,0,0,0,155,106,261
fa10,103,ROOSEVELT,ESYS,EnvSys(EB),3,2,5,0,0,0,1,3,4,1,7,8,3,8,11,0,0,0,8,20,28
fa10,103,ROOSEVELT,ESYS,EnvSys(EC),0,1,1,0,0,0,0,1,1,0,0,0,0,0,0,0,0,0,0,2,2
fa10,103,ROOSEVELT,ESYS,EnvSys(EP),0,1,1,0,0,0,0,0,0,0,2,2,2,2,4,0,0,0,2,5,7
fa10,103,ROOSEVELT,ESYS,EnvSys(ES),0,0,0,0,0,0,0,3,3,1,3,4,0,1,1,0,0,0,1,7,8
fa10,103,ROOSEVELT,ETHN,Ethnic St,0,1,1,0,0,0,1,3,4,0,3,3,0,8,8,0,0,0,1,15,16
fa10,103,ROOSEVELT,HDP,Human Dev,0,0,0,0,0,0,0,1,1,0,1,1,1,16,17,0,0,0,1,18,19
fa10,103,ROOSEVELT,HDP,Pr-HumnDev,0,1,1,0,1,1,2,12,14,1,11,12,0,3,3,0,0,0,3,28,31
fa10,103,ROOSEVELT,HIST,History,4,6,10,0,0,0,2,7,9,12,13,25,16,24,40,0,0,0,34,50,84
fa10,103,ROOSEVELT,INTD,Roos IndSt,0,0,0,0,0,0,0,0,0,0,0,0,1,0,1,0,0,0,1,0,1
fa10,103,ROOSEVELT,INTL,Int-5yrPS,0,0,0,0,0,0,0,0,0,0,0,0,1,1,2,0,0,0,1,1,2
fa10,103,ROOSEVELT,INTL,IntSt-Anth,0,1,1,0,0,0,0,2,2,0,7,7,1,4,5,0,0,0,1,14,15
fa10,103,ROOSEVELT,INTL,IntSt-Econ,4,12,16,0,0,0,5,11,16,11,18,29,20,30,50,0,0,0,40,71,111
fa10,103,ROOSEVELT,INTL,IntSt-Hist,3,3,6,0,1,1,1,1,2,3,7,10,6,11,17,0,0,0,13,23,36
fa10,103,ROOSEVELT,INTL,IntSt-Ling,0,4,4,0,1,1,1,4,5,0,2,2,1,3,4,0,0,0,2,14,16
fa10,103,ROOSEVELT,INTL,IntSt-Lit,0,0,0,0,0,0,0,1,1,0,0,0,0,1,1,0,0,0,0,2,2
fa10,103,ROOSEVELT,INTL,IntSt-PolS,6,15,21,0,0,0,1,11,12,12,28,40,11,37,48,0,0,0,30,91,121
fa10,103,ROOSEVELT,INTL,IntSt-Soc,1,5,6,0,1,1,0,6,6,1,23,24,0,16,16,0,0,0,2,51,53
fa10,103,ROOSEVELT,ITAL,Italian St,0,0,0,0,0,0,0,0,0,0,0,0,1,0,1,0,0,0,1,0,1
fa10,103,ROOSEVELT,JAPN,JapaneseSt,0,2,2,0,0,0,1,0,1,1,2,3,1,1,2,0,0,0,3,5,8
fa10,103,ROOSEVELT,LATI,LatinAm St,0,0,0,0,0,0,0,1,1,1,2,3,1,2,3,0,0,0,2,5,7
fa10,103,ROOSEVELT,LING,Lang Stu,0,3,3,0,0,0,0,0,0,0,1,1,0,1,1,0,0,0,0,5,5
fa10,103,ROOSEVELT,LING,Ling-CogLn,0,0,0,0,0,0,0,0,0,0,1,1,0,1,1,0,0,0,0,2,2
fa10,103,ROOSEVELT,LING,Ling-LSoc,1,2,3,0,0,0,0,1,1,0,2,2,1,0,1,0,0,0,2,5,7
fa10,103,ROOSEVELT,LING,Linguistcs,0,0,0,0,0,0,0,2,2,0,5,5,0,5,5,0,0,0,0,12,12
fa10,103,ROOSEVELT,LIT,French Lit,0,1,1,0,0,0,0,0,0,0,0,0,1,1,2,0,0,0,1,2,3
fa10,103,ROOSEVELT,LIT,Lit/Compos,0,0,0,0,0,0,0,0,0,0,0,0,1,2,3,0,0,0,1,2,3
fa10,103,ROOSEVELT,LIT,Lit/CultSt,0,0,0,0,0,0,0,0,0,0,1,1,0,1,1,0,0,0,0,2,2
fa10,103,ROOSEVELT,LIT,Lit/Engl,0,1,1,0,1,1,1,1,2,1,6,7,4,7,11,0,0,0,6,16,22
fa10,103,ROOSEVELT,LIT,Lit/World,0,0,0,0,0,0,0,0,0,0,1,1,1,2,3,0,0,0,1,3,4
fa10,103,ROOSEVELT,LIT,Lit/Writng,1,3,4,0,0,0,0,0,0,5,5,10,2,14,16,0,0,0,8,22,30
fa10,103,ROOSEVELT,LIT,Pre-Lit/Wr,0,0,0,0,0,0,0,3,3,2,5,7,6,1,7,0,0,0,8,9,17
fa10,103,ROOSEVELT,LIT,Spanish Lt,1,0,1,0,0,0,0,0,0,1,1,2,0,1,1,0,0,0,2,2,4
fa10,103,ROOSEVELT,MAE,Aerosp Eng,3,1,4,0,0,0,6,0,6,8,2,10,10,3,13,0,0,0,27,6,33
fa10,103,ROOSEVELT,MAE,Engin Sci,2,1,3,0,0,0,0,0,0,2,0,2,0,0,0,0,0,0,4,1,5
fa10,103,ROOSEVELT,MAE,Envir Eng,3,3,6,0,0,0,0,2,2,3,0,3,2,3,5,0,0,0,8,8,16
fa10,103,ROOSEVELT,MAE,Mech Engin,5,0,5,0,0,0,6,1,7,23,2,25,23,5,28,0,0,0,57,8,65
fa10,103,ROOSEVELT,MATH,Appld Math,2,1,3,0,1,1,0,0,0,0,0,0,2,0,2,0,0,0,4,2,6
fa10,103,ROOSEVELT,MATH,Math/SecEd,0,0,0,0,0,0,0,0,0,0,0,0,1,0,1,0,0,0,1,0,1
fa10,103,ROOSEVELT,MATH,Mathematcs,3,2,5,0,0,0,2,0,2,2,1,3,2,1,3,0,0,0,9,4,13
fa10,103,ROOSEVELT,MATH,Mth-CompSc,0,0,0,0,0,0,0,1,1,0,0,0,1,1,2,0,0,0,1,2,3
fa10,103,ROOSEVELT,MATH,Mth-Mth&Ec,1,2,3,0,0,0,1,1,2,3,1,4,2,0,2,0,0,0,7,4,11
fa10,103,ROOSEVELT,MATH,Mth-SciCom,0,0,0,0,0,0,0,0,0,0,0,0,0,1,1,0,0,0,0,1,1
fa10,103,ROOSEVELT,MATH,Mth/ApldSc,0,0,0,0,0,0,1,0,1,0,0,0,2,0,2,0,0,0,3,0,3
fa10,103,ROOSEVELT,MATH,Prob&Stats,0,0,0,0,0,0,0,1,1,2,2,4,0,0,0,0,0,0,2,3,5
fa10,103,ROOSEVELT,MUS,Mu-CompArt,1,1,2,0,0,0,0,0,0,0,1,1,3,0,3,0,0,0,4,2,6
fa10,103,ROOSEVELT,MUS,Music,1,1,2,0,0,0,1,0,1,1,3,4,4,3,7,0,0,0,7,7,14
fa10,103,ROOSEVELT,MUS,Music Hum,0,1,1,0,0,0,0,0,0,0,0,0,0,0,0,0,0,0,0,1,1
fa10,103,ROOSEVELT,NENG,NanoEng,2,0,2,0,0,0,1,0,1,1,0,1,0,0,0,0,0,0,4,0,4
fa10,103,ROOSEVELT,PHIL,Philosophy,0,0,0,0,0,0,0,1,1,3,2,5,2,1,3,0,0,0,5,4,9
fa10,103,ROOSEVELT,PHYS,Biophysics,0,0,0,0,0,0,0,0,0,0,0,0,0,1,1,0,0,0,0,1,1
fa10,103,ROOSEVELT,PHYS,Gen Physcs,0,1,1,0,0,0,0,0,0,0,0,0,0,0,0,0,0,0,0,1,1
fa10,103,ROOSEVELT,PHYS,GenPys/SEd,0,0,0,0,0,0,0,0,0,0,0,0,1,1,2,0,0,0,1,1,2
fa10,103,ROOSEVELT,PHYS,Phys/Astro,1,0,1,0,0,0,0,0,0,1,0,1,1,0,1,0,0,0,3,0,3
fa10,103,ROOSEVELT,PHYS,Physics,1,1,2,0,0,0,1,0,1,1,1,2,4,3,7,0,0,0,7,5,12
fa10,103,ROOSEVELT,POLI,Polit Sci,6,5,11,0,1,1,4,6,10,30,21,51,25,31,56,0,0,0,65,64,129
fa10,103,ROOSEVELT,POLI,PolSc-Amer,0,1,1,0,0,0,2,3,5,2,4,6,4,3,7,0,0,0,8,11,19
fa10,103,ROOSEVELT,POLI,PolSc-Comp,0,0,0,0,0,0,0,0,0,2,0,2,0,4,4,0,0,0,2,4,6
fa10,103,ROOSEVELT,POLI,PolSc-Intl,2,8,10,1,3,4,9,13,22,18,17,35,12,20,32,0,0,0,42,61,103
fa10,103,ROOSEVELT,POLI,PolSc-PLaw,1,4,5,0,0,0,4,1,5,6,4,10,2,11,13,0,0,0,13,20,33
fa10,103,ROOSEVELT,POLI,PolSc-PPol,0,1,1,1,0,1,0,0,0,0,0,0,4,2,6,0,0,0,5,3,8
fa10,103,ROOSEVELT,POLI,PolSc-Thry,1,0,1,0,0,0,0,0,0,1,0,1,1,4,5,0,0,0,3,4,7
fa10,103,ROOSEVELT,PSYC,Psychology,11,30,41,2,1,3,9,25,34,24,66,90,36,79,115,0,0,0,82,201,283
fa10,103,ROOSEVELT,RELI,Relig/Stu,0,0,0,0,0,0,0,1,1,0,1,1,0,2,2,0,0,0,0,4,4
fa10,103,ROOSEVELT,SE,Engin Sci,2,0,2,0,1,1,1,0,1,0,1,1,0,0,0,0,0,0,3,2,5
fa10,103,ROOSEVELT,SE,Struct Eng,4,3,7,0,0,0,8,4,12,12,3,15,27,7,34,0,0,0,51,17,68
fa10,103,ROOSEVELT,SIO,Earth Sci,0,0,0,0,0,0,0,0,0,0,1,1,0,0,0,0,0,0,0,1,1
fa10,103,ROOSEVELT,SIO,ErSc-Geol,0,1,1,0,0,0,0,0,0,0,1,1,0,0,0,0,0,0,0,2,2
fa10,103,ROOSEVELT,SIO,ErSc-Geoph,0,0,0,0,0,0,0,0,0,1,0,1,0,0,0,0,0,0,1,0,1
fa10,103,ROOSEVELT,SOC,SocAmSt,0,0,0,0,0,0,0,0,0,0,1,1,0,2,2,0,0,0,0,3,3
fa10,103,ROOSEVELT,SOC,SocCulCom,0,1,1,0,0,0,0,0,0,0,2,2,1,2,3,0,0,0,1,5,6
fa10,103,ROOSEVELT,SOC,SocIntlStu,0,0,0,0,0,0,0,1,1,1,1,2,1,3,4,0,0,0,2,5,7
fa10,103,ROOSEVELT,SOC,Sociology,2,4,6,0,3,3,1,3,4,8,20,28,8,8,16,0,0,0,19,38,57
fa10,103,ROOSEVELT,SOC,SocLawSoc,0,0,0,0,0,0,1,1,2,1,1,2,2,2,4,0,0,0,4,4,8
fa10,103,ROOSEVELT,SOC,SocSciMed,0,0,0,0,0,0,0,1,1,0,0,0,1,0,1,0,0,0,1,1,2
fa10,103,ROOSEVELT,SOC,SocSolneq,0,0,0,0,0,0,0,0,0,0,1,1,0,3,3,0,0,0,0,4,4
fa10,103,ROOSEVELT,THEA,Dance,0,0,0,0,0,0,0,0,0,0,1,1,0,0,0,0,0,0,0,1,1
fa10,103,ROOSEVELT,THEA,Theatre,1,2,3,0,0,0,1,2,3,1,5,6,4,6,10,0,0,0,7,15,22
fa10,103,ROOSEVELT,TWS,ThirdWldSt,1,1,2,0,0,0,0,1,1,0,1,1,0,3,3,0,0,0,1,6,7
fa10,103,ROOSEVELT,UNAF,UndecHumAr,2,7,9,1,0,1,0,0,0,0,1,1,0,0,0,0,0,0,3,8,11
fa10,103,ROOSEVELT,UNAF,Undeclared,35,64,99,1,1,2,3,14,17,3,1,4,0,0,0,0,0,0,42,80,122
fa10,103,ROOSEVELT,UNAF,UndecPhysS,5,7,12,0,0,0,1,2,3,1,0,1,0,0,0,0,0,0,7,9,16
fa10,103,ROOSEVELT,UNAF,UndecSocSc,3,16,19,0,0,0,0,1,1,1,0,1,0,0,0,0,0,0,4,17,21
fa10,103,ROOSEVELT,USP,Urb Stu&Pl,0,1,1,0,1,1,0,2,2,6,8,14,7,13,20,0,0,0,13,25,38
fa10,103,ROOSEVELT,VIS,Art Hst/Cr,1,1,2,0,0,0,0,0,0,1,1,2,1,5,6,0,0,0,3,7,10
fa10,103,ROOSEVELT,VIS,Media,1,4,5,0,0,0,1,0,1,3,11,14,7,9,16,0,0,0,12,24,36
fa10,103,ROOSEVELT,VIS,Studio VA,0,0,0,0,0,0,1,2,3,0,4,4,1,4,5,0,0,0,2,10,12
fa10,103,ROOSEVELT,VIS,VA-CompArt,0,0,0,0,0,0,0,0,0,0,2,2,2,3,5,0,0,0,2,5,7
fa10,103,SIXTH,ANTH,Anth-Arch,0,2,2,0,0,0,0,1,1,1,3,4,1,1,2,0,0,0,2,7,9
fa10,103,SIXTH,ANTH,Anth-Biol,0,0,0,0,0,0,0,0,0,1,5,6,1,5,6,0,0,0,2,10,12
fa10,103,SIXTH,ANTH,Anth-Soci,1,2,3,0,0,0,0,2,2,1,4,5,0,7,7,0,0,0,2,15,17
fa10,103,SIXTH,BENG,Bioen:Binf,0,0,0,0,0,0,1,0,1,0,0,0,3,0,3,0,0,0,4,0,4
fa10,103,SIXTH,BENG,Bioeng:PM,0,0,0,0,0,0,1,0,1,2,1,3,9,3,12,0,0,0,12,4,16
fa10,103,SIXTH,BENG,BioengBiot,4,2,6,0,0,0,3,2,5,7,2,9,10,2,12,0,0,0,24,8,32
fa10,103,SIXTH,BENG,Bioengin,3,1,4,0,0,0,3,3,6,3,1,4,3,2,5,0,0,0,12,7,19
fa10,103,SIXTH,BENG,Pr-BioenPM,0,0,0,1,0,1,4,1,5,2,0,2,0,0,0,0,0,0,7,1,8
fa10,103,SIXTH,BIOL,Bioc/CellB,5,1,6,0,0,0,2,5,7,10,11,21,31,30,61,0,0,0,48,47,95
fa10,103,SIXTH,BIOL,BiolBioinf,0,0,0,0,0,0,0,0,0,0,0,0,1,0,1,0,0,0,1,0,1
fa10,103,SIXTH,BIOL,Ec/Beh/Evo,0,2,2,0,0,0,0,0,0,1,2,3,3,12,15,0,0,0,4,16,20
fa10,103,SIXTH,BIOL,Genl Biol,6,13,19,0,0,0,4,6,10,13,12,25,32,47,79,0,0,0,55,78,133
fa10,103,SIXTH,BIOL,Human Bio,16,9,25,2,0,2,9,5,14,38,35,73,39,51,90,0,0,0,104,100,204
fa10,103,SIXTH,BIOL,Microbiol,0,2,2,0,0,0,2,1,3,2,3,5,5,6,11,0,0,0,9,12,21
fa10,103,SIXTH,BIOL,Molec Biol,2,3,5,0,0,0,0,0,0,2,1,3,4,10,14,0,0,0,8,14,22
fa10,103,SIXTH,BIOL,PhyslNeuro,6,7,13,0,0,0,0,3,3,9,9,18,12,16,28,0,0,0,27,35,62
fa10,103,SIXTH,CENG,Chem Engin,8,3,11,0,0,0,1,0,1,7,1,8,15,3,18,0,0,0,31,7,38
fa10,103,SIXTH,CGS,CritGendSt,0,0,0,0,0,0,0,1,1,0,0,0,0,1,1,0,0,0,0,2,2
fa10,103,SIXTH,CHEM,Bioch/Chem,16,13,29,0,0,0,9,8,17,9,7,16,11,8,19,0,0,0,45,36,81
fa10,103,SIXTH,CHEM,Bioinform,0,0,0,0,0,0,1,0,1,0,0,0,0,0,0,0,0,0,1,0,1
fa10,103,SIXTH,CHEM,Chem Educ,0,0,0,0,0,0,0,0,0,1,0,1,0,0,0,0,0,0,1,0,1
fa10,103,SIXTH,CHEM,Chemistry,9,5,14,0,0,0,1,5,6,1,3,4,8,3,11,0,0,0,19,16,35
fa10,103,SIXTH,CHEM,Envir Chem,0,0,0,0,0,0,0,0,0,0,1,1,2,0,2,0,0,0,2,1,3
fa10,103,SIXTH,CHEM,MolecSynth,0,0,0,0,0,0,0,1,1,0,0,0,0,1,1,0,0,0,0,2,2
fa10,103,SIXTH,CHEM,Pharm Chem,6,11,17,1,0,1,6,9,15,7,13,20,7,9,16,0,0,0,27,42,69
fa10,103,SIXTH,CHIN,Chinese St,0,1,1,0,0,0,0,1,1,1,0,1,0,0,0,0,0,0,1,2,3
fa10,103,SIXTH,CLAS,Classic St,0,0,0,0,0,0,0,0,0,0,1,1,1,0,1,0,0,0,1,1,2
fa10,103,SIXTH,COGS,Cog Sci,3,2,5,0,0,0,5,3,8,5,0,5,9,2,11,0,0,0,22,7,29
fa10,103,SIXTH,COGS,CogSc/ClAs,0,0,0,0,0,0,0,2,2,0,1,1,0,3,3,0,0,0,0,6,6
fa10,103,SIXTH,COGS,CogSc/HCI,0,0,0,0,0,0,0,0,0,1,1,2,3,3,6,0,0,0,4,4,8
fa10,103,SIXTH,COGS,CogSc/HCog,0,0,0,0,0,0,1,0,1,0,0,0,1,0,1,0,0,0,2,0,2
fa10,103,SIXTH,COGS,CogSc/Neur,0,1,1,0,0,0,2,4,6,3,5,8,3,7,10,0,0,0,8,17,25
fa10,103,SIXTH,COMM,Communic,3,16,19,0,4,4,5,20,25,22,38,60,16,47,63,0,0,0,46,125,171
fa10,103,SIXTH,CSE,Comp Sci,18,7,25,2,1,3,20,5,25,30,5,35,64,9,73,0,0,0,134,27,161
fa10,103,SIXTH,CSE,CompEngCSE,17,3,20,1,0,1,6,1,7,9,0,9,22,1,23,0,0,0,55,5,60
fa10,103,SIXTH,CSE,CompScBinf,0,0,0,0,0,0,0,1,1,4,0,4,1,0,1,0,0,0,5,1,6
fa10,103,SIXTH,ECE,CompEngECE,3,1,4,0,0,0,1,0,1,2,0,2,4,0,4,0,0,0,10,1,11
fa10,103,SIXTH,ECE,Electr Eng,20,0,20,2,0,2,7,0,7,18,2,20,44,6,50,0,0,0,91,8,99
fa10,103,SIXTH,ECE,Engin Phys,1,0,1,0,0,0,0,0,0,0,0,0,0,0,0,0,0,0,1,0,1
fa10,103,SIXTH,ECE,Pr-EngPhys,2,0,2,1,0,1,2,0,2,2,1,3,0,0,0,0,0,0,7,1,8
fa10,103,SIXTH,ECON,Ec-Mth&Ecn,3,0,3,0,0,0,1,2,3,2,4,6,6,2,8,0,0,0,12,8,20
fa10,103,SIXTH,ECON,Econ-MgtSc,3,5,8,0,1,1,9,8,17,19,13,32,45,30,75,0,0,0,76,57,133
fa10,103,SIXTH,ECON,Economics,15,7,22,1,1,2,5,2,7,72,33,105,61,22,83,0,0,0,154,65,219
fa10,103,SIXTH,ESYS,EnvSys(EB),1,4,5,0,1,1,2,6,8,1,3,4,3,7,10,0,0,0,7,21,28
fa10,103,SIXTH,ESYS,EnvSys(EC),0,1,1,0,0,0,0,0,0,1,1,2,1,0,1,0,0,0,2,2,4
fa10,103,SIXTH,ESYS,EnvSys(EP),2,4,6,0,0,0,1,1,2,2,0,2,1,1,2,0,0,0,6,6,12
fa10,103,SIXTH,ESYS,EnvSys(ES),0,2,2,0,1,1,0,1,1,1,1,2,2,1,3,0,0,0,3,6,9
fa10,103,SIXTH,ETHN,Ethnic St,0,1,1,0,0,0,0,0,0,1,2,3,3,4,7,0,0,0,4,7,11
fa10,103,SIXTH,HDP,Human Dev,0,0,0,0,0,0,0,2,2,0,5,5,0,13,13,0,0,0,0,20,20
fa10,103,SIXTH,HDP,Pr-HumnDev,0,3,3,0,0,0,1,7,8,1,11,12,1,2,3,0,0,0,3,23,26
fa10,103,SIXTH,HIST,History,2,2,4,0,0,0,1,2,3,7,2,9,8,6,14,0,0,0,18,12,30
fa10,103,SIXTH,INTL,IntSt-Anth,0,0,0,0,0,0,0,0,0,0,4,4,2,2,4,0,0,0,2,6,8
fa10,103,SIXTH,INTL,IntSt-Econ,4,0,4,0,0,0,2,4,6,10,8,18,4,9,13,0,0,0,20,21,41
fa10,103,SIXTH,INTL,IntSt-Hist,0,1,1,0,0,0,0,1,1,0,2,2,1,4,5,0,0,0,1,8,9
fa10,103,SIXTH,INTL,IntSt-Ling,0,1,1,0,0,0,1,0,1,1,2,3,0,0,0,0,0,0,2,3,5
fa10,103,SIXTH,INTL,IntSt-PolS,1,3,4,0,0,0,5,0,5,3,8,11,9,9,18,0,0,0,18,20,38
fa10,103,SIXTH,INTL,IntSt-Soc,0,2,2,0,0,0,0,2,2,0,2,2,4,5,9,0,0,0,4,11,15
fa10,103,SIXTH,ITAL,Italian St,0,0,0,0,0,0,0,0,0,0,1,1,0,1,1,0,0,0,0,2,2
fa10,103,SIXTH,JAPN,JapaneseSt,0,1,1,0,0,0,0,0,0,1,2,3,1,0,1,0,0,0,2,3,5
fa10,103,SIXTH,LATI,LatinAm St,0,0,0,0,0,0,0,0,0,0,1,1,0,0,0,0,0,0,0,1,1
fa10,103,SIXTH,LING,Lang Stu,0,0,0,0,1,1,1,1,2,0,1,1,0,1,1,0,0,0,1,4,5
fa10,103,SIXTH,LING,Ling-CogLn,0,0,0,0,0,0,0,0,0,1,0,1,0,2,2,0,0,0,1,2,3
fa10,103,SIXTH,LING,Ling-LSoc,0,1,1,0,0,0,0,1,1,0,1,1,1,0,1,0,0,0,1,3,4
fa10,103,SIXTH,LING,Linguistcs,0,0,0,0,1,1,0,1,1,0,3,3,2,2,4,0,0,0,2,7,9
fa10,103,SIXTH,LIT,French Lit,0,0,0,0,0,0,0,0,0,0,0,0,0,1,1,0,0,0,0,1,1
fa10,103,SIXTH,LIT,Lit/Compos,0,0,0,0,0,0,1,0,1,0,0,0,0,0,0,0,0,0,1,0,1
fa10,103,SIXTH,LIT,Lit/CultSt,0,0,0,0,0,0,0,0,0,0,0,0,0,2,2,0,0,0,0,2,2
fa10,103,SIXTH,LIT,Lit/Engl,1,5,6,0,0,0,1,0,1,2,1,3,2,1,3,0,0,0,6,7,13
fa10,103,SIXTH,LIT,Lit/World,0,0,0,0,0,0,0,0,0,0,3,3,0,2,2,0,0,0,0,5,5
fa10,103,SIXTH,LIT,Lit/Writng,1,2,3,0,0,0,0,0,0,2,6,8,1,9,10,0,0,0,4,17,21
fa10,103,SIXTH,LIT,Pre-Lit/Wr,0,0,0,0,0,0,0,2,2,1,3,4,1,0,1,0,0,0,2,5,7
fa10,103,SIXTH,MAE,Aerosp Eng,9,4,13,2,0,2,11,2,13,17,1,18,27,3,30,0,0,0,66,10,76
fa10,103,SIXTH,MAE,Engin Sci,2,1,3,0,0,0,2,0,2,1,0,1,2,1,3,0,0,0,7,2,9
fa10,103,SIXTH,MAE,Envir Eng,8,5,13,0,0,0,4,0,4,3,2,5,3,3,6,0,0,0,18,10,28
fa10,103,SIXTH,MAE,Mech Engin,9,2,11,2,0,2,12,2,14,32,5,37,60,13,73,0,0,0,115,22,137
fa10,103,SIXTH,MATH,Appld Math,1,2,3,0,0,0,1,0,1,1,3,4,1,0,1,0,0,0,4,5,9
fa10,103,SIXTH,MATH,Math/SecEd,0,1,1,0,0,0,1,4,5,1,0,1,0,3,3,0,0,0,2,8,10
fa10,103,SIXTH,MATH,Mathematcs,4,2,6,0,0,0,1,1,2,3,3,6,2,5,7,0,0,0,10,11,21
fa10,103,SIXTH,MATH,Mth-CompSc,0,0,0,0,0,0,0,0,0,1,0,1,1,0,1,0,0,0,2,0,2
fa10,103,SIXTH,MATH,Mth-Mth&Ec,2,1,3,0,0,0,0,1,1,1,1,2,4,2,6,0,0,0,7,5,12
fa10,103,SIXTH,MATH,Mth/ApldSc,2,1,3,0,0,0,1,0,1,1,0,1,0,0,0,0,0,0,4,1,5
fa10,103,SIXTH,MATH,Pr-Math CS,5,0,5,0,0,0,0,0,0,0,0,0,0,0,0,0,0,0,5,0,5
fa10,103,SIXTH,MATH,Prob&Stats,1,0,1,0,0,0,0,1,1,1,0,1,2,0,2,0,0,0,4,1,5
fa10,103,SIXTH,MUS,Mu-CompArt,2,0,2,0,1,1,5,1,6,10,0,10,8,1,9,0,0,0,25,3,28
fa10,103,SIXTH,MUS,Music,2,0,2,0,0,0,2,1,3,2,2,4,5,3,8,0,0,0,11,6,17
fa10,103,SIXTH,NENG,NanoEng,1,1,2,0,0,0,2,0,2,0,0,0,0,0,0,0,0,0,3,1,4
fa10,103,SIXTH,PHIL,Philosophy,0,0,0,0,0,0,0,1,1,6,1,7,4,0,4,0,0,0,10,2,12
fa10,103,SIXTH,PHYS,Biophysics,3,0,3,0,0,0,0,0,0,2,0,2,1,0,1,0,0,0,6,0,6
fa10,103,SIXTH,PHYS,Phy/ErthSc,0,0,0,0,0,0,0,0,0,1,0,1,0,0,0,0,0,0,1,0,1
fa10,103,SIXTH,PHYS,Phys/Astro,1,0,1,0,0,0,0,0,0,1,1,2,2,0,2,0,0,0,4,1,5
fa10,103,SIXTH,PHYS,Phys/Comp,0,0,0,0,0,0,1,0,1,0,0,0,0,0,0,0,0,0,1,0,1
fa10,103,SIXTH,PHYS,Phys/Mtrls,1,0,1,0,0,0,0,0,0,0,0,0,0,0,0,0,0,0,1,0,1
fa10,103,SIXTH,PHYS,Physics,3,1,4,0,0,0,4,0,4,6,0,6,4,0,4,0,0,0,17,1,18
fa10,103,SIXTH,POLI,Polit Sci,6,3,9,1,0,1,5,5,10,17,4,21,17,7,24,0,0,0,46,19,65
fa10,103,SIXTH,POLI,PolSc-Amer,0,1,1,0,0,0,0,0,0,2,4,6,2,0,2,0,0,0,4,5,9
fa10,103,SIXTH,POLI,PolSc-Intl,1,2,3,0,1,1,2,3,5,5,7,12,8,3,11,0,0,0,16,16,32
fa10,103,SIXTH,POLI,PolSc-PLaw,0,3,3,1,0,1,3,6,9,2,1,3,5,2,7,0,0,0,11,12,23
fa10,103,SIXTH,POLI,PolSc-PPol,1,0,1,0,0,0,1,0,1,1,0,1,1,0,1,0,0,0,4,0,4
fa10,103,SIXTH,POLI,PolSc-Thry,0,0,0,0,0,0,0,0,0,1,0,1,2,0,2,0,0,0,3,0,3
fa10,103,SIXTH,PSYC,Psychology,14,27,41,2,0,2,11,16,27,26,31,57,27,62,89,0,0,0,80,136,216
fa10,103,SIXTH,RUSS,Russ&SovSt,0,0,0,0,0,0,0,0,0,0,1,1,0,0,0,0,0,0,0,1,1
fa10,103,SIXTH,SE,Engin Sci,0,1,1,0,0,0,1,0,1,0,0,0,0,0,0,0,0,0,1,1,2
fa10,103,SIXTH,SE,Struct Eng,10,5,15,0,0,0,12,3,15,10,4,14,30,14,44,0,0,0,62,26,88
fa10,103,SIXTH,SIO,Earth Sci,0,0,0,0,0,0,0,0,0,1,0,1,1,0,1,0,0,0,2,0,2
fa10,103,SIXTH,SIO,ErSc-Geol,0,1,1,0,0,0,0,0,0,0,0,0,0,0,0,0,0,0,0,1,1
fa10,103,SIXTH,SIO,ErSc-Geoph,0,0,0,0,0,0,0,1,1,0,0,0,0,0,0,0,0,0,0,1,1
fa10,103,SIXTH,SOC,SocCulCom,0,0,0,0,0,0,0,1,1,0,2,2,1,1,2,0,0,0,1,4,5
fa10,103,SIXTH,SOC,SocEconSoc,0,0,0,0,0,0,0,0,0,0,0,0,0,3,3,0,0,0,0,3,3
fa10,103,SIXTH,SOC,SocIntlStu,0,0,0,0,0,0,0,0,0,0,1,1,0,3,3,0,0,0,0,4,4
fa10,103,SIXTH,SOC,Sociology,0,4,4,0,0,0,1,2,3,2,12,14,6,9,15,0,0,0,9,27,36
fa10,103,SIXTH,SOC,SocLawSoc,0,1,1,0,0,0,0,1,1,1,2,3,0,2,2,0,0,0,1,6,7
fa10,103,SIXTH,SOC,SocSciMed,0,0,0,0,0,0,0,0,0,0,1,1,0,2,2,0,0,0,0,3,3
fa10,103,SIXTH,SOC,SocSolneq,0,0,0,0,0,0,0,0,0,0,2,2,0,1,1,0,0,0,0,3,3
fa10,103,SIXTH,THEA,Dance,0,1,1,0,0,0,0,0,0,0,1,1,0,3,3,0,0,0,0,5,5
fa10,103,SIXTH,THEA,Theatre,0,2,2,0,1,1,2,1,3,4,4,8,1,3,4,0,0,0,7,11,18
fa10,103,SIXTH,TWS,ThirdWldSt,0,0,0,0,0,0,0,1,1,0,0,0,0,1,1,0,0,0,0,2,2
fa10,103,SIXTH,UNAF,UndecBiolS,0,1,1,0,0,0,0,0,0,0,0,0,0,0,0,0,0,0,0,1,1
fa10,103,SIXTH,UNAF,UndecHumAr,3,8,11,0,0,0,0,1,1,0,0,0,0,0,0,0,0,0,3,9,12
fa10,103,SIXTH,UNAF,Undeclared,44,58,102,2,3,5,12,17,29,2,6,8,0,0,0,0,0,0,60,84,144
fa10,103,SIXTH,UNAF,UndecPhysS,4,8,12,0,0,0,0,0,0,0,0,0,0,0,0,0,0,0,4,8,12
fa10,103,SIXTH,UNAF,UndecSocSc,3,3,6,0,1,1,3,1,4,0,0,0,0,0,0,0,0,0,6,5,11
fa10,103,SIXTH,USP,Urb Stu&Pl,0,1,1,0,0,0,2,1,3,2,3,5,6,6,12,0,0,0,10,11,21
fa10,103,SIXTH,VIS,Art Hst/Cr,0,0,0,0,0,0,0,0,0,1,6,7,0,10,10,0,0,0,1,16,17
fa10,103,SIXTH,VIS,Media,4,7,11,0,1,1,2,12,14,21,11,32,12,17,29,0,0,0,39,48,87
fa10,103,SIXTH,VIS,Studio VA,1,3,4,0,0,0,1,1,2,6,11,17,5,8,13,0,0,0,13,23,36
fa10,103,SIXTH,VIS,VA-CompArt,1,3,4,0,0,0,2,2,4,7,8,15,8,5,13,0,0,0,18,18,36
fa10,103,WARREN,ANTH,Anth-Arch,0,0,0,0,0,0,0,0,0,2,3,5,1,4,5,0,0,0,3,7,10
fa10,103,WARREN,ANTH,Anth-Biol,0,0,0,0,0,0,0,1,1,0,0,0,0,5,5,0,0,0,0,6,6
fa10,103,WARREN,ANTH,Anth-Soci,0,1,1,0,0,0,0,1,1,1,2,3,0,5,5,0,0,0,1,9,10
fa10,103,WARREN,BENG,Bioen:Binf,2,1,3,0,0,0,0,0,0,0,1,1,7,1,8,0,0,0,9,3,12
fa10,103,WARREN,BENG,Bioeng:PM,0,0,0,0,0,0,2,1,3,6,1,7,21,9,30,0,0,0,29,11,40
fa10,103,WARREN,BENG,BioengBiot,3,7,10,0,0,0,12,6,18,24,12,36,24,4,28,0,0,0,63,29,92
fa10,103,WARREN,BENG,Bioengin,10,8,18,0,0,0,7,2,9,9,7,16,22,6,28,0,0,0,48,23,71
fa10,103,WARREN,BENG,Pr-BioenPM,0,0,0,0,0,0,9,4,13,5,2,7,0,0,0,0,0,0,14,6,20
fa10,103,WARREN,BIOL,Anml Physl,0,0,0,0,0,0,0,0,0,0,1,1,0,0,0,0,0,0,0,1,1
fa10,103,WARREN,BIOL,Bioc/CellB,10,12,22,0,0,0,9,7,16,19,14,33,61,64,125,0,0,0,99,97,196
fa10,103,WARREN,BIOL,BiolBioinf,0,0,0,0,0,0,0,0,0,0,0,0,1,0,1,0,0,0,1,0,1
fa10,103,WARREN,BIOL,Ec/Beh/Evo,2,1,3,0,0,0,0,2,2,3,1,4,9,13,22,0,0,0,14,17,31
fa10,103,WARREN,BIOL,Genl Biol,9,10,19,0,0,0,6,10,16,20,34,54,33,68,101,0,0,0,68,122,190
fa10,103,WARREN,BIOL,Human Bio,17,13,30,2,4,6,6,22,28,35,42,77,47,80,127,0,0,0,107,161,268
fa10,103,WARREN,BIOL,Microbiol,4,1,5,0,0,0,1,1,2,1,3,4,6,4,10,0,0,0,12,9,21
fa10,103,WARREN,BIOL,Molec Biol,2,1,3,0,0,0,1,0,1,7,4,11,8,11,19,0,0,0,18,16,34
fa10,103,WARREN,BIOL,PhyslNeuro,4,8,12,0,1,1,6,3,9,17,15,32,25,26,51,0,0,0,52,53,105
fa10,103,WARREN,CENG,Chem Engin,19,7,26,0,0,0,11,5,16,19,3,22,22,9,31,0,0,0,71,24,95
fa10,103,WARREN,CGS,CritGendSt,0,1,1,0,0,0,0,0,0,0,1,1,1,1,2,0,0,0,1,3,4
fa10,103,WARREN,CHEM,Bioch/Chem,19,18,37,3,1,4,9,8,17,14,10,24,12,13,25,0,0,0,57,50,107
fa10,103,WARREN,CHEM,Bioinform,0,0,0,0,0,0,0,0,0,0,1,1,0,0,0,0,0,0,0,1,1
fa10,103,WARREN,CHEM,Chem Phys,0,0,0,0,0,0,0,0,0,0,0,0,2,0,2,0,0,0,2,0,2
fa10,103,WARREN,CHEM,Chemistry,5,6,11,0,1,1,2,3,5,3,5,8,8,5,13,0,0,0,18,20,38
fa10,103,WARREN,CHEM,Envir Chem,0,0,0,0,0,0,0,0,0,0,0,0,1,0,1,0,0,0,1,0,1
fa10,103,WARREN,CHEM,MolecSynth,0,0,0,0,0,0,0,0,0,0,0,0,4,1,5,0,0,0,4,1,5
fa10,103,WARREN,CHEM,Pharm Chem,11,15,26,0,0,0,7,8,15,5,8,13,14,16,30,0,0,0,37,47,84
fa10,103,WARREN,CHIN,Chinese St,0,1,1,0,0,0,0,0,0,0,0,0,1,4,5,0,0,0,1,5,6
fa10,103,WARREN,CLAS,Classic St,0,0,0,0,0,0,0,0,0,0,1,1,0,0,0,0,0,0,0,1,1
fa10,103,WARREN,COGS,Cog Sci,3,3,6,0,0,0,1,2,3,0,7,7,3,4,7,0,0,0,7,16,23
fa10,103,WARREN,COGS,CogSc/ClAs,1,0,1,0,0,0,0,2,2,1,2,3,1,2,3,0,0,0,3,6,9
fa10,103,WARREN,COGS,CogSc/Comp,0,0,0,0,1,1,1,0,1,1,0,1,1,0,1,0,0,0,3,1,4
fa10,103,WARREN,COGS,CogSc/HCI,0,0,0,0,0,0,0,0,0,3,2,5,3,1,4,0,0,0,6,3,9
fa10,103,WARREN,COGS,CogSc/HCog,0,0,0,0,0,0,0,1,1,0,1,1,0,0,0,0,0,0,0,2,2
fa10,103,WARREN,COGS,CogSc/Neur,1,2,3,0,0,0,2,6,8,3,1,4,6,6,12,0,0,0,12,15,27
fa10,103,WARREN,COMM,Communic,2,5,7,1,3,4,4,10,14,13,30,43,22,36,58,0,0,0,42,84,126
fa10,103,WARREN,CSE,Comp Sci,30,7,37,0,0,0,26,6,32,41,8,49,64,12,76,0,0,0,161,33,194
fa10,103,WARREN,CSE,CompEngCSE,15,9,24,0,0,0,10,4,14,18,0,18,12,1,13,0,0,0,55,14,69
fa10,103,WARREN,CSE,CompScBinf,1,1,2,0,0,0,0,1,1,1,2,3,2,0,2,0,0,0,4,4,8
fa10,103,WARREN,ECE,CompEngECE,8,1,9,1,0,1,4,0,4,5,0,5,3,0,3,0,0,0,21,1,22
fa10,103,WARREN,ECE,Electr Eng,32,5,37,0,0,0,12,6,18,35,8,43,64,7,71,0,0,0,143,26,169
fa10,103,WARREN,ECE,EleEng&Soc,0,0,0,0,0,0,0,0,0,1,0,1,0,0,0,0,0,0,1,0,1
fa10,103,WARREN,ECE,Engin Phys,0,0,0,0,0,0,0,0,0,2,0,2,1,0,1,0,0,0,3,0,3
fa10,103,WARREN,ECE,Pr-EngPhys,2,0,2,0,0,0,0,0,0,2,0,2,0,0,0,0,0,0,4,0,4
fa10,103,WARREN,ECON,Ec-Mth&Ecn,1,1,2,1,2,3,1,0,1,8,1,9,9,7,16,0,0,0,20,11,31
fa10,103,WARREN,ECON,Econ-MgtSc,4,11,15,3,1,4,7,9,16,15,10,25,44,30,74,0,0,0,73,61,134
fa10,103,WARREN,ECON,Economics,13,10,23,1,0,1,7,4,11,68,29,97,56,40,96,0,0,0,145,83,228
fa10,103,WARREN,ESYS,EnvSys(EB),1,2,3,0,0,0,2,7,9,0,1,1,1,4,5,0,0,0,4,14,18
fa10,103,WARREN,ESYS,EnvSys(EC),0,0,0,0,0,0,0,2,2,0,0,0,1,1,2,0,0,0,1,3,4
fa10,103,WARREN,ESYS,EnvSys(EP),0,3,3,1,0,1,1,0,1,1,0,1,1,1,2,0,0,0,4,4,8
fa10,103,WARREN,ESYS,EnvSys(ES),0,0,0,0,0,0,0,1,1,2,0,2,1,1,2,0,0,0,3,2,5
fa10,103,WARREN,ETHN,Ethnic St,0,0,0,0,0,0,0,2,2,0,3,3,3,2,5,0,0,0,3,7,10
fa10,103,WARREN,HDP,Human Dev,0,0,0,0,0,0,0,0,0,1,2,3,1,10,11,0,0,0,2,12,14
fa10,103,WARREN,HDP,Pr-HumnDev,0,4,4,0,1,1,1,9,10,0,5,5,0,5,5,0,0,0,1,24,25
fa10,103,WARREN,HIST,History,2,2,4,0,0,0,4,2,6,13,6,19,24,10,34,0,0,0,43,20,63
fa10,103,WARREN,INTD,Wa Ind St,0,0,0,0,0,0,0,0,0,0,0,0,0,1,1,0,0,0,0,1,1
fa10,103,WARREN,INTL,IntSt-Anth,0,0,0,0,0,0,0,0,0,1,0,1,0,0,0,0,0,0,1,0,1
fa10,103,WARREN,INTL,IntSt-Econ,0,1,1,0,0,0,1,2,3,7,3,10,11,5,16,0,0,0,19,11,30
fa10,103,WARREN,INTL,IntSt-Hist,0,0,0,0,0,0,1,0,1,1,1,2,1,2,3,0,0,0,3,3,6
fa10,103,WARREN,INTL,IntSt-Ling,1,0,1,0,0,0,0,1,1,1,1,2,0,0,0,0,0,0,2,2,4
fa10,103,WARREN,INTL,IntSt-Lit,0,0,0,0,0,0,0,0,0,0,1,1,0,1,1,0,0,0,0,2,2
fa10,103,WARREN,INTL,IntSt-PolS,1,2,3,1,0,1,0,2,2,0,3,3,10,9,19,0,0,0,12,16,28
fa10,103,WARREN,INTL,IntSt-Soc,1,0,1,0,0,0,0,3,3,0,4,4,0,5,5,0,0,0,1,12,13
fa10,103,WARREN,ITAL,Italian St,0,1,1,0,0,0,0,0,0,1,0,1,0,0,0,0,0,0,1,1,2
fa10,103,WARREN,JAPN,JapaneseSt,0,0,0,0,0,0,0,0,0,0,0,0,3,0,3,0,0,0,3,0,3
fa10,103,WARREN,LING,Lang Stu,1,0,1,0,0,0,0,0,0,0,0,0,0,1,1,0,0,0,1,1,2
fa10,103,WARREN,LING,Ling-CogLn,0,0,0,0,0,0,0,1,1,0,1,1,0,0,0,0,0,0,0,2,2
fa10,103,WARREN,LING,Ling-LSoc,0,0,0,0,0,0,0,0,0,1,1,2,0,1,1,0,0,0,1,2,3
fa10,103,WARREN,LING,Linguistcs,0,1,1,0,0,0,0,0,0,0,3,3,1,3,4,0,0,0,1,7,8
fa10,103,WARREN,LIT,French Lit,0,0,0,0,0,0,0,0,0,0,0,0,1,0,1,0,0,0,1,0,1
fa10,103,WARREN,LIT,Lit/CultSt,0,0,0,0,0,0,0,0,0,0,0,0,0,1,1,0,0,0,0,1,1
fa10,103,WARREN,LIT,Lit/Engl,1,2,3,0,0,0,1,1,2,2,5,7,0,4,4,0,0,0,4,12,16
fa10,103,WARREN,LIT,Lit/World,0,0,0,0,0,0,0,0,0,0,1,1,0,1,1,0,0,0,0,2,2
fa10,103,WARREN,LIT,Lit/Writng,0,3,3,0,0,0,0,1,1,2,2,4,2,10,12,0,0,0,4,16,20
fa10,103,WARREN,LIT,Pre-Lit/Wr,0,0,0,0,0,0,1,0,1,2,1,3,1,2,3,0,0,0,4,3,7
fa10,103,WARREN,LIT,Spanish Lt,0,0,0,0,0,0,0,0,0,0,0,0,0,1,1,0,0,0,0,1,1
fa10,103,WARREN,MAE,Aerosp Eng,16,2,18,2,0,2,12,1,13,19,6,25,18,2,20,0,0,0,67,11,78
fa10,103,WARREN,MAE,Engin Sci,4,0,4,0,0,0,2,1,3,0,0,0,0,1,1,0,0,0,6,2,8
fa10,103,WARREN,MAE,Envir Eng,10,7,17,0,0,0,2,2,4,6,5,11,3,3,6,0,0,0,21,17,38
fa10,103,WARREN,MAE,Mech Engin,24,4,28,0,0,0,27,3,30,54,4,58,84,14,98,0,0,0,189,25,214
fa10,103,WARREN,MATH,Appld Math,5,0,5,0,0,0,0,0,0,0,1,1,5,2,7,0,0,0,10,3,13
fa10,103,WARREN,MATH,Math/SecEd,0,3,3,0,0,0,1,0,1,0,1,1,1,2,3,0,0,0,2,6,8
fa10,103,WARREN,MATH,Mathematcs,0,5,5,0,0,0,1,3,4,4,1,5,13,6,19,0,0,0,18,15,33
fa10,103,WARREN,MATH,Mth-Mth&Ec,3,2,5,0,0,0,0,0,0,0,2,2,3,2,5,0,0,0,6,6,12
fa10,103,WARREN,MATH,Mth-SciCom,1,0,1,0,0,0,1,1,2,0,0,0,1,0,1,0,0,0,3,1,4
fa10,103,WARREN,MATH,Mth/ApldSc,1,1,2,0,0,0,0,0,0,1,2,3,1,0,1,0,0,0,3,3,6
fa10,103,WARREN,MATH,Prob&Stats,1,0,1,0,0,0,2,0,2,0,1,1,1,3,4,0,0,0,4,4,8
fa10,103,WARREN,MUS,Mu-CompArt,0,0,0,0,0,0,1,0,1,1,0,1,9,0,9,0,0,0,11,0,11
fa10,103,WARREN,MUS,Music,1,1,2,0,0,0,2,0,2,0,3,3,3,1,4,0,0,0,6,5,11
fa10,103,WARREN,NENG,NanoEng,5,2,7,1,0,1,2,0,2,2,0,2,0,0,0,0,0,0,10,2,12
fa10,103,WARREN,PHIL,Philosophy,0,0,0,0,0,0,1,0,1,11,2,13,11,4,15,0,0,0,23,6,29
fa10,103,WARREN,PHYS,Biophysics,0,0,0,0,0,0,1,0,1,1,2,3,1,0,1,0,0,0,3,2,5
fa10,103,WARREN,PHYS,Gen Physcs,0,0,0,0,0,0,1,0,1,0,0,0,0,0,0,0,0,0,1,0,1
fa10,103,WARREN,PHYS,Phys/Astro,0,1,1,0,0,0,1,0,1,2,0,2,3,0,3,0,0,0,6,1,7
fa10,103,WARREN,PHYS,Phys/Comp,1,0,1,0,0,0,0,0,0,0,0,0,0,0,0,0,0,0,1,0,1
fa10,103,WARREN,PHYS,Phys/Mtrls,0,0,0,0,0,0,0,0,0,0,0,0,1,0,1,0,0,0,1,0,1
fa10,103,WARREN,PHYS,Physics,4,2,6,0,0,0,3,0,3,3,0,3,3,1,4,0,0,0,13,3,16
fa10,103,WARREN,POLI,Polit Sci,3,8,11,4,1,5,10,6,16,21,16,37,18,18,36,0,0,0,56,49,105
fa10,103,WARREN,POLI,PolSc-Amer,3,1,4,0,1,1,2,1,3,3,2,5,5,3,8,0,0,0,13,8,21
fa10,103,WARREN,POLI,PolSc-Comp,0,0,0,0,0,0,0,0,0,0,0,0,1,1,2,0,0,0,1,1,2
fa10,103,WARREN,POLI,PolSc-Intl,4,4,8,0,0,0,3,7,10,10,12,22,17,9,26,0,0,0,34,32,66
fa10,103,WARREN,POLI,PolSc-PLaw,0,5,5,0,0,0,2,9,11,8,6,14,4,4,8,0,0,0,14,24,38
fa10,103,WARREN,POLI,PolSc-PPol,0,0,0,0,0,0,0,2,2,1,1,2,0,1,1,0,0,0,1,4,5
fa10,103,WARREN,POLI,PolSc-Thry,0,0,0,0,0,0,0,0,0,2,1,3,1,2,3,0,0,0,3,3,6
fa10,103,WARREN,PSYC,Psychology,13,21,34,0,2,2,7,28,35,17,52,69,25,64,89,0,0,0,62,167,229
fa10,103,WARREN,RELI,Relig/Stu,1,1,2,0,0,0,0,0,0,0,1,1,0,0,0,0,0,0,1,2,3
fa10,103,WARREN,SE,Engin Sci,2,1,3,1,0,1,0,0,0,0,0,0,0,0,0,0,0,0,3,1,4
fa10,103,WARREN,SE,Struct Eng,25,8,33,4,2,6,24,5,29,20,12,32,49,19,68,0,0,0,122,46,168
fa10,103,WARREN,SIO,Earth Sci,0,0,0,0,0,0,0,0,0,1,1,2,1,0,1,0,0,0,2,1,3
fa10,103,WARREN,SIO,ErSc-Geoch,0,0,0,0,0,0,1,0,1,0,0,0,0,1,1,0,0,0,1,1,2
fa10,103,WARREN,SIO,ErSc-Geoph,0,0,0,0,0,0,1,0,1,0,0,0,0,0,0,0,0,0,1,0,1
fa10,103,WARREN,SOC,SocIntlStu,0,0,0,0,0,0,0,0,0,1,1,2,1,0,1,0,0,0,2,1,3
fa10,103,WARREN,SOC,Sociology,0,2,2,0,1,1,2,1,3,8,10,18,1,14,15,0,0,0,11,28,39
fa10,103,WARREN,SOC,SocLawSoc,0,0,0,0,1,1,1,1,2,3,1,4,0,1,1,0,0,0,4,4,8
fa10,103,WARREN,SOC,SocSciMed,0,0,0,0,0,0,0,0,0,0,1,1,0,0,0,0,0,0,0,1,1
fa10,103,WARREN,SOC,SocSolneq,0,0,0,0,0,0,0,0,0,0,2,2,1,1,2,0,0,0,1,3,4
fa10,103,WARREN,THEA,Dance,0,0,0,0,0,0,0,0,0,0,0,0,1,1,2,0,0,0,1,1,2
fa10,103,WARREN,THEA,Theatre,1,0,1,0,0,0,0,0,0,1,1,2,2,1,3,0,0,0,4,2,6
fa10,103,WARREN,TWS,ThirdWldSt,0,0,0,0,0,0,0,0,0,0,1,1,0,0,0,0,0,0,0,1,1
fa10,103,WARREN,UNAF,IntcampVis,0,0,0,0,0,0,0,0,0,0,4,4,1,0,1,0,0,0,1,4,5
fa10,103,WARREN,UNAF,Limited St,0,0,0,0,0,0,0,0,0,0,0,0,0,0,0,2,2,4,2,2,4
fa10,103,WARREN,UNAF,UndecHumAr,0,4,4,0,0,0,1,0,1,0,0,0,0,0,0,0,0,0,1,4,5
fa10,103,WARREN,UNAF,Undeclared,40,39,79,0,1,1,11,7,18,2,1,3,0,0,0,0,0,0,53,48,101
fa10,103,WARREN,UNAF,UndecPhysS,6,7,13,0,0,0,1,0,1,0,0,0,0,0,0,0,0,0,7,7,14
fa10,103,WARREN,UNAF,UndecSocSc,2,5,7,0,1,1,0,1,1,0,1,1,0,0,0,0,0,0,2,8,10
fa10,103,WARREN,USP,Urb Stu&Pl,0,1,1,0,0,0,2,2,4,4,4,8,3,5,8,0,0,0,9,12,21
fa10,103,WARREN,VIS,Art Hst/Cr,0,0,0,0,0,0,0,2,2,0,1,1,2,2,4,0,0,0,2,5,7
fa10,103,WARREN,VIS,Media,0,2,2,0,0,0,2,1,3,7,5,12,7,6,13,0,0,0,16,14,30
fa10,103,WARREN,VIS,Studio VA,0,1,1,0,0,0,0,0,0,1,3,4,1,4,5,0,0,0,2,8,10
fa10,103,WARREN,VIS,VA-CompArt,0,0,0,0,0,0,0,1,1,1,1,2,1,0,1,0,0,0,2,2,4
sp10,102,MARSHALL,ANTH,Anth-Arch,0,0,0,0,0,0,0,1,1,1,1,2,2,4,6,0,0,0,3,6,9
sp10,102,MARSHALL,ANTH,Anth-Biol,0,0,0,0,0,0,1,0,1,1,4,5,0,3,3,0,0,0,2,7,9
sp10,102,MARSHALL,ANTH,Anth-Soci,0,0,0,0,0,0,0,1,1,2,3,5,2,7,9,0,0,0,4,11,15
sp10,102,MARSHALL,ANTH,Anthropol,0,0,0,0,0,0,0,0,0,0,1,1,1,2,3,0,0,0,1,3,4
sp10,102,MARSHALL,BENG,Bioen:Binf,0,0,0,0,0,0,0,0,0,1,1,2,2,0,2,0,0,0,3,1,4
sp10,102,MARSHALL,BENG,Bioeng:PM,0,0,0,0,0,0,1,1,2,4,2,6,17,2,19,0,0,0,22,5,27
sp10,102,MARSHALL,BENG,BioengBiot,0,0,0,0,1,1,7,2,9,6,5,11,7,2,9,0,0,0,20,10,30
sp10,102,MARSHALL,BENG,Bioengin,0,0,0,1,1,2,3,2,5,4,2,6,2,4,6,0,0,0,10,9,19
sp10,102,MARSHALL,BENG,Pr-BioenPM,0,0,0,0,1,1,7,7,14,0,1,1,0,0,0,0,0,0,7,9,16
sp10,102,MARSHALL,BIOL,Bioc/CellB,0,0,0,1,5,6,8,15,23,17,22,39,50,59,109,0,0,0,76,101,177
sp10,102,MARSHALL,BIOL,BiolBioinf,0,0,0,0,0,0,0,0,0,0,0,0,1,0,1,0,0,0,1,0,1
sp10,102,MARSHALL,BIOL,Ec/Beh/Evo,0,0,0,0,0,0,0,0,0,3,2,5,8,5,13,0,0,0,11,7,18
sp10,102,MARSHALL,BIOL,Genl Biol,0,0,0,1,4,5,6,29,35,14,27,41,50,67,117,0,0,0,71,127,198
sp10,102,MARSHALL,BIOL,Human Bio,0,0,0,0,8,8,29,49,78,30,60,90,52,97,149,0,0,0,111,214,325
sp10,102,MARSHALL,BIOL,Microbiol,0,0,0,0,0,0,1,1,2,2,6,8,4,8,12,0,0,0,7,15,22
sp10,102,MARSHALL,BIOL,Molec Biol,0,0,0,0,1,1,3,0,3,3,6,9,5,4,9,0,0,0,11,11,22
sp10,102,MARSHALL,BIOL,PhyslNeuro,0,0,0,0,1,1,2,12,14,11,21,32,18,29,47,0,0,0,31,63,94
sp10,102,MARSHALL,CENG,Chem Engin,0,0,0,1,0,1,3,3,6,7,4,11,14,7,21,0,0,0,25,14,39
sp10,102,MARSHALL,CGS,CritGendSt,0,0,0,0,0,0,0,0,0,1,1,2,0,5,5,0,0,0,1,6,7
sp10,102,MARSHALL,CHEM,Bioch/Chem,0,0,0,4,3,7,10,12,22,7,17,24,13,12,25,0,0,0,34,44,78
sp10,102,MARSHALL,CHEM,Bioinform,0,0,0,0,0,0,0,1,1,0,0,0,0,0,0,0,0,0,0,1,1
sp10,102,MARSHALL,CHEM,Chemistry,0,0,0,1,3,4,4,4,8,2,2,4,6,6,12,0,0,0,13,15,28
sp10,102,MARSHALL,CHEM,Envir Chem,0,0,0,0,0,0,1,0,1,0,0,0,1,1,2,0,0,0,2,1,3
sp10,102,MARSHALL,CHEM,Pharm Chem,0,0,0,2,8,10,6,9,15,5,4,9,11,11,22,0,0,0,24,32,56
sp10,102,MARSHALL,CHIN,Chinese St,0,0,0,0,0,0,0,0,0,0,1,1,0,2,2,0,0,0,0,3,3
sp10,102,MARSHALL,CLAS,Classic St,0,0,0,0,1,1,0,0,0,0,0,0,0,1,1,0,0,0,0,2,2
sp10,102,MARSHALL,COGS,Cog Sci,0,0,0,0,2,2,4,0,4,2,4,6,4,4,8,0,0,0,10,10,20
sp10,102,MARSHALL,COGS,CogSc/ClAs,0,0,0,0,2,2,0,1,1,0,3,3,0,2,2,0,0,0,0,8,8
sp10,102,MARSHALL,COGS,CogSc/HCI,0,0,0,0,0,0,0,1,1,2,0,2,5,3,8,0,0,0,7,4,11
sp10,102,MARSHALL,COGS,CogSc/Neur,0,0,0,1,0,1,1,2,3,1,6,7,5,15,20,0,0,0,8,23,31
sp10,102,MARSHALL,COMM,Communic,0,0,0,3,6,9,4,16,20,28,59,87,25,52,77,0,0,0,60,133,193
sp10,102,MARSHALL,CSE,Comp Sci,0,0,0,3,0,3,4,4,8,22,4,26,43,6,49,0,0,0,72,14,86
sp10,102,MARSHALL,CSE,CompEngCSE,0,0,0,1,0,1,2,2,4,6,1,7,6,0,6,0,0,0,15,3,18
sp10,102,MARSHALL,CSE,CompScBinf,0,0,0,0,0,0,0,0,0,0,0,0,1,3,4,0,0,0,1,3,4
sp10,102,MARSHALL,ECE,CompEngECE,0,0,0,1,0,1,0,0,0,2,0,2,3,0,3,0,0,0,6,0,6
sp10,102,MARSHALL,ECE,Electr Eng,0,0,0,3,1,4,7,1,8,15,6,21,31,5,36,0,0,0,56,13,69
sp10,102,MARSHALL,ECE,EleEng&Soc,0,0,0,0,0,0,0,0,0,2,0,2,0,0,0,0,0,0,2,0,2
sp10,102,MARSHALL,ECE,Engin Phys,0,0,0,0,0,0,0,0,0,1,0,1,0,0,0,0,0,0,1,0,1
sp10,102,MARSHALL,ECON,Ec-Mth&Ecn,0,0,0,0,2,2,3,0,3,3,0,3,6,3,9,0,0,0,12,5,17
sp10,102,MARSHALL,ECON,Econ-MgtSc,0,0,0,5,8,13,9,7,16,33,36,69,64,36,100,0,0,0,111,87,198
sp10,102,MARSHALL,ECON,Economics,0,0,0,4,2,6,23,9,32,76,42,118,107,60,167,0,0,0,210,113,323
sp10,102,MARSHALL,ESYS,EnvSys(EB),0,0,0,0,2,2,2,2,4,2,3,5,2,6,8,0,0,0,6,13,19
sp10,102,MARSHALL,ESYS,EnvSys(EC),0,0,0,0,0,0,0,0,0,1,0,1,0,1,1,0,0,0,1,1,2
sp10,102,MARSHALL,ESYS,EnvSys(EP),0,0,0,1,0,1,0,0,0,1,2,3,0,2,2,0,0,0,2,4,6
sp10,102,MARSHALL,ESYS,EnvSys(ES),0,0,0,0,0,0,0,0,0,2,0,2,0,1,1,0,0,0,2,1,3
sp10,102,MARSHALL,ETHN,Ethnic St,0,0,0,0,0,0,1,1,2,2,4,6,4,21,25,0,0,0,7,26,33
sp10,102,MARSHALL,GMST,German Stu,0,0,0,0,0,0,0,0,0,1,0,1,0,0,0,0,0,0,1,0,1
sp10,102,MARSHALL,HDP,Human Dev,0,0,0,0,0,0,0,0,0,0,8,8,2,39,41,0,0,0,2,47,49
sp10,102,MARSHALL,HDP,Pr-HumnDev,0,0,0,0,5,5,0,15,15,1,12,13,0,5,5,0,0,0,1,37,38
sp10,102,MARSHALL,HIST,History,0,0,0,0,2,2,2,2,4,13,13,26,22,10,32,0,0,0,37,27,64
sp10,102,MARSHALL,INTL,IntSt-Anth,0,0,0,0,0,0,0,1,1,0,1,1,1,3,4,0,0,0,1,5,6
sp10,102,MARSHALL,INTL,IntSt-Econ,0,0,0,0,0,0,6,6,12,10,9,19,6,8,14,0,0,0,22,23,45
sp10,102,MARSHALL,INTL,IntSt-Hist,0,0,0,0,0,0,0,0,0,1,1,2,0,5,5,0,0,0,1,6,7
sp10,102,MARSHALL,INTL,IntSt-Ling,0,0,0,0,0,0,0,1,1,0,3,3,0,2,2,0,0,0,0,6,6
sp10,102,MARSHALL,INTL,IntSt-Lit,0,0,0,0,0,0,0,1,1,0,0,0,0,0,0,0,0,0,0,1,1
sp10,102,MARSHALL,INTL,IntSt-PolS,0,0,0,0,2,2,0,4,4,5,10,15,8,21,29,0,0,0,13,37,50
sp10,102,MARSHALL,INTL,IntSt-Soc,0,0,0,0,1,1,0,4,4,0,8,8,3,7,10,0,0,0,3,20,23
sp10,102,MARSHALL,JAPN,JapaneseSt,0,0,0,0,0,0,0,0,0,0,0,0,1,0,1,0,0,0,1,0,1
sp10,102,MARSHALL,JUDA,Judaic Stu,0,0,0,0,0,0,0,0,0,0,0,0,1,0,1,0,0,0,1,0,1
sp10,102,MARSHALL,LATI,LatinAm St,0,0,0,0,0,0,0,0,0,0,0,0,1,1,2,0,0,0,1,1,2
sp10,102,MARSHALL,LING,Lang Stu,0,0,0,0,0,0,1,1,2,0,1,1,0,3,3,0,0,0,1,5,6
sp10,102,MARSHALL,LING,Ling-CogLn,0,0,0,0,0,0,0,0,0,1,0,1,1,0,1,0,0,0,2,0,2
sp10,102,MARSHALL,LING,Ling-LSoc,0,0,0,0,0,0,0,0,0,0,1,1,0,0,0,0,0,0,0,1,1
sp10,102,MARSHALL,LING,Linguistcs,0,0,0,0,0,0,1,2,3,0,2,2,0,2,2,0,0,0,1,6,7
sp10,102,MARSHALL,LIT,Lit/CultSt,0,0,0,0,0,0,0,0,0,0,2,2,0,0,0,0,0,0,0,2,2
sp10,102,MARSHALL,LIT,Lit/Engl,0,0,0,2,2,4,0,2,2,1,4,5,2,3,5,0,0,0,5,11,16
sp10,102,MARSHALL,LIT,Lit/World,0,0,0,0,0,0,0,1,1,0,1,1,0,4,4,0,0,0,0,6,6
sp10,102,MARSHALL,LIT,Lit/Writng,0,0,0,0,0,0,0,0,0,0,0,0,9,9,18,0,0,0,9,9,18
sp10,102,MARSHALL,LIT,Pre-Lit/Wr,0,0,0,0,1,1,1,1,2,6,4,10,2,1,3,0,0,0,9,7,16
sp10,102,MARSHALL,LIT,Spanish Lt,0,0,0,0,0,0,0,1,1,0,2,2,0,2,2,0,0,0,0,5,5
sp10,102,MARSHALL,MAE,Aerosp Eng,0,0,0,4,0,4,5,0,5,7,2,9,19,5,24,0,0,0,35,7,42
sp10,102,MARSHALL,MAE,Engin Sci,0,0,0,0,1,1,1,0,1,0,0,0,1,0,1,0,0,0,2,1,3
sp10,102,MARSHALL,MAE,Envir Eng,0,0,0,1,0,1,0,1,1,1,1,2,1,2,3,0,0,0,3,4,7
sp10,102,MARSHALL,MAE,Mech Engin,0,0,0,2,0,2,13,3,16,14,1,15,63,5,68,0,0,0,92,9,101
sp10,102,MARSHALL,MATH,Appld Math,0,0,0,0,0,0,0,0,0,1,0,1,2,1,3,0,0,0,3,1,4
sp10,102,MARSHALL,MATH,Math/SecEd,0,0,0,2,0,2,2,1,3,0,2,2,2,0,2,0,0,0,6,3,9
sp10,102,MARSHALL,MATH,Mathematcs,0,0,0,0,1,1,1,1,2,5,8,13,6,1,7,0,0,0,12,11,23
sp10,102,MARSHALL,MATH,Mth-CompSc,0,0,0,0,0,0,0,0,0,1,1,2,0,2,2,0,0,0,1,3,4
sp10,102,MARSHALL,MATH,Mth-Mth&Ec,0,0,0,0,0,0,0,1,1,6,3,9,5,2,7,0,0,0,11,6,17
sp10,102,MARSHALL,MATH,Mth-SciCom,0,0,0,0,0,0,1,0,1,0,0,0,0,1,1,0,0,0,1,1,2
sp10,102,MARSHALL,MATH,Mth/ApldSc,0,0,0,0,0,0,0,1,1,0,0,0,0,0,0,0,0,0,0,1,1
sp10,102,MARSHALL,MATH,Pr-Math CS,0,0,0,0,1,1,0,0,0,0,1,1,0,0,0,0,0,0,0,2,2
sp10,102,MARSHALL,MATH,Prob&Stats,0,0,0,0,0,0,0,0,0,1,0,1,3,1,4,0,0,0,4,1,5
sp10,102,MARSHALL,MUS,Mu-CompArt,0,0,0,0,0,0,1,0,1,2,0,2,3,1,4,0,0,0,6,1,7
sp10,102,MARSHALL,MUS,Music,0,0,0,0,0,0,2,0,2,3,4,7,2,4,6,0,0,0,7,8,15
sp10,102,MARSHALL,MUS,Music Hum,0,0,0,0,0,0,0,0,0,0,0,0,0,1,1,0,0,0,0,1,1
sp10,102,MARSHALL,PHIL,Philosophy,0,0,0,0,1,1,1,0,1,4,1,5,8,4,12,0,0,0,13,6,19
sp10,102,MARSHALL,PHYS,Biophysics,0,0,0,0,0,0,2,0,2,2,0,2,0,1,1,0,0,0,4,1,5
sp10,102,MARSHALL,PHYS,Phy/ErthSc,0,0,0,0,0,0,0,0,0,1,0,1,0,1,1,0,0,0,1,1,2
sp10,102,MARSHALL,PHYS,Phys/Astro,0,0,0,0,0,0,0,1,1,0,0,0,1,2,3,0,0,0,1,3,4
sp10,102,MARSHALL,PHYS,Phys/Mtrls,0,0,0,0,0,0,0,0,0,0,0,0,0,1,1,0,0,0,0,1,1
sp10,102,MARSHALL,PHYS,Physics,0,0,0,0,0,0,3,2,5,4,0,4,0,1,1,0,0,0,7,3,10
sp10,102,MARSHALL,POLI,Polit Sci,0,0,0,1,1,2,8,8,16,25,17,42,27,32,59,0,0,0,61,58,119
sp10,102,MARSHALL,POLI,PolSc-Amer,0,0,0,0,0,0,0,3,3,2,1,3,5,3,8,0,0,0,7,7,14
sp10,102,MARSHALL,POLI,PolSc-Comp,0,0,0,0,0,0,0,1,1,1,0,1,1,0,1,0,0,0,2,1,3
sp10,102,MARSHALL,POLI,PolSc-Intl,0,0,0,1,0,1,3,5,8,12,20,32,29,15,44,0,0,0,45,40,85
sp10,102,MARSHALL,POLI,PolSc-PLaw,0,0,0,1,3,4,2,3,5,8,3,11,11,9,20,0,0,0,22,18,40
sp10,102,MARSHALL,POLI,PolSc-PPol,0,0,0,0,0,0,0,0,0,0,1,1,1,3,4,0,0,0,1,4,5
sp10,102,MARSHALL,POLI,PolSc-Thry,0,0,0,0,0,0,0,1,1,1,2,3,1,0,1,0,0,0,2,3,5
sp10,102,MARSHALL,PSYC,Psychology,0,0,0,4,11,15,12,39,51,17,60,77,38,98,136,0,0,0,71,208,279
sp10,102,MARSHALL,RELI,Relig/Stu,0,0,0,0,0,0,0,0,0,0,2,2,2,0,2,0,0,0,2,2,4
sp10,102,MARSHALL,SE,Engin Sci,0,0,0,0,0,0,0,0,0,0,0,0,2,0,2,0,0,0,2,0,2
sp10,102,MARSHALL,SE,Struct Eng,0,0,0,3,0,3,6,7,13,7,6,13,14,13,27,0,0,0,30,26,56
sp10,102,MARSHALL,SIO,ErSc-Geoch,0,0,0,0,0,0,0,0,0,1,0,1,0,0,0,0,0,0,1,0,1
sp10,102,MARSHALL,SIO,ErSc-Geol,0,0,0,0,0,0,0,0,0,0,0,0,0,1,1,0,0,0,0,1,1
sp10,102,MARSHALL,SOC,SocCulCom,0,0,0,0,0,0,0,0,0,1,2,3,0,2,2,0,0,0,1,4,5
sp10,102,MARSHALL,SOC,SocEconSoc,0,0,0,0,0,0,0,0,0,0,1,1,1,1,2,0,0,0,1,2,3
sp10,102,MARSHALL,SOC,SocIntlStu,0,0,0,0,1,1,0,0,0,0,1,1,0,1,1,0,0,0,0,3,3
sp10,102,MARSHALL,SOC,Sociology,0,0,0,1,3,4,1,6,7,9,16,25,7,22,29,0,0,0,18,47,65
sp10,102,MARSHALL,SOC,SocLawSoc,0,0,0,0,0,0,1,1,2,2,4,6,3,5,8,0,0,0,6,10,16
sp10,102,MARSHALL,SOC,SocSciMed,0,0,0,0,0,0,1,0,1,0,1,1,0,0,0,0,0,0,1,1,2
sp10,102,MARSHALL,SOC,SocSolneq,0,0,0,0,0,0,0,0,0,0,2,2,2,2,4,0,0,0,2,4,6
sp10,102,MARSHALL,THEA,Dance,0,0,0,0,0,0,0,0,0,0,1,1,0,1,1,0,0,0,0,2,2
sp10,102,MARSHALL,THEA,Theatre,0,0,0,0,1,1,0,1,1,1,3,4,4,5,9,0,0,0,5,10,15
sp10,102,MARSHALL,UNAF,UndecHumAr,0,0,0,0,0,0,0,2,2,0,0,0,0,0,0,0,0,0,0,2,2
sp10,102,MARSHALL,UNAF,Undeclared,0,0,0,12,27,39,13,31,44,1,3,4,0,0,0,0,0,0,26,61,87
sp10,102,MARSHALL,UNAF,UndecPhysS,0,0,0,2,2,4,0,2,2,0,0,0,0,0,0,0,0,0,2,4,6
sp10,102,MARSHALL,UNAF,UndecSocSc,0,0,0,0,2,2,1,5,6,0,0,0,0,0,0,0,0,0,1,7,8
sp10,102,MARSHALL,USP,Urb Stu&Pl,0,0,0,0,0,0,1,1,2,6,8,14,5,9,14,0,0,0,12,18,30
sp10,102,MARSHALL,VIS,Art Hst/Cr,0,0,0,0,0,0,0,2,2,0,5,5,1,7,8,0,0,0,1,14,15
sp10,102,MARSHALL,VIS,Media,0,0,0,0,1,1,1,0,1,7,7,14,10,7,17,0,0,0,18,15,33
sp10,102,MARSHALL,VIS,Studio VA,0,0,0,0,0,0,0,2,2,2,4,6,5,5,10,0,0,0,7,11,18
sp10,102,MARSHALL,VIS,VA-CompArt,0,0,0,0,0,0,0,0,0,1,2,3,3,0,3,0,0,0,4,2,6
sp10,102,MUIR,ANTH,Anth-Arch,0,0,0,0,0,0,0,1,1,1,2,3,4,2,6,0,0,0,5,5,10
sp10,102,MUIR,ANTH,Anth-Biol,0,0,0,0,0,0,0,1,1,1,5,6,4,11,15,0,0,0,5,17,22
sp10,102,MUIR,ANTH,Anth-Soci,0,0,0,0,0,0,1,2,3,2,4,6,0,4,4,0,0,0,3,10,13
sp10,102,MUIR,BENG,Bioen:Binf,0,0,0,0,0,0,1,0,1,0,0,0,0,0,0,0,0,0,1,0,1
sp10,102,MUIR,BENG,Bioeng:PM,0,0,0,0,0,0,0,0,0,0,0,0,12,5,17,0,0,0,12,5,17
sp10,102,MUIR,BENG,BioengBiot,0,0,0,0,0,0,6,6,12,6,5,11,7,5,12,0,0,0,19,16,35
sp10,102,MUIR,BENG,Bioengin,0,0,0,2,0,2,3,5,8,9,2,11,18,6,24,0,0,0,32,13,45
sp10,102,MUIR,BENG,Pr-BioenPM,0,0,0,1,1,2,6,2,8,2,2,4,0,0,0,0,0,0,9,5,14
sp10,102,MUIR,BIOL,Bioc/CellB,0,0,0,1,1,2,7,4,11,29,35,64,67,63,130,0,0,0,104,103,207
sp10,102,MUIR,BIOL,Ec/Beh/Evo,0,0,0,0,1,1,1,1,2,3,10,13,6,20,26,0,0,0,10,32,42
sp10,102,MUIR,BIOL,Genl Biol,0,0,0,1,5,6,5,26,31,13,32,45,56,92,148,0,0,0,75,155,230
sp10,102,MUIR,BIOL,Human Bio,0,0,0,2,11,13,18,47,65,43,57,100,80,106,186,0,0,0,143,221,364
sp10,102,MUIR,BIOL,Microbiol,0,0,0,0,0,0,1,3,4,2,1,3,5,6,11,0,0,0,8,10,18
sp10,102,MUIR,BIOL,Molec Biol,0,0,0,0,1,1,5,0,5,6,6,12,11,10,21,0,0,0,22,17,39
sp10,102,MUIR,BIOL,PhyslNeuro,0,0,0,2,0,2,6,12,18,18,25,43,29,36,65,0,0,0,55,73,128
sp10,102,MUIR,CENG,Chem Engin,0,0,0,0,0,0,7,1,8,3,4,7,17,8,25,0,0,0,27,13,40
sp10,102,MUIR,CGS,CritGendSt,0,0,0,0,0,0,0,0,0,0,1,1,0,6,6,0,0,0,0,7,7
sp10,102,MUIR,CHEM,Bioch/Chem,0,0,0,0,4,4,12,12,24,12,12,24,14,20,34,0,0,0,38,48,86
sp10,102,MUIR,CHEM,Bioinform,0,0,0,0,0,0,1,0,1,0,0,0,0,0,0,0,0,0,1,0,1
sp10,102,MUIR,CHEM,Chem Educ,0,0,0,0,0,0,1,1,2,0,0,0,0,0,0,0,0,0,1,1,2
sp10,102,MUIR,CHEM,Chem Phys,0,0,0,0,0,0,0,0,0,1,0,1,0,0,0,0,0,0,1,0,1
sp10,102,MUIR,CHEM,Chemistry,0,0,0,1,2,3,2,5,7,7,3,10,9,3,12,0,0,0,19,13,32
sp10,102,MUIR,CHEM,Envir Chem,0,0,0,0,1,1,1,0,1,0,0,0,2,1,3,0,0,0,3,2,5
sp10,102,MUIR,CHEM,MolecSynth,0,0,0,0,0,0,0,0,0,0,0,0,2,0,2,0,0,0,2,0,2
sp10,102,MUIR,CHEM,Pharm Chem,0,0,0,2,2,4,5,9,14,8,5,13,14,17,31,0,0,0,29,33,62
sp10,102,MUIR,CHIN,Chinese St,0,0,0,0,0,0,0,0,0,1,0,1,3,1,4,0,0,0,4,1,5
sp10,102,MUIR,CLAS,Classic St,0,0,0,0,0,0,0,1,1,0,1,1,0,2,2,0,0,0,0,4,4
sp10,102,MUIR,COGS,Cog Sci,0,0,0,3,1,4,3,2,5,8,10,18,15,7,22,0,0,0,29,20,49
sp10,102,MUIR,COGS,CogSc/ClAs,0,0,0,0,2,2,0,0,0,0,3,3,2,4,6,0,0,0,2,9,11
sp10,102,MUIR,COGS,CogSc/Comp,0,0,0,0,0,0,0,0,0,1,0,1,3,0,3,0,0,0,4,0,4
sp10,102,MUIR,COGS,CogSc/HCI,0,0,0,0,1,1,2,1,3,1,3,4,4,2,6,0,0,0,7,7,14
sp10,102,MUIR,COGS,CogSc/HCog,0,0,0,0,1,1,0,1,1,1,4,5,2,0,2,0,0,0,3,6,9
sp10,102,MUIR,COGS,CogSc/Neur,0,0,0,1,2,3,4,4,8,5,8,13,12,12,24,0,0,0,22,26,48
sp10,102,MUIR,COMM,Communic,0,0,0,0,4,4,5,21,26,9,40,49,14,71,85,0,0,0,28,136,164
sp10,102,MUIR,CSE,Comp Sci,0,0,0,5,0,5,13,2,15,14,7,21,38,6,44,0,0,0,70,15,85
sp10,102,MUIR,CSE,CompEngCSE,0,0,0,1,0,1,6,1,7,2,2,4,7,1,8,0,0,0,16,4,20
sp10,102,MUIR,CSE,CompScBinf,0,0,0,0,0,0,3,0,3,1,1,2,2,1,3,0,0,0,6,2,8
sp10,102,MUIR,CSE,Pr-Comp Sc,0,0,0,0,0,0,0,0,0,1,0,1,0,0,0,0,0,0,1,0,1
sp10,102,MUIR,ECE,CompEngECE,0,0,0,0,0,0,2,1,3,1,0,1,2,0,2,0,0,0,5,1,6
sp10,102,MUIR,ECE,Electr Eng,0,0,0,1,0,1,7,1,8,8,0,8,19,4,23,0,0,0,35,5,40
sp10,102,MUIR,ECE,Engin Phys,0,0,0,0,0,0,0,0,0,1,0,1,0,0,0,0,0,0,1,0,1
sp10,102,MUIR,ECON,Ec-Mth&Ecn,0,0,0,0,2,2,2,1,3,4,3,7,6,1,7,0,0,0,12,7,19
sp10,102,MUIR,ECON,Econ-MgtSc,0,0,0,3,3,6,15,11,26,29,15,44,53,31,84,0,0,0,100,60,160
sp10,102,MUIR,ECON,Economics,0,0,0,3,2,5,13,8,21,40,31,71,80,56,136,0,0,0,136,97,233
sp10,102,MUIR,ESYS,EnvSys(EB),0,0,0,1,0,1,4,9,13,6,8,14,3,10,13,0,0,0,14,27,41
sp10,102,MUIR,ESYS,EnvSys(EC),0,0,0,0,0,0,0,1,1,0,0,0,0,2,2,0,0,0,0,3,3
sp10,102,MUIR,ESYS,EnvSys(EP),0,0,0,0,0,0,0,0,0,1,0,1,2,3,5,0,0,0,3,3,6
sp10,102,MUIR,ESYS,EnvSys(ES),0,0,0,0,0,0,0,2,2,0,2,2,3,0,3,0,0,0,3,4,7
sp10,102,MUIR,ETHN,Ethnic St,0,0,0,0,1,1,1,4,5,1,3,4,2,11,13,0,0,0,4,19,23
sp10,102,MUIR,GMST,German Stu,0,0,0,0,0,0,0,0,0,0,0,0,0,1,1,0,0,0,0,1,1
sp10,102,MUIR,HDP,Human Dev,0,0,0,0,0,0,0,4,4,0,3,3,1,22,23,0,0,0,1,29,30
sp10,102,MUIR,HDP,Pr-HumnDev,0,0,0,1,4,5,1,11,12,1,11,12,0,4,4,0,0,0,3,30,33
sp10,102,MUIR,HIST,History,0,0,0,0,0,0,2,5,7,11,10,21,16,17,33,0,0,0,29,32,61
sp10,102,MUIR,INTD,Muir Sp Pr,0,0,0,0,0,0,0,0,0,0,0,0,0,1,1,0,0,0,0,1,1
sp10,102,MUIR,INTL,IntSt-Anth,0,0,0,0,0,0,0,0,0,0,0,0,3,0,3,0,0,0,3,0,3
sp10,102,MUIR,INTL,IntSt-Econ,0,0,0,0,0,0,2,7,9,3,12,15,13,13,26,0,0,0,18,32,50
sp10,102,MUIR,INTL,IntSt-Hist,0,0,0,0,0,0,0,0,0,0,0,0,3,5,8,0,0,0,3,5,8
sp10,102,MUIR,INTL,IntSt-Ling,0,0,0,0,1,1,0,0,0,0,0,0,0,3,3,0,0,0,0,4,4
sp10,102,MUIR,INTL,IntSt-Lit,0,0,0,0,0,0,0,0,0,0,3,3,1,0,1,0,0,0,1,3,4
sp10,102,MUIR,INTL,IntSt-PolS,0,0,0,0,0,0,1,2,3,2,10,12,6,19,25,0,0,0,9,31,40
sp10,102,MUIR,INTL,IntSt-Soc,0,0,0,0,0,0,0,2,2,3,5,8,3,8,11,0,0,0,6,15,21
sp10,102,MUIR,JAPN,JapaneseSt,0,0,0,0,0,0,0,0,0,0,2,2,4,5,9,0,0,0,4,7,11
sp10,102,MUIR,JUDA,Judaic Stu,0,0,0,0,0,0,0,1,1,0,0,0,0,0,0,0,0,0,0,1,1
sp10,102,MUIR,LATI,LatinAm St,0,0,0,1,0,1,0,0,0,0,1,1,1,2,3,0,0,0,2,3,5
sp10,102,MUIR,LING,Lang Stu,0,0,0,0,0,0,0,0,0,0,1,1,2,2,4,0,0,0,2,3,5
sp10,102,MUIR,LING,Ling-CogLn,0,0,0,0,0,0,1,1,2,0,0,0,1,3,4,0,0,0,2,4,6
sp10,102,MUIR,LING,Ling-LSoc,0,0,0,0,1,1,0,0,0,0,0,0,0,1,1,0,0,0,0,2,2
sp10,102,MUIR,LING,Linguistcs,0,0,0,0,0,0,0,0,0,3,7,10,0,6,6,0,0,0,3,13,16
sp10,102,MUIR,LIT,French Lit,0,0,0,0,0,0,0,0,0,0,0,0,0,1,1,0,0,0,0,1,1
sp10,102,MUIR,LIT,Lit/CultSt,0,0,0,0,0,0,0,0,0,0,1,1,0,2,2,0,0,0,0,3,3
sp10,102,MUIR,LIT,Lit/Engl,0,0,0,1,2,3,0,1,1,4,5,9,6,12,18,0,0,0,11,20,31
sp10,102,MUIR,LIT,Lit/World,0,0,0,0,0,0,0,1,1,0,4,4,0,5,5,0,0,0,0,10,10
sp10,102,MUIR,LIT,Lit/Writng,0,0,0,0,0,0,0,0,0,0,0,0,5,10,15,0,0,0,5,10,15
sp10,102,MUIR,LIT,Pre-Lit/Wr,0,0,0,0,2,2,2,3,5,1,7,8,4,6,10,0,0,0,7,18,25
sp10,102,MUIR,LIT,Spanish Lt,0,0,0,0,0,0,0,1,1,0,2,2,2,5,7,0,0,0,2,8,10
sp10,102,MUIR,MAE,Aerosp Eng,0,0,0,1,0,1,8,2,10,12,1,13,14,4,18,0,0,0,35,7,42
sp10,102,MUIR,MAE,Engin Sci,0,0,0,0,0,0,0,0,0,1,0,1,0,2,2,0,0,0,1,2,3
sp10,102,MUIR,MAE,Envir Eng,0,0,0,0,0,0,6,1,7,1,2,3,5,5,10,0,0,0,12,8,20
sp10,102,MUIR,MAE,Mech Engin,0,0,0,1,1,2,6,0,6,20,2,22,52,7,59,0,0,0,79,10,89
sp10,102,MUIR,MATH,Appld Math,0,0,0,0,0,0,0,0,0,1,2,3,4,2,6,0,0,0,5,4,9
sp10,102,MUIR,MATH,Math/SecEd,0,0,0,0,0,0,0,2,2,2,1,3,3,5,8,0,0,0,5,8,13
sp10,102,MUIR,MATH,Mathematcs,0,0,0,1,2,3,1,2,3,4,3,7,6,6,12,0,0,0,12,13,25
sp10,102,MUIR,MATH,Mth-CompSc,0,0,0,0,0,0,0,0,0,1,0,1,0,1,1,0,0,0,1,1,2
sp10,102,MUIR,MATH,Mth-Mth&Ec,0,0,0,1,0,1,0,0,0,4,0,4,6,4,10,0,0,0,11,4,15
sp10,102,MUIR,MATH,Mth-SciCom,0,0,0,0,0,0,0,0,0,0,0,0,1,0,1,0,0,0,1,0,1
sp10,102,MUIR,MATH,Mth/ApldSc,0,0,0,0,0,0,0,0,0,0,1,1,0,2,2,0,0,0,0,3,3
sp10,102,MUIR,MATH,Pr-Math CS,0,0,0,0,0,0,0,1,1,0,0,0,0,0,0,0,0,0,0,1,1
sp10,102,MUIR,MATH,Prob&Stats,0,0,0,0,0,0,1,0,1,2,0,2,1,0,1,0,0,0,4,0,4
sp10,102,MUIR,MUS,Mu-CompArt,0,0,0,1,0,1,0,0,0,4,0,4,10,1,11,0,0,0,15,1,16
sp10,102,MUIR,MUS,Music,0,0,0,1,1,2,1,1,2,1,2,3,7,10,17,0,0,0,10,14,24
sp10,102,MUIR,MUS,Music Hum,0,0,0,0,0,0,1,0,1,1,0,1,0,2,2,0,0,0,2,2,4
sp10,102,MUIR,PHIL,Philosophy,0,0,0,0,0,0,0,0,0,3,0,3,6,3,9,0,0,0,9,3,12
sp10,102,MUIR,PHYS,Biophysics,0,0,0,0,0,0,0,0,0,1,0,1,1,0,1,0,0,0,2,0,2
sp10,102,MUIR,PHYS,Phy/ErthSc,0,0,0,0,0,0,0,0,0,0,1,1,0,0,0,0,0,0,0,1,1
sp10,102,MUIR,PHYS,Phys/Astro,0,0,0,0,0,0,1,0,1,2,1,3,3,1,4,0,0,0,6,2,8
sp10,102,MUIR,PHYS,Phys/Comp,0,0,0,0,0,0,0,0,0,1,0,1,2,0,2,0,0,0,3,0,3
sp10,102,MUIR,PHYS,Phys/Mtrls,0,0,0,0,0,0,1,0,1,0,0,0,0,0,0,0,0,0,1,0,1
sp10,102,MUIR,PHYS,Physics,0,0,0,0,0,0,2,0,2,2,1,3,3,1,4,0,0,0,7,2,9
sp10,102,MUIR,POLI,Polit Sci,0,0,0,0,0,0,4,5,9,17,21,38,20,27,47,0,0,0,41,53,94
sp10,102,MUIR,POLI,PolSc-Amer,0,0,0,0,0,0,0,1,1,2,1,3,3,5,8,0,0,0,5,7,12
sp10,102,MUIR,POLI,PolSc-Comp,0,0,0,0,0,0,0,0,0,1,0,1,2,1,3,0,0,0,3,1,4
sp10,102,MUIR,POLI,PolSc-Intl,0,0,0,0,2,2,7,6,13,13,8,21,15,9,24,0,0,0,35,25,60
sp10,102,MUIR,POLI,PolSc-PLaw,0,0,0,0,3,3,2,1,3,8,5,13,12,5,17,0,0,0,22,14,36
sp10,102,MUIR,POLI,PolSc-PPol,0,0,0,0,0,0,0,0,0,2,0,2,2,2,4,0,0,0,4,2,6
sp10,102,MUIR,POLI,PolSc-Thry,0,0,0,0,0,0,0,0,0,2,0,2,5,1,6,0,0,0,7,1,8
sp10,102,MUIR,PSYC,Psychology,0,0,0,5,13,18,9,35,44,22,55,77,39,113,152,0,0,0,75,216,291
sp10,102,MUIR,RELI,Relig/Stu,0,0,0,0,0,0,0,0,0,0,1,1,3,1,4,0,0,0,3,2,5
sp10,102,MUIR,SE,Struct Eng,0,0,0,3,0,3,9,7,16,16,2,18,27,12,39,0,0,0,55,21,76
sp10,102,MUIR,SIO,ErSc-Geol,0,0,0,0,0,0,1,0,1,1,0,1,2,0,2,0,0,0,4,0,4
sp10,102,MUIR,SOC,SocCulCom,0,0,0,0,0,0,0,1,1,1,1,2,0,2,2,0,0,0,1,4,5
sp10,102,MUIR,SOC,SocEconSoc,0,0,0,0,0,0,0,0,0,1,0,1,0,0,0,0,0,0,1,0,1
sp10,102,MUIR,SOC,SocIntlStu,0,0,0,0,0,0,0,0,0,0,1,1,0,1,1,0,0,0,0,2,2
sp10,102,MUIR,SOC,Sociology,0,0,0,3,6,9,2,4,6,3,13,16,5,25,30,0,0,0,13,48,61
sp10,102,MUIR,SOC,SocLawSoc,0,0,0,0,0,0,1,0,1,0,0,0,1,0,1,0,0,0,2,0,2
sp10,102,MUIR,SOC,SocSciMed,0,0,0,0,1,1,1,2,3,3,2,5,0,1,1,0,0,0,4,6,10
sp10,102,MUIR,SOC,SocSolneq,0,0,0,0,0,0,0,0,0,0,1,1,0,1,1,0,0,0,0,2,2
sp10,102,MUIR,THEA,Dance,0,0,0,0,0,0,0,0,0,0,0,0,2,5,7,0,0,0,2,5,7
sp10,102,MUIR,THEA,Theatre,0,0,0,0,0,0,2,2,4,1,6,7,4,10,14,0,0,0,7,18,25
sp10,102,MUIR,TWS,ThirdWldSt,0,0,0,0,0,0,0,1,1,0,0,0,0,0,0,0,0,0,0,1,1
sp10,102,MUIR,UNAF,Limited St,0,0,0,0,0,0,0,0,0,0,0,0,0,0,0,1,0,1,1,0,1
sp10,102,MUIR,UNAF,UndecBiolS,0,0,0,0,1,1,0,0,0,0,0,0,0,0,0,0,0,0,0,1,1
sp10,102,MUIR,UNAF,UndecHumAr,0,0,0,1,1,2,1,2,3,0,0,0,0,0,0,0,0,0,2,3,5
sp10,102,MUIR,UNAF,Undeclared,0,0,0,13,16,29,23,25,48,2,3,5,0,0,0,0,0,0,38,44,82
sp10,102,MUIR,UNAF,UndecPhysS,0,0,0,3,0,3,2,2,4,0,0,0,0,0,0,0,0,0,5,2,7
sp10,102,MUIR,UNAF,UndecSocSc,0,0,0,0,1,1,1,4,5,0,0,0,0,0,0,0,0,0,1,5,6
sp10,102,MUIR,USP,Urb Stu&Pl,0,0,0,0,1,1,3,1,4,4,5,9,9,8,17,0,0,0,16,15,31
sp10,102,MUIR,VIS,Art Hst/Cr,0,0,0,0,0,0,0,0,0,0,3,3,0,9,9,0,0,0,0,12,12
sp10,102,MUIR,VIS,Media,0,0,0,0,2,2,0,3,3,8,5,13,16,13,29,0,0,0,24,23,47
sp10,102,MUIR,VIS,Studio VA,0,0,0,0,1,1,0,1,1,1,3,4,1,7,8,0,0,0,2,12,14
sp10,102,MUIR,VIS,VA-CompArt,0,0,0,0,1,1,2,3,5,5,0,5,3,5,8,0,0,0,10,9,19
sp10,102,REVELLE,ANTH,Anth-Arch,0,0,0,0,0,0,1,1,2,0,1,1,0,1,1,0,0,0,1,3,4
sp10,102,REVELLE,ANTH,Anth-Biol,0,0,0,0,1,1,0,1,1,0,4,4,3,1,4,0,0,0,3,7,10
sp10,102,REVELLE,ANTH,Anth-Soci,0,0,0,0,1,1,0,2,2,2,5,7,1,7,8,0,0,0,3,15,18
sp10,102,REVELLE,BENG,Bioen:Binf,0,0,0,0,0,0,0,0,0,1,0,1,3,1,4,0,0,0,4,1,5
sp10,102,REVELLE,BENG,Bioeng:PM,0,0,0,0,0,0,1,0,1,4,1,5,34,13,47,0,0,0,39,14,53
sp10,102,REVELLE,BENG,BioengBiot,0,0,0,0,0,0,13,4,17,5,4,9,13,9,22,0,0,0,31,17,48
sp10,102,REVELLE,BENG,Bioengin,0,0,0,0,2,2,6,3,9,10,2,12,9,12,21,0,0,0,25,19,44
sp10,102,REVELLE,BENG,Pr-BioenPM,0,0,0,2,2,4,7,4,11,4,3,7,0,0,0,0,0,0,13,9,22
sp10,102,REVELLE,BIOL,Bioc/CellB,0,0,0,0,0,0,8,16,24,39,38,77,94,97,191,0,0,0,141,151,292
sp10,102,REVELLE,BIOL,BiolBioinf,0,0,0,0,0,0,3,1,4,0,0,0,1,0,1,0,0,0,4,1,5
sp10,102,REVELLE,BIOL,Ec/Beh/Evo,0,0,0,1,0,1,3,2,5,3,6,9,6,10,16,0,0,0,13,18,31
sp10,102,REVELLE,BIOL,Genl Biol,0,0,0,2,2,4,13,19,32,22,40,62,49,99,148,0,0,0,86,160,246
sp10,102,REVELLE,BIOL,Human Bio,0,0,0,10,12,22,30,55,85,58,82,140,103,136,239,0,0,0,201,285,486
sp10,102,REVELLE,BIOL,Microbiol,0,0,0,0,0,0,2,1,3,6,4,10,8,12,20,0,0,0,16,17,33
sp10,102,REVELLE,BIOL,Molec Biol,0,0,0,1,0,1,2,2,4,8,7,15,28,17,45,0,0,0,39,26,65
sp10,102,REVELLE,BIOL,PhyslNeuro,0,0,0,0,1,1,8,12,20,14,24,38,41,47,88,0,0,0,63,84,147
sp10,102,REVELLE,CENG,Chem Engin,0,0,0,0,0,0,12,4,16,10,3,13,22,9,31,0,0,0,44,16,60
sp10,102,REVELLE,CGS,CritGendSt,0,0,0,0,0,0,0,0,0,1,0,1,0,0,0,0,0,0,1,0,1
sp10,102,REVELLE,CHEM,Bioch/Chem,0,0,0,3,5,8,17,20,37,8,18,26,25,30,55,0,0,0,53,73,126
sp10,102,REVELLE,CHEM,Chemistry,0,0,0,2,1,3,5,3,8,4,3,7,10,13,23,0,0,0,21,20,41
sp10,102,REVELLE,CHEM,Envir Chem,0,0,0,1,0,1,0,0,0,2,0,2,1,0,1,0,0,0,4,0,4
sp10,102,REVELLE,CHEM,MolecSynth,0,0,0,0,0,0,0,0,0,0,0,0,3,1,4,0,0,0,3,1,4
sp10,102,REVELLE,CHEM,Pharm Chem,0,0,0,0,8,8,12,15,27,10,17,27,17,25,42,0,0,0,39,65,104
sp10,102,REVELLE,CHIN,Chinese St,0,0,0,0,0,0,0,0,0,0,0,0,2,0,2,0,0,0,2,0,2
sp10,102,REVELLE,CLAS,Classic St,0,0,0,0,0,0,0,0,0,0,1,1,1,0,1,0,0,0,1,1,2
sp10,102,REVELLE,COGS,Cog Sci,0,0,0,0,1,1,1,1,2,2,0,2,2,3,5,0,0,0,5,5,10
sp10,102,REVELLE,COGS,CogSc/ClAs,0,0,0,0,1,1,1,0,1,0,3,3,1,1,2,0,0,0,2,5,7
sp10,102,REVELLE,COGS,CogSc/Comp,0,0,0,0,0,0,0,0,0,1,0,1,1,0,1,0,0,0,2,0,2
sp10,102,REVELLE,COGS,CogSc/HCI,0,0,0,0,0,0,0,0,0,1,0,1,3,2,5,0,0,0,4,2,6
sp10,102,REVELLE,COGS,CogSc/HCog,0,0,0,0,2,2,0,2,2,1,0,1,1,0,1,0,0,0,2,4,6
sp10,102,REVELLE,COGS,CogSc/Neur,0,0,0,1,3,4,2,8,10,2,3,5,3,6,9,0,0,0,8,20,28
sp10,102,REVELLE,COMM,Communic,0,0,0,0,2,2,3,9,12,4,18,22,13,22,35,0,0,0,20,51,71
sp10,102,REVELLE,CSE,Comp Sci,0,0,0,0,0,0,13,1,14,22,5,27,28,2,30,0,0,0,63,8,71
sp10,102,REVELLE,CSE,CompEngCSE,0,0,0,5,0,5,5,2,7,8,0,8,5,0,5,0,0,0,23,2,25
sp10,102,REVELLE,CSE,CompScBinf,0,0,0,0,0,0,0,0,0,1,0,1,1,0,1,0,0,0,2,0,2
sp10,102,REVELLE,CSE,Hn-CompSci,0,0,0,0,0,0,1,0,1,0,0,0,0,0,0,0,0,0,1,0,1
sp10,102,REVELLE,ECE,CompEngECE,0,0,0,0,0,0,3,0,3,2,0,2,1,0,1,0,0,0,6,0,6
sp10,102,REVELLE,ECE,Electr Eng,0,0,0,2,0,2,6,1,7,10,2,12,29,5,34,0,0,0,47,8,55
sp10,102,REVELLE,ECE,Engin Phys,0,0,0,0,0,0,0,0,0,0,0,0,1,0,1,0,0,0,1,0,1
sp10,102,REVELLE,ECON,Ec-Mth&Ecn,0,0,0,0,0,0,1,0,1,3,0,3,4,1,5,0,0,0,8,1,9
sp10,102,REVELLE,ECON,Econ-MgtSc,0,0,0,1,2,3,9,4,13,20,5,25,31,22,53,0,0,0,61,33,94
sp10,102,REVELLE,ECON,Economics,0,0,0,6,2,8,6,7,13,32,19,51,45,31,76,0,0,0,89,59,148
sp10,102,REVELLE,ERTH,ErthSc-Phy,0,0,0,0,0,0,0,0,0,0,0,0,1,0,1,0,0,0,1,0,1
sp10,102,REVELLE,ESYS,EnvSys(EB),0,0,0,1,2,3,0,2,2,3,1,4,2,5,7,0,0,0,6,10,16
sp10,102,REVELLE,ESYS,EnvSys(EC),0,0,0,0,0,0,0,1,1,1,0,1,1,0,1,0,0,0,2,1,3
sp10,102,REVELLE,ESYS,EnvSys(EP),0,0,0,0,0,0,0,0,0,0,0,0,0,1,1,0,0,0,0,1,1
sp10,102,REVELLE,ESYS,EnvSys(ES),0,0,0,0,1,1,0,0,0,1,0,1,0,2,2,0,0,0,1,3,4
sp10,102,REVELLE,ETHN,Ethnic St,0,0,0,0,0,0,1,2,3,1,2,3,2,2,4,0,0,0,4,6,10
sp10,102,REVELLE,HDP,Human Dev,0,0,0,0,0,0,0,1,1,0,4,4,3,18,21,0,0,0,3,23,26
sp10,102,REVELLE,HDP,Pr-HumnDev,0,0,0,0,1,1,0,5,5,0,3,3,0,2,2,0,0,0,0,11,11
sp10,102,REVELLE,HIST,History,0,0,0,0,0,0,2,2,4,4,4,8,5,9,14,0,0,0,11,15,26
sp10,102,REVELLE,INTD,Rev Ind Mj,0,0,0,0,0,0,0,0,0,0,0,0,1,0,1,0,0,0,1,0,1
sp10,102,REVELLE,INTL,IntSt-Econ,0,0,0,0,0,0,2,3,5,4,3,7,4,3,7,0,0,0,10,9,19
sp10,102,REVELLE,INTL,IntSt-Hist,0,0,0,0,0,0,0,0,0,0,3,3,0,2,2,0,0,0,0,5,5
sp10,102,REVELLE,INTL,IntSt-Ling,0,0,0,0,0,0,0,0,0,1,1,2,0,3,3,0,0,0,1,4,5
sp10,102,REVELLE,INTL,IntSt-Lit,0,0,0,0,0,0,0,0,0,0,1,1,0,1,1,0,0,0,0,2,2
sp10,102,REVELLE,INTL,IntSt-PolS,0,0,0,0,1,1,2,3,5,1,4,5,2,9,11,0,0,0,5,17,22
sp10,102,REVELLE,INTL,IntSt-Soc,0,0,0,0,1,1,0,0,0,1,5,6,1,2,3,0,0,0,2,8,10
sp10,102,REVELLE,ITAL,Italian St,0,0,0,0,0,0,0,0,0,0,0,0,0,1,1,0,0,0,0,1,1
sp10,102,REVELLE,JAPN,JapaneseSt,0,0,0,1,0,1,1,0,1,1,0,1,1,0,1,0,0,0,4,0,4
sp10,102,REVELLE,JUDA,Judaic Stu,0,0,0,0,0,0,1,0,1,0,1,1,0,0,0,0,0,0,1,1,2
sp10,102,REVELLE,LATI,LatinAm St,0,0,0,0,0,0,0,0,0,1,0,1,0,0,0,0,0,0,1,0,1
sp10,102,REVELLE,LING,Lang Stu,0,0,0,0,0,0,0,0,0,0,0,0,0,1,1,0,0,0,0,1,1
sp10,102,REVELLE,LING,Ling-CogLn,0,0,0,0,0,0,0,3,3,0,1,1,0,2,2,0,0,0,0,6,6
sp10,102,REVELLE,LING,Linguistcs,0,0,0,0,2,2,0,1,1,0,1,1,2,4,6,0,0,0,2,8,10
sp10,102,REVELLE,LIT,French Lit,0,0,0,0,0,0,0,1,1,0,0,0,0,0,0,0,0,0,0,1,1
sp10,102,REVELLE,LIT,Ital Lit,0,0,0,0,0,0,0,0,0,0,0,0,0,2,2,0,0,0,0,2,2
sp10,102,REVELLE,LIT,Lit/Compos,0,0,0,0,0,0,1,0,1,0,2,2,0,0,0,0,0,0,1,2,3
sp10,102,REVELLE,LIT,Lit/Engl,0,0,0,0,1,1,1,1,2,1,1,2,1,8,9,0,0,0,3,11,14
sp10,102,REVELLE,LIT,Lit/World,0,0,0,0,0,0,0,0,0,2,1,3,2,6,8,0,0,0,4,7,11
sp10,102,REVELLE,LIT,Lit/Writng,0,0,0,0,0,0,0,0,0,0,0,0,2,7,9,0,0,0,2,7,9
sp10,102,REVELLE,LIT,Pre-Lit/Wr,0,0,0,0,0,0,0,3,3,3,2,5,4,2,6,0,0,0,7,7,14
sp10,102,REVELLE,LIT,Spanish Lt,0,0,0,0,0,0,0,0,0,0,0,0,0,3,3,0,0,0,0,3,3
sp10,102,REVELLE,MAE,Aerosp Eng,0,0,0,0,0,0,9,1,10,7,2,9,23,6,29,0,0,0,39,9,48
sp10,102,REVELLE,MAE,Engin Sci,0,0,0,1,0,1,2,0,2,1,0,1,1,0,1,0,0,0,5,0,5
sp10,102,REVELLE,MAE,Envir Eng,0,0,0,1,0,1,1,1,2,0,1,1,3,1,4,0,0,0,5,3,8
sp10,102,REVELLE,MAE,Mech Engin,0,0,0,1,2,3,8,1,9,18,4,22,50,12,62,0,0,0,77,19,96
sp10,102,REVELLE,MATH,Appld Math,0,0,0,0,0,0,0,0,0,1,0,1,3,3,6,0,0,0,4,3,7
sp10,102,REVELLE,MATH,Math/SecEd,0,0,0,0,0,0,0,0,0,3,0,3,0,0,0,0,0,0,3,0,3
sp10,102,REVELLE,MATH,Mathematcs,0,0,0,0,0,0,4,2,6,2,8,10,10,9,19,0,0,0,16,19,35
sp10,102,REVELLE,MATH,Mth-CompSc,0,0,0,0,0,0,0,0,0,0,0,0,3,0,3,0,0,0,3,0,3
sp10,102,REVELLE,MATH,Mth-Mth&Ec,0,0,0,0,1,1,1,0,1,3,1,4,4,0,4,0,0,0,8,2,10
sp10,102,REVELLE,MATH,Mth-SciCom,0,0,0,0,0,0,0,0,0,0,0,0,1,1,2,0,0,0,1,1,2
sp10,102,REVELLE,MATH,Mth/ApldSc,0,0,0,0,0,0,0,1,1,1,0,1,1,0,1,0,0,0,2,1,3
sp10,102,REVELLE,MATH,Prob&Stats,0,0,0,0,0,0,1,0,1,2,1,3,3,1,4,0,0,0,6,2,8
sp10,102,REVELLE,MUS,Mu-CompArt,0,0,0,0,0,0,0,0,0,1,0,1,3,0,3,0,0,0,4,0,4
sp10,102,REVELLE,MUS,Music,0,0,0,0,1,1,1,0,1,6,1,7,3,1,4,0,0,0,10,3,13
sp10,102,REVELLE,MUS,Music Hum,0,0,0,0,0,0,0,0,0,1,0,1,0,0,0,0,0,0,1,0,1
sp10,102,REVELLE,PHIL,Philosophy,0,0,0,0,0,0,0,0,0,4,0,4,1,3,4,0,0,0,5,3,8
sp10,102,REVELLE,PHYS,Biophysics,0,0,0,1,0,1,0,1,1,0,0,0,1,1,2,0,0,0,2,2,4
sp10,102,REVELLE,PHYS,Phy/ErthSc,0,0,0,0,0,0,0,0,0,0,0,0,1,0,1,0,0,0,1,0,1
sp10,102,REVELLE,PHYS,Phys/Astro,0,0,0,0,0,0,1,0,1,5,1,6,1,3,4,0,0,0,7,4,11
sp10,102,REVELLE,PHYS,Phys/Comp,0,0,0,1,0,1,0,1,1,0,0,0,0,0,0,0,0,0,1,1,2
sp10,102,REVELLE,PHYS,Phys/Mtrls,0,0,0,0,0,0,0,0,0,1,0,1,0,0,0,0,0,0,1,0,1
sp10,102,REVELLE,PHYS,Physics,0,0,0,0,0,0,3,0,3,3,1,4,7,2,9,0,0,0,13,3,16
sp10,102,REVELLE,POLI,Polit Sci,0,0,0,3,2,5,2,6,8,14,4,18,9,10,19,0,0,0,28,22,50
sp10,102,REVELLE,POLI,PolSc-Amer,0,0,0,0,0,0,1,4,5,1,0,1,1,2,3,0,0,0,3,6,9
sp10,102,REVELLE,POLI,PolSc-Comp,0,0,0,0,0,0,0,0,0,0,0,0,0,1,1,0,0,0,0,1,1
sp10,102,REVELLE,POLI,PolSc-Intl,0,0,0,0,0,0,1,2,3,6,5,11,6,6,12,0,0,0,13,13,26
sp10,102,REVELLE,POLI,PolSc-PLaw,0,0,0,1,0,1,0,0,0,6,5,11,2,4,6,0,0,0,9,9,18
sp10,102,REVELLE,POLI,PolSc-PPol,0,0,0,0,0,0,0,0,0,1,0,1,0,3,3,0,0,0,1,3,4
sp10,102,REVELLE,POLI,PolSc-Thry,0,0,0,0,0,0,0,0,0,0,0,0,0,1,1,0,0,0,0,1,1
sp10,102,REVELLE,PSYC,Psychology,0,0,0,2,11,13,8,31,39,24,51,75,33,80,113,0,0,0,67,173,240
sp10,102,REVELLE,RELI,Relig/Stu,0,0,0,0,0,0,0,0,0,0,0,0,1,0,1,0,0,0,1,0,1
sp10,102,REVELLE,SE,Struct Eng,0,0,0,0,1,1,8,2,10,12,3,15,28,12,40,0,0,0,48,18,66
sp10,102,REVELLE,SIO,ErSc-Geoch,0,0,0,0,0,0,0,0,0,0,1,1,0,0,0,0,0,0,0,1,1
sp10,102,REVELLE,SIO,ErSc-Geol,0,0,0,0,0,0,0,0,0,2,1,3,2,0,2,0,0,0,4,1,5
sp10,102,REVELLE,SOC,SocCulCom,0,0,0,0,0,0,0,0,0,0,0,0,1,0,1,0,0,0,1,0,1
sp10,102,REVELLE,SOC,SocEconSoc,0,0,0,0,0,0,0,0,0,1,0,1,0,0,0,0,0,0,1,0,1
sp10,102,REVELLE,SOC,Sociology,0,0,0,0,0,0,0,3,3,4,8,12,3,6,9,0,0,0,7,17,24
sp10,102,REVELLE,SOC,SocLawSoc,0,0,0,0,0,0,0,0,0,0,1,1,1,1,2,0,0,0,1,2,3
sp10,102,REVELLE,SOC,SocSciMed,0,0,0,0,0,0,0,2,2,0,1,1,0,0,0,0,0,0,0,3,3
sp10,102,REVELLE,SOC,SocSolneq,0,0,0,0,0,0,0,0,0,0,1,1,0,0,0,0,0,0,0,1,1
sp10,102,REVELLE,THEA,Dance,0,0,0,0,0,0,0,0,0,0,0,0,1,1,2,0,0,0,1,1,2
sp10,102,REVELLE,THEA,Theatre,0,0,0,0,0,0,0,0,0,0,2,2,2,3,5,0,0,0,2,5,7
sp10,102,REVELLE,TWS,ThirdWldSt,0,0,0,0,0,0,0,0,0,0,1,1,0,0,0,0,0,0,0,1,1
sp10,102,REVELLE,UNAF,Limited St,0,0,0,0,0,0,0,0,0,0,0,0,0,0,0,4,8,12,4,8,12
sp10,102,REVELLE,UNAF,Spec-Emply,0,0,0,0,0,0,0,0,0,0,0,0,0,0,0,3,3,6,3,3,6
sp10,102,REVELLE,UNAF,UndecHumAr,0,0,0,0,2,2,0,4,4,0,0,0,0,0,0,0,0,0,0,6,6
sp10,102,REVELLE,UNAF,Undeclared,0,0,0,7,22,29,14,25,39,0,4,4,0,0,0,0,0,0,21,51,72
sp10,102,REVELLE,UNAF,UndecPhysS,0,0,0,0,2,2,5,8,13,0,0,0,0,0,0,0,0,0,5,10,15
sp10,102,REVELLE,UNAF,UndecSocSc,0,0,0,1,2,3,3,2,5,0,1,1,0,0,0,0,0,0,4,5,9
sp10,102,REVELLE,USP,Urb Stu&Pl,0,0,0,0,1,1,2,1,3,1,2,3,1,3,4,0,0,0,4,7,11
sp10,102,REVELLE,VIS,Art Hst/Cr,0,0,0,0,1,1,0,0,0,0,5,5,1,2,3,0,0,0,1,8,9
sp10,102,REVELLE,VIS,Media,0,0,0,0,0,0,2,1,3,0,3,3,3,6,9,0,0,0,5,10,15
sp10,102,REVELLE,VIS,Studio VA,0,0,0,0,0,0,0,0,0,2,3,5,1,0,1,0,0,0,3,3,6
sp10,102,REVELLE,VIS,VA-CompArt,0,0,0,0,0,0,0,0,0,5,3,8,2,1,3,0,0,0,7,4,11
sp10,102,ROOSEVELT,ANTH,Anth-Arch,0,0,0,0,1,1,0,1,1,0,5,5,4,6,10,0,0,0,4,13,17
sp10,102,ROOSEVELT,ANTH,Anth-Biol,0,0,0,0,0,0,0,3,3,1,5,6,1,5,6,0,0,0,2,13,15
sp10,102,ROOSEVELT,ANTH,Anth-Soci,0,0,0,0,0,0,0,3,3,1,3,4,2,6,8,0,0,0,3,12,15
sp10,102,ROOSEVELT,ANTH,Anthropol,0,0,0,0,0,0,0,0,0,0,0,0,0,1,1,0,0,0,0,1,1
sp10,102,ROOSEVELT,BENG,Bioen:Binf,0,0,0,0,0,0,0,0,0,0,1,1,0,0,0,0,0,0,0,1,1
sp10,102,ROOSEVELT,BENG,Bioeng:PM,0,0,0,0,0,0,0,0,0,2,2,4,11,5,16,0,0,0,13,7,20
sp10,102,ROOSEVELT,BENG,BioengBiot,0,0,0,0,0,0,7,2,9,3,3,6,4,2,6,0,0,0,14,7,21
sp10,102,ROOSEVELT,BENG,Bioengin,0,0,0,1,0,1,1,1,2,3,4,7,3,5,8,0,0,0,8,10,18
sp10,102,ROOSEVELT,BENG,Pr-BioenPM,0,0,0,2,1,3,6,0,6,5,2,7,0,1,1,0,0,0,13,4,17
sp10,102,ROOSEVELT,BIOL,Bioc/CellB,0,0,0,0,1,1,4,7,11,8,16,24,26,40,66,0,0,0,38,64,102
sp10,102,ROOSEVELT,BIOL,Ec/Beh/Evo,0,0,0,1,1,2,1,2,3,0,4,4,2,10,12,0,0,0,4,17,21
sp10,102,ROOSEVELT,BIOL,Genl Biol,0,0,0,1,0,1,3,11,14,13,25,38,28,63,91,0,0,0,45,99,144
sp10,102,ROOSEVELT,BIOL,Human Bio,0,0,0,2,9,11,17,28,45,35,56,91,35,68,103,0,0,0,89,161,250
sp10,102,ROOSEVELT,BIOL,Microbiol,0,0,0,0,0,0,1,2,3,3,0,3,3,2,5,0,0,0,7,4,11
sp10,102,ROOSEVELT,BIOL,Molec Biol,0,0,0,0,0,0,1,2,3,4,3,7,6,9,15,0,0,0,11,14,25
sp10,102,ROOSEVELT,BIOL,PhyslNeuro,0,0,0,0,1,1,4,4,8,8,10,18,15,24,39,0,0,0,27,39,66
sp10,102,ROOSEVELT,CENG,Chem Engin,0,0,0,1,0,1,6,0,6,0,4,4,3,4,7,0,0,0,10,8,18
sp10,102,ROOSEVELT,CGS,CritGendSt,0,0,0,0,0,0,0,0,0,0,0,0,0,1,1,0,0,0,0,1,1
sp10,102,ROOSEVELT,CHEM,Bioch/Chem,0,0,0,6,2,8,8,10,18,7,8,15,11,6,17,0,0,0,32,26,58
sp10,102,ROOSEVELT,CHEM,Bioinform,0,0,0,0,0,0,1,0,1,0,0,0,0,0,0,0,0,0,1,0,1
sp10,102,ROOSEVELT,CHEM,Chemistry,0,0,0,1,2,3,1,1,2,3,2,5,3,1,4,0,0,0,8,6,14
sp10,102,ROOSEVELT,CHEM,Envir Chem,0,0,0,1,0,1,0,1,1,2,0,2,0,2,2,0,0,0,3,3,6
sp10,102,ROOSEVELT,CHEM,Pharm Chem,0,0,0,0,6,6,2,8,10,6,7,13,3,3,6,0,0,0,11,24,35
sp10,102,ROOSEVELT,CHIN,Chinese St,0,0,0,1,2,3,0,0,0,1,2,3,1,2,3,0,0,0,3,6,9
sp10,102,ROOSEVELT,CLAS,Classic St,0,0,0,0,0,0,0,1,1,0,0,0,2,0,2,0,0,0,2,1,3
sp10,102,ROOSEVELT,COGS,Cog Sci,0,0,0,1,1,2,1,5,6,6,5,11,3,3,6,0,0,0,11,14,25
sp10,102,ROOSEVELT,COGS,CogSc/ClAs,0,0,0,0,0,0,0,2,2,0,0,0,1,0,1,0,0,0,1,2,3
sp10,102,ROOSEVELT,COGS,CogSc/HCI,0,0,0,0,0,0,1,1,2,1,1,2,3,6,9,0,0,0,5,8,13
sp10,102,ROOSEVELT,COGS,CogSc/HCog,0,0,0,0,1,1,1,0,1,0,1,1,1,0,1,0,0,0,2,2,4
sp10,102,ROOSEVELT,COGS,CogSc/Neur,0,0,0,0,1,1,3,2,5,2,7,9,3,13,16,0,0,0,8,23,31
sp10,102,ROOSEVELT,COMM,Communic,0,0,0,0,5,5,4,27,31,19,49,68,24,74,98,0,0,0,47,155,202
sp10,102,ROOSEVELT,CSE,Comp Sci,0,0,0,1,2,3,9,2,11,17,4,21,19,3,22,0,0,0,46,11,57
sp10,102,ROOSEVELT,CSE,CompEngCSE,0,0,0,2,1,3,1,0,1,5,0,5,3,0,3,0,0,0,11,1,12
sp10,102,ROOSEVELT,CSE,CompScBinf,0,0,0,0,0,0,0,0,0,0,1,1,1,0,1,0,0,0,1,1,2
sp10,102,ROOSEVELT,ECE,CompEngECE,0,0,0,0,0,0,2,0,2,2,0,2,0,0,0,0,0,0,4,0,4
sp10,102,ROOSEVELT,ECE,Electr Eng,0,0,0,1,0,1,2,0,2,7,2,9,13,5,18,0,0,0,23,7,30
sp10,102,ROOSEVELT,ECE,Engin Phys,0,0,0,0,0,0,0,0,0,1,0,1,0,0,0,0,0,0,1,0,1
sp10,102,ROOSEVELT,ECE,Pr-EngPhys,0,0,0,0,0,0,1,0,1,0,0,0,0,0,0,0,0,0,1,0,1
sp10,102,ROOSEVELT,ECON,Ec-Mth&Ecn,0,0,0,0,0,0,1,1,2,7,0,7,5,3,8,0,0,0,13,4,17
sp10,102,ROOSEVELT,ECON,Econ-MgtSc,0,0,0,2,3,5,13,8,21,31,18,49,55,36,91,0,0,0,101,65,166
sp10,102,ROOSEVELT,ECON,Economics,0,0,0,4,6,10,16,16,32,50,26,76,69,39,108,0,0,0,139,87,226
sp10,102,ROOSEVELT,ESYS,EnvSys(EB),0,0,0,0,0,0,3,3,6,1,8,9,2,5,7,0,0,0,6,16,22
sp10,102,ROOSEVELT,ESYS,EnvSys(EC),0,0,0,0,0,0,0,0,0,0,0,0,1,2,3,0,0,0,1,2,3
sp10,102,ROOSEVELT,ESYS,EnvSys(EP),0,0,0,0,0,0,0,0,0,1,2,3,3,2,5,0,0,0,4,4,8
sp10,102,ROOSEVELT,ESYS,EnvSys(ES),0,0,0,0,0,0,1,2,3,1,3,4,1,1,2,0,0,0,3,6,9
sp10,102,ROOSEVELT,ETHN,Ethnic St,0,0,0,1,0,1,0,3,3,0,3,3,0,13,13,0,0,0,1,19,20
sp10,102,ROOSEVELT,HDP,Human Dev,0,0,0,0,0,0,0,0,0,0,2,2,3,26,29,0,0,0,3,28,31
sp10,102,ROOSEVELT,HDP,Pr-HumnDev,0,0,0,0,2,2,3,11,14,0,7,7,0,5,5,0,0,0,3,25,28
sp10,102,ROOSEVELT,HIST,History,0,0,0,2,0,2,1,5,6,12,16,28,21,30,51,0,0,0,36,51,87
sp10,102,ROOSEVELT,INTD,Roos IndSt,0,0,0,0,0,0,0,0,0,0,0,0,1,0,1,0,0,0,1,0,1
sp10,102,ROOSEVELT,INTL,Int-5yrEC,0,0,0,0,0,0,0,0,0,0,0,0,0,1,1,0,0,0,0,1,1
sp10,102,ROOSEVELT,INTL,IntSt-Anth,0,0,0,0,0,0,0,1,1,1,5,6,0,5,5,0,0,0,1,11,12
sp10,102,ROOSEVELT,INTL,IntSt-Econ,0,0,0,0,5,5,4,9,13,16,22,38,21,33,54,0,0,0,41,69,110
sp10,102,ROOSEVELT,INTL,IntSt-Hist,0,0,0,0,2,2,2,1,3,4,10,14,2,9,11,0,0,0,8,22,30
sp10,102,ROOSEVELT,INTL,IntSt-Ling,0,0,0,0,1,1,1,3,4,0,2,2,2,4,6,0,0,0,3,10,13
sp10,102,ROOSEVELT,INTL,IntSt-Lit,0,0,0,0,0,0,0,0,0,0,0,0,0,3,3,0,0,0,0,3,3
sp10,102,ROOSEVELT,INTL,IntSt-PolS,0,0,0,0,2,2,2,19,21,8,35,43,23,37,60,0,0,0,33,93,126
sp10,102,ROOSEVELT,INTL,IntSt-Soc,0,0,0,0,3,3,0,6,6,2,20,22,0,24,24,0,0,0,2,53,55
sp10,102,ROOSEVELT,ITAL,Italian St,0,0,0,0,0,0,0,0,0,1,1,2,0,0,0,0,0,0,1,1,2
sp10,102,ROOSEVELT,JAPN,JapaneseSt,0,0,0,0,0,0,1,0,1,0,2,2,2,3,5,0,0,0,3,5,8
sp10,102,ROOSEVELT,JUDA,Judaic Stu,0,0,0,0,0,0,0,0,0,0,0,0,0,1,1,0,0,0,0,1,1
sp10,102,ROOSEVELT,LATI,LatinAm St,0,0,0,0,1,1,0,1,1,0,0,0,2,2,4,0,0,0,2,4,6
sp10,102,ROOSEVELT,LING,Lang Stu,0,0,0,0,0,0,0,0,0,0,1,1,0,2,2,0,0,0,0,3,3
sp10,102,ROOSEVELT,LING,Ling-CogLn,0,0,0,0,0,0,0,0,0,0,0,0,0,1,1,0,0,0,0,1,1
sp10,102,ROOSEVELT,LING,Ling-LSoc,0,0,0,0,0,0,0,2,2,0,0,0,1,2,3,0,0,0,1,4,5
sp10,102,ROOSEVELT,LING,Linguistcs,0,0,0,1,0,1,0,3,3,0,6,6,1,3,4,0,0,0,2,12,14
sp10,102,ROOSEVELT,LIT,French Lit,0,0,0,0,0,0,0,0,0,0,1,1,1,0,1,0,0,0,1,1,2
sp10,102,ROOSEVELT,LIT,Lit/Compos,0,0,0,0,0,0,1,0,1,0,1,1,0,1,1,0,0,0,1,2,3
sp10,102,ROOSEVELT,LIT,Lit/CultSt,0,0,0,0,0,0,0,0,0,0,2,2,0,1,1,0,0,0,0,3,3
sp10,102,ROOSEVELT,LIT,Lit/Engl,0,0,0,0,1,1,0,1,1,3,9,12,5,5,10,0,0,0,8,16,24
sp10,102,ROOSEVELT,LIT,Lit/World,0,0,0,0,0,0,0,0,0,0,2,2,1,1,2,0,0,0,1,3,4
sp10,102,ROOSEVELT,LIT,Lit/Writng,0,0,0,0,0,0,0,0,0,0,2,2,2,16,18,0,0,0,2,18,20
sp10,102,ROOSEVELT,LIT,Pre-Lit/Wr,0,0,0,0,0,0,1,6,7,6,9,15,4,3,7,0,0,0,11,18,29
sp10,102,ROOSEVELT,LIT,Spanish Lt,0,0,0,0,0,0,0,1,1,1,0,1,0,3,3,0,0,0,1,4,5
sp10,102,ROOSEVELT,MAE,Aerosp Eng,0,0,0,4,0,4,5,1,6,7,2,9,11,2,13,0,0,0,27,5,32
sp10,102,ROOSEVELT,MAE,Engin Sci,0,0,0,0,0,0,0,1,1,2,0,2,1,0,1,0,0,0,3,1,4
sp10,102,ROOSEVELT,MAE,Envir Eng,0,0,0,0,0,0,1,2,3,3,1,4,2,2,4,0,0,0,6,5,11
sp10,102,ROOSEVELT,MAE,Mech Engin,0,0,0,2,0,2,9,3,12,12,2,14,24,9,33,0,0,0,47,14,61
sp10,102,ROOSEVELT,MATH,Appld Math,0,0,0,0,0,0,0,1,1,1,0,1,2,2,4,0,0,0,3,3,6
sp10,102,ROOSEVELT,MATH,Math/SecEd,0,0,0,0,0,0,1,1,2,0,0,0,1,0,1,0,0,0,2,1,3
sp10,102,ROOSEVELT,MATH,Mathematcs,0,0,0,0,0,0,1,1,2,1,1,2,3,4,7,0,0,0,5,6,11
sp10,102,ROOSEVELT,MATH,Mth-CompSc,0,0,0,0,0,0,0,0,0,0,1,1,0,0,0,0,0,0,0,1,1
sp10,102,ROOSEVELT,MATH,Mth-Mth&Ec,0,0,0,0,1,1,2,1,3,4,0,4,3,1,4,0,0,0,9,3,12
sp10,102,ROOSEVELT,MATH,Mth/ApldSc,0,0,0,1,0,1,0,0,0,0,0,0,2,0,2,0,0,0,3,0,3
sp10,102,ROOSEVELT,MATH,Pr-Math CS,0,0,0,0,1,1,1,0,1,1,0,1,0,0,0,0,0,0,2,1,3
sp10,102,ROOSEVELT,MATH,Prob&Stats,0,0,0,0,0,0,0,0,0,1,0,1,0,0,0,0,0,0,1,0,1
sp10,102,ROOSEVELT,MUS,Mu-CompArt,0,0,0,0,0,0,1,0,1,0,1,1,4,1,5,0,0,0,5,2,7
sp10,102,ROOSEVELT,MUS,Music,0,0,0,0,0,0,1,2,3,2,0,2,5,4,9,0,0,0,8,6,14
sp10,102,ROOSEVELT,PHIL,Philosophy,0,0,0,0,0,0,2,0,2,1,3,4,2,2,4,0,0,0,5,5,10
sp10,102,ROOSEVELT,PHYS,Biophysics,0,0,0,0,0,0,0,0,0,0,0,0,1,0,1,0,0,0,1,0,1
sp10,102,ROOSEVELT,PHYS,GenPys/SEd,0,0,0,0,0,0,0,0,0,0,1,1,1,0,1,0,0,0,1,1,2
sp10,102,ROOSEVELT,PHYS,Phys/Astro,0,0,0,0,0,0,0,0,0,1,0,1,1,1,2,0,0,0,2,1,3
sp10,102,ROOSEVELT,PHYS,Phys/Comp,0,0,0,0,0,0,0,0,0,0,0,0,0,1,1,0,0,0,0,1,1
sp10,102,ROOSEVELT,PHYS,Phys/Mtrls,0,0,0,0,0,0,0,0,0,1,0,1,0,0,0,0,0,0,1,0,1
sp10,102,ROOSEVELT,PHYS,Physics,0,0,0,0,0,0,0,1,1,1,0,1,5,3,8,0,0,0,6,4,10
sp10,102,ROOSEVELT,POLI,Polit Sci,0,0,0,0,3,3,6,7,13,20,24,44,30,40,70,0,0,0,56,74,130
sp10,102,ROOSEVELT,POLI,PolSc-Amer,0,0,0,0,1,1,2,3,5,3,2,5,4,6,10,0,0,0,9,12,21
sp10,102,ROOSEVELT,POLI,PolSc-Comp,0,0,0,0,0,0,0,0,0,0,2,2,0,2,2,0,0,0,0,4,4
sp10,102,ROOSEVELT,POLI,PolSc-Intl,0,0,0,3,8,11,9,7,16,20,13,33,11,30,41,0,0,0,43,58,101
sp10,102,ROOSEVELT,POLI,PolSc-PLaw,0,0,0,1,1,2,4,4,8,5,6,11,6,14,20,0,0,0,16,25,41
sp10,102,ROOSEVELT,POLI,PolSc-PPol,0,0,0,1,2,3,0,0,0,2,2,4,2,0,2,0,0,0,5,4,9
sp10,102,ROOSEVELT,POLI,PolSc-Thry,0,0,0,0,0,0,0,0,0,2,0,2,0,4,4,0,0,0,2,4,6
sp10,102,ROOSEVELT,PSYC,Psychology,0,0,0,5,10,15,12,34,46,25,65,90,26,92,118,0,0,0,68,201,269
sp10,102,ROOSEVELT,RELI,Relig/Stu,0,0,0,0,0,0,0,1,1,0,0,0,0,2,2,0,0,0,0,3,3
sp10,102,ROOSEVELT,RUSS,Russ&SovSt,0,0,0,0,0,0,0,0,0,1,0,1,0,0,0,0,0,0,1,0,1
sp10,102,ROOSEVELT,SE,Engin Sci,0,0,0,1,1,2,0,0,0,0,1,1,0,0,0,0,0,0,1,2,3
sp10,102,ROOSEVELT,SE,Struct Eng,0,0,0,1,3,4,11,3,14,10,2,12,23,7,30,0,0,0,45,15,60
sp10,102,ROOSEVELT,SIO,ErSc-Geol,0,0,0,0,0,0,0,0,0,1,2,3,0,0,0,0,0,0,1,2,3
sp10,102,ROOSEVELT,SOC,SocAmSt,0,0,0,0,0,0,0,0,0,0,0,0,0,1,1,0,0,0,0,1,1
sp10,102,ROOSEVELT,SOC,SocCulCom,0,0,0,0,0,0,0,0,0,1,3,4,1,2,3,0,0,0,2,5,7
sp10,102,ROOSEVELT,SOC,SocEconSoc,0,0,0,0,0,0,0,0,0,0,0,0,0,1,1,0,0,0,0,1,1
sp10,102,ROOSEVELT,SOC,SocIntlStu,0,0,0,0,0,0,0,0,0,2,2,4,0,3,3,0,0,0,2,5,7
sp10,102,ROOSEVELT,SOC,Sociology,0,0,0,0,3,3,1,5,6,6,16,22,7,18,25,0,0,0,14,42,56
sp10,102,ROOSEVELT,SOC,SocLawSoc,0,0,0,0,0,0,2,0,2,1,1,2,1,2,3,0,0,0,4,3,7
sp10,102,ROOSEVELT,SOC,SocSciMed,0,0,0,0,0,0,0,1,1,1,0,1,0,1,1,0,0,0,1,2,3
sp10,102,ROOSEVELT,SOC,SocSolneq,0,0,0,0,0,0,0,0,0,0,1,1,1,2,3,0,0,0,1,3,4
sp10,102,ROOSEVELT,THEA,Dance,0,0,0,0,0,0,0,1,1,0,0,0,0,0,0,0,0,0,0,1,1
sp10,102,ROOSEVELT,THEA,Theatre,0,0,0,0,1,1,2,4,6,0,6,6,5,6,11,0,0,0,7,17,24
sp10,102,ROOSEVELT,TWS,ThirdWldSt,0,0,0,0,0,0,0,0,0,0,1,1,0,4,4,0,0,0,0,5,5
sp10,102,ROOSEVELT,UNAF,Limited St,0,0,0,0,0,0,0,0,0,0,0,0,0,0,0,1,0,1,1,0,1
sp10,102,ROOSEVELT,UNAF,UndecHumAr,0,0,0,0,1,1,1,2,3,0,0,0,0,0,0,0,0,0,1,3,4
sp10,102,ROOSEVELT,UNAF,Undeclared,0,0,0,5,14,19,8,22,30,1,3,4,0,0,0,0,0,0,14,39,53
sp10,102,ROOSEVELT,UNAF,UndecPhysS,0,0,0,0,2,2,4,3,7,0,0,0,0,0,0,0,0,0,4,5,9
sp10,102,ROOSEVELT,UNAF,UndecSocSc,0,0,0,0,1,1,1,1,2,0,1,1,0,0,0,0,0,0,1,3,4
sp10,102,ROOSEVELT,USP,Urb Stu&Pl,0,0,0,0,0,0,1,3,4,8,11,19,6,10,16,0,0,0,15,24,39
sp10,102,ROOSEVELT,VIS,Art Hst/Cr,0,0,0,0,0,0,0,0,0,1,1,2,2,10,12,0,0,0,3,11,14
sp10,102,ROOSEVELT,VIS,Media,0,0,0,0,0,0,0,5,5,2,7,9,9,14,23,0,0,0,11,26,37
sp10,102,ROOSEVELT,VIS,Studio VA,0,0,0,1,0,1,0,2,2,1,5,6,2,6,8,0,0,0,4,13,17
sp10,102,ROOSEVELT,VIS,VA-CompArt,0,0,0,0,0,0,0,2,2,0,0,0,2,3,5,0,0,0,2,5,7
sp10,102,SIXTH,ANTH,Anth-Arch,0,0,0,0,0,0,0,1,1,0,1,1,4,2,6,0,0,0,4,4,8
sp10,102,SIXTH,ANTH,Anth-Biol,0,0,0,0,0,0,1,2,3,1,1,2,1,6,7,0,0,0,3,9,12
sp10,102,SIXTH,ANTH,Anth-Soci,0,0,0,0,1,1,0,2,2,0,5,5,0,5,5,0,0,0,0,13,13
sp10,102,SIXTH,BENG,Bioen:Binf,0,0,0,1,0,1,0,0,0,1,0,1,4,0,4,0,0,0,6,0,6
sp10,102,SIXTH,BENG,Bioeng:PM,0,0,0,0,0,0,0,0,0,2,0,2,13,5,18,0,0,0,15,5,20
sp10,102,SIXTH,BENG,BioengBiot,0,0,0,0,0,0,6,4,10,6,3,9,9,2,11,0,0,0,21,9,30
sp10,102,SIXTH,BENG,Bioengin,0,0,0,0,0,0,2,4,6,2,0,2,6,2,8,0,0,0,10,6,16
sp10,102,SIXTH,BENG,Pr-BioenPM,0,0,0,2,1,3,7,1,8,3,0,3,0,0,0,0,0,0,12,2,14
sp10,102,SIXTH,BIOL,Bioc/CellB,0,0,0,0,1,1,5,6,11,14,13,27,42,41,83,0,0,0,61,61,122
sp10,102,SIXTH,BIOL,Ec/Beh/Evo,0,0,0,0,0,0,0,0,0,1,4,5,2,9,11,0,0,0,3,13,16
sp10,102,SIXTH,BIOL,Genl Biol,0,0,0,0,0,0,6,7,13,15,17,32,35,47,82,0,0,0,56,71,127
sp10,102,SIXTH,BIOL,Human Bio,0,0,0,4,3,7,18,16,34,26,43,69,43,59,102,0,0,0,91,121,212
sp10,102,SIXTH,BIOL,Microbiol,0,0,0,2,1,3,1,0,1,3,3,6,6,6,12,0,0,0,12,10,22
sp10,102,SIXTH,BIOL,Molec Biol,0,0,0,0,0,0,0,0,0,3,1,4,6,9,15,0,0,0,9,10,19
sp10,102,SIXTH,BIOL,PhyslNeuro,0,0,0,0,0,0,1,5,6,11,8,19,22,16,38,0,0,0,34,29,63
sp10,102,SIXTH,CENG,Chem Engin,0,0,0,1,0,1,5,0,5,11,2,13,15,6,21,0,0,0,32,8,40
sp10,102,SIXTH,CGS,CritGendSt,0,0,0,0,0,0,0,1,1,0,0,0,0,1,1,0,0,0,0,2,2
sp10,102,SIXTH,CHEM,Bioch/Chem,0,0,0,3,2,5,9,9,18,6,2,8,6,10,16,0,0,0,24,23,47
sp10,102,SIXTH,CHEM,Chem Educ,0,0,0,0,0,0,0,1,1,1,0,1,0,0,0,0,0,0,1,1,2
sp10,102,SIXTH,CHEM,Chemistry,0,0,0,0,2,2,2,4,6,2,2,4,12,3,15,0,0,0,16,11,27
sp10,102,SIXTH,CHEM,Envir Chem,0,0,0,0,0,0,0,1,1,0,0,0,2,1,3,0,0,0,2,2,4
sp10,102,SIXTH,CHEM,MolecSynth,0,0,0,0,0,0,0,0,0,0,0,0,1,1,2,0,0,0,1,1,2
sp10,102,SIXTH,CHEM,Pharm Chem,0,0,0,2,1,3,4,13,17,4,7,11,11,13,24,0,0,0,21,34,55
sp10,102,SIXTH,CHIN,Chinese St,0,0,0,0,1,1,0,0,0,1,0,1,0,0,0,0,0,0,1,1,2
sp10,102,SIXTH,CLAS,Classic St,0,0,0,0,0,0,0,0,0,0,1,1,1,0,1,0,0,0,1,1,2
sp10,102,SIXTH,COGS,Cog Sci,0,0,0,1,0,1,4,5,9,7,1,8,5,3,8,0,0,0,17,9,26
sp10,102,SIXTH,COGS,CogSc/ClAs,0,0,0,0,0,0,0,1,1,0,1,1,0,2,2,0,0,0,0,4,4
sp10,102,SIXTH,COGS,CogSc/Comp,0,0,0,0,0,0,1,0,1,0,0,0,0,0,0,0,0,0,1,0,1
sp10,102,SIXTH,COGS,CogSc/HCI,0,0,0,0,0,0,0,0,0,1,1,2,6,3,9,0,0,0,7,4,11
sp10,102,SIXTH,COGS,CogSc/HCog,0,0,0,0,0,0,1,1,2,1,0,1,0,0,0,0,0,0,2,1,3
sp10,102,SIXTH,COGS,CogSc/Neur,0,0,0,0,0,0,6,4,10,0,4,4,4,7,11,0,0,0,10,15,25
sp10,102,SIXTH,COMM,Communic,0,0,0,1,8,9,3,13,16,16,43,59,23,50,73,0,0,0,43,114,157
sp10,102,SIXTH,CSE,Comp Sci,0,0,0,9,4,13,21,7,28,27,2,29,62,18,80,0,0,0,119,31,150
sp10,102,SIXTH,CSE,CompEngCSE,0,0,0,3,0,3,7,2,9,11,0,11,16,3,19,0,0,0,37,5,42
sp10,102,SIXTH,CSE,CompScBinf,0,0,0,1,0,1,3,0,3,1,0,1,1,1,2,0,0,0,6,1,7
sp10,102,SIXTH,ECE,CompEngECE,0,0,0,2,0,2,0,0,0,3,0,3,5,0,5,0,0,0,10,0,10
sp10,102,SIXTH,ECE,Electr Eng,0,0,0,4,0,4,12,0,12,22,2,24,46,5,51,0,0,0,84,7,91
sp10,102,SIXTH,ECE,Pr-EngPhys,0,0,0,1,0,1,2,1,3,0,0,0,0,0,0,0,0,0,3,1,4
sp10,102,SIXTH,ECON,Ec-Mth&Ecn,0,0,0,1,2,3,1,3,4,4,2,6,5,1,6,0,0,0,11,8,19
sp10,102,SIXTH,ECON,Econ-MgtSc,0,0,0,2,1,3,12,8,20,26,20,46,58,31,89,0,0,0,98,60,158
sp10,102,SIXTH,ECON,Economics,0,0,0,6,0,6,14,4,18,58,23,81,60,32,92,0,0,0,138,59,197
sp10,102,SIXTH,ESYS,EnvSys(EB),0,0,0,0,0,0,0,7,7,0,2,2,6,9,15,0,0,0,6,18,24
sp10,102,SIXTH,ESYS,EnvSys(EC),0,0,0,0,0,0,1,0,1,0,0,0,2,0,2,0,0,0,3,0,3
sp10,102,SIXTH,ESYS,EnvSys(EP),0,0,0,0,0,0,1,2,3,1,0,1,1,2,3,0,0,0,3,4,7
sp10,102,SIXTH,ESYS,EnvSys(ES),0,0,0,0,1,1,1,1,2,0,1,1,2,2,4,0,0,0,3,5,8
sp10,102,SIXTH,ETHN,Ethnic St,0,0,0,1,0,1,0,0,0,2,1,3,4,4,8,0,0,0,7,5,12
sp10,102,SIXTH,HDP,Human Dev,0,0,0,0,0,0,0,1,1,0,7,7,2,13,15,0,0,0,2,21,23
sp10,102,SIXTH,HDP,Pr-HumnDev,0,0,0,0,3,3,0,7,7,1,4,5,0,2,2,0,0,0,1,16,17
sp10,102,SIXTH,HIST,History,0,0,0,0,0,0,0,2,2,6,6,12,10,6,16,0,0,0,16,14,30
sp10,102,SIXTH,INTL,IntSt-Anth,0,0,0,0,0,0,0,1,1,1,5,6,0,0,0,0,0,0,1,6,7
sp10,102,SIXTH,INTL,IntSt-Econ,0,0,0,1,0,1,1,3,4,4,7,11,10,13,23,0,0,0,16,23,39
sp10,102,SIXTH,INTL,IntSt-Hist,0,0,0,0,1,1,0,0,0,1,4,5,2,3,5,0,0,0,3,8,11
sp10,102,SIXTH,INTL,IntSt-Ling,0,0,0,0,0,0,1,1,2,0,0,0,2,0,2,0,0,0,3,1,4
sp10,102,SIXTH,INTL,IntSt-Lit,0,0,0,0,0,0,0,0,0,0,2,2,0,1,1,0,0,0,0,3,3
sp10,102,SIXTH,INTL,IntSt-PolS,0,0,0,3,0,3,3,1,4,3,10,13,10,11,21,0,0,0,19,22,41
sp10,102,SIXTH,INTL,IntSt-Soc,0,0,0,0,0,0,0,2,2,0,5,5,5,3,8,0,0,0,5,10,15
sp10,102,SIXTH,ITAL,Italian St,0,0,0,0,0,0,0,0,0,0,1,1,0,1,1,0,0,0,0,2,2
sp10,102,SIXTH,JAPN,JapaneseSt,0,0,0,0,0,0,1,0,1,1,1,2,3,1,4,0,0,0,5,2,7
sp10,102,SIXTH,LATI,LatinAm St,0,0,0,0,0,0,0,0,0,0,1,1,0,0,0,0,0,0,0,1,1
sp10,102,SIXTH,LING,Lang Stu,0,0,0,0,1,1,0,0,0,0,0,0,0,0,0,0,0,0,0,1,1
sp10,102,SIXTH,LING,Ling-CogLn,0,0,0,0,0,0,0,0,0,0,0,0,0,3,3,0,0,0,0,3,3
sp10,102,SIXTH,LING,Ling-LSoc,0,0,0,0,0,0,0,1,1,1,1,2,0,1,1,0,0,0,1,3,4
sp10,102,SIXTH,LING,Linguistcs,0,0,0,0,1,1,0,2,2,1,2,3,1,3,4,0,0,0,2,8,10
sp10,102,SIXTH,LIT,French Lit,0,0,0,0,0,0,0,0,0,0,0,0,0,1,1,0,0,0,0,1,1
sp10,102,SIXTH,LIT,Lit/Compos,0,0,0,1,0,1,0,0,0,0,0,0,0,1,1,0,0,0,1,1,2
sp10,102,SIXTH,LIT,Lit/CultSt,0,0,0,0,0,0,0,0,0,0,1,1,0,2,2,0,0,0,0,3,3
sp10,102,SIXTH,LIT,Lit/Engl,0,0,0,1,0,1,0,0,0,1,2,3,1,1,2,0,0,0,3,3,6
sp10,102,SIXTH,LIT,Lit/World,0,0,0,0,0,0,0,0,0,0,2,2,1,1,2,0,0,0,1,3,4
sp10,102,SIXTH,LIT,Lit/Writng,0,0,0,0,0,0,0,0,0,2,1,3,6,7,13,0,0,0,8,8,16
sp10,102,SIXTH,LIT,Pre-Lit/Wr,0,0,0,0,0,0,1,5,6,2,7,9,1,1,2,0,0,0,4,13,17
sp10,102,SIXTH,MAE,Aerosp Eng,0,0,0,6,0,6,13,2,15,16,1,17,31,5,36,0,0,0,66,8,74
sp10,102,SIXTH,MAE,Engin Sci,0,0,0,0,0,0,1,0,1,3,0,3,0,1,1,0,0,0,4,1,5
sp10,102,SIXTH,MAE,Envir Eng,0,0,0,2,0,2,5,2,7,0,3,3,3,3,6,0,0,0,10,8,18
sp10,102,SIXTH,MAE,Mech Engin,0,0,0,5,1,6,14,3,17,37,4,41,65,13,78,0,0,0,121,21,142
sp10,102,SIXTH,MATH,Appld Math,0,0,0,0,0,0,1,0,1,0,2,2,2,1,3,0,0,0,3,3,6
sp10,102,SIXTH,MATH,Math/SecEd,0,0,0,0,1,1,1,3,4,1,2,3,0,2,2,0,0,0,2,8,10
sp10,102,SIXTH,MATH,Mathematcs,0,0,0,0,0,0,1,0,1,5,0,5,6,3,9,0,0,0,12,3,15
sp10,102,SIXTH,MATH,Mth-CompSc,0,0,0,0,0,0,0,0,0,0,0,0,1,0,1,0,0,0,1,0,1
sp10,102,SIXTH,MATH,Mth-Mth&Ec,0,0,0,0,0,0,1,2,3,1,2,3,5,2,7,0,0,0,7,6,13
sp10,102,SIXTH,MATH,Mth/ApldSc,0,0,0,0,0,0,1,0,1,0,0,0,1,0,1,0,0,0,2,0,2
sp10,102,SIXTH,MATH,Pr-Math CS,0,0,0,0,0,0,0,0,0,1,0,1,1,0,1,0,0,0,2,0,2
sp10,102,SIXTH,MATH,Prob&Stats,0,0,0,0,0,0,0,1,1,1,0,1,0,0,0,0,0,0,1,1,2
sp10,102,SIXTH,MUS,Mu-CompArt,0,0,0,2,1,3,5,1,6,5,0,5,14,2,16,0,0,0,26,4,30
sp10,102,SIXTH,MUS,Music,0,0,0,0,2,2,1,0,1,3,2,5,8,3,11,0,0,0,12,7,19
sp10,102,SIXTH,MUS,Music Hum,0,0,0,0,0,0,0,0,0,0,1,1,1,0,1,0,0,0,1,1,2
sp10,102,SIXTH,PHIL,Philosophy,0,0,0,0,0,0,2,0,2,1,0,1,3,1,4,0,0,0,6,1,7
sp10,102,SIXTH,PHYS,Biophysics,0,0,0,0,0,0,2,0,2,0,0,0,2,0,2,0,0,0,4,0,4
sp10,102,SIXTH,PHYS,Phy/ErthSc,0,0,0,0,0,0,1,0,1,0,0,0,0,0,0,0,0,0,1,0,1
sp10,102,SIXTH,PHYS,Phys/Astro,0,0,0,0,0,0,0,0,0,1,0,1,2,0,2,0,0,0,3,0,3
sp10,102,SIXTH,PHYS,Phys/Comp,0,0,0,1,0,1,0,0,0,1,0,1,0,0,0,0,0,0,2,0,2
sp10,102,SIXTH,PHYS,Physics,0,0,0,2,0,2,4,0,4,2,0,2,8,0,8,0,0,0,16,0,16
sp10,102,SIXTH,POLI,Polit Sci,0,0,0,0,2,2,6,2,8,17,6,23,22,12,34,0,0,0,45,22,67
sp10,102,SIXTH,POLI,PolSc-Amer,0,0,0,0,0,0,0,0,0,2,3,5,3,4,7,0,0,0,5,7,12
sp10,102,SIXTH,POLI,PolSc-Comp,0,0,0,0,0,0,0,0,0,0,0,0,0,1,1,0,0,0,0,1,1
sp10,102,SIXTH,POLI,PolSc-Intl,0,0,0,0,1,1,3,2,5,8,3,11,7,9,16,0,0,0,18,15,33
sp10,102,SIXTH,POLI,PolSc-PLaw,0,0,0,2,4,6,0,4,4,5,1,6,6,5,11,0,0,0,13,14,27
sp10,102,SIXTH,POLI,PolSc-PPol,0,0,0,0,0,0,0,0,0,1,0,1,0,0,0,0,0,0,1,0,1
sp10,102,SIXTH,POLI,PolSc-Thry,0,0,0,0,0,0,0,0,0,2,0,2,1,0,1,0,0,0,3,0,3
sp10,102,SIXTH,PSYC,Psychology,0,0,0,5,7,12,10,19,29,18,42,60,29,68,97,0,0,0,62,136,198
sp10,102,SIXTH,RELI,Relig/Stu,0,0,0,0,0,0,1,0,1,0,0,0,0,0,0,0,0,0,1,0,1
sp10,102,SIXTH,SE,Engin Sci,0,0,0,0,0,0,1,0,1,0,0,0,1,0,1,0,0,0,2,0,2
sp10,102,SIXTH,SE,Struct Eng,0,0,0,3,1,4,12,4,16,15,6,21,24,15,39,0,0,0,54,26,80
sp10,102,SIXTH,SIO,ErSc-Geoch,0,0,0,0,0,0,1,1,2,0,0,0,0,0,0,0,0,0,1,1,2
sp10,102,SIXTH,SIO,ErSc-Geol,0,0,0,0,0,0,0,1,1,0,1,1,1,0,1,0,0,0,1,2,3
sp10,102,SIXTH,SIO,ErSc-Geoph,0,0,0,0,0,0,0,1,1,0,0,0,0,0,0,0,0,0,0,1,1
sp10,102,SIXTH,SOC,SocCulCom,0,0,0,0,0,0,0,2,2,0,2,2,1,1,2,0,0,0,1,5,6
sp10,102,SIXTH,SOC,SocEconSoc,0,0,0,0,0,0,0,1,1,0,0,0,0,3,3,0,0,0,0,4,4
sp10,102,SIXTH,SOC,SocIntlStu,0,0,0,0,0,0,0,0,0,0,2,2,0,1,1,0,0,0,0,3,3
sp10,102,SIXTH,SOC,Sociology,0,0,0,0,0,0,0,0,0,1,7,8,6,21,27,0,0,0,7,28,35
sp10,102,SIXTH,SOC,SocLawSoc,0,0,0,0,0,0,0,0,0,2,3,5,0,2,2,0,0,0,2,5,7
sp10,102,SIXTH,SOC,SocSciMed,0,0,0,0,0,0,0,1,1,0,3,3,0,0,0,0,0,0,0,4,4
sp10,102,SIXTH,SOC,SocSolneq,0,0,0,0,0,0,0,0,0,0,1,1,0,1,1,0,0,0,0,2,2
sp10,102,SIXTH,THEA,Dance,0,0,0,0,0,0,0,0,0,0,0,0,0,4,4,0,0,0,0,4,4
sp10,102,SIXTH,THEA,Theatre,0,0,0,2,1,3,1,1,2,2,1,3,1,8,9,0,0,0,6,11,17
sp10,102,SIXTH,TWS,ThirdWldSt,0,0,0,0,0,0,0,1,1,0,0,0,0,1,1,0,0,0,0,2,2
sp10,102,SIXTH,UNAF,UndecHumAr,0,0,0,0,2,2,1,2,3,0,0,0,0,0,0,0,0,0,1,4,5
sp10,102,SIXTH,UNAF,Undeclared,0,0,0,14,16,30,15,25,40,1,1,2,0,0,0,0,0,0,30,42,72
sp10,102,SIXTH,UNAF,UndecPhysS,0,0,0,0,0,0,0,1,1,0,0,0,0,0,0,0,0,0,0,1,1
sp10,102,SIXTH,UNAF,UndecSocSc,0,0,0,1,1,2,3,0,3,1,1,2,0,0,0,0,0,0,5,2,7
sp10,102,SIXTH,USP,Urb Stu&Pl,0,0,0,0,0,0,2,1,3,2,4,6,6,6,12,0,0,0,10,11,21
sp10,102,SIXTH,VIS,Art Hst/Cr,0,0,0,0,1,1,0,1,1,0,9,9,0,14,14,0,0,0,0,25,25
sp10,102,SIXTH,VIS,Media,0,0,0,1,3,4,6,10,16,17,11,28,12,19,31,0,0,0,36,43,79
sp10,102,SIXTH,VIS,Studio VA,0,0,0,1,0,1,1,3,4,5,10,15,8,8,16,0,0,0,15,21,36
sp10,102,SIXTH,VIS,VA-CompArt,0,0,0,0,0,0,1,4,5,6,6,12,8,8,16,0,0,0,15,18,33
sp10,102,WARREN,ANTH,Anth-Arch,0,0,0,0,0,0,0,0,0,1,2,3,1,3,4,0,0,0,2,5,7
sp10,102,WARREN,ANTH,Anth-Biol,0,0,0,0,0,0,0,4,4,0,2,2,0,6,6,0,0,0,0,12,12
sp10,102,WARREN,ANTH,Anth-Soci,0,0,0,0,0,0,0,0,0,0,0,0,0,6,6,0,0,0,0,6,6
sp10,102,WARREN,BENG,Bioen:Binf,0,0,0,0,0,0,0,0,0,6,0,6,5,1,6,0,0,0,11,1,12
sp10,102,WARREN,BENG,Bioeng:PM,0,0,0,0,0,0,1,0,1,6,1,7,33,14,47,0,0,0,40,15,55
sp10,102,WARREN,BENG,BioengBiot,0,0,0,3,2,5,13,6,19,23,10,33,29,9,38,0,0,0,68,27,95
sp10,102,WARREN,BENG,Bioengin,0,0,0,2,1,3,8,4,12,12,2,14,21,9,30,0,0,0,43,16,59
sp10,102,WARREN,BENG,Pr-BioenPM,0,0,0,1,3,4,15,7,22,3,0,3,2,0,2,0,0,0,21,10,31
sp10,102,WARREN,BIOL,Anml Physl,0,0,0,0,0,0,0,0,0,0,1,1,0,0,0,0,0,0,0,1,1
sp10,102,WARREN,BIOL,Bioc/CellB,0,0,0,1,1,2,12,7,19,22,20,42,76,86,162,0,0,0,111,114,225
sp10,102,WARREN,BIOL,BiolBioinf,0,0,0,0,0,0,0,0,0,0,0,0,1,0,1,0,0,0,1,0,1
sp10,102,WARREN,BIOL,Ec/Beh/Evo,0,0,0,0,0,0,0,1,1,5,1,6,6,13,19,0,0,0,11,15,26
sp10,102,WARREN,BIOL,Genl Biol,0,0,0,2,1,3,10,16,26,12,32,44,38,68,106,0,0,0,62,117,179
sp10,102,WARREN,BIOL,Human Bio,0,0,0,2,7,9,19,30,49,21,54,75,63,97,160,0,0,0,105,188,293
sp10,102,WARREN,BIOL,Microbiol,0,0,0,0,0,0,1,1,2,1,5,6,8,4,12,0,0,0,10,10,20
sp10,102,WARREN,BIOL,Molec Biol,0,0,0,0,0,0,2,1,3,1,5,6,9,13,22,0,0,0,12,19,31
sp10,102,WARREN,BIOL,PhyslNeuro,0,0,0,2,2,4,10,6,16,14,16,30,26,32,58,0,0,0,52,56,108
sp10,102,WARREN,CENG,Chem Engin,0,0,0,2,0,2,10,9,19,14,0,14,33,15,48,0,0,0,59,24,83
sp10,102,WARREN,CGS,CritGendSt,0,0,0,0,0,0,0,0,0,0,1,1,1,2,3,0,0,0,1,3,4
sp10,102,WARREN,CHEM,Bioch/Chem,0,0,0,8,4,12,9,9,18,8,7,15,15,18,33,0,0,0,40,38,78
sp10,102,WARREN,CHEM,Bioinform,0,0,0,0,0,0,0,1,1,0,0,0,0,0,0,0,0,0,0,1,1
sp10,102,WARREN,CHEM,Chem Phys,0,0,0,0,0,0,0,0,0,0,0,0,3,0,3,0,0,0,3,0,3
sp10,102,WARREN,CHEM,Chemistry,0,0,0,0,4,4,2,2,4,4,4,8,8,7,15,0,0,0,14,17,31
sp10,102,WARREN,CHEM,Envir Chem,0,0,0,0,0,0,0,0,0,1,0,1,0,0,0,0,0,0,1,0,1
sp10,102,WARREN,CHEM,MolecSynth,0,0,0,0,0,0,0,0,0,1,0,1,4,1,5,0,0,0,5,1,6
sp10,102,WARREN,CHEM,Pharm Chem,0,0,0,0,2,2,8,9,17,2,9,11,12,13,25,0,0,0,22,33,55
sp10,102,WARREN,CHIN,Chinese St,0,0,0,0,0,0,0,0,0,0,0,0,1,6,7,0,0,0,1,6,7
sp10,102,WARREN,CLAS,Classic St,0,0,0,0,0,0,0,1,1,0,0,0,0,0,0,0,0,0,0,1,1
sp10,102,WARREN,COGS,Cog Sci,0,0,0,0,1,1,0,3,3,0,3,3,3,9,12,0,0,0,3,16,19
sp10,102,WARREN,COGS,CogSc/ClAs,0,0,0,0,1,1,0,1,1,0,1,1,1,1,2,0,0,0,1,4,5
sp10,102,WARREN,COGS,CogSc/Clin,0,0,0,0,0,0,0,0,0,0,0,0,0,1,1,0,0,0,0,1,1
sp10,102,WARREN,COGS,CogSc/Comp,0,0,0,0,0,0,1,0,1,2,0,2,1,0,1,0,0,0,4,0,4
sp10,102,WARREN,COGS,CogSc/HCI,0,0,0,0,0,0,0,2,2,1,1,2,7,1,8,0,0,0,8,4,12
sp10,102,WARREN,COGS,CogSc/HCog,0,0,0,0,0,0,0,1,1,0,1,1,0,2,2,0,0,0,0,4,4
sp10,102,WARREN,COGS,CogSc/Neur,0,0,0,0,0,0,5,6,11,2,2,4,8,4,12,0,0,0,15,12,27
sp10,102,WARREN,COMM,Communic,0,0,0,3,2,5,5,10,15,15,33,48,22,37,59,0,0,0,45,82,127
sp10,102,WARREN,CSE,Comp Sci,0,0,0,4,0,4,28,6,34,36,7,43,65,16,81,0,0,0,133,29,162
sp10,102,WARREN,CSE,CompEngCSE,0,0,0,4,2,6,16,2,18,12,0,12,9,1,10,0,0,0,41,5,46
sp10,102,WARREN,CSE,CompScBinf,0,0,0,0,0,0,2,1,3,0,2,2,1,0,1,0,0,0,3,3,6
sp10,102,WARREN,ECE,CompEngECE,0,0,0,4,1,5,5,1,6,4,0,4,5,0,5,0,0,0,18,2,20
sp10,102,WARREN,ECE,Electr Eng,0,0,0,4,0,4,18,6,24,23,6,29,85,13,98,0,0,0,130,25,155
sp10,102,WARREN,ECE,Engin Phys,0,0,0,0,0,0,0,0,0,1,0,1,2,0,2,0,0,0,3,0,3
sp10,102,WARREN,ECE,Pr-EngPhys,0,0,0,0,0,0,1,0,1,2,0,2,2,0,2,0,0,0,5,0,5
sp10,102,WARREN,ECON,Ec-Mth&Ecn,0,0,0,1,1,2,0,1,1,7,2,9,8,6,14,0,0,0,16,10,26
sp10,102,WARREN,ECON,Econ-MgtSc,0,0,0,2,0,2,4,7,11,22,20,42,50,36,86,0,0,0,78,63,141
sp10,102,WARREN,ECON,Econ-QEDS,0,0,0,0,0,0,0,0,0,0,0,0,0,1,1,0,0,0,0,1,1
sp10,102,WARREN,ECON,Economics,0,0,0,2,2,4,15,8,23,48,27,75,66,35,101,0,0,0,131,72,203
sp10,102,WARREN,ESYS,EnvSys(EB),0,0,0,0,1,1,1,5,6,1,2,3,1,3,4,0,0,0,3,11,14
sp10,102,WARREN,ESYS,EnvSys(EC),0,0,0,0,0,0,0,3,3,0,1,1,2,1,3,0,0,0,2,5,7
sp10,102,WARREN,ESYS,EnvSys(EP),0,0,0,0,0,0,1,0,1,0,0,0,1,2,3,0,0,0,2,2,4
sp10,102,WARREN,ESYS,EnvSys(ES),0,0,0,0,1,1,1,0,1,0,0,0,1,1,2,0,0,0,2,2,4
sp10,102,WARREN,ETHN,Ethnic St,0,0,0,0,1,1,0,2,2,0,3,3,2,2,4,0,0,0,2,8,10
sp10,102,WARREN,GMST,German Stu,0,0,0,0,0,0,0,0,0,0,0,0,1,0,1,0,0,0,1,0,1
sp10,102,WARREN,HDP,Human Dev,0,0,0,0,0,0,0,1,1,1,2,3,2,14,16,0,0,0,3,17,20
sp10,102,WARREN,HDP,Pr-HumnDev,0,0,0,0,3,3,0,3,3,0,4,4,0,2,2,0,0,0,0,12,12
sp10,102,WARREN,HIST,History,0,0,0,0,0,0,3,1,4,13,6,19,21,15,36,0,0,0,37,22,59
sp10,102,WARREN,INTD,Wa Ind St,0,0,0,0,0,0,0,0,0,0,0,0,0,1,1,0,0,0,0,1,1
sp10,102,WARREN,INTL,Int-5yrEC,0,0,0,0,0,0,0,0,0,0,0,0,0,1,1,0,0,0,0,1,1
sp10,102,WARREN,INTL,IntSt-Anth,0,0,0,0,0,0,0,0,0,0,1,1,0,1,1,0,0,0,0,2,2
sp10,102,WARREN,INTL,IntSt-Econ,0,0,0,0,1,1,2,3,5,4,4,8,10,10,20,0,0,0,16,18,34
sp10,102,WARREN,INTL,IntSt-Hist,0,0,0,0,0,0,2,0,2,0,1,1,1,2,3,0,0,0,3,3,6
sp10,102,WARREN,INTL,IntSt-Ling,0,0,0,0,0,0,0,1,1,0,3,3,0,1,1,0,0,0,0,5,5
sp10,102,WARREN,INTL,IntSt-Lit,0,0,0,0,0,0,0,1,1,0,0,0,0,1,1,0,0,0,0,2,2
sp10,102,WARREN,INTL,IntSt-PolS,0,0,0,2,0,2,0,4,4,4,4,8,8,14,22,0,0,0,14,22,36
sp10,102,WARREN,INTL,IntSt-Soc,0,0,0,0,0,0,0,1,1,0,3,3,1,7,8,0,0,0,1,11,12
sp10,102,WARREN,ITAL,Italian St,0,0,0,0,0,0,0,0,0,1,0,1,1,0,1,0,0,0,2,0,2
sp10,102,WARREN,JAPN,JapaneseSt,0,0,0,0,0,0,0,0,0,0,0,0,2,0,2,0,0,0,2,0,2
sp10,102,WARREN,LING,Lang Stu,0,0,0,0,0,0,0,0,0,0,0,0,0,2,2,0,0,0,0,2,2
sp10,102,WARREN,LING,Ling-CogLn,0,0,0,0,0,0,0,0,0,0,0,0,1,0,1,0,0,0,1,0,1
sp10,102,WARREN,LING,Ling-LSoc,0,0,0,0,0,0,0,0,0,0,0,0,0,1,1,0,0,0,0,1,1
sp10,102,WARREN,LING,Linguistcs,0,0,0,0,0,0,0,0,0,0,2,2,1,2,3,0,0,0,1,4,5
sp10,102,WARREN,LIT,French Lit,0,0,0,0,0,0,0,0,0,0,0,0,1,0,1,0,0,0,1,0,1
sp10,102,WARREN,LIT,Hn-Span Lt,0,0,0,0,0,0,0,0,0,0,0,0,0,1,1,0,0,0,0,1,1
sp10,102,WARREN,LIT,Lit/Compos,0,0,0,0,0,0,0,0,0,0,0,0,0,1,1,0,0,0,0,1,1
sp10,102,WARREN,LIT,Lit/CultSt,0,0,0,0,0,0,0,0,0,0,0,0,0,2,2,0,0,0,0,2,2
sp10,102,WARREN,LIT,Lit/Engl,0,0,0,0,0,0,1,2,3,1,5,6,0,4,4,0,0,0,2,11,13
sp10,102,WARREN,LIT,Lit/World,0,0,0,0,0,0,0,0,0,0,1,1,0,1,1,0,0,0,0,2,2
sp10,102,WARREN,LIT,Lit/Writng,0,0,0,0,0,0,0,0,0,0,2,2,1,9,10,0,0,0,1,11,12
sp10,102,WARREN,LIT,Pre-Lit/Wr,0,0,0,1,0,1,0,2,2,3,3,6,2,3,5,0,0,0,6,8,14
sp10,102,WARREN,LIT,Spanish Lt,0,0,0,0,1,1,0,0,0,0,0,0,1,4,5,0,0,0,1,5,6
sp10,102,WARREN,MAE,Aerosp Eng,0,0,0,5,0,5,15,2,17,11,2,13,37,4,41,0,0,0,68,8,76
sp10,102,WARREN,MAE,Engin Sci,0,0,0,0,0,0,2,0,2,0,1,1,1,0,1,0,0,0,3,1,4
sp10,102,WARREN,MAE,Envir Eng,0,0,0,0,2,2,3,4,7,5,1,6,4,5,9,0,0,0,12,12,24
sp10,102,WARREN,MAE,Mech Engin,0,0,0,9,1,10,25,3,28,44,6,50,105,12,117,0,0,0,183,22,205
sp10,102,WARREN,MATH,Appld Math,0,0,0,0,0,0,0,0,0,0,2,2,4,3,7,0,0,0,4,5,9
sp10,102,WARREN,MATH,Math/SecEd,0,0,0,0,0,0,1,0,1,1,0,1,2,1,3,0,0,0,4,1,5
sp10,102,WARREN,MATH,Mathematcs,0,0,0,0,1,1,3,3,6,4,1,5,15,6,21,0,0,0,22,11,33
sp10,102,WARREN,MATH,Mth-CompSc,0,0,0,0,0,0,0,0,0,0,0,0,4,1,5,0,0,0,4,1,5
sp10,102,WARREN,MATH,Mth-Mth&Ec,0,0,0,0,1,1,1,1,2,0,2,2,4,1,5,0,0,0,5,5,10
sp10,102,WARREN,MATH,Mth-SciCom,0,0,0,0,0,0,0,1,1,0,0,0,2,0,2,0,0,0,2,1,3
sp10,102,WARREN,MATH,Mth/ApldSc,0,0,0,0,0,0,1,0,1,0,0,0,2,0,2,0,0,0,3,0,3
sp10,102,WARREN,MATH,Prob&Stats,0,0,0,1,0,1,0,1,1,1,1,2,3,4,7,0,0,0,5,6,11
sp10,102,WARREN,MUS,Mu-CompArt,0,0,0,1,0,1,0,0,0,3,0,3,10,2,12,0,0,0,14,2,16
sp10,102,WARREN,MUS,Music,0,0,0,1,0,1,1,0,1,2,3,5,9,1,10,0,0,0,13,4,17
sp10,102,WARREN,MUS,Music Hum,0,0,0,0,0,0,0,0,0,0,0,0,0,1,1,0,0,0,0,1,1
sp10,102,WARREN,PHIL,Philosophy,0,0,0,1,0,1,2,1,3,6,2,8,8,3,11,0,0,0,17,6,23
sp10,102,WARREN,PHYS,Biophysics,0,0,0,0,0,0,3,0,3,1,1,2,3,1,4,0,0,0,7,2,9
sp10,102,WARREN,PHYS,Gen Physcs,0,0,0,0,0,0,1,0,1,0,0,0,0,0,0,0,0,0,1,0,1
sp10,102,WARREN,PHYS,Phys/Astro,0,0,0,0,0,0,1,0,1,2,0,2,2,0,2,0,0,0,5,0,5
sp10,102,WARREN,PHYS,Phys/Comp,0,0,0,0,0,0,0,0,0,0,0,0,2,0,2,0,0,0,2,0,2
sp10,102,WARREN,PHYS,Phys/Mtrls,0,0,0,0,0,0,0,0,0,0,0,0,1,0,1,0,0,0,1,0,1
sp10,102,WARREN,PHYS,Physics,0,0,0,0,0,0,2,0,2,0,0,0,8,1,9,0,0,0,10,1,11
sp10,102,WARREN,POLI,Polit Sci,0,0,0,3,3,6,7,6,13,22,14,36,24,28,52,0,0,0,56,51,107
sp10,102,WARREN,POLI,PolSc-Amer,0,0,0,1,1,2,1,2,3,3,3,6,4,5,9,0,0,0,9,11,20
sp10,102,WARREN,POLI,PolSc-Comp,0,0,0,0,0,0,1,0,1,0,1,1,1,1,2,0,0,0,2,2,4
sp10,102,WARREN,POLI,PolSc-Intl,0,0,0,2,1,3,3,4,7,11,6,17,19,14,33,0,0,0,35,25,60
sp10,102,WARREN,POLI,PolSc-PLaw,0,0,0,0,2,2,3,5,8,5,5,10,11,5,16,0,0,0,19,17,36
sp10,102,WARREN,POLI,PolSc-PPol,0,0,0,0,0,0,0,0,0,1,1,2,1,2,3,0,0,0,2,3,5
sp10,102,WARREN,POLI,PolSc-Thry,0,0,0,0,0,0,0,0,0,2,1,3,3,1,4,0,0,0,5,2,7
sp10,102,WARREN,PSYC,Psychology,0,0,0,1,13,14,7,25,32,21,45,66,26,79,105,0,0,0,55,162,217
sp10,102,WARREN,RELI,Relig/Stu,0,0,0,0,0,0,0,0,0,0,0,0,0,2,2,0,0,0,0,2,2
sp10,102,WARREN,SE,Engin Sci,0,0,0,0,0,0,0,0,0,1,0,1,0,0,0,0,0,0,1,0,1
sp10,102,WARREN,SE,Struct Eng,0,0,0,11,3,14,20,6,26,21,9,30,57,27,84,0,0,0,109,45,154
sp10,102,WARREN,SIO,ErSc-Geoch,0,0,0,0,0,0,1,0,1,1,1,2,0,1,1,0,0,0,2,2,4
sp10,102,WARREN,SIO,ErSc-Geoph,0,0,0,1,0,1,0,0,0,0,0,0,0,0,0,0,0,0,1,0,1
sp10,102,WARREN,SOC,SocCulCom,0,0,0,0,0,0,0,0,0,0,0,0,0,1,1,0,0,0,0,1,1
sp10,102,WARREN,SOC,SocIntlStu,0,0,0,0,0,0,0,0,0,1,0,1,0,1,1,0,0,0,1,1,2
sp10,102,WARREN,SOC,Sociology,0,0,0,0,2,2,2,0,2,3,9,12,6,17,23,0,0,0,11,28,39
sp10,102,WARREN,SOC,SocLawSoc,0,0,0,0,1,1,1,1,2,0,0,0,1,3,4,0,0,0,2,5,7
sp10,102,WARREN,SOC,SocSciMed,0,0,0,0,0,0,0,0,0,0,1,1,0,0,0,0,0,0,0,1,1
sp10,102,WARREN,SOC,SocSolneq,0,0,0,0,0,0,0,0,0,1,1,2,0,2,2,0,0,0,1,3,4
sp10,102,WARREN,THEA,Dance,0,0,0,0,0,0,0,0,0,1,0,1,0,2,2,0,0,0,1,2,3
sp10,102,WARREN,THEA,Theatre,0,0,0,0,0,0,1,1,2,0,0,0,1,7,8,0,0,0,2,8,10
sp10,102,WARREN,TWS,ThirdWldSt,0,0,0,0,0,0,0,1,1,0,0,0,0,0,0,0,0,0,0,1,1
sp10,102,WARREN,UNAF,Limited St,0,0,0,0,0,0,0,0,0,0,0,0,0,0,0,1,1,2,1,1,2
sp10,102,WARREN,UNAF,UndecHumAr,0,0,0,0,0,0,2,1,3,0,0,0,0,0,0,0,0,0,2,1,3
sp10,102,WARREN,UNAF,Undeclared,0,0,0,6,9,15,14,19,33,1,1,2,0,0,0,0,0,0,21,29,50
sp10,102,WARREN,UNAF,UndecPhysS,0,0,0,2,0,2,0,1,1,1,0,1,0,0,0,0,0,0,3,1,4
sp10,102,WARREN,UNAF,UndecSocSc,0,0,0,0,2,2,0,0,0,0,0,0,0,0,0,0,0,0,0,2,2
sp10,102,WARREN,USP,Urb Stu&Pl,0,0,0,0,0,0,3,3,6,5,5,10,2,2,4,0,0,0,10,10,20
sp10,102,WARREN,VIS,Art Hst/Cr,0,0,0,0,1,1,0,1,1,0,0,0,2,5,7,0,0,0,2,7,9
sp10,102,WARREN,VIS,Media,0,0,0,0,0,0,2,1,3,3,5,8,12,4,16,0,0,0,17,10,27
sp10,102,WARREN,VIS,Studio VA,0,0,0,0,0,0,0,1,1,1,2,3,3,6,9,0,0,0,4,9,13
sp10,102,WARREN,VIS,VA-CompArt,0,0,0,0,1,1,0,1,1,0,1,1,3,0,3,0,0,0,3,3,6
sp09,92,MARSHALL,ANTH,Anth-Arch,0,0,0,0,0,0,1,0,1,1,4,5,2,0,2,0,0,0,4,4,8
sp09,92,MARSHALL,ANTH,Anth-Biol,0,0,0,0,0,0,0,2,2,0,2,2,1,3,4,0,0,0,1,7,8
sp09,92,MARSHALL,ANTH,Anth-Soci,0,0,0,0,0,0,0,2,2,1,3,4,0,6,6,0,0,0,1,11,12
sp09,92,MARSHALL,ANTH,Anthropol,0,0,0,0,0,0,0,0,0,0,1,1,1,1,2,0,0,0,1,2,3
sp09,92,MARSHALL,BENG,Bioen:Binf,0,0,0,0,0,0,0,0,0,1,0,1,0,0,0,0,0,0,1,0,1
sp09,92,MARSHALL,BENG,Bioeng:PM,0,0,0,0,0,0,2,0,2,4,0,4,17,3,20,0,0,0,23,3,26
sp09,92,MARSHALL,BENG,BioengBiot,0,0,0,1,1,2,4,0,4,1,1,2,7,5,12,0,0,0,13,7,20
sp09,92,MARSHALL,BENG,Bioengin,0,0,0,0,0,0,4,1,5,0,1,1,4,4,8,0,0,0,8,6,14
sp09,92,MARSHALL,BENG,Pr-BioenPM,0,0,0,0,1,1,7,5,12,3,1,4,0,0,0,0,0,0,10,7,17
sp09,92,MARSHALL,BIOL,Anml Physl,0,0,0,0,0,0,0,0,0,0,0,0,3,2,5,0,0,0,3,2,5
sp09,92,MARSHALL,BIOL,Bioc/CellB,0,0,0,2,8,10,11,12,23,17,27,44,53,56,109,0,0,0,83,103,186
sp09,92,MARSHALL,BIOL,BiolBioinf,0,0,0,0,0,0,0,0,0,0,1,1,2,0,2,0,0,0,2,1,3
sp09,92,MARSHALL,BIOL,Ec/Beh/Evo,0,0,0,0,0,0,1,2,3,5,2,7,3,8,11,0,0,0,9,12,21
sp09,92,MARSHALL,BIOL,Genl Biol,0,0,0,3,11,14,6,19,25,26,33,59,31,44,75,0,0,0,66,107,173
sp09,92,MARSHALL,BIOL,Human Bio,0,0,0,9,31,40,27,63,90,35,80,115,56,71,127,0,0,0,127,245,372
sp09,92,MARSHALL,BIOL,Microbiol,0,0,0,0,0,0,2,3,5,4,2,6,2,5,7,0,0,0,8,10,18
sp09,92,MARSHALL,BIOL,Molec Biol,0,0,0,1,0,1,3,6,9,3,4,7,8,8,16,0,0,0,15,18,33
sp09,92,MARSHALL,BIOL,PhyslNeuro,0,0,0,1,3,4,11,18,29,11,22,33,19,19,38,0,0,0,42,62,104
sp09,92,MARSHALL,CENG,Chem Engin,0,0,0,2,1,3,4,2,6,2,2,4,13,6,19,0,0,0,21,11,32
sp09,92,MARSHALL,CGS,CritGendSt,0,0,0,0,0,0,0,0,0,0,1,1,0,3,3,0,0,0,0,4,4
sp09,92,MARSHALL,CHEM,Bioch/Chem,0,0,0,0,3,3,5,6,11,4,8,12,13,11,24,0,0,0,22,28,50
sp09,92,MARSHALL,CHEM,Chemistry,0,0,0,0,0,0,4,1,5,5,5,10,4,6,10,0,0,0,13,12,25
sp09,92,MARSHALL,CHEM,Envir Chem,0,0,0,0,0,0,0,0,0,0,0,0,1,0,1,0,0,0,1,0,1
sp09,92,MARSHALL,CHEM,MolecSynth,0,0,0,0,0,0,0,0,0,0,0,0,1,0,1,0,0,0,1,0,1
sp09,92,MARSHALL,CHEM,Pharm Chem,0,0,0,1,4,5,1,6,7,4,6,10,9,16,25,0,0,0,15,32,47
sp09,92,MARSHALL,CHIN,Chinese St,0,0,0,0,0,0,0,0,0,0,1,1,0,1,1,0,0,0,0,2,2
sp09,92,MARSHALL,CLAS,Classic St,0,0,0,0,0,0,0,0,0,0,0,0,1,1,2,0,0,0,1,1,2
sp09,92,MARSHALL,COGS,Cog Sci,0,0,0,0,0,0,1,7,8,2,2,4,3,4,7,0,0,0,6,13,19
sp09,92,MARSHALL,COGS,CogSc/ClAs,0,0,0,0,0,0,0,1,1,0,1,1,0,1,1,0,0,0,0,3,3
sp09,92,MARSHALL,COGS,CogSc/Comp,0,0,0,0,0,0,0,0,0,0,0,0,2,0,2,0,0,0,2,0,2
sp09,92,MARSHALL,COGS,CogSc/HCI,0,0,0,0,0,0,1,0,1,0,1,1,6,1,7,0,0,0,7,2,9
sp09,92,MARSHALL,COGS,CogSc/HCog,0,0,0,0,0,0,0,0,0,0,1,1,0,2,2,0,0,0,0,3,3
sp09,92,MARSHALL,COGS,CogSc/Neur,0,0,0,1,2,3,0,2,2,4,6,10,7,11,18,0,0,0,12,21,33
sp09,92,MARSHALL,COMM,Communic,0,0,0,3,10,13,4,17,21,17,32,49,18,58,76,0,0,0,42,117,159
sp09,92,MARSHALL,CSE,Comp Sci,0,0,0,2,1,3,11,4,15,17,0,17,28,4,32,0,0,0,58,9,67
sp09,92,MARSHALL,CSE,CompEngCSE,0,0,0,3,1,4,5,1,6,5,0,5,6,0,6,0,0,0,19,2,21
sp09,92,MARSHALL,CSE,CompScBinf,0,0,0,0,0,0,0,0,0,0,1,1,2,0,2,0,0,0,2,1,3
sp09,92,MARSHALL,ECE,CompEngECE,0,0,0,0,1,1,1,0,1,1,0,1,1,0,1,0,0,0,3,1,4
sp09,92,MARSHALL,ECE,Electr Eng,0,0,0,3,0,3,13,4,17,15,0,15,25,10,35,0,0,0,56,14,70
sp09,92,MARSHALL,ECE,Pr-EngPhys,0,0,0,0,0,0,2,0,2,0,0,0,0,0,0,0,0,0,2,0,2
sp09,92,MARSHALL,ECON,Ec-Mth&Ecn,0,0,0,0,1,1,4,2,6,4,4,8,3,1,4,0,0,0,11,8,19
sp09,92,MARSHALL,ECON,Econ-MgtSc,0,0,0,6,6,12,20,20,40,34,23,57,66,38,104,0,0,0,126,87,213
sp09,92,MARSHALL,ECON,Economics,0,0,0,6,5,11,20,18,38,75,33,108,109,62,171,0,0,0,210,118,328
sp09,92,MARSHALL,ESYS,EnvSys(EB),0,0,0,0,0,0,2,1,3,0,4,4,4,8,12,0,0,0,6,13,19
sp09,92,MARSHALL,ESYS,EnvSys(EC),0,0,0,0,0,0,0,0,0,0,0,0,2,1,3,0,0,0,2,1,3
sp09,92,MARSHALL,ESYS,EnvSys(EP),0,0,0,0,0,0,2,1,3,0,1,1,0,1,1,0,0,0,2,3,5
sp09,92,MARSHALL,ESYS,EnvSys(ES),0,0,0,0,0,0,2,1,3,0,1,1,1,0,1,0,0,0,3,2,5
sp09,92,MARSHALL,ETHN,Ethnic St,0,0,0,0,1,1,1,1,2,0,9,9,2,20,22,0,0,0,3,31,34
sp09,92,MARSHALL,HDP,Human Dev,0,0,0,0,0,0,0,0,0,1,18,19,2,26,28,0,0,0,3,44,47
sp09,92,MARSHALL,HDP,Pr-HumnDev,0,0,0,0,2,2,0,9,9,0,9,9,0,6,6,0,0,0,0,26,26
sp09,92,MARSHALL,HIST,History,0,0,0,0,1,1,4,6,10,13,5,18,16,22,38,0,0,0,33,34,67
sp09,92,MARSHALL,INTD,Mar Ind St,0,0,0,0,0,0,0,0,0,0,0,0,0,1,1,0,0,0,0,1,1
sp09,92,MARSHALL,INTL,Int-5yrEC,0,0,0,0,0,0,0,1,1,0,0,0,0,1,1,0,0,0,0,2,2
sp09,92,MARSHALL,INTL,IntSt-Anth,0,0,0,0,0,0,0,0,0,0,2,2,0,2,2,0,0,0,0,4,4
sp09,92,MARSHALL,INTL,IntSt-Econ,0,0,0,2,3,5,5,11,16,8,4,12,6,12,18,0,0,0,21,30,51
sp09,92,MARSHALL,INTL,IntSt-Hist,0,0,0,0,0,0,0,0,0,0,0,0,2,3,5,0,0,0,2,3,5
sp09,92,MARSHALL,INTL,IntSt-Ling,0,0,0,0,0,0,0,4,4,0,0,0,1,1,2,0,0,0,1,5,6
sp09,92,MARSHALL,INTL,IntSt-Lit,0,0,0,0,1,1,0,0,0,0,0,0,0,0,0,0,0,0,0,1,1
sp09,92,MARSHALL,INTL,IntSt-PolS,0,0,0,0,0,0,1,3,4,3,13,16,7,17,24,0,0,0,11,33,44
sp09,92,MARSHALL,INTL,IntSt-Soc,0,0,0,0,0,0,1,3,4,1,3,4,2,11,13,0,0,0,4,17,21
sp09,92,MARSHALL,JAPN,JapaneseSt,0,0,0,0,0,0,0,0,0,0,0,0,1,2,3,0,0,0,1,2,3
sp09,92,MARSHALL,JUDA,Judaic Stu,0,0,0,0,0,0,0,0,0,1,0,1,0,0,0,0,0,0,1,0,1
sp09,92,MARSHALL,LATI,LatinAm St,0,0,0,0,0,0,0,0,0,0,1,1,1,3,4,0,0,0,1,4,5
sp09,92,MARSHALL,LING,Lang Stu,0,0,0,0,1,1,1,0,1,0,1,1,0,2,2,0,0,0,1,4,5
sp09,92,MARSHALL,LING,Linguistcs,0,0,0,0,0,0,0,2,2,0,1,1,1,1,2,0,0,0,1,4,5
sp09,92,MARSHALL,LIT,Lit/Compos,0,0,0,0,0,0,0,1,1,0,1,1,0,0,0,0,0,0,0,2,2
sp09,92,MARSHALL,LIT,Lit/Engl,0,0,0,1,2,3,0,2,2,3,2,5,0,4,4,0,0,0,4,10,14
sp09,92,MARSHALL,LIT,Lit/World,0,0,0,0,0,0,0,0,0,0,1,1,1,4,5,0,0,0,1,5,6
sp09,92,MARSHALL,LIT,Lit/Writng,0,0,0,0,0,0,0,0,0,1,3,4,4,7,11,0,0,0,5,10,15
sp09,92,MARSHALL,LIT,Pre-Lit/Wr,0,0,0,0,0,0,0,2,2,4,4,8,2,1,3,0,0,0,6,7,13
sp09,92,MARSHALL,LIT,Spanish Lt,0,0,0,0,0,0,0,1,1,0,1,1,0,6,6,0,0,0,0,8,8
sp09,92,MARSHALL,MAE,Aerosp Eng,0,0,0,4,0,4,6,2,8,4,3,7,23,2,25,0,0,0,37,7,44
sp09,92,MARSHALL,MAE,Engin Sci,0,0,0,0,0,0,0,0,0,0,0,0,2,0,2,0,0,0,2,0,2
sp09,92,MARSHALL,MAE,Envir Eng,0,0,0,0,0,0,0,3,3,1,0,1,0,2,2,0,0,0,1,5,6
sp09,92,MARSHALL,MAE,Mech Engin,0,0,0,9,1,10,8,1,9,21,1,22,59,5,64,0,0,0,97,8,105
sp09,92,MARSHALL,MATH,Appld Math,0,0,0,0,0,0,0,1,1,1,3,4,3,3,6,0,0,0,4,7,11
sp09,92,MARSHALL,MATH,Math/SecEd,0,0,0,0,0,0,1,2,3,1,0,1,2,1,3,0,0,0,4,3,7
sp09,92,MARSHALL,MATH,Mathematcs,0,0,0,1,0,1,3,5,8,4,1,5,3,2,5,0,0,0,11,8,19
sp09,92,MARSHALL,MATH,Mth-CompSc,0,0,0,0,0,0,1,1,2,0,0,0,0,1,1,0,0,0,1,2,3
sp09,92,MARSHALL,MATH,Mth-Mth&Ec,0,0,0,1,1,2,1,3,4,3,1,4,7,3,10,0,0,0,12,8,20
sp09,92,MARSHALL,MATH,Mth-SciCom,0,0,0,0,0,0,0,0,0,0,0,0,0,1,1,0,0,0,0,1,1
sp09,92,MARSHALL,MATH,Mth/ApldSc,0,0,0,0,1,1,0,0,0,0,0,0,1,0,1,0,0,0,1,1,2
sp09,92,MARSHALL,MATH,Pr-Math CS,0,0,0,0,0,0,0,1,1,0,0,0,0,0,0,0,0,0,0,1,1
sp09,92,MARSHALL,MATH,Prob&Stats,0,0,0,0,0,0,0,0,0,0,0,0,1,2,3,0,0,0,1,2,3
sp09,92,MARSHALL,MUS,Mu-CompArt,0,0,0,0,0,0,1,0,1,1,0,1,1,0,1,0,0,0,3,0,3
sp09,92,MARSHALL,MUS,Music,0,0,0,0,1,1,1,1,2,1,0,1,2,6,8,0,0,0,4,8,12
sp09,92,MARSHALL,MUS,Music Hum,0,0,0,0,0,0,0,0,0,0,1,1,0,1,1,0,0,0,0,2,2
sp09,92,MARSHALL,PHIL,Philosophy,0,0,0,0,0,0,0,3,3,5,1,6,3,4,7,0,0,0,8,8,16
sp09,92,MARSHALL,PHYS,Biophysics,0,0,0,1,0,1,0,0,0,0,0,0,0,0,0,0,0,0,1,0,1
sp09,92,MARSHALL,PHYS,Phy/ErthSc,0,0,0,0,0,0,0,0,0,1,0,1,0,1,1,0,0,0,1,1,2
sp09,92,MARSHALL,PHYS,Phys/Astro,0,0,0,0,0,0,0,0,0,0,1,1,2,3,5,0,0,0,2,4,6
sp09,92,MARSHALL,PHYS,Physics,0,0,0,1,0,1,1,0,1,0,0,0,3,1,4,0,0,0,5,1,6
sp09,92,MARSHALL,POLI,Polit Sci,0,0,0,1,5,6,10,10,20,28,19,47,25,26,51,0,0,0,64,60,124
sp09,92,MARSHALL,POLI,PolSc-Amer,0,0,0,0,2,2,0,3,3,2,1,3,6,1,7,0,0,0,8,7,15
sp09,92,MARSHALL,POLI,PolSc-Comp,0,0,0,0,1,1,0,0,0,1,0,1,0,1,1,0,0,0,1,2,3
sp09,92,MARSHALL,POLI,PolSc-Intl,0,0,0,1,3,4,5,9,14,17,5,22,13,15,28,0,0,0,36,32,68
sp09,92,MARSHALL,POLI,PolSc-PLaw,0,0,0,1,3,4,10,5,15,7,8,15,5,4,9,0,0,0,23,20,43
sp09,92,MARSHALL,POLI,PolSc-PPol,0,0,0,0,0,0,0,0,0,1,1,2,0,3,3,0,0,0,1,4,5
sp09,92,MARSHALL,POLI,PolSc-Thry,0,0,0,0,0,0,0,0,0,0,0,0,3,0,3,0,0,0,3,0,3
sp09,92,MARSHALL,PSYC,Psychology,0,0,0,5,14,19,6,44,50,22,58,80,31,86,117,0,0,0,64,202,266
sp09,92,MARSHALL,RELI,Relig/Stu,0,0,0,0,0,0,0,0,0,0,2,2,2,1,3,0,0,0,2,3,5
sp09,92,MARSHALL,SE,Struct Eng,0,0,0,2,4,6,6,5,11,11,5,16,16,12,28,0,0,0,35,26,61
sp09,92,MARSHALL,SOC,Sociology,0,0,0,2,5,7,1,8,9,11,24,35,13,23,36,0,0,0,27,60,87
sp09,92,MARSHALL,THEA,Theatre,0,0,0,0,0,0,0,2,2,1,3,4,5,3,8,0,0,0,6,8,14
sp09,92,MARSHALL,UNAF,UndecHumAr,0,0,0,1,2,3,1,2,3,0,0,0,0,0,0,0,0,0,2,4,6
sp09,92,MARSHALL,UNAF,Undeclared,0,0,0,7,20,27,14,19,33,0,1,1,0,0,0,0,0,0,21,40,61
sp09,92,MARSHALL,UNAF,UndecPhysS,0,0,0,1,1,2,0,0,0,0,0,0,0,0,0,0,0,0,1,1,2
sp09,92,MARSHALL,UNAF,UndecSocSc,0,0,0,1,5,6,1,6,7,1,0,1,0,0,0,0,0,0,3,11,14
sp09,92,MARSHALL,USP,Urb Stu&Pl,0,0,0,1,0,1,1,4,5,3,6,9,5,8,13,0,0,0,10,18,28
sp09,92,MARSHALL,VIS,Art Hst/Cr,0,0,0,0,1,1,0,2,2,0,4,4,0,4,4,0,0,0,0,11,11
sp09,92,MARSHALL,VIS,Media,0,0,0,2,1,3,2,9,11,7,4,11,7,4,11,0,0,0,18,18,36
sp09,92,MARSHALL,VIS,Studio VA,0,0,0,0,0,0,1,1,2,3,2,5,4,4,8,0,0,0,8,7,15
sp09,92,MARSHALL,VIS,VA-CompArt,0,0,0,0,0,0,1,1,2,0,0,0,2,0,2,0,0,0,3,1,4
sp09,92,MUIR,ANTH,Anth-Arch,0,0,0,0,0,0,1,2,3,2,1,3,4,3,7,0,0,0,7,6,13
sp09,92,MUIR,ANTH,Anth-Biol,0,0,0,0,0,0,0,2,2,3,4,7,1,11,12,0,0,0,4,17,21
sp09,92,MUIR,ANTH,Anth-Soci,0,0,0,0,0,0,1,1,2,2,2,4,4,3,7,0,0,0,7,6,13
sp09,92,MUIR,ANTH,Anthropol,0,0,0,0,0,0,0,0,0,0,0,0,0,1,1,0,0,0,0,1,1
sp09,92,MUIR,BENG,Bioen:Binf,0,0,0,0,1,1,0,0,0,0,0,0,1,0,1,0,0,0,1,1,2
sp09,92,MUIR,BENG,Bioeng:PM,0,0,0,0,0,0,0,0,0,1,1,2,18,12,30,0,0,0,19,13,32
sp09,92,MUIR,BENG,BioengBiot,0,0,0,0,1,1,3,4,7,4,4,8,8,3,11,0,0,0,15,12,27
sp09,92,MUIR,BENG,Bioengin,0,0,0,0,1,1,7,5,12,8,2,10,9,5,14,0,0,0,24,13,37
sp09,92,MUIR,BENG,Pr-BioenPM,0,0,0,0,1,1,11,5,16,2,1,3,3,0,3,0,0,0,16,7,23
sp09,92,MUIR,BIOL,Anml Physl,0,0,0,0,0,0,0,0,0,0,0,0,0,2,2,0,0,0,0,2,2
sp09,92,MUIR,BIOL,Bioc/CellB,0,0,0,1,6,7,17,21,38,30,19,49,65,68,133,0,0,0,113,114,227
sp09,92,MUIR,BIOL,Ec/Beh/Evo,0,0,0,1,1,2,1,8,9,2,10,12,3,18,21,0,0,0,7,37,44
sp09,92,MUIR,BIOL,Genl Biol,0,0,0,0,15,15,10,30,40,18,32,50,46,72,118,0,0,0,74,149,223
sp09,92,MUIR,BIOL,Human Bio,0,1,1,11,22,33,33,59,92,40,65,105,77,88,165,0,0,0,161,235,396
sp09,92,MUIR,BIOL,Microbiol,0,0,0,1,1,2,2,2,4,3,4,7,3,5,8,0,0,0,9,12,21
sp09,92,MUIR,BIOL,Molec Biol,0,0,0,3,0,3,5,4,9,5,7,12,10,8,18,0,0,0,23,19,42
sp09,92,MUIR,BIOL,PhyslNeuro,0,0,0,3,4,7,8,12,20,13,15,28,33,35,68,0,0,0,57,66,123
sp09,92,MUIR,CENG,Chem Engin,0,0,0,4,1,5,5,5,10,0,5,5,21,5,26,0,0,0,30,16,46
sp09,92,MUIR,CGS,CritGendSt,0,0,0,0,0,0,0,1,1,0,3,3,0,3,3,0,0,0,0,7,7
sp09,92,MUIR,CHEM,Bioch/Chem,0,0,0,1,1,2,1,8,9,6,9,15,21,16,37,0,0,0,29,34,63
sp09,92,MUIR,CHEM,Chem Educ,0,0,0,0,0,0,0,0,0,0,0,0,0,1,1,0,0,0,0,1,1
sp09,92,MUIR,CHEM,Chemistry,0,0,0,0,0,0,4,2,6,4,2,6,5,7,12,0,0,0,13,11,24
sp09,92,MUIR,CHEM,Envir Chem,0,0,0,0,0,0,0,0,0,1,0,1,1,0,1,0,0,0,2,0,2
sp09,92,MUIR,CHEM,MolecSynth,0,0,0,0,0,0,0,0,0,0,0,0,2,0,2,0,0,0,2,0,2
sp09,92,MUIR,CHEM,Pharm Chem,0,0,0,0,0,0,4,8,12,10,6,16,14,17,31,0,0,0,28,31,59
sp09,92,MUIR,CHIN,Chinese St,0,0,0,0,0,0,0,0,0,0,0,0,0,3,3,0,0,0,0,3,3
sp09,92,MUIR,CLAS,Classic St,0,0,0,0,0,0,0,1,1,0,0,0,1,2,3,0,0,0,1,3,4
sp09,92,MUIR,COGS,Cog Sci,0,0,0,0,0,0,3,4,7,9,3,12,13,13,26,0,0,0,25,20,45
sp09,92,MUIR,COGS,CogSc/ClAs,0,0,0,0,0,0,0,3,3,0,0,0,2,5,7,0,0,0,2,8,10
sp09,92,MUIR,COGS,CogSc/Comp,0,0,0,0,0,0,0,0,0,2,0,2,1,0,1,0,0,0,3,0,3
sp09,92,MUIR,COGS,CogSc/HCI,0,0,0,0,1,1,1,1,2,4,0,4,8,4,12,0,0,0,13,6,19
sp09,92,MUIR,COGS,CogSc/HCog,0,0,0,0,0,0,1,3,4,0,1,1,3,1,4,0,0,0,4,5,9
sp09,92,MUIR,COGS,CogSc/Neur,0,0,0,0,2,2,0,3,3,4,3,7,9,11,20,0,0,0,13,19,32
sp09,92,MUIR,COMM,Communic,0,0,0,2,9,11,3,14,17,8,50,58,29,55,84,0,0,0,42,128,170
sp09,92,MUIR,CSE,Comp Sci,0,0,0,4,1,5,6,5,11,19,2,21,28,2,30,0,0,0,57,10,67
sp09,92,MUIR,CSE,CompEngCSE,0,0,0,3,0,3,3,3,6,4,1,5,5,0,5,0,0,0,15,4,19
sp09,92,MUIR,CSE,CompScBinf,0,0,0,0,0,0,0,0,0,0,0,0,3,0,3,0,0,0,3,0,3
sp09,92,MUIR,ECE,CompEngECE,0,0,0,1,0,1,1,1,2,0,0,0,2,0,2,0,0,0,4,1,5
sp09,92,MUIR,ECE,Electr Eng,0,0,0,3,0,3,3,0,3,6,1,7,15,6,21,0,0,0,27,7,34
sp09,92,MUIR,ECE,Engin Phys,0,0,0,0,0,0,0,0,0,0,0,0,1,0,1,0,0,0,1,0,1
sp09,92,MUIR,ECON,Ec-Mth&Ecn,0,0,0,0,1,1,4,1,5,6,1,7,3,2,5,0,0,0,13,5,18
sp09,92,MUIR,ECON,Econ-MgtSc,0,0,0,5,4,9,18,6,24,35,17,52,44,34,78,0,0,0,102,61,163
sp09,92,MUIR,ECON,Economics,0,0,0,4,3,7,18,11,29,62,32,94,77,53,130,0,0,0,161,99,260
sp09,92,MUIR,ERTH,ErSc-GeoCh,0,0,0,0,0,0,0,0,0,0,1,1,0,0,0,0,0,0,0,1,1
sp09,92,MUIR,ESYS,EnvSys(EB),0,0,0,0,2,2,2,3,5,2,3,5,4,10,14,0,0,0,8,18,26
sp09,92,MUIR,ESYS,EnvSys(EC),0,0,0,0,0,0,0,1,1,0,0,0,0,1,1,0,0,0,0,2,2
sp09,92,MUIR,ESYS,EnvSys(EP),0,0,0,1,1,2,0,1,1,1,2,3,2,4,6,0,0,0,4,8,12
sp09,92,MUIR,ESYS,EnvSys(ES),0,0,0,0,1,1,0,0,0,1,0,1,2,0,2,0,0,0,3,1,4
sp09,92,MUIR,ETHN,Ethnic St,0,0,0,1,2,3,0,2,2,1,7,8,2,6,8,0,0,0,4,17,21
sp09,92,MUIR,HDP,Human Dev,0,0,0,0,0,0,0,0,0,0,6,6,1,31,32,0,0,0,1,37,38
sp09,92,MUIR,HDP,Pr-HumnDev,0,0,0,0,5,5,1,7,8,1,7,8,0,2,2,0,0,0,2,21,23
sp09,92,MUIR,HIST,History,0,0,0,1,2,3,3,5,8,9,3,12,17,16,33,0,0,0,30,26,56
sp09,92,MUIR,INTL,IntSt-Anth,0,0,0,0,0,0,0,1,1,0,0,0,3,4,7,0,0,0,3,5,8
sp09,92,MUIR,INTL,IntSt-Econ,0,0,0,0,1,1,1,5,6,6,10,16,9,14,23,0,0,0,16,30,46
sp09,92,MUIR,INTL,IntSt-Hist,0,0,0,0,0,0,1,0,1,0,4,4,2,2,4,0,0,0,3,6,9
sp09,92,MUIR,INTL,IntSt-Ling,0,0,0,0,0,0,1,3,4,0,1,1,1,3,4,0,0,0,2,7,9
sp09,92,MUIR,INTL,IntSt-Lit,0,0,0,0,0,0,0,1,1,1,0,1,0,0,0,0,0,0,1,1,2
sp09,92,MUIR,INTL,IntSt-PolS,0,0,0,0,1,1,2,5,7,2,11,13,8,20,28,0,0,0,12,37,49
sp09,92,MUIR,INTL,IntSt-Soc,0,0,0,0,1,1,1,2,3,2,4,6,5,7,12,0,0,0,8,14,22
sp09,92,MUIR,ITAL,Italian St,0,0,0,1,0,1,0,0,0,0,0,0,0,0,0,0,0,0,1,0,1
sp09,92,MUIR,JAPN,JapaneseSt,0,0,0,0,0,0,0,2,2,2,3,5,3,1,4,0,0,0,5,6,11
sp09,92,MUIR,LATI,LatinAm St,0,0,0,0,0,0,0,0,0,1,1,2,1,2,3,0,0,0,2,3,5
sp09,92,MUIR,LING,Lang Stu,0,0,0,0,1,1,0,0,0,1,3,4,0,2,2,0,0,0,1,6,7
sp09,92,MUIR,LING,Ling-CogLn,0,0,0,1,0,1,0,0,0,1,2,3,0,1,1,0,0,0,2,3,5
sp09,92,MUIR,LING,Ling-LSoc,0,0,0,0,0,0,0,1,1,0,0,0,0,2,2,0,0,0,0,3,3
sp09,92,MUIR,LING,Linguistcs,0,0,0,0,1,1,1,2,3,1,2,3,0,4,4,0,0,0,2,9,11
sp09,92,MUIR,LIT,French Lit,0,0,0,0,0,0,0,0,0,0,1,1,0,0,0,0,0,0,0,1,1
sp09,92,MUIR,LIT,Lit/Compos,0,0,0,0,0,0,0,1,1,0,0,0,0,1,1,0,0,0,0,2,2
sp09,92,MUIR,LIT,Lit/CultSt,0,0,0,0,0,0,0,0,0,0,1,1,0,1,1,0,0,0,0,2,2
sp09,92,MUIR,LIT,Lit/Engl,0,0,0,0,0,0,2,4,6,0,8,8,10,10,20,0,0,0,12,22,34
sp09,92,MUIR,LIT,Lit/World,0,0,0,0,0,0,0,1,1,1,2,3,2,11,13,0,0,0,3,14,17
sp09,92,MUIR,LIT,Lit/Writng,0,0,0,0,0,0,0,0,0,1,0,1,8,19,27,0,0,0,9,19,28
sp09,92,MUIR,LIT,Pre-Lit/Wr,0,0,0,0,1,1,2,2,4,5,8,13,5,3,8,0,0,0,12,14,26
sp09,92,MUIR,LIT,Spanish Lt,0,0,0,0,0,0,1,0,1,1,3,4,4,3,7,0,0,0,6,6,12
sp09,92,MUIR,MAE,Aerosp Eng,0,0,0,3,1,4,10,0,10,6,1,7,17,5,22,0,0,0,36,7,43
sp09,92,MUIR,MAE,Engin Sci,0,0,0,0,0,0,0,0,0,0,0,0,1,0,1,0,0,0,1,0,1
sp09,92,MUIR,MAE,Envir Eng,0,0,0,1,0,1,5,2,7,1,1,2,2,4,6,0,0,0,9,7,16
sp09,92,MUIR,MAE,Mech Engin,0,0,0,1,0,1,17,2,19,21,2,23,56,6,62,0,0,0,95,10,105
sp09,92,MUIR,MATH,Appld Math,0,0,0,0,0,0,1,1,2,2,2,4,3,2,5,0,0,0,6,5,11
sp09,92,MUIR,MATH,Math/SecEd,0,0,0,0,0,0,1,2,3,2,3,5,4,1,5,0,0,0,7,6,13
sp09,92,MUIR,MATH,Mathematcs,0,0,0,1,1,2,1,3,4,4,4,8,8,6,14,0,0,0,14,14,28
sp09,92,MUIR,MATH,Mth-CompSc,0,0,0,0,0,0,0,0,0,1,0,1,0,2,2,0,0,0,1,2,3
sp09,92,MUIR,MATH,Mth-Mth&Ec,0,0,0,1,1,2,1,0,1,1,4,5,3,2,5,0,0,0,6,7,13
sp09,92,MUIR,MATH,Mth-SciCom,0,0,0,0,0,0,0,1,1,0,0,0,2,0,2,0,0,0,2,1,3
sp09,92,MUIR,MATH,Mth/ApldSc,0,0,0,0,0,0,0,0,0,0,0,0,0,2,2,0,0,0,0,2,2
sp09,92,MUIR,MATH,Prob&Stats,0,0,0,1,0,1,0,0,0,0,0,0,0,0,0,0,0,0,1,0,1
sp09,92,MUIR,MUS,Mu-CompArt,0,0,0,0,0,0,3,0,3,4,0,4,3,5,8,0,0,0,10,5,15
sp09,92,MUIR,MUS,Music,0,0,0,0,0,0,0,1,1,2,5,7,7,6,13,0,0,0,9,12,21
sp09,92,MUIR,MUS,Music Hum,0,0,0,0,0,0,1,0,1,0,2,2,1,0,1,0,0,0,2,2,4
sp09,92,MUIR,PHIL,Philosophy,0,0,0,0,2,2,2,0,2,5,2,7,4,5,9,0,0,0,11,9,20
sp09,92,MUIR,PHYS,Biophysics,0,0,0,0,0,0,0,0,0,0,0,0,3,1,4,0,0,0,3,1,4
sp09,92,MUIR,PHYS,Phy/ErthSc,0,0,0,0,0,0,0,1,1,0,0,0,0,0,0,0,0,0,0,1,1
sp09,92,MUIR,PHYS,Phys/Astro,0,0,0,0,0,0,2,1,3,1,1,2,1,1,2,0,0,0,4,3,7
sp09,92,MUIR,PHYS,Phys/Comp,0,0,0,0,0,0,0,0,0,0,0,0,1,0,1,0,0,0,1,0,1
sp09,92,MUIR,PHYS,Phys/Mtrls,0,0,0,1,0,1,0,0,0,0,0,0,0,0,0,0,0,0,1,0,1
sp09,92,MUIR,PHYS,Physics,0,0,0,3,0,3,4,0,4,1,1,2,7,0,7,0,0,0,15,1,16
sp09,92,MUIR,POLI,Polit Sci,0,0,0,1,6,7,5,12,17,18,12,30,29,23,52,0,0,0,53,53,106
sp09,92,MUIR,POLI,PolSc-Amer,0,0,0,0,0,0,2,0,2,2,3,5,3,1,4,0,0,0,7,4,11
sp09,92,MUIR,POLI,PolSc-Comp,0,0,0,0,0,0,0,0,0,1,0,1,1,0,1,0,0,0,2,0,2
sp09,92,MUIR,POLI,PolSc-Intl,0,0,0,1,0,1,2,5,7,8,6,14,8,17,25,0,0,0,19,28,47
sp09,92,MUIR,POLI,PolSc-PLaw,0,0,0,0,1,1,1,4,5,8,7,15,7,5,12,0,0,0,16,17,33
sp09,92,MUIR,POLI,PolSc-PPol,0,0,0,0,0,0,1,0,1,2,1,3,2,0,2,0,0,0,5,1,6
sp09,92,MUIR,POLI,PolSc-Thry,0,0,0,0,0,0,0,0,0,4,1,5,4,1,5,0,0,0,8,2,10
sp09,92,MUIR,PSYC,Psychology,0,0,0,3,11,14,12,41,53,25,69,94,43,112,155,0,0,0,83,233,316
sp09,92,MUIR,RELI,Relig/Stu,0,0,0,0,0,0,0,1,1,1,2,3,4,1,5,0,0,0,5,4,9
sp09,92,MUIR,SE,Engin Sci,0,0,0,0,0,0,1,0,1,1,0,1,0,0,0,0,0,0,2,0,2
sp09,92,MUIR,SE,Struct Eng,0,0,0,5,5,10,6,2,8,9,3,12,29,12,41,0,0,0,49,22,71
sp09,92,MUIR,SIO,ErSc-Geol,0,0,0,1,0,1,0,0,0,0,0,0,1,0,1,0,0,0,2,0,2
sp09,92,MUIR,SOC,Sociology,0,0,0,2,2,4,0,5,5,3,17,20,9,25,34,0,0,0,14,49,63
sp09,92,MUIR,THEA,Dance,0,0,0,0,0,0,0,0,0,2,2,4,0,3,3,0,0,0,2,5,7
sp09,92,MUIR,THEA,Theatre,0,0,0,1,1,2,0,2,2,2,6,8,6,7,13,0,0,0,9,16,25
sp09,92,MUIR,UNAF,Limited St,0,0,0,0,0,0,0,0,0,0,0,0,0,0,0,1,1,2,1,1,2
sp09,92,MUIR,UNAF,UndecBiolS,0,0,0,1,0,1,0,0,0,0,0,0,0,0,0,0,0,0,1,0,1
sp09,92,MUIR,UNAF,UndecHumAr,0,0,0,0,1,1,3,3,6,0,0,0,0,0,0,0,0,0,3,4,7
sp09,92,MUIR,UNAF,Undeclared,0,0,0,13,15,28,26,39,65,2,2,4,0,0,0,0,0,0,41,56,97
sp09,92,MUIR,UNAF,UndecPhysS,0,0,0,1,1,2,4,1,5,1,0,1,0,0,0,0,0,0,6,2,8
sp09,92,MUIR,UNAF,UndecSocSc,0,0,0,2,3,5,1,3,4,0,1,1,0,0,0,0,0,0,3,7,10
sp09,92,MUIR,USP,Urb Stu&Pl,0,0,0,0,0,0,0,2,2,4,5,9,9,6,15,0,0,0,13,13,26
sp09,92,MUIR,VIS,Art Hst/Cr,0,0,0,0,0,0,0,1,1,0,6,6,0,8,8,0,0,0,0,15,15
sp09,92,MUIR,VIS,Media,0,0,0,2,2,4,1,4,5,10,12,22,15,9,24,0,0,0,28,27,55
sp09,92,MUIR,VIS,Studio VA,0,0,0,0,0,0,0,0,0,0,3,3,0,8,8,0,0,0,0,11,11
sp09,92,MUIR,VIS,VA-CompArt,0,0,0,0,1,1,3,0,3,4,2,6,5,3,8,0,0,0,12,6,18
sp09,92,REVELLE,ANTH,Anth-Arch,0,0,0,0,0,0,0,1,1,0,1,1,0,1,1,0,0,0,0,3,3
sp09,92,REVELLE,ANTH,Anth-Biol,0,0,0,0,1,1,0,0,0,2,1,3,1,2,3,0,0,0,3,4,7
sp09,92,REVELLE,ANTH,Anth-Soci,0,0,0,0,1,1,1,0,1,1,3,4,0,4,4,0,0,0,2,8,10
sp09,92,REVELLE,ANTH,Anthropol,0,0,0,0,0,0,0,0,0,0,0,0,0,1,1,0,0,0,0,1,1
sp09,92,REVELLE,BENG,Bioen:Binf,0,0,0,1,0,1,0,0,0,0,0,0,3,0,3,0,0,0,4,0,4
sp09,92,REVELLE,BENG,Bioeng:PM,0,0,0,0,0,0,2,1,3,7,4,11,35,18,53,0,0,0,44,23,67
sp09,92,REVELLE,BENG,BioengBiot,0,0,0,0,2,2,5,1,6,5,3,8,18,8,26,0,0,0,28,14,42
sp09,92,REVELLE,BENG,Bioengin,0,0,0,1,0,1,7,2,9,6,4,10,11,8,19,0,0,0,25,14,39
sp09,92,REVELLE,BENG,Pr-BioenPM,0,0,0,3,0,3,9,7,16,10,3,13,0,0,0,0,0,0,22,10,32
sp09,92,REVELLE,BIOL,Anml Physl,0,0,0,0,0,0,0,0,0,0,0,0,1,4,5,0,0,0,1,4,5
sp09,92,REVELLE,BIOL,Bioc/CellB,0,0,0,3,9,12,29,33,62,57,51,108,84,90,174,0,0,0,173,183,356
sp09,92,REVELLE,BIOL,BiolBioinf,0,0,0,0,0,0,0,0,0,0,0,0,1,0,1,0,0,0,1,0,1
sp09,92,REVELLE,BIOL,Ec/Beh/Evo,0,0,0,1,0,1,0,5,5,5,3,8,7,2,9,0,0,0,13,10,23
sp09,92,REVELLE,BIOL,Genl Biol,0,0,0,6,8,14,21,29,50,21,53,74,48,83,131,0,0,0,96,173,269
sp09,92,REVELLE,BIOL,Human Bio,0,0,0,10,28,38,57,81,138,57,80,137,90,120,210,0,0,0,214,309,523
sp09,92,REVELLE,BIOL,Microbiol,0,0,0,2,2,4,3,3,6,5,5,10,6,14,20,0,0,0,16,24,40
sp09,92,REVELLE,BIOL,Molec Biol,0,0,0,0,1,1,5,7,12,13,7,20,19,18,37,0,0,0,37,33,70
sp09,92,REVELLE,BIOL,PhyslNeuro,0,0,0,4,6,10,16,19,35,26,29,55,21,36,57,0,0,0,67,90,157
sp09,92,REVELLE,CENG,Chem Engin,0,0,0,3,0,3,5,5,10,9,5,14,15,10,25,0,0,0,32,20,52
sp09,92,REVELLE,CGS,CritGendSt,0,0,0,0,0,0,0,0,0,0,0,0,0,3,3,0,0,0,0,3,3
sp09,92,REVELLE,CHEM,Bioch/Chem,0,0,0,1,1,2,8,11,19,10,13,23,23,28,51,0,0,0,42,53,95
sp09,92,REVELLE,CHEM,Chem Phys,0,0,0,0,0,0,0,0,0,0,0,0,5,0,5,0,0,0,5,0,5
sp09,92,REVELLE,CHEM,Chemistry,0,0,0,0,1,1,1,6,7,7,4,11,10,10,20,0,0,0,18,21,39
sp09,92,REVELLE,CHEM,Envir Chem,0,0,0,0,0,0,0,0,0,1,0,1,0,1,1,0,0,0,1,1,2
sp09,92,REVELLE,CHEM,MolecSynth,0,0,0,0,0,0,0,0,0,1,0,1,0,2,2,0,0,0,1,2,3
sp09,92,REVELLE,CHEM,Pharm Chem,0,0,0,4,3,7,4,15,19,6,12,18,21,31,52,0,0,0,35,61,96
sp09,92,REVELLE,CHIN,Chinese St,0,0,0,0,0,0,0,0,0,0,0,0,1,3,4,0,0,0,1,3,4
sp09,92,REVELLE,CLAS,Classic St,0,0,0,0,0,0,0,0,0,0,0,0,1,0,1,0,0,0,1,0,1
sp09,92,REVELLE,COGS,Cog Sci,0,0,0,0,2,2,0,4,4,3,4,7,3,2,5,0,0,0,6,12,18
sp09,92,REVELLE,COGS,CogSc/ClAs,0,0,0,0,1,1,0,1,1,0,0,0,1,0,1,0,0,0,1,2,3
sp09,92,REVELLE,COGS,CogSc/HCI,0,0,0,0,0,0,1,0,1,0,1,1,4,1,5,0,0,0,5,2,7
sp09,92,REVELLE,COGS,CogSc/HCog,0,0,0,0,2,2,0,0,0,0,0,0,1,3,4,0,0,0,1,5,6
sp09,92,REVELLE,COGS,CogSc/Neur,0,0,0,0,0,0,0,3,3,2,3,5,3,9,12,0,0,0,5,15,20
sp09,92,REVELLE,COMM,Communic,0,0,0,0,3,3,2,11,13,5,13,18,8,18,26,0,0,0,15,45,60
sp09,92,REVELLE,CSE,Comp Sci,0,0,0,4,1,5,12,2,14,13,0,13,26,4,30,0,0,0,55,7,62
sp09,92,REVELLE,CSE,CompEngCSE,0,0,0,5,0,5,7,1,8,5,0,5,3,0,3,0,0,0,20,1,21
sp09,92,REVELLE,CSE,CompScBinf,0,0,0,0,0,0,0,0,0,1,0,1,1,0,1,0,0,0,2,0,2
sp09,92,REVELLE,ECE,CompEngECE,0,0,0,1,0,1,1,0,1,0,0,0,3,0,3,0,0,0,5,0,5
sp09,92,REVELLE,ECE,Electr Eng,0,0,0,0,0,0,4,0,4,8,1,9,34,2,36,0,0,0,46,3,49
sp09,92,REVELLE,ECE,Engin Phys,0,0,0,0,0,0,0,0,0,0,0,0,1,0,1,0,0,0,1,0,1
sp09,92,REVELLE,ECE,Pr-EngPhys,0,0,0,0,0,0,0,0,0,1,0,1,0,0,0,0,0,0,1,0,1
sp09,92,REVELLE,ECON,Ec-Mth&Ecn,0,0,0,2,0,2,4,0,4,2,0,2,3,2,5,0,0,0,11,2,13
sp09,92,REVELLE,ECON,Econ-MgtSc,0,0,0,4,1,5,9,7,16,18,10,28,37,32,69,0,0,0,68,50,118
sp09,92,REVELLE,ECON,Economics,0,0,0,4,3,7,14,8,22,29,13,42,42,30,72,0,0,0,89,54,143
sp09,92,REVELLE,ERTH,ErSc-GeoPh,0,0,0,0,0,0,0,0,0,0,0,0,1,0,1,0,0,0,1,0,1
sp09,92,REVELLE,ERTH,ErthSc-Phy,0,0,0,0,0,0,0,0,0,0,0,0,1,0,1,0,0,0,1,0,1
sp09,92,REVELLE,ESYS,EnvSys(EB),0,0,0,0,0,0,0,1,1,0,2,2,4,7,11,0,0,0,4,10,14
sp09,92,REVELLE,ESYS,EnvSys(EC),0,0,0,0,0,0,1,0,1,1,0,1,0,0,0,0,0,0,2,0,2
sp09,92,REVELLE,ESYS,EnvSys(EP),0,0,0,0,0,0,0,0,0,0,1,1,1,1,2,0,0,0,1,2,3
sp09,92,REVELLE,ESYS,EnvSys(ES),0,0,0,0,0,0,0,0,0,0,0,0,3,2,5,0,0,0,3,2,5
sp09,92,REVELLE,ETHN,Ethnic St,0,0,0,0,1,1,0,2,2,1,0,1,0,2,2,0,0,0,1,5,6
sp09,92,REVELLE,HDP,Human Dev,0,0,0,0,0,0,0,0,0,1,0,1,3,13,16,0,0,0,4,13,17
sp09,92,REVELLE,HDP,Pr-HumnDev,0,0,0,1,2,3,0,3,3,0,8,8,0,5,5,0,0,0,1,18,19
sp09,92,REVELLE,HIST,History,0,0,0,1,0,1,1,1,2,6,2,8,10,6,16,0,0,0,18,9,27
sp09,92,REVELLE,INTD,Rev Ind Mj,0,0,0,0,0,0,0,0,0,0,0,0,0,1,1,0,0,0,0,1,1
sp09,92,REVELLE,INTL,IntSt-Anth,0,0,0,0,0,0,0,1,1,1,0,1,0,0,0,0,0,0,1,1,2
sp09,92,REVELLE,INTL,IntSt-Econ,0,0,0,0,1,1,1,4,5,5,4,9,4,5,9,0,0,0,10,14,24
sp09,92,REVELLE,INTL,IntSt-Hist,0,0,0,0,0,0,0,1,1,0,0,0,2,1,3,0,0,0,2,2,4
sp09,92,REVELLE,INTL,IntSt-Ling,0,0,0,0,0,0,0,0,0,0,2,2,0,1,1,0,0,0,0,3,3
sp09,92,REVELLE,INTL,IntSt-Lit,0,0,0,0,0,0,0,0,0,0,0,0,0,1,1,0,0,0,0,1,1
sp09,92,REVELLE,INTL,IntSt-PolS,0,0,0,0,0,0,1,1,2,0,2,2,3,13,16,0,0,0,4,16,20
sp09,92,REVELLE,INTL,IntSt-Soc,0,0,0,0,0,0,0,2,2,0,2,2,0,2,2,0,0,0,0,6,6
sp09,92,REVELLE,ITAL,Italian St,0,0,0,0,0,0,0,0,0,0,0,0,0,1,1,0,0,0,0,1,1
sp09,92,REVELLE,JAPN,JapaneseSt,0,0,0,0,0,0,0,0,0,0,0,0,3,0,3,0,0,0,3,0,3
sp09,92,REVELLE,LING,Lang Stu,0,0,0,0,0,0,0,1,1,0,1,1,0,2,2,0,0,0,0,4,4
sp09,92,REVELLE,LING,Ling-CogLn,0,0,0,0,0,0,0,0,0,0,0,0,0,1,1,0,0,0,0,1,1
sp09,92,REVELLE,LING,Ling-LSoc,0,0,0,0,0,0,0,1,1,0,0,0,0,0,0,0,0,0,0,1,1
sp09,92,REVELLE,LING,Linguistcs,0,0,0,0,1,1,0,1,1,2,2,4,1,0,1,0,0,0,3,4,7
sp09,92,REVELLE,LIT,Hn-Span Lt,0,0,0,0,0,0,0,0,0,0,0,0,0,1,1,0,0,0,0,1,1
sp09,92,REVELLE,LIT,Ital Lit,0,0,0,0,0,0,0,0,0,0,0,0,0,1,1,0,0,0,0,1,1
sp09,92,REVELLE,LIT,Lit/Compos,0,0,0,0,0,0,0,1,1,0,1,1,0,0,0,0,0,0,0,2,2
sp09,92,REVELLE,LIT,Lit/Engl,0,0,0,0,0,0,0,1,1,0,2,2,2,8,10,0,0,0,2,11,13
sp09,92,REVELLE,LIT,Lit/World,0,0,0,0,0,0,1,0,1,1,3,4,2,3,5,0,0,0,4,6,10
sp09,92,REVELLE,LIT,Lit/Writng,0,0,0,0,0,0,0,0,0,0,0,0,4,11,15,0,0,0,4,11,15
sp09,92,REVELLE,LIT,Pre-Lit/Wr,0,0,0,1,2,3,3,2,5,4,2,6,3,1,4,0,0,0,11,7,18
sp09,92,REVELLE,LIT,Russian Lt,0,0,0,0,1,1,0,0,0,0,0,0,0,0,0,0,0,0,0,1,1
sp09,92,REVELLE,LIT,Spanish Lt,0,0,0,0,0,0,0,1,1,0,2,2,0,2,2,0,0,0,0,5,5
sp09,92,REVELLE,MAE,Aerosp Eng,0,0,0,5,0,5,9,2,11,2,3,5,31,7,38,0,0,0,47,12,59
sp09,92,REVELLE,MAE,Engin Sci,0,0,0,0,0,0,0,1,1,0,0,0,1,0,1,0,0,0,1,1,2
sp09,92,REVELLE,MAE,Envir Eng,0,0,0,0,0,0,0,0,0,3,1,4,1,2,3,0,0,0,4,3,7
sp09,92,REVELLE,MAE,Mech Engin,0,0,0,4,1,5,11,4,15,17,3,20,58,9,67,0,0,0,90,17,107
sp09,92,REVELLE,MATH,Appld Math,0,0,0,0,0,0,0,1,1,1,3,4,2,3,5,0,0,0,3,7,10
sp09,92,REVELLE,MATH,Math/SecEd,0,0,0,0,1,1,1,1,2,0,2,2,0,2,2,0,0,0,1,6,7
sp09,92,REVELLE,MATH,Mathematcs,0,0,0,1,0,1,1,1,2,7,2,9,8,9,17,0,0,0,17,12,29
sp09,92,REVELLE,MATH,Mth-CompSc,0,0,0,0,0,0,0,0,0,0,0,0,2,0,2,0,0,0,2,0,2
sp09,92,REVELLE,MATH,Mth-Mth&Ec,0,0,0,1,0,1,1,0,1,5,1,6,5,1,6,0,0,0,12,2,14
sp09,92,REVELLE,MATH,Mth-SciCom,0,0,0,0,0,0,1,0,1,0,0,0,1,2,3,0,0,0,2,2,4
sp09,92,REVELLE,MATH,Mth/ApldSc,0,0,0,1,0,1,1,1,2,0,0,0,0,0,0,0,0,0,2,1,3
sp09,92,REVELLE,MATH,Pr-Math CS,0,0,0,0,0,0,0,0,0,1,0,1,0,0,0,0,0,0,1,0,1
sp09,92,REVELLE,MATH,Prob&Stats,0,0,0,0,0,0,1,0,1,1,1,2,0,0,0,0,0,0,2,1,3
sp09,92,REVELLE,MUS,Mu-CompArt,0,0,0,0,0,0,0,0,0,2,0,2,4,0,4,0,0,0,6,0,6
sp09,92,REVELLE,MUS,Music,0,0,0,0,0,0,2,0,2,0,0,0,1,1,2,0,0,0,3,1,4
sp09,92,REVELLE,MUS,Music Hum,0,0,0,0,0,0,0,0,0,0,0,0,1,0,1,0,0,0,1,0,1
sp09,92,REVELLE,PHIL,Philosophy,0,0,0,0,0,0,2,1,3,4,3,7,1,2,3,0,0,0,7,6,13
sp09,92,REVELLE,PHYS,Biophysics,0,0,0,0,0,0,0,0,0,0,1,1,1,0,1,0,0,0,1,1,2
sp09,92,REVELLE,PHYS,Gen Physcs,0,0,0,0,0,0,1,0,1,1,0,1,0,0,0,0,0,0,2,0,2
sp09,92,REVELLE,PHYS,Phy/ErthSc,0,0,0,0,0,0,0,0,0,1,0,1,0,0,0,0,0,0,1,0,1
sp09,92,REVELLE,PHYS,Phys/Astro,0,0,0,0,0,0,0,1,1,0,1,1,5,3,8,0,0,0,5,5,10
sp09,92,REVELLE,PHYS,Phys/Comp,0,0,0,0,0,0,1,0,1,0,0,0,0,0,0,0,0,0,1,0,1
sp09,92,REVELLE,PHYS,Phys/Mtrls,0,0,0,0,0,0,0,0,0,0,0,0,1,0,1,0,0,0,1,0,1
sp09,92,REVELLE,PHYS,Physics,0,0,0,1,0,1,3,0,3,5,1,6,4,2,6,0,0,0,13,3,16
sp09,92,REVELLE,POLI,Polit Sci,0,0,0,0,4,4,1,2,3,5,4,9,10,7,17,0,0,0,16,17,33
sp09,92,REVELLE,POLI,PolSc-Amer,0,0,0,0,0,0,1,0,1,0,2,2,1,2,3,0,0,0,2,4,6
sp09,92,REVELLE,POLI,PolSc-Comp,0,0,0,0,0,0,0,0,0,0,0,0,1,0,1,0,0,0,1,0,1
sp09,92,REVELLE,POLI,PolSc-Intl,0,0,0,1,0,1,1,4,5,5,5,10,9,5,14,0,0,0,16,14,30
sp09,92,REVELLE,POLI,PolSc-PLaw,0,0,0,1,0,1,2,3,5,1,5,6,1,4,5,0,0,0,5,12,17
sp09,92,REVELLE,POLI,PolSc-PPol,0,0,0,0,0,0,0,1,1,0,3,3,0,0,0,0,0,0,0,4,4
sp09,92,REVELLE,POLI,PolSc-Thry,0,0,0,0,0,0,0,0,0,0,0,0,0,2,2,0,0,0,0,2,2
sp09,92,REVELLE,PSYC,Psychology,0,0,0,3,12,15,11,28,39,17,45,62,32,83,115,0,0,0,63,168,231
sp09,92,REVELLE,SE,Engin Sci,0,0,0,0,0,0,0,0,0,0,0,0,1,0,1,0,0,0,1,0,1
sp09,92,REVELLE,SE,Struct Eng,0,0,0,3,1,4,5,1,6,15,6,21,26,7,33,0,0,0,49,15,64
sp09,92,REVELLE,SIO,ErSc-Geol,0,0,0,0,0,0,0,0,0,0,0,0,1,1,2,0,0,0,1,1,2
sp09,92,REVELLE,SIO,ErSc-Geoph,0,0,0,0,0,0,1,0,1,0,0,0,0,0,0,0,0,0,1,0,1
sp09,92,REVELLE,SOC,Sociology,0,0,0,0,2,2,1,2,3,2,6,8,2,7,9,0,0,0,5,17,22
sp09,92,REVELLE,THEA,Dance,0,0,0,0,0,0,0,1,1,0,1,1,1,0,1,0,0,0,1,2,3
sp09,92,REVELLE,THEA,Theatre,0,0,0,0,0,0,0,1,1,0,1,1,2,3,5,0,0,0,2,5,7
sp09,92,REVELLE,UNAF,Limited St,0,0,0,0,0,0,0,0,0,0,0,0,0,0,0,8,12,20,8,12,20
sp09,92,REVELLE,UNAF,Spec-Emply,0,0,0,0,0,0,0,0,0,0,0,0,0,0,0,6,2,8,6,2,8
sp09,92,REVELLE,UNAF,UndecHumAr,0,0,0,0,1,1,0,4,4,0,1,1,0,0,0,0,0,0,0,6,6
sp09,92,REVELLE,UNAF,Undeclared,0,0,0,5,14,19,22,18,40,0,1,1,0,0,0,0,0,0,27,33,60
sp09,92,REVELLE,UNAF,UndecPhysS,0,0,0,1,1,2,2,1,3,0,0,0,0,0,0,0,0,0,3,2,5
sp09,92,REVELLE,UNAF,UndecSocSc,0,0,0,0,1,1,4,1,5,0,0,0,0,0,0,0,0,0,4,2,6
sp09,92,REVELLE,USP,Urb Stu&Pl,0,0,0,1,0,1,0,2,2,2,1,3,3,4,7,0,0,0,6,7,13
sp09,92,REVELLE,VIS,Art Hst/Cr,0,0,0,0,0,0,1,1,2,0,0,0,1,5,6,0,0,0,2,6,8
sp09,92,REVELLE,VIS,Media,0,0,0,0,0,0,0,1,1,3,4,7,4,4,8,0,0,0,7,9,16
sp09,92,REVELLE,VIS,Studio VA,0,0,0,0,1,1,0,3,3,0,0,0,0,5,5,0,0,0,0,9,9
sp09,92,REVELLE,VIS,VA-CompArt,0,0,0,0,0,0,2,0,2,1,0,1,0,0,0,0,0,0,3,0,3
sp09,92,ROOSEVELT,ANTH,Anth-Arch,0,0,0,0,1,1,0,5,5,2,4,6,2,7,9,0,0,0,4,17,21
sp09,92,ROOSEVELT,ANTH,Anth-Biol,0,0,0,0,2,2,0,1,1,1,3,4,1,8,9,0,0,0,2,14,16
sp09,92,ROOSEVELT,ANTH,Anth-Soci,0,0,0,0,2,2,1,0,1,1,2,3,0,5,5,0,0,0,2,9,11
sp09,92,ROOSEVELT,ANTH,Anthropol,0,0,0,0,0,0,0,0,0,0,1,1,0,2,2,0,0,0,0,3,3
sp09,92,ROOSEVELT,BENG,Bioen:Binf,0,0,0,0,0,0,0,2,2,0,0,0,0,0,0,0,0,0,0,2,2
sp09,92,ROOSEVELT,BENG,Bioeng:PM,0,0,0,0,0,0,0,0,0,3,1,4,7,6,13,0,0,0,10,7,17
sp09,92,ROOSEVELT,BENG,BioengBiot,0,0,0,1,0,1,1,3,4,0,1,1,4,2,6,0,0,0,6,6,12
sp09,92,ROOSEVELT,BENG,Bioengin,0,0,0,0,0,0,4,1,5,2,0,2,3,2,5,0,0,0,9,3,12
sp09,92,ROOSEVELT,BENG,Pr-BioenPM,0,0,0,1,3,4,7,6,13,3,1,4,2,0,2,0,0,0,13,10,23
sp09,92,ROOSEVELT,BIOL,Anml Physl,0,0,0,0,0,0,0,0,0,0,0,0,1,0,1,0,0,0,1,0,1
sp09,92,ROOSEVELT,BIOL,Bioc/CellB,0,0,0,1,2,3,10,15,25,18,17,35,25,35,60,0,0,0,54,69,123
sp09,92,ROOSEVELT,BIOL,Ec/Beh/Evo,0,0,0,1,1,2,1,4,5,1,5,6,5,8,13,0,0,0,8,18,26
sp09,92,ROOSEVELT,BIOL,Genl Biol,0,0,0,3,6,9,8,14,22,17,27,44,23,45,68,0,0,0,51,92,143
sp09,92,ROOSEVELT,BIOL,Human Bio,0,0,0,9,20,29,24,60,84,24,50,74,22,57,79,0,0,0,79,187,266
sp09,92,ROOSEVELT,BIOL,Microbiol,0,0,0,0,0,0,2,0,2,4,2,6,1,4,5,0,0,0,7,6,13
sp09,92,ROOSEVELT,BIOL,Molec Biol,0,0,0,0,1,1,2,4,6,1,6,7,10,8,18,0,0,0,13,19,32
sp09,92,ROOSEVELT,BIOL,PhyslNeuro,0,0,0,1,3,4,6,8,14,9,3,12,10,26,36,0,0,0,26,40,66
sp09,92,ROOSEVELT,CENG,Chem Engin,0,0,0,1,0,1,1,2,3,2,3,5,1,4,5,0,0,0,5,9,14
sp09,92,ROOSEVELT,CGS,CritGendSt,0,0,0,0,0,0,0,0,0,0,1,1,0,2,2,0,0,0,0,3,3
sp09,92,ROOSEVELT,CHEM,Bioch/Chem,0,0,0,2,1,3,3,3,6,5,4,9,6,7,13,0,0,0,16,15,31
sp09,92,ROOSEVELT,CHEM,Bioinform,0,0,0,0,0,0,0,0,0,1,0,1,0,0,0,0,0,0,1,0,1
sp09,92,ROOSEVELT,CHEM,Chem Phys,0,0,0,0,0,0,0,0,0,0,0,0,1,0,1,0,0,0,1,0,1
sp09,92,ROOSEVELT,CHEM,Chemistry,0,0,0,1,0,1,1,3,4,2,0,2,5,0,5,0,0,0,9,3,12
sp09,92,ROOSEVELT,CHEM,Envir Chem,0,0,0,0,0,0,1,0,1,0,0,0,0,1,1,0,0,0,1,1,2
sp09,92,ROOSEVELT,CHEM,Pharm Chem,0,0,0,0,6,6,4,6,10,0,1,1,11,3,14,0,0,0,15,16,31
sp09,92,ROOSEVELT,CHIN,Chinese St,0,0,0,0,0,0,0,1,1,0,1,1,5,2,7,0,0,0,5,4,9
sp09,92,ROOSEVELT,CLAS,Classic St,0,0,0,0,0,0,1,0,1,0,0,0,2,0,2,0,0,0,3,0,3
sp09,92,ROOSEVELT,COGS,Cog Sci,0,0,0,0,0,0,3,2,5,1,4,5,3,8,11,0,0,0,7,14,21
sp09,92,ROOSEVELT,COGS,CogSc/ClAs,0,0,0,0,0,0,0,0,0,0,1,1,0,0,0,0,0,0,0,1,1
sp09,92,ROOSEVELT,COGS,CogSc/HCI,0,0,0,0,0,0,1,0,1,1,1,2,3,5,8,0,0,0,5,6,11
sp09,92,ROOSEVELT,COGS,CogSc/HCog,0,0,0,0,0,0,0,2,2,0,1,1,0,1,1,0,0,0,0,4,4
sp09,92,ROOSEVELT,COGS,CogSc/Neur,0,0,0,0,2,2,1,2,3,1,6,7,2,7,9,0,0,0,4,17,21
sp09,92,ROOSEVELT,COMM,Communic,0,0,0,4,10,14,6,16,22,15,45,60,16,62,78,0,0,0,41,133,174
sp09,92,ROOSEVELT,CSE,Comp Sci,0,0,0,1,0,1,10,1,11,10,2,12,20,4,24,0,0,0,41,7,48
sp09,92,ROOSEVELT,CSE,CompEngCSE,0,0,0,1,1,2,2,1,3,0,1,1,3,0,3,0,0,0,6,3,9
sp09,92,ROOSEVELT,CSE,Pr-Comp Sc,0,0,0,0,0,0,0,1,1,0,0,0,0,0,0,0,0,0,0,1,1
sp09,92,ROOSEVELT,ECE,CompEngECE,0,0,0,1,0,1,1,0,1,1,0,1,0,0,0,0,0,0,3,0,3
sp09,92,ROOSEVELT,ECE,Electr Eng,0,0,0,1,1,2,3,2,5,6,2,8,21,4,25,0,0,0,31,9,40
sp09,92,ROOSEVELT,ECE,Pr-EngPhys,0,0,0,1,0,1,2,0,2,0,0,0,0,0,0,0,0,0,3,0,3
sp09,92,ROOSEVELT,ECON,Ec-Mth&Ecn,0,0,0,0,0,0,2,1,3,1,1,2,3,3,6,0,0,0,6,5,11
sp09,92,ROOSEVELT,ECON,Econ-MgtSc,0,0,0,4,6,10,15,11,26,29,20,49,47,32,79,0,0,0,95,69,164
sp09,92,ROOSEVELT,ECON,Economics,0,0,0,8,7,15,19,15,34,52,22,74,67,39,106,0,0,0,146,83,229
sp09,92,ROOSEVELT,ERTH,ErSc-Geol,0,0,0,0,0,0,0,0,0,0,0,0,1,1,2,0,0,0,1,1,2
sp09,92,ROOSEVELT,ESYS,EnvSys(EB),0,0,0,0,0,0,0,3,3,1,3,4,3,3,6,0,0,0,4,9,13
sp09,92,ROOSEVELT,ESYS,EnvSys(EC),0,0,0,0,0,0,0,0,0,0,1,1,2,2,4,0,0,0,2,3,5
sp09,92,ROOSEVELT,ESYS,EnvSys(EP),0,0,0,1,1,2,0,2,2,1,4,5,0,2,2,0,0,0,2,9,11
sp09,92,ROOSEVELT,ESYS,EnvSys(ES),0,0,0,0,0,0,1,2,3,2,0,2,3,2,5,0,0,0,6,4,10
sp09,92,ROOSEVELT,ETHN,Ethnic St,0,0,0,0,0,0,0,1,1,0,5,5,2,13,15,0,0,0,2,19,21
sp09,92,ROOSEVELT,HDP,Human Dev,0,0,0,0,0,0,0,0,0,0,8,8,3,18,21,0,0,0,3,26,29
sp09,92,ROOSEVELT,HDP,Pr-HumnDev,0,0,0,0,3,3,0,4,4,1,8,9,0,4,4,0,0,0,1,19,20
sp09,92,ROOSEVELT,HIST,History,0,0,0,0,1,1,3,7,10,13,20,33,19,22,41,0,0,0,35,50,85
sp09,92,ROOSEVELT,INTL,IntSt-Anth,0,0,0,0,0,0,0,4,4,0,2,2,0,10,10,0,0,0,0,16,16
sp09,92,ROOSEVELT,INTL,IntSt-Econ,0,0,0,2,2,4,10,13,23,11,32,43,21,32,53,0,0,0,44,79,123
sp09,92,ROOSEVELT,INTL,IntSt-Hist,0,0,0,0,0,0,1,7,8,2,4,6,2,6,8,0,0,0,5,17,22
sp09,92,ROOSEVELT,INTL,IntSt-Ling,0,0,0,0,2,2,0,0,0,1,2,3,0,5,5,0,0,0,1,9,10
sp09,92,ROOSEVELT,INTL,IntSt-Lit,0,0,0,0,0,0,0,0,0,0,1,1,0,2,2,0,0,0,0,3,3
sp09,92,ROOSEVELT,INTL,IntSt-PolS,0,0,0,1,5,6,3,18,21,11,19,30,19,48,67,0,0,0,34,90,124
sp09,92,ROOSEVELT,INTL,IntSt-Soc,0,0,0,0,3,3,0,16,16,1,14,15,1,22,23,0,0,0,2,55,57
sp09,92,ROOSEVELT,ITAL,Italian St,0,0,0,0,0,0,0,1,1,0,0,0,0,0,0,0,0,0,0,1,1
sp09,92,ROOSEVELT,JAPN,JapaneseSt,0,0,0,0,0,0,0,1,1,1,1,2,1,5,6,0,0,0,2,7,9
sp09,92,ROOSEVELT,JUDA,Judaic Stu,0,0,0,0,0,0,1,0,1,0,1,1,0,0,0,0,0,0,1,1,2
sp09,92,ROOSEVELT,LATI,LatinAm St,0,0,0,0,0,0,0,0,0,0,2,2,0,2,2,0,0,0,0,4,4
sp09,92,ROOSEVELT,LING,Lang Stu,0,0,0,0,0,0,0,3,3,0,2,2,2,0,2,0,0,0,2,5,7
sp09,92,ROOSEVELT,LING,Ling-CogLn,0,0,0,0,0,0,0,0,0,0,0,0,0,1,1,0,0,0,0,1,1
sp09,92,ROOSEVELT,LING,Ling-LSoc,0,0,0,0,0,0,0,0,0,1,1,2,0,1,1,0,0,0,1,2,3
sp09,92,ROOSEVELT,LING,Linguistcs,0,0,0,0,0,0,0,2,2,1,2,3,4,5,9,0,0,0,5,9,14
sp09,92,ROOSEVELT,LIT,French Lit,0,0,0,0,0,0,0,0,0,0,0,0,0,2,2,0,0,0,0,2,2
sp09,92,ROOSEVELT,LIT,Lit/Compos,0,0,0,0,0,0,0,1,1,1,2,3,0,0,0,0,0,0,1,3,4
sp09,92,ROOSEVELT,LIT,Lit/CultSt,0,0,0,0,0,0,0,0,0,0,1,1,0,0,0,0,0,0,0,1,1
sp09,92,ROOSEVELT,LIT,Lit/Engl,0,0,0,1,4,5,1,4,5,3,4,7,2,8,10,0,0,0,7,20,27
sp09,92,ROOSEVELT,LIT,Lit/World,0,0,0,0,0,0,0,1,1,1,0,1,1,5,6,0,0,0,2,6,8
sp09,92,ROOSEVELT,LIT,Lit/Writng,0,0,0,0,0,0,0,0,0,0,1,1,5,8,13,0,0,0,5,9,14
sp09,92,ROOSEVELT,LIT,Pre-Lit/Wr,0,0,0,1,1,2,3,5,8,3,7,10,0,4,4,0,0,0,7,17,24
sp09,92,ROOSEVELT,LIT,Spanish Lt,0,0,0,0,0,0,0,0,0,0,2,2,1,1,2,0,0,0,1,3,4
sp09,92,ROOSEVELT,MAE,Aerosp Eng,0,0,0,2,0,2,4,2,6,4,1,5,11,3,14,0,0,0,21,6,27
sp09,92,ROOSEVELT,MAE,Engin Sci,0,0,0,0,0,0,1,0,1,0,0,0,2,0,2,0,0,0,3,0,3
sp09,92,ROOSEVELT,MAE,Envir Eng,0,0,0,0,0,0,2,1,3,1,2,3,1,0,1,0,0,0,4,3,7
sp09,92,ROOSEVELT,MAE,Mech Engin,0,0,0,7,0,7,9,3,12,13,0,13,25,12,37,0,0,0,54,15,69
sp09,92,ROOSEVELT,MATH,Appld Math,0,0,0,1,0,1,0,0,0,0,0,0,3,1,4,0,0,0,4,1,5
sp09,92,ROOSEVELT,MATH,Math/SecEd,0,0,0,0,1,1,0,0,0,0,0,0,1,1,2,0,0,0,1,2,3
sp09,92,ROOSEVELT,MATH,Mathematcs,0,0,0,2,1,3,0,1,1,2,0,2,2,5,7,0,0,0,6,7,13
sp09,92,ROOSEVELT,MATH,Mth-CompSc,0,0,0,0,0,0,0,0,0,1,0,1,1,1,2,0,0,0,2,1,3
sp09,92,ROOSEVELT,MATH,Mth-Mth&Ec,0,0,0,2,0,2,2,0,2,0,0,0,4,3,7,0,0,0,8,3,11
sp09,92,ROOSEVELT,MATH,Mth-SciCom,0,0,0,0,0,0,0,0,0,0,0,0,0,1,1,0,0,0,0,1,1
sp09,92,ROOSEVELT,MATH,Mth/ApldSc,0,0,0,0,0,0,0,0,0,0,0,0,2,1,3,0,0,0,2,1,3
sp09,92,ROOSEVELT,MATH,Prob&Stats,0,0,0,1,0,1,0,0,0,0,0,0,0,0,0,0,0,0,1,0,1
sp09,92,ROOSEVELT,MUS,Mu-CompArt,0,0,0,0,1,1,1,0,1,5,0,5,3,1,4,0,0,0,9,2,11
sp09,92,ROOSEVELT,MUS,Music,0,0,0,0,0,0,3,0,3,0,2,2,3,2,5,0,0,0,6,4,10
sp09,92,ROOSEVELT,PHIL,Philosophy,0,0,0,1,0,1,2,1,3,0,0,0,2,2,4,0,0,0,5,3,8
sp09,92,ROOSEVELT,PHYS,Biophysics,0,0,0,0,0,0,0,1,1,0,1,1,1,0,1,0,0,0,1,2,3
sp09,92,ROOSEVELT,PHYS,Phys/Astro,0,0,0,0,0,0,1,0,1,0,1,1,0,1,1,0,0,0,1,2,3
sp09,92,ROOSEVELT,PHYS,Phys/Comp,0,0,0,0,0,0,0,0,0,0,1,1,1,0,1,0,0,0,1,1,2
sp09,92,ROOSEVELT,PHYS,Phys/Mtrls,0,0,0,0,0,0,0,0,0,0,0,0,1,0,1,0,0,0,1,0,1
sp09,92,ROOSEVELT,PHYS,Physics,0,0,0,0,0,0,1,0,1,5,1,6,2,1,3,0,0,0,8,2,10
sp09,92,ROOSEVELT,POLI,Polit Sci,0,0,0,0,5,5,8,10,18,11,17,28,29,31,60,0,0,0,48,63,111
sp09,92,ROOSEVELT,POLI,PolSc-Amer,0,0,0,1,0,1,0,2,2,3,3,6,1,3,4,0,0,0,5,8,13
sp09,92,ROOSEVELT,POLI,PolSc-Comp,0,0,0,0,0,0,0,1,1,0,2,2,4,2,6,0,0,0,4,5,9
sp09,92,ROOSEVELT,POLI,PolSc-Intl,0,0,0,3,4,7,8,7,15,7,22,29,16,25,41,0,0,0,34,58,92
sp09,92,ROOSEVELT,POLI,PolSc-PLaw,0,0,0,2,1,3,1,3,4,7,14,21,8,8,16,0,0,0,18,26,44
sp09,92,ROOSEVELT,POLI,PolSc-PPol,0,0,0,0,0,0,0,2,2,0,1,1,3,1,4,0,0,0,3,4,7
sp09,92,ROOSEVELT,POLI,PolSc-Thry,0,0,0,0,0,0,0,0,0,0,1,1,1,3,4,0,0,0,1,4,5
sp09,92,ROOSEVELT,PSYC,Psychology,0,0,0,4,9,13,10,38,48,17,57,74,16,65,81,0,0,0,47,169,216
sp09,92,ROOSEVELT,RELI,Relig/Stu,0,0,0,0,1,1,0,0,0,0,0,0,1,0,1,0,0,0,1,1,2
sp09,92,ROOSEVELT,RUSS,Russ&SovSt,0,0,0,0,0,0,1,0,1,0,0,0,1,1,2,0,0,0,2,1,3
sp09,92,ROOSEVELT,SE,Engin Sci,0,0,0,0,1,1,0,0,0,0,0,0,0,0,0,0,0,0,0,1,1
sp09,92,ROOSEVELT,SE,Struct Eng,0,0,0,6,0,6,8,0,8,12,6,18,16,7,23,0,0,0,42,13,55
sp09,92,ROOSEVELT,SIO,ErSc-Geol,0,0,0,0,0,0,1,2,3,0,0,0,0,0,0,0,0,0,1,2,3
sp09,92,ROOSEVELT,SOC,Sociology,0,0,0,1,1,2,1,7,8,9,19,28,3,27,30,0,0,0,14,54,68
sp09,92,ROOSEVELT,THEA,Dance,0,0,0,0,0,0,0,0,0,0,0,0,0,1,1,0,0,0,0,1,1
sp09,92,ROOSEVELT,THEA,Theatre,0,0,0,0,2,2,0,5,5,3,4,7,2,7,9,0,0,0,5,18,23
sp09,92,ROOSEVELT,TWS,ThirdWldSt,0,0,0,0,1,1,0,1,1,0,4,4,0,3,3,0,0,0,0,9,9
sp09,92,ROOSEVELT,UNAF,Limited St,0,0,0,0,0,0,0,0,0,0,0,0,0,0,0,0,1,1,0,1,1
sp09,92,ROOSEVELT,UNAF,UndecHumAr,0,0,0,0,1,1,0,8,8,0,2,2,0,0,0,0,0,0,0,11,11
sp09,92,ROOSEVELT,UNAF,Undeclared,0,0,0,12,11,23,14,38,52,1,3,4,0,0,0,0,0,0,27,52,79
sp09,92,ROOSEVELT,UNAF,UndecPhysS,0,0,0,1,0,1,4,1,5,0,0,0,0,0,0,0,0,0,5,1,6
sp09,92,ROOSEVELT,UNAF,UndecSocSc,0,0,0,0,0,0,2,6,8,1,0,1,0,0,0,0,0,0,3,6,9
sp09,92,ROOSEVELT,USP,Urb Stu&Pl,0,0,0,1,0,1,0,5,5,3,8,11,8,6,14,0,0,0,12,19,31
sp09,92,ROOSEVELT,VIS,Art Hst/Cr,0,0,0,0,0,0,0,1,1,2,5,7,0,11,11,0,0,0,2,17,19
sp09,92,ROOSEVELT,VIS,Media,0,0,0,0,0,0,1,8,9,8,6,14,9,9,18,0,0,0,18,23,41
sp09,92,ROOSEVELT,VIS,Studio VA,0,0,0,0,3,3,1,1,2,1,8,9,1,1,2,0,0,0,3,13,16
sp09,92,ROOSEVELT,VIS,VA-CompArt,0,0,0,1,1,2,0,0,0,1,3,4,1,1,2,0,0,0,3,5,8
sp09,92,SIXTH,ANTH,Anth-Arch,0,0,0,0,0,0,0,0,0,2,1,3,2,1,3,0,0,0,4,2,6
sp09,92,SIXTH,ANTH,Anth-Biol,0,0,0,0,1,1,0,1,1,0,2,2,3,4,7,0,0,0,3,8,11
sp09,92,SIXTH,ANTH,Anth-Soci,0,0,0,0,0,0,0,1,1,0,2,2,2,2,4,0,0,0,2,5,7
sp09,92,SIXTH,ANTH,Anthropol,0,0,0,0,0,0,0,0,0,0,0,0,0,2,2,0,0,0,0,2,2
sp09,92,SIXTH,BENG,Bioen:Binf,0,0,0,0,0,0,0,0,0,1,0,1,3,0,3,0,0,0,4,0,4
sp09,92,SIXTH,BENG,Bioeng:PM,0,0,0,0,0,0,0,0,0,4,0,4,7,5,12,0,0,0,11,5,16
sp09,92,SIXTH,BENG,BioengBiot,0,0,0,3,0,3,4,2,6,3,0,3,6,4,10,0,0,0,16,6,22
sp09,92,SIXTH,BENG,Bioengin,0,0,0,0,0,0,3,1,4,1,0,1,9,4,13,0,0,0,13,5,18
sp09,92,SIXTH,BENG,Pr-BioenPM,0,0,0,1,0,1,3,3,6,5,0,5,2,0,2,0,0,0,11,3,14
sp09,92,SIXTH,BIOL,Anml Physl,0,0,0,0,0,0,0,0,0,0,1,1,1,1,2,0,0,0,1,2,3
sp09,92,SIXTH,BIOL,Bioc/CellB,0,0,0,2,5,7,9,9,18,22,15,37,29,39,68,0,0,0,62,68,130
sp09,92,SIXTH,BIOL,BiolBioinf,0,0,0,0,0,0,1,0,1,0,0,0,1,0,1,0,0,0,2,0,2
sp09,92,SIXTH,BIOL,Ec/Beh/Evo,0,0,0,0,1,1,2,3,5,1,11,12,3,5,8,0,0,0,6,20,26
sp09,92,SIXTH,BIOL,Genl Biol,0,0,0,4,4,8,7,10,17,22,32,54,17,22,39,0,0,0,50,68,118
sp09,92,SIXTH,BIOL,Human Bio,0,0,0,18,16,34,26,37,63,34,34,68,34,51,85,0,0,0,112,138,250
sp09,92,SIXTH,BIOL,Microbiol,0,0,0,1,0,1,1,1,2,4,3,7,3,1,4,0,0,0,9,5,14
sp09,92,SIXTH,BIOL,Molec Biol,0,0,0,0,0,0,1,2,3,7,6,13,5,4,9,0,0,0,13,12,25
sp09,92,SIXTH,BIOL,PhyslNeuro,0,0,0,0,4,4,6,3,9,4,8,12,16,9,25,0,0,0,26,24,50
sp09,92,SIXTH,CENG,Chem Engin,0,0,0,1,0,1,4,0,4,8,1,9,7,5,12,0,0,0,20,6,26
sp09,92,SIXTH,CGS,CritGendSt,0,0,0,0,0,0,0,0,0,0,0,0,0,1,1,0,0,0,0,1,1
sp09,92,SIXTH,CHEM,Bioch/Chem,0,0,0,2,1,3,4,6,10,2,3,5,8,8,16,0,0,0,16,18,34
sp09,92,SIXTH,CHEM,Chem Educ,0,0,0,0,0,0,1,0,1,0,0,0,0,0,0,0,0,0,1,0,1
sp09,92,SIXTH,CHEM,Chemistry,0,0,0,0,0,0,1,2,3,8,2,10,4,3,7,0,0,0,13,7,20
sp09,92,SIXTH,CHEM,Envir Chem,0,0,0,0,0,0,0,0,0,0,0,0,1,1,2,0,0,0,1,1,2
sp09,92,SIXTH,CHEM,MolecSynth,0,0,0,0,0,0,0,0,0,0,1,1,2,0,2,0,0,0,2,1,3
sp09,92,SIXTH,CHEM,Pharm Chem,0,0,0,1,4,5,3,6,9,3,8,11,11,8,19,0,0,0,18,26,44
sp09,92,SIXTH,CLAS,Classic St,0,0,0,0,0,0,0,1,1,1,0,1,0,0,0,0,0,0,1,1,2
sp09,92,SIXTH,COGS,Cog Sci,0,0,0,1,0,1,3,1,4,6,4,10,6,3,9,0,0,0,16,8,24
sp09,92,SIXTH,COGS,CogSc/Comp,0,0,0,0,0,0,0,0,0,0,0,0,2,0,2,0,0,0,2,0,2
sp09,92,SIXTH,COGS,CogSc/HCI,0,0,0,0,0,0,0,0,0,2,2,4,8,2,10,0,0,0,10,4,14
sp09,92,SIXTH,COGS,CogSc/HCog,0,0,0,0,0,0,0,0,0,0,0,0,1,1,2,0,0,0,1,1,2
sp09,92,SIXTH,COGS,CogSc/Neur,0,0,0,0,0,0,1,1,2,1,2,3,2,1,3,0,0,0,4,4,8
sp09,92,SIXTH,COMM,Communic,0,0,0,1,4,5,6,17,23,14,34,48,21,40,61,0,0,0,42,95,137
sp09,92,SIXTH,CSE,Comp Sci,0,0,0,6,2,8,14,6,20,22,6,28,39,10,49,0,0,0,81,24,105
sp09,92,SIXTH,CSE,CompEngCSE,0,0,0,2,0,2,9,0,9,10,0,10,12,2,14,0,0,0,33,2,35
sp09,92,SIXTH,CSE,CompScBinf,0,0,0,0,0,0,2,0,2,1,0,1,0,1,1,0,0,0,3,1,4
sp09,92,SIXTH,ECE,CompEngECE,0,0,0,2,0,2,4,0,4,4,1,5,5,0,5,0,0,0,15,1,16
sp09,92,SIXTH,ECE,Electr Eng,0,0,0,3,2,5,10,2,12,22,3,25,30,4,34,0,0,0,65,11,76
sp09,92,SIXTH,ECE,Engin Phys,0,0,0,0,0,0,0,0,0,0,0,0,1,0,1,0,0,0,1,0,1
sp09,92,SIXTH,ECE,Pr-EngPhys,0,0,0,0,0,0,0,0,0,0,1,1,1,0,1,0,0,0,1,1,2
sp09,92,SIXTH,ECON,Ec-Mth&Ecn,0,0,0,0,2,2,1,1,2,5,0,5,4,2,6,0,0,0,10,5,15
sp09,92,SIXTH,ECON,Econ-MgtSc,0,0,0,2,2,4,16,8,24,36,23,59,47,18,65,0,0,0,101,51,152
sp09,92,SIXTH,ECON,Economics,0,0,0,10,2,12,21,10,31,48,29,77,54,35,89,0,0,0,133,76,209
sp09,92,SIXTH,ESYS,EnvSys(EB),0,0,0,0,1,1,0,2,2,3,3,6,4,5,9,0,0,0,7,11,18
sp09,92,SIXTH,ESYS,EnvSys(EC),0,0,0,0,0,0,0,0,0,1,0,1,1,0,1,0,0,0,2,0,2
sp09,92,SIXTH,ESYS,EnvSys(EP),0,0,0,0,1,1,0,1,1,1,1,2,1,2,3,0,0,0,2,5,7
sp09,92,SIXTH,ESYS,EnvSys(ES),0,0,0,0,0,0,0,0,0,0,1,1,0,2,2,0,0,0,0,3,3
sp09,92,SIXTH,ETHN,Ethnic St,0,0,0,0,0,0,1,1,2,3,2,5,3,8,11,0,0,0,7,11,18
sp09,92,SIXTH,GMST,German Stu,0,0,0,0,0,0,0,0,0,0,1,1,0,0,0,0,0,0,0,1,1
sp09,92,SIXTH,HDP,Human Dev,0,0,0,0,0,0,0,2,2,1,6,7,0,5,5,0,0,0,1,13,14
sp09,92,SIXTH,HDP,Pr-HumnDev,0,0,0,0,6,6,0,4,4,0,7,7,1,1,2,0,0,0,1,18,19
sp09,92,SIXTH,HIST,History,0,0,0,2,0,2,0,0,0,6,4,10,5,2,7,0,0,0,13,6,19
sp09,92,SIXTH,INTL,IntSt-Anth,0,0,0,0,0,0,1,0,1,0,0,0,3,0,3,0,0,0,4,0,4
sp09,92,SIXTH,INTL,IntSt-Econ,0,0,0,0,0,0,3,6,9,8,8,16,8,9,17,0,0,0,19,23,42
sp09,92,SIXTH,INTL,IntSt-Hist,0,0,0,0,0,0,1,0,1,1,4,5,1,0,1,0,0,0,3,4,7
sp09,92,SIXTH,INTL,IntSt-Ling,0,0,0,0,0,0,0,0,0,4,1,5,0,0,0,0,0,0,4,1,5
sp09,92,SIXTH,INTL,IntSt-Lit,0,0,0,0,0,0,0,0,0,0,0,0,0,2,2,0,0,0,0,2,2
sp09,92,SIXTH,INTL,IntSt-PolS,0,0,0,0,0,0,2,4,6,8,7,15,4,7,11,0,0,0,14,18,32
sp09,92,SIXTH,INTL,IntSt-Soc,0,0,0,0,1,1,0,2,2,1,2,3,2,3,5,0,0,0,3,8,11
sp09,92,SIXTH,ITAL,Italian St,0,0,0,0,0,0,0,1,1,0,1,1,0,0,0,0,0,0,0,2,2
sp09,92,SIXTH,JAPN,JapaneseSt,0,0,0,0,1,1,0,0,0,2,0,2,1,2,3,0,0,0,3,3,6
sp09,92,SIXTH,LATI,LatinAm St,0,0,0,0,0,0,0,0,0,0,0,0,1,0,1,0,0,0,1,0,1
sp09,92,SIXTH,LING,Lang Stu,0,0,0,1,0,1,0,0,0,0,0,0,0,1,1,0,0,0,1,1,2
sp09,92,SIXTH,LING,Ling-CogLn,0,0,0,0,1,1,0,0,0,0,2,2,1,1,2,0,0,0,1,4,5
sp09,92,SIXTH,LING,Ling-LSoc,0,0,0,0,0,0,0,0,0,0,0,0,1,1,2,0,0,0,1,1,2
sp09,92,SIXTH,LING,Linguistcs,0,0,0,0,0,0,0,1,1,1,0,1,0,3,3,0,0,0,1,4,5
sp09,92,SIXTH,LIT,French Lit,0,0,0,0,0,0,0,0,0,0,1,1,0,0,0,0,0,0,0,1,1
sp09,92,SIXTH,LIT,Lit/Compos,0,0,0,0,0,0,0,0,0,0,0,0,0,1,1,0,0,0,0,1,1
sp09,92,SIXTH,LIT,Lit/CultSt,0,0,0,0,0,0,0,1,1,1,1,2,0,1,1,0,0,0,1,3,4
sp09,92,SIXTH,LIT,Lit/Engl,0,0,0,0,1,1,1,0,1,1,4,5,1,1,2,0,0,0,3,6,9
sp09,92,SIXTH,LIT,Lit/World,0,0,0,0,0,0,0,1,1,0,1,1,1,0,1,0,0,0,1,2,3
sp09,92,SIXTH,LIT,Lit/Writng,0,0,0,0,0,0,0,0,0,0,3,3,3,7,10,0,0,0,3,10,13
sp09,92,SIXTH,LIT,Pre-Lit/Wr,0,0,0,0,2,2,3,5,8,3,3,6,2,1,3,0,0,0,8,11,19
sp09,92,SIXTH,LIT,Spanish Lt,0,0,0,0,0,0,0,1,1,0,0,0,1,0,1,0,0,0,1,1,2
sp09,92,SIXTH,MAE,Aerosp Eng,0,0,0,6,1,7,16,0,16,12,3,15,28,3,31,0,0,0,62,7,69
sp09,92,SIXTH,MAE,Engin Sci,0,0,0,0,0,0,1,0,1,0,1,1,0,0,0,0,0,0,1,1,2
sp09,92,SIXTH,MAE,Envir Eng,0,0,0,3,0,3,0,4,4,1,0,1,1,3,4,0,0,0,5,7,12
sp09,92,SIXTH,MAE,Mech Engin,0,0,0,7,2,9,24,4,28,28,6,34,59,9,68,0,0,0,118,21,139
sp09,92,SIXTH,MATH,Appld Math,0,0,0,0,0,0,2,1,3,1,0,1,2,2,4,0,0,0,5,3,8
sp09,92,SIXTH,MATH,Math/SecEd,0,0,0,1,0,1,1,1,2,0,3,3,0,1,1,0,0,0,2,5,7
sp09,92,SIXTH,MATH,Mathematcs,0,0,0,1,1,2,4,0,4,3,2,5,4,1,5,0,0,0,12,4,16
sp09,92,SIXTH,MATH,Mth-CompSc,0,0,0,0,0,0,0,0,0,1,0,1,1,0,1,0,0,0,2,0,2
sp09,92,SIXTH,MATH,Mth-Mth&Ec,0,0,0,1,1,2,0,0,0,1,2,3,2,1,3,0,0,0,4,4,8
sp09,92,SIXTH,MATH,Mth/ApldSc,0,0,0,2,0,2,0,0,0,0,0,0,0,0,0,0,0,0,2,0,2
sp09,92,SIXTH,MATH,Pr-Math CS,0,0,0,0,0,0,1,0,1,1,0,1,0,0,0,0,0,0,2,0,2
sp09,92,SIXTH,MUS,Mu-CompArt,0,0,0,2,4,6,2,0,2,7,1,8,6,3,9,0,0,0,17,8,25
sp09,92,SIXTH,MUS,Music,0,0,0,0,0,0,1,1,2,3,0,3,6,6,12,0,0,0,10,7,17
sp09,92,SIXTH,MUS,Music Hum,0,0,0,0,0,0,0,0,0,0,0,0,0,1,1,0,0,0,0,1,1
sp09,92,SIXTH,PHIL,Philosophy,0,0,0,1,0,1,0,0,0,3,0,3,2,4,6,0,0,0,6,4,10
sp09,92,SIXTH,PHYS,Biophysics,0,0,0,0,0,0,1,0,1,1,0,1,2,0,2,0,0,0,4,0,4
sp09,92,SIXTH,PHYS,GenPys/SEd,0,0,0,0,0,0,0,0,0,1,0,1,0,0,0,0,0,0,1,0,1
sp09,92,SIXTH,PHYS,Phys/Astro,0,0,0,0,0,0,1,0,1,1,0,1,1,1,2,0,0,0,3,1,4
sp09,92,SIXTH,PHYS,Phys/Comp,0,0,0,0,0,0,1,0,1,0,0,0,0,0,0,0,0,0,1,0,1
sp09,92,SIXTH,PHYS,Phys/Mtrls,0,0,0,0,0,0,0,0,0,0,1,1,1,0,1,0,0,0,1,1,2
sp09,92,SIXTH,PHYS,Physics,0,0,0,0,0,0,2,0,2,3,0,3,5,1,6,0,0,0,10,1,11
sp09,92,SIXTH,POLI,Polit Sci,0,0,0,0,0,0,3,4,7,20,9,29,8,8,16,0,0,0,31,21,52
sp09,92,SIXTH,POLI,PolSc-Amer,0,0,0,0,0,0,1,2,3,3,1,4,3,2,5,0,0,0,7,5,12
sp09,92,SIXTH,POLI,PolSc-Comp,0,0,0,0,1,1,0,0,0,0,0,0,0,1,1,0,0,0,0,2,2
sp09,92,SIXTH,POLI,PolSc-Intl,0,0,0,0,0,0,5,3,8,11,5,16,13,8,21,0,0,0,29,16,45
sp09,92,SIXTH,POLI,PolSc-PLaw,0,0,0,0,1,1,4,2,6,5,4,9,1,3,4,0,0,0,10,10,20
sp09,92,SIXTH,POLI,PolSc-PPol,0,0,0,0,0,0,1,0,1,0,0,0,1,1,2,0,0,0,2,1,3
sp09,92,SIXTH,POLI,PolSc-Thry,0,0,0,0,0,0,1,0,1,0,0,0,1,1,2,0,0,0,2,1,3
sp09,92,SIXTH,PSYC,Psychology,0,0,0,2,7,9,14,18,32,21,48,69,25,38,63,0,0,0,62,111,173
sp09,92,SIXTH,SE,Engin Sci,0,0,0,0,0,0,0,1,1,0,0,0,0,0,0,0,0,0,0,1,1
sp09,92,SIXTH,SE,Struct Eng,0,0,0,4,2,6,11,5,16,11,8,19,23,11,34,0,0,0,49,26,75
sp09,92,SIXTH,SIO,ErSc-Geol,0,0,0,0,0,0,0,0,0,1,0,1,0,0,0,0,0,0,1,0,1
sp09,92,SIXTH,SOC,Sociology,0,0,0,0,0,0,1,6,7,4,23,27,6,13,19,0,0,0,11,42,53
sp09,92,SIXTH,THEA,Dance,0,0,0,0,0,0,0,0,0,0,2,2,1,3,4,0,0,0,1,5,6
sp09,92,SIXTH,THEA,Theatre,0,0,0,0,1,1,1,0,1,1,2,3,2,8,10,0,0,0,4,11,15
sp09,92,SIXTH,TWS,ThirdWldSt,0,0,0,0,0,0,0,0,0,0,1,1,0,0,0,0,0,0,0,1,1
sp09,92,SIXTH,UNAF,Limited St,0,0,0,0,0,0,0,0,0,0,0,0,0,0,0,1,0,1,1,0,1
sp09,92,SIXTH,UNAF,UndecHumAr,0,0,0,0,1,1,0,2,2,0,0,0,0,0,0,0,0,0,0,3,3
sp09,92,SIXTH,UNAF,Undeclared,0,0,0,13,12,25,17,20,37,0,1,1,0,0,0,0,0,0,30,33,63
sp09,92,SIXTH,UNAF,UndecPhysS,0,0,0,0,3,3,0,2,2,0,0,0,0,0,0,0,0,0,0,5,5
sp09,92,SIXTH,UNAF,UndecSocSc,0,0,0,1,2,3,0,4,4,0,0,0,0,0,0,0,0,0,1,6,7
sp09,92,SIXTH,USP,Urb Stu&Pl,0,0,0,1,0,1,0,2,2,6,3,9,4,3,7,0,0,0,11,8,19
sp09,92,SIXTH,VIS,Art Hst/Cr,0,0,0,0,0,0,0,1,1,0,8,8,2,9,11,0,0,0,2,18,20
sp09,92,SIXTH,VIS,Media,0,0,0,3,4,7,7,4,11,14,18,32,15,13,28,0,0,0,39,39,78
sp09,92,SIXTH,VIS,Studio VA,0,0,0,0,2,2,0,1,1,5,5,10,5,10,15,0,0,0,10,18,28
sp09,92,SIXTH,VIS,VA-CompArt,0,0,0,0,0,0,7,1,8,9,6,15,3,5,8,0,0,0,19,12,31
sp09,92,WARREN,ANTH,Anth-Arch,0,0,0,0,0,0,0,2,2,0,2,2,1,4,5,0,0,0,1,8,9
sp09,92,WARREN,ANTH,Anth-Biol,0,0,0,0,1,1,0,0,0,0,3,3,1,9,10,0,0,0,1,13,14
sp09,92,WARREN,ANTH,Anth-Soci,0,0,0,0,0,0,1,0,1,0,5,5,0,2,2,0,0,0,1,7,8
sp09,92,WARREN,ANTH,Anthropol,0,0,0,0,0,0,0,0,0,0,0,0,1,1,2,0,0,0,1,1,2
sp09,92,WARREN,BENG,Bioen:Binf,0,0,0,0,0,0,2,1,3,0,1,1,2,2,4,0,0,0,4,4,8
sp09,92,WARREN,BENG,Bioeng:PM,0,0,0,0,0,0,0,0,0,9,8,17,31,12,43,0,0,0,40,20,60
sp09,92,WARREN,BENG,BioengBiot,0,0,0,1,1,2,13,3,16,9,1,10,25,13,38,0,0,0,48,18,66
sp09,92,WARREN,BENG,Bioengin,0,0,0,2,0,2,11,5,16,7,4,11,18,9,27,0,0,0,38,18,56
sp09,92,WARREN,BENG,Pr-BioenPM,0,0,0,2,0,2,10,10,20,5,1,6,2,1,3,0,0,0,19,12,31
sp09,92,WARREN,BIOL,Anml Physl,0,0,0,0,0,0,0,1,1,0,0,0,0,1,1,0,0,0,0,2,2
sp09,92,WARREN,BIOL,Bioc/CellB,0,0,0,4,4,8,9,12,21,31,35,66,72,73,145,0,0,0,116,124,240
sp09,92,WARREN,BIOL,BiolBioinf,0,0,0,0,0,0,1,0,1,0,0,0,1,0,1,0,0,0,2,0,2
sp09,92,WARREN,BIOL,Ec/Beh/Evo,0,0,0,0,0,0,6,1,7,3,8,11,4,8,12,0,0,0,13,17,30
sp09,92,WARREN,BIOL,Genl Biol,0,0,0,1,4,5,7,17,24,19,25,44,48,66,114,0,0,0,75,112,187
sp09,92,WARREN,BIOL,Human Bio,1,0,1,9,16,25,19,54,73,41,59,100,55,97,152,0,0,0,125,226,351
sp09,92,WARREN,BIOL,Microbiol,0,0,0,0,1,1,0,2,2,4,5,9,9,7,16,0,0,0,13,15,28
sp09,92,WARREN,BIOL,Molec Biol,0,0,0,2,0,2,1,3,4,7,10,17,12,7,19,0,0,0,22,20,42
sp09,92,WARREN,BIOL,PhyslNeuro,0,0,0,1,3,4,10,15,25,8,19,27,19,23,42,0,0,0,38,60,98
sp09,92,WARREN,CENG,Chem Engin,0,0,0,3,0,3,12,1,13,14,6,20,26,13,39,0,0,0,55,20,75
sp09,92,WARREN,CGS,CritGendSt,0,0,0,0,0,0,0,1,1,0,2,2,0,1,1,0,0,0,0,4,4
sp09,92,WARREN,CHEM,Bioch/Chem,0,0,0,0,0,0,3,5,8,9,8,17,16,22,38,0,0,0,28,35,63
sp09,92,WARREN,CHEM,Chem Phys,0,0,0,0,0,0,0,0,0,1,0,1,1,1,2,0,0,0,2,1,3
sp09,92,WARREN,CHEM,Chemistry,0,0,0,1,0,1,1,1,2,5,4,9,6,5,11,0,0,0,13,10,23
sp09,92,WARREN,CHEM,Chm/ErthSc,0,0,0,0,0,0,1,0,1,0,0,0,0,0,0,0,0,0,1,0,1
sp09,92,WARREN,CHEM,Envir Chem,0,0,0,0,0,0,1,0,1,0,0,0,1,0,1,0,0,0,2,0,2
sp09,92,WARREN,CHEM,MolecSynth,0,0,0,0,0,0,1,0,1,2,0,2,2,1,3,0,0,0,5,1,6
sp09,92,WARREN,CHEM,Pharm Chem,0,0,0,0,0,0,1,5,6,4,13,17,15,26,41,0,0,0,20,44,64
sp09,92,WARREN,CHIN,Chinese St,0,0,0,0,0,0,0,0,0,0,1,1,0,5,5,0,0,0,0,6,6
sp09,92,WARREN,COGS,Cog Sci,0,0,0,0,1,1,1,1,2,4,5,9,7,6,13,0,0,0,12,13,25
sp09,92,WARREN,COGS,CogSc/ClAs,0,0,0,0,0,0,0,1,1,0,1,1,0,0,0,0,0,0,0,2,2
sp09,92,WARREN,COGS,CogSc/Clin,0,0,0,0,0,0,0,0,0,0,1,1,0,0,0,0,0,0,0,1,1
sp09,92,WARREN,COGS,CogSc/HCI,0,0,0,0,0,0,1,1,2,2,0,2,2,1,3,0,0,0,5,2,7
sp09,92,WARREN,COGS,CogSc/HCog,0,0,0,0,0,0,0,0,0,1,0,1,0,1,1,0,0,0,1,1,2
sp09,92,WARREN,COGS,CogSc/Neur,0,0,0,0,0,0,2,3,5,5,1,6,1,3,4,0,0,0,8,7,15
sp09,92,WARREN,COMM,Communic,0,0,0,0,5,5,2,12,14,16,28,44,18,45,63,0,0,0,36,90,126
sp09,92,WARREN,CSE,Comp Sci,1,0,1,6,1,7,15,8,23,34,5,39,45,13,58,0,0,0,101,27,128
sp09,92,WARREN,CSE,CompEngCSE,0,0,0,4,1,5,15,0,15,13,2,15,11,5,16,0,0,0,43,8,51
sp09,92,WARREN,CSE,CompScBinf,0,0,0,0,0,0,0,0,0,0,0,0,3,0,3,0,0,0,3,0,3
sp09,92,WARREN,ECE,CompEngECE,0,0,0,0,0,0,6,1,7,2,0,2,7,0,7,0,0,0,15,1,16
sp09,92,WARREN,ECE,Electr Eng,0,0,0,1,1,2,9,2,11,25,4,29,76,10,86,0,0,0,111,17,128
sp09,92,WARREN,ECE,Engin Phys,0,0,0,0,0,0,0,0,0,0,0,0,3,0,3,0,0,0,3,0,3
sp09,92,WARREN,ECE,Pr-EngPhys,0,0,0,2,0,2,3,0,3,2,0,2,2,0,2,0,0,0,9,0,9
sp09,92,WARREN,ECON,Ec-Mth&Ecn,0,0,0,0,0,0,9,2,11,4,1,5,6,4,10,0,0,0,19,7,26
sp09,92,WARREN,ECON,Econ-MgtSc,0,0,0,3,0,3,10,14,24,31,19,50,51,41,92,0,0,0,95,74,169
sp09,92,WARREN,ECON,Economics,0,0,0,5,5,10,12,9,21,47,20,67,80,41,121,0,0,0,144,75,219
sp09,92,WARREN,ESYS,EnvSys(EB),0,0,0,0,0,0,0,1,1,0,2,2,2,2,4,0,0,0,2,5,7
sp09,92,WARREN,ESYS,EnvSys(EC),0,0,0,0,0,0,0,0,0,1,0,1,1,1,2,0,0,0,2,1,3
sp09,92,WARREN,ESYS,EnvSys(EP),0,0,0,0,0,0,0,0,0,1,1,2,0,2,2,0,0,0,1,3,4
sp09,92,WARREN,ESYS,EnvSys(ES),0,0,0,0,0,0,1,0,1,0,0,0,1,2,3,0,0,0,2,2,4
sp09,92,WARREN,ETHN,Ethnic St,0,0,0,0,1,1,0,2,2,1,0,1,1,2,3,0,0,0,2,5,7
sp09,92,WARREN,GMST,German Stu,0,0,0,0,0,0,0,0,0,1,0,1,1,0,1,0,0,0,2,0,2
sp09,92,WARREN,HDP,Human Dev,0,0,0,0,0,0,1,0,1,0,3,3,5,24,29,0,0,0,6,27,33
sp09,92,WARREN,HDP,Pr-HumnDev,0,0,0,0,0,0,2,2,4,0,3,3,1,5,6,0,0,0,3,10,13
sp09,92,WARREN,HIST,History,0,0,0,0,0,0,1,3,4,18,9,27,12,20,32,0,0,0,31,32,63
sp09,92,WARREN,INTD,Wa Ind St,0,0,0,0,0,0,0,0,0,0,0,0,0,1,1,0,0,0,0,1,1
sp09,92,WARREN,INTL,Int-5yrPS,0,0,0,0,0,0,0,0,0,0,1,1,0,0,0,0,0,0,0,1,1
sp09,92,WARREN,INTL,IntSt-Anth,0,0,0,0,0,0,0,2,2,0,3,3,1,0,1,0,0,0,1,5,6
sp09,92,WARREN,INTL,IntSt-Econ,0,0,0,2,2,4,4,1,5,7,3,10,3,12,15,0,0,0,16,18,34
sp09,92,WARREN,INTL,IntSt-Hist,0,0,0,0,0,0,0,0,0,0,2,2,3,2,5,0,0,0,3,4,7
sp09,92,WARREN,INTL,IntSt-Ling,0,0,0,0,0,0,0,1,1,0,2,2,1,0,1,0,0,0,1,3,4
sp09,92,WARREN,INTL,IntSt-Lit,0,0,0,0,0,0,0,0,0,0,0,0,1,0,1,0,0,0,1,0,1
sp09,92,WARREN,INTL,IntSt-PolS,0,0,0,0,2,2,1,3,4,7,6,13,3,7,10,0,0,0,11,18,29
sp09,92,WARREN,INTL,IntSt-Soc,0,0,0,0,1,1,0,0,0,0,6,6,1,6,7,0,0,0,1,13,14
sp09,92,WARREN,ITAL,Italian St,0,0,0,0,0,0,0,0,0,0,0,0,1,0,1,0,0,0,1,0,1
sp09,92,WARREN,JAPN,JapaneseSt,0,0,0,0,0,0,0,0,0,1,0,1,1,1,2,0,0,0,2,1,3
sp09,92,WARREN,LATI,LatinAm St,0,0,0,0,0,0,0,0,0,0,0,0,0,1,1,0,0,0,0,1,1
sp09,92,WARREN,LING,Lang Stu,0,0,0,0,0,0,0,0,0,0,1,1,0,1,1,0,0,0,0,2,2
sp09,92,WARREN,LING,Ling-CogLn,0,0,0,0,0,0,0,2,2,0,0,0,1,0,1,0,0,0,1,2,3
sp09,92,WARREN,LING,Ling-LSoc,0,0,0,0,0,0,0,0,0,1,0,1,0,0,0,0,0,0,1,0,1
sp09,92,WARREN,LING,Linguistcs,0,0,0,0,0,0,0,1,1,1,2,3,0,1,1,0,0,0,1,4,5
sp09,92,WARREN,LIT,French Lit,0,0,0,0,0,0,0,0,0,1,0,1,0,0,0,0,0,0,1,0,1
sp09,92,WARREN,LIT,German Lit,0,0,0,0,0,0,0,0,0,0,0,0,0,1,1,0,0,0,0,1,1
sp09,92,WARREN,LIT,Lit/CultSt,0,0,0,0,0,0,0,0,0,0,2,2,0,0,0,0,0,0,0,2,2
sp09,92,WARREN,LIT,Lit/Engl,0,0,0,0,0,0,1,2,3,1,3,4,1,4,5,0,0,0,3,9,12
sp09,92,WARREN,LIT,Lit/World,0,0,0,0,0,0,0,1,1,0,0,0,0,2,2,0,0,0,0,3,3
sp09,92,WARREN,LIT,Lit/Writng,0,0,0,0,0,0,0,0,0,0,2,2,1,6,7,0,0,0,1,8,9
sp09,92,WARREN,LIT,Pre-Lit/Wr,0,0,0,0,0,0,1,3,4,3,6,9,0,2,2,0,0,0,4,11,15
sp09,92,WARREN,LIT,Spanish Lt,0,0,0,0,0,0,0,0,0,0,1,1,4,3,7,0,0,0,4,4,8
sp09,92,WARREN,MAE,Aerosp Eng,0,0,0,4,3,7,8,2,10,13,0,13,50,5,55,0,0,0,75,10,85
sp09,92,WARREN,MAE,Engin Sci,0,0,0,0,0,0,0,0,0,0,1,1,1,0,1,0,0,0,1,1,2
sp09,92,WARREN,MAE,Envir Eng,0,0,0,0,1,1,4,1,5,0,2,2,5,4,9,0,0,0,9,8,17
sp09,92,WARREN,MAE,Mech Engin,0,0,0,6,1,7,36,4,40,49,5,54,106,13,119,0,0,0,197,23,220
sp09,92,WARREN,MATH,Appld Math,0,0,0,0,1,1,0,0,0,5,3,8,2,6,8,0,0,0,7,10,17
sp09,92,WARREN,MATH,Math/SecEd,0,0,0,0,0,0,0,0,0,2,0,2,1,3,4,0,0,0,3,3,6
sp09,92,WARREN,MATH,Mathematcs,0,0,0,0,2,2,1,0,1,7,5,12,10,5,15,0,0,0,18,12,30
sp09,92,WARREN,MATH,Mth-CompSc,0,0,0,0,0,0,0,0,0,0,0,0,6,1,7,0,0,0,6,1,7
sp09,92,WARREN,MATH,Mth-Mth&Ec,0,0,0,0,0,0,0,0,0,2,3,5,5,3,8,0,0,0,7,6,13
sp09,92,WARREN,MATH,Mth-SciCom,0,0,0,0,0,0,0,0,0,0,0,0,2,2,4,0,0,0,2,2,4
sp09,92,WARREN,MATH,Mth/ApldSc,0,0,0,1,0,1,0,0,0,0,0,0,1,0,1,0,0,0,2,0,2
sp09,92,WARREN,MATH,Pr-Math CS,0,0,0,0,0,0,1,0,1,1,0,1,0,0,0,0,0,0,2,0,2
sp09,92,WARREN,MATH,Prob&Stats,0,0,0,0,0,0,1,0,1,3,1,4,6,3,9,0,0,0,10,4,14
sp09,92,WARREN,MUS,Mu-CompArt,0,0,0,0,0,0,1,0,1,3,0,3,7,3,10,0,0,0,11,3,14
sp09,92,WARREN,MUS,Music,0,0,0,0,0,0,0,1,1,3,0,3,7,1,8,0,0,0,10,2,12
sp09,92,WARREN,MUS,Music Hum,0,0,0,0,0,0,0,0,0,0,0,0,0,1,1,0,0,0,0,1,1
sp09,92,WARREN,PHIL,Philosophy,0,0,0,1,0,1,2,0,2,7,3,10,7,5,12,0,0,0,17,8,25
sp09,92,WARREN,PHYS,Biophysics,0,0,0,0,0,0,0,0,0,1,0,1,6,1,7,0,0,0,7,1,8
sp09,92,WARREN,PHYS,Gen Physcs,0,0,0,0,0,0,0,0,0,0,0,0,1,0,1,0,0,0,1,0,1
sp09,92,WARREN,PHYS,Phys/Astro,0,0,0,1,0,1,3,1,4,1,0,1,4,0,4,0,0,0,9,1,10
sp09,92,WARREN,PHYS,Phys/Comp,0,0,0,0,0,0,0,0,0,0,0,0,1,0,1,0,0,0,1,0,1
sp09,92,WARREN,PHYS,Phys/Mtrls,0,0,0,0,0,0,0,0,0,0,0,0,2,0,2,0,0,0,2,0,2
sp09,92,WARREN,PHYS,Physics,0,0,0,0,0,0,1,0,1,6,0,6,3,1,4,0,0,0,10,1,11
sp09,92,WARREN,POLI,Polit Sci,0,0,0,0,2,2,8,9,17,21,17,38,25,24,49,0,0,0,54,52,106
sp09,92,WARREN,POLI,PolSc-Amer,0,0,0,0,0,0,4,2,6,1,1,2,5,3,8,0,0,0,10,6,16
sp09,92,WARREN,POLI,PolSc-Comp,0,0,0,1,0,1,1,1,2,1,1,2,0,0,0,0,0,0,3,2,5
sp09,92,WARREN,POLI,PolSc-Intl,0,0,0,3,1,4,0,4,4,16,8,24,12,15,27,0,0,0,31,28,59
sp09,92,WARREN,POLI,PolSc-PLaw,0,0,0,2,3,5,3,7,10,8,9,17,6,13,19,0,0,0,19,32,51
sp09,92,WARREN,POLI,PolSc-PPol,0,0,0,0,0,0,1,0,1,0,2,2,0,1,1,0,0,0,1,3,4
sp09,92,WARREN,POLI,PolSc-Thry,0,0,0,0,0,0,1,0,1,3,1,4,1,2,3,0,0,0,5,3,8
sp09,92,WARREN,PSYC,Psychology,0,0,0,3,10,13,7,29,36,23,57,80,33,60,93,0,0,0,66,156,222
sp09,92,WARREN,RELI,Relig/Stu,0,0,0,0,0,0,0,0,0,0,1,1,2,1,3,0,0,0,2,2,4
sp09,92,WARREN,SE,Engin Sci,0,0,0,0,0,0,1,0,1,0,0,0,0,0,0,0,0,0,1,0,1
sp09,92,WARREN,SE,Struct Eng,0,0,0,4,3,7,16,2,18,31,9,40,60,28,88,0,0,0,111,42,153
sp09,92,WARREN,SIO,ErSc-Geoch,0,0,0,0,0,0,0,0,0,0,0,0,0,1,1,0,0,0,0,1,1
sp09,92,WARREN,SIO,ErSc-Geol,0,0,0,0,0,0,1,0,1,0,0,0,0,0,0,0,0,0,1,0,1
sp09,92,WARREN,SOC,Sociology,0,0,0,1,0,1,2,2,4,3,18,21,12,14,26,0,0,0,18,34,52
sp09,92,WARREN,THEA,Dance,0,0,0,0,0,0,1,0,1,0,1,1,0,0,0,0,0,0,1,1,2
sp09,92,WARREN,THEA,Theatre,0,0,0,0,0,0,0,0,0,1,3,4,3,8,11,0,0,0,4,11,15
sp09,92,WARREN,TWS,ThirdWldSt,0,0,0,0,1,1,0,0,0,0,0,0,0,0,0,0,0,0,0,1,1
sp09,92,WARREN,UNAF,IntcampVis,0,0,0,0,0,0,1,0,1,0,2,2,2,0,2,0,0,0,3,2,5
sp09,92,WARREN,UNAF,Limited St,0,0,0,0,0,0,0,0,0,0,0,0,0,0,0,3,1,4,3,1,4
sp09,92,WARREN,UNAF,UndecHumAr,0,0,0,0,3,3,1,2,3,0,0,0,0,0,0,0,0,0,1,5,6
sp09,92,WARREN,UNAF,Undeclared,0,0,0,6,14,20,12,12,24,1,0,1,0,0,0,0,0,0,19,26,45
sp09,92,WARREN,UNAF,UndecPhysS,0,0,0,1,0,1,0,2,2,1,0,1,0,0,0,0,0,0,2,2,4
sp09,92,WARREN,UNAF,UndecSocSc,0,0,0,0,1,1,1,0,1,0,0,0,0,0,0,0,0,0,1,1,2
sp09,92,WARREN,USP,Urb Stu&Pl,0,0,0,1,2,3,1,0,1,2,1,3,6,3,9,0,0,0,10,6,16
sp09,92,WARREN,VIS,Art Hst/Cr,0,0,0,0,1,1,0,0,0,1,3,4,1,5,6,0,0,0,2,9,11
sp09,92,WARREN,VIS,Media,0,0,0,0,1,1,0,3,3,8,3,11,8,9,17,0,0,0,16,16,32
sp09,92,WARREN,VIS,Studio VA,0,0,0,1,1,2,0,0,0,3,1,4,0,6,6,0,0,0,4,8,12
sp09,92,WARREN,VIS,VA-CompArt,0,0,0,0,0,0,0,1,1,2,1,3,0,2,2,0,0,0,2,4,6
wi08,81,MARSHALL,ANTH,Anth-Arch,0,0,0,0,2,2,0,1,1,1,0,1,1,1,2,0,0,0,2,4,6
wi08,81,MARSHALL,ANTH,Anth-Biol,0,0,0,0,0,0,0,0,0,2,3,5,1,3,4,0,0,0,3,6,9
wi08,81,MARSHALL,ANTH,Anth-Soci,0,0,0,0,1,1,0,1,1,1,4,5,0,1,1,0,0,0,1,7,8
wi08,81,MARSHALL,ANTH,Anthropol,0,0,0,0,0,0,0,1,1,1,2,3,1,6,7,0,0,0,2,9,11
wi08,81,MARSHALL,BENG,Bioen:Binf,0,0,0,0,0,0,0,0,0,0,0,0,1,0,1,0,0,0,1,0,1
wi08,81,MARSHALL,BENG,Bioeng:PM,0,0,0,0,0,0,2,0,2,3,0,3,13,9,22,0,0,0,18,9,27
wi08,81,MARSHALL,BENG,BioengBiot,0,0,0,1,1,2,0,0,0,4,1,5,9,6,15,0,0,0,14,8,22
wi08,81,MARSHALL,BENG,Bioengin,0,0,0,0,2,2,1,0,1,0,3,3,5,4,9,0,0,0,6,9,15
wi08,81,MARSHALL,BENG,Pr-BioenPM,0,0,0,6,1,7,9,4,13,9,2,11,0,1,1,0,0,0,24,8,32
wi08,81,MARSHALL,BIOL,Anml Physl,0,0,0,0,0,0,0,0,0,1,0,1,11,12,23,0,0,0,12,12,24
wi08,81,MARSHALL,BIOL,Bioc/CellB,0,0,0,2,7,9,10,16,26,17,16,33,47,33,80,0,0,0,76,72,148
wi08,81,MARSHALL,BIOL,BiolBioinf,0,0,0,0,0,0,0,0,0,0,0,0,1,0,1,0,0,0,1,0,1
wi08,81,MARSHALL,BIOL,Ec/Beh/Evo,0,0,0,0,1,1,4,0,4,2,5,7,1,5,6,0,0,0,7,11,18
wi08,81,MARSHALL,BIOL,Genl Biol,0,0,0,6,14,20,15,26,41,28,24,52,25,43,68,0,0,0,74,107,181
wi08,81,MARSHALL,BIOL,Human Bio,0,0,0,11,31,42,25,40,65,30,44,74,46,62,108,0,0,0,112,177,289
wi08,81,MARSHALL,BIOL,Microbiol,0,0,0,1,2,3,1,1,2,2,2,4,3,2,5,0,0,0,7,7,14
wi08,81,MARSHALL,BIOL,Molec Biol,0,0,0,3,2,5,4,1,5,5,2,7,5,7,12,0,0,0,17,12,29
wi08,81,MARSHALL,BIOL,PhyslNeuro,0,0,0,3,12,15,4,10,14,7,8,15,9,7,16,0,0,0,23,37,60
wi08,81,MARSHALL,CENG,Chem Engin,0,0,0,0,1,1,3,4,7,7,1,8,7,5,12,0,0,0,17,11,28
wi08,81,MARSHALL,CGS,CritGendSt,0,0,0,0,1,1,0,0,0,0,1,1,0,5,5,0,0,0,0,7,7
wi08,81,MARSHALL,CHEM,Bioch/Chem,0,0,0,7,4,11,5,13,18,8,8,16,9,8,17,0,0,0,29,33,62
wi08,81,MARSHALL,CHEM,Chem Phys,0,0,0,0,0,0,0,0,0,0,0,0,0,1,1,0,0,0,0,1,1
wi08,81,MARSHALL,CHEM,Chemistry,0,0,0,1,3,4,5,5,10,5,3,8,0,3,3,0,0,0,11,14,25
wi08,81,MARSHALL,CHEM,Envir Chem,0,0,0,0,0,0,1,0,1,0,0,0,0,0,0,0,0,0,1,0,1
wi08,81,MARSHALL,CHEM,MolecSynth,0,0,0,0,0,0,0,0,0,0,0,0,0,1,1,0,0,0,0,1,1
wi08,81,MARSHALL,CHEM,Pharm Chem,0,0,0,2,6,8,3,11,14,8,12,20,7,13,20,0,0,0,20,42,62
wi08,81,MARSHALL,CHIN,Chinese St,0,0,0,0,1,1,0,0,0,0,0,0,1,2,3,0,0,0,1,3,4
wi08,81,MARSHALL,CLAS,Classic St,0,0,0,0,0,0,0,0,0,0,1,1,1,0,1,0,0,0,1,1,2
wi08,81,MARSHALL,COGS,Cog Sci,0,0,0,1,3,4,3,1,4,5,3,8,6,3,9,0,0,0,15,10,25
wi08,81,MARSHALL,COGS,CogSc/ClAs,0,0,0,0,0,0,0,1,1,0,0,0,1,2,3,0,0,0,1,3,4
wi08,81,MARSHALL,COGS,CogSc/Comp,0,0,0,0,0,0,0,0,0,1,0,1,0,0,0,0,0,0,1,0,1
wi08,81,MARSHALL,COGS,CogSc/HCI,0,0,0,0,0,0,0,0,0,2,1,3,2,0,2,0,0,0,4,1,5
wi08,81,MARSHALL,COGS,CogSc/HCog,0,0,0,0,0,0,0,0,0,0,1,1,1,0,1,0,0,0,1,1,2
wi08,81,MARSHALL,COGS,CogSc/Neur,0,0,0,0,0,0,2,1,3,3,3,6,3,2,5,0,0,0,8,6,14
wi08,81,MARSHALL,COMM,Communic,0,0,0,5,11,16,2,17,19,14,46,60,15,42,57,0,0,0,36,116,152
wi08,81,MARSHALL,CSE,Comp Sci,0,0,0,4,0,4,6,2,8,7,0,7,20,3,23,0,0,0,37,5,42
wi08,81,MARSHALL,CSE,CompEngCSE,0,0,0,3,0,3,5,0,5,8,0,8,7,0,7,0,0,0,23,0,23
wi08,81,MARSHALL,ECE,CompEngECE,0,0,0,0,0,0,1,0,1,0,0,0,0,0,0,0,0,0,1,0,1
wi08,81,MARSHALL,ECE,Electr Eng,0,0,0,2,0,2,10,1,11,12,6,18,17,5,22,0,0,0,41,12,53
wi08,81,MARSHALL,ECE,Engin Phys,0,0,0,0,0,0,0,0,0,0,0,0,2,0,2,0,0,0,2,0,2
wi08,81,MARSHALL,ECE,Pr-ElecEng,0,0,0,0,0,0,0,0,0,1,0,1,1,0,1,0,0,0,2,0,2
wi08,81,MARSHALL,ECON,Ec-Mth&Ecn,0,0,0,1,0,1,3,2,5,6,3,9,2,2,4,0,0,0,12,7,19
wi08,81,MARSHALL,ECON,Econ-MgtSc,0,0,0,6,3,9,17,12,29,38,26,64,40,33,73,0,0,0,101,74,175
wi08,81,MARSHALL,ECON,Economics,0,0,0,15,4,19,26,16,42,66,33,99,72,41,113,0,0,0,179,94,273
wi08,81,MARSHALL,ERTH,Earth Scis,0,0,0,0,0,0,0,0,0,0,0,0,0,1,1,0,0,0,0,1,1
wi08,81,MARSHALL,ESYS,EnvSys(EB),0,0,0,0,0,0,0,3,3,2,3,5,1,4,5,0,0,0,3,10,13
wi08,81,MARSHALL,ESYS,EnvSys(EC),0,0,0,0,0,0,0,0,0,1,0,1,0,0,0,0,0,0,1,0,1
wi08,81,MARSHALL,ESYS,EnvSys(EP),0,0,0,0,1,1,1,0,1,1,1,2,0,1,1,0,0,0,2,3,5
wi08,81,MARSHALL,ESYS,EnvSys(ES),0,0,0,0,0,0,0,0,0,2,1,3,1,1,2,0,0,0,3,2,5
wi08,81,MARSHALL,ETHN,Ethnic St,0,0,0,0,2,2,0,2,2,1,14,15,2,8,10,0,0,0,3,26,29
wi08,81,MARSHALL,GMST,German Stu,0,0,0,0,1,1,0,0,0,0,0,0,0,0,0,0,0,0,0,1,1
wi08,81,MARSHALL,HDP,Human Dev,0,0,0,0,0,0,0,1,1,0,8,8,0,30,30,0,0,0,0,39,39
wi08,81,MARSHALL,HDP,Pr-HumnDev,0,0,0,1,1,2,0,13,13,1,12,13,0,4,4,0,0,0,2,30,32
wi08,81,MARSHALL,HIST,History,0,0,0,2,2,4,2,4,6,10,12,22,15,18,33,0,0,0,29,36,65
wi08,81,MARSHALL,INTL,IntSt-Anth,0,0,0,0,0,0,0,0,0,0,3,3,0,0,0,0,0,0,0,3,3
wi08,81,MARSHALL,INTL,IntSt-Econ,0,0,0,1,6,7,3,6,9,7,12,19,5,14,19,0,0,0,16,38,54
wi08,81,MARSHALL,INTL,IntSt-Hist,0,0,0,0,0,0,1,1,2,1,3,4,1,0,1,0,0,0,3,4,7
wi08,81,MARSHALL,INTL,IntSt-Ling,0,0,0,1,1,2,2,2,4,0,2,2,1,0,1,0,0,0,4,5,9
wi08,81,MARSHALL,INTL,IntSt-PolS,0,0,0,1,1,2,5,2,7,4,9,13,2,10,12,0,0,0,12,22,34
wi08,81,MARSHALL,INTL,IntSt-Soc,0,0,0,0,1,1,0,4,4,2,8,10,0,9,9,0,0,0,2,22,24
wi08,81,MARSHALL,JAPN,JapaneseSt,0,0,0,1,1,2,1,0,1,0,0,0,0,2,2,0,0,0,2,3,5
wi08,81,MARSHALL,JUDA,Judaic Stu,0,0,0,1,0,1,0,1,1,0,0,0,0,1,1,0,0,0,1,2,3
wi08,81,MARSHALL,LATI,LatinAm St,0,0,0,0,2,2,0,1,1,1,2,3,1,1,2,0,0,0,2,6,8
wi08,81,MARSHALL,LING,Lang Stu,0,0,0,0,0,0,0,1,1,0,0,0,0,2,2,0,0,0,0,3,3
wi08,81,MARSHALL,LING,Linguistcs,0,0,0,0,2,2,0,0,0,1,1,2,1,2,3,0,0,0,2,5,7
wi08,81,MARSHALL,LIT,Lit/Compos,0,0,0,0,0,0,0,0,0,0,1,1,0,0,0,0,0,0,0,1,1
wi08,81,MARSHALL,LIT,Lit/Engl,0,0,0,0,3,3,4,2,6,0,2,2,3,9,12,0,0,0,7,16,23
wi08,81,MARSHALL,LIT,Lit/World,0,0,0,0,0,0,0,1,1,0,2,2,0,1,1,0,0,0,0,4,4
wi08,81,MARSHALL,LIT,Lit/Writng,0,0,0,0,1,1,0,0,0,0,1,1,4,2,6,0,0,0,4,4,8
wi08,81,MARSHALL,LIT,Pre-Lit/Wr,0,0,0,0,3,3,1,3,4,2,6,8,0,2,2,0,0,0,3,14,17
wi08,81,MARSHALL,LIT,Russian Lt,0,0,0,0,0,0,0,0,0,0,0,0,0,1,1,0,0,0,0,1,1
wi08,81,MARSHALL,LIT,Spanish Lt,0,0,0,0,0,0,0,0,0,0,1,1,0,5,5,0,0,0,0,6,6
wi08,81,MARSHALL,MAE,Aerosp Eng,0,0,0,1,2,3,5,0,5,12,1,13,16,0,16,0,0,0,34,3,37
wi08,81,MARSHALL,MAE,Engin Sci,0,0,0,1,0,1,0,0,0,0,0,0,1,0,1,0,0,0,2,0,2
wi08,81,MARSHALL,MAE,Envir Eng,0,0,0,1,2,3,1,0,1,0,0,0,1,0,1,0,0,0,3,2,5
wi08,81,MARSHALL,MAE,Mech Engin,0,0,0,9,4,13,17,2,19,28,1,29,49,4,53,0,0,0,103,11,114
wi08,81,MARSHALL,MATH,Appld Math,0,0,0,0,1,1,2,0,2,1,2,3,4,1,5,0,0,0,7,4,11
wi08,81,MARSHALL,MATH,Math/SecEd,0,0,0,0,0,0,1,0,1,3,2,5,2,2,4,0,0,0,6,4,10
wi08,81,MARSHALL,MATH,Mathematcs,0,0,0,3,4,7,1,0,1,4,2,6,2,0,2,0,0,0,10,6,16
wi08,81,MARSHALL,MATH,Mth-CompSc,0,0,0,0,0,0,0,0,0,0,0,0,2,0,2,0,0,0,2,0,2
wi08,81,MARSHALL,MATH,Mth-Mth&Ec,0,0,0,0,1,1,0,0,0,2,3,5,2,1,3,0,0,0,4,5,9
wi08,81,MARSHALL,MATH,Mth-SciCom,0,0,0,0,0,0,0,1,1,0,0,0,0,0,0,0,0,0,0,1,1
wi08,81,MARSHALL,MATH,Mth/ApldSc,0,0,0,0,1,1,0,0,0,0,1,1,2,0,2,0,0,0,2,2,4
wi08,81,MARSHALL,MATH,Pr-Math CS,0,0,0,0,1,1,1,0,1,1,1,2,0,1,1,0,0,0,2,3,5
wi08,81,MARSHALL,MATH,Prob&Stats,0,0,0,0,0,0,0,0,0,1,0,1,0,2,2,0,0,0,1,2,3
wi08,81,MARSHALL,MUS,Mu-CompArt,0,0,0,0,0,0,0,0,0,2,1,3,0,0,0,0,0,0,2,1,3
wi08,81,MARSHALL,MUS,Music,0,0,0,1,1,2,1,1,2,3,4,7,2,0,2,0,0,0,7,6,13
wi08,81,MARSHALL,MUS,Music Hum,0,0,0,0,0,0,0,2,2,0,1,1,0,0,0,0,0,0,0,3,3
wi08,81,MARSHALL,PHIL,Philosophy,0,0,0,1,1,2,1,1,2,2,2,4,9,6,15,0,0,0,13,10,23
wi08,81,MARSHALL,PHYS,Biophysics,0,0,0,0,0,0,0,0,0,0,0,0,0,2,2,0,0,0,0,2,2
wi08,81,MARSHALL,PHYS,Gen Physcs,0,0,0,0,0,0,0,0,0,1,1,2,0,0,0,0,0,0,1,1,2
wi08,81,MARSHALL,PHYS,Phys/Astro,0,0,0,1,2,3,0,0,0,1,1,2,2,3,5,0,0,0,4,6,10
wi08,81,MARSHALL,PHYS,Phys/Comp,0,0,0,0,0,0,0,0,0,0,0,0,1,0,1,0,0,0,1,0,1
wi08,81,MARSHALL,PHYS,Physics,0,0,0,0,0,0,3,0,3,2,0,2,4,0,4,0,0,0,9,0,9
wi08,81,MARSHALL,POLI,Polit Sci,0,0,0,4,6,10,15,12,27,20,17,37,25,23,48,0,0,0,64,58,122
wi08,81,MARSHALL,POLI,PolSc-Amer,0,0,0,1,1,2,2,1,3,5,0,5,3,9,12,0,0,0,11,11,22
wi08,81,MARSHALL,POLI,PolSc-Comp,0,0,0,0,0,0,0,0,0,0,0,0,0,2,2,0,0,0,0,2,2
wi08,81,MARSHALL,POLI,PolSc-Intl,0,0,0,3,8,11,2,5,7,10,12,22,9,10,19,0,0,0,24,35,59
wi08,81,MARSHALL,POLI,PolSc-PLaw,0,0,0,6,4,10,5,5,10,7,6,13,7,6,13,0,0,0,25,21,46
wi08,81,MARSHALL,POLI,PolSc-PPol,0,0,0,0,0,0,1,0,1,0,3,3,3,1,4,0,0,0,4,4,8
wi08,81,MARSHALL,POLI,PolSc-Thry,0,0,0,0,0,0,0,0,0,0,1,1,0,1,1,0,0,0,0,2,2
wi08,81,MARSHALL,PSYC,Psychology,0,0,0,6,21,27,14,33,47,22,50,72,34,69,103,0,0,0,76,173,249
wi08,81,MARSHALL,RELI,Relig/Stu,0,0,0,0,0,0,0,0,0,1,1,2,0,1,1,0,0,0,1,2,3
wi08,81,MARSHALL,SE,Struct Eng,0,0,0,6,1,7,4,3,7,7,4,11,23,9,32,0,0,0,40,17,57
wi08,81,MARSHALL,SOC,Sociology,0,0,0,1,5,6,0,12,12,13,22,35,10,29,39,0,0,0,24,68,92
wi08,81,MARSHALL,THEA,Dance,0,0,0,0,0,0,0,0,0,0,1,1,0,1,1,0,0,0,0,2,2
wi08,81,MARSHALL,THEA,Theatre,0,0,0,0,0,0,0,2,2,2,3,5,3,3,6,0,0,0,5,8,13
wi08,81,MARSHALL,TWS,ThirdWldSt,0,0,0,0,0,0,0,1,1,0,0,0,1,0,1,0,0,0,1,1,2
wi08,81,MARSHALL,UNAF,UndecBiolS,0,0,0,9,17,26,5,27,32,3,1,4,0,0,0,0,0,0,17,45,62
wi08,81,MARSHALL,UNAF,UndecHumAr,0,0,0,1,10,11,0,9,9,1,0,1,0,0,0,0,0,0,2,19,21
wi08,81,MARSHALL,UNAF,Undeclared,0,0,0,31,52,83,24,38,62,0,4,4,0,0,0,0,0,0,55,94,149
wi08,81,MARSHALL,UNAF,UndecPhysS,0,0,0,3,3,6,5,2,7,1,0,1,0,0,0,0,0,0,9,5,14
wi08,81,MARSHALL,UNAF,UndecSocSc,0,0,0,4,13,17,2,10,12,1,1,2,0,0,0,0,0,0,7,24,31
wi08,81,MARSHALL,USP,Urb Stu&Pl,0,0,0,0,2,2,1,4,5,2,5,7,11,16,27,0,0,0,14,27,41
wi08,81,MARSHALL,VIS,Art Hst/Cr,0,0,0,0,0,0,0,3,3,0,5,5,0,3,3,0,0,0,0,11,11
wi08,81,MARSHALL,VIS,Media,0,0,0,0,3,3,2,2,4,5,1,6,10,3,13,0,0,0,17,9,26
wi08,81,MARSHALL,VIS,Studio VA,0,0,0,1,0,1,1,0,1,0,4,4,2,6,8,0,0,0,4,10,14
wi08,81,MARSHALL,VIS,VA-CompArt,0,0,0,0,0,0,0,0,0,1,2,3,1,0,1,0,0,0,2,2,4
wi08,81,MUIR,ANTH,Anth-Arch,0,0,0,0,0,0,1,1,2,1,3,4,2,1,3,0,0,0,4,5,9
wi08,81,MUIR,ANTH,Anth-Biol,0,0,0,0,0,0,1,0,1,4,4,8,1,9,10,0,0,0,6,13,19
wi08,81,MUIR,ANTH,Anth-Soci,0,0,0,1,0,1,0,2,2,1,4,5,1,0,1,0,0,0,3,6,9
wi08,81,MUIR,ANTH,Anthropol,0,0,0,0,0,0,0,1,1,0,2,2,0,7,7,0,0,0,0,10,10
wi08,81,MUIR,BENG,Bioen:Binf,0,0,0,0,0,0,0,0,0,0,0,0,1,0,1,0,0,0,1,0,1
wi08,81,MUIR,BENG,Bioeng:PM,0,0,0,0,0,0,2,0,2,5,0,5,11,10,21,0,0,0,18,10,28
wi08,81,MUIR,BENG,BioengBiot,0,0,0,2,1,3,2,1,3,6,1,7,8,9,17,0,0,0,18,12,30
wi08,81,MUIR,BENG,Bioengin,0,0,0,5,0,5,2,3,5,5,5,10,10,3,13,0,0,0,22,11,33
wi08,81,MUIR,BENG,Pr-BioenBf,0,0,0,0,0,0,0,0,0,0,0,0,1,1,2,0,0,0,1,1,2
wi08,81,MUIR,BENG,Pr-BioenPM,0,0,0,4,4,8,11,9,20,5,4,9,2,1,3,0,0,0,22,18,40
wi08,81,MUIR,BIOL,Anml Physl,0,0,0,0,0,0,0,0,0,0,0,0,5,14,19,0,0,0,5,14,19
wi08,81,MUIR,BIOL,Bioc/CellB,0,0,0,4,6,10,15,15,30,29,29,58,32,52,84,0,0,0,80,102,182
wi08,81,MUIR,BIOL,BiolBioinf,0,0,0,0,0,0,0,0,0,0,0,0,1,0,1,0,0,0,1,0,1
wi08,81,MUIR,BIOL,Ec/Beh/Evo,0,0,0,0,0,0,5,2,7,0,10,10,3,12,15,0,0,0,8,24,32
wi08,81,MUIR,BIOL,Genl Biol,0,0,0,5,15,20,21,25,46,18,40,58,25,47,72,0,0,0,69,127,196
wi08,81,MUIR,BIOL,Human Bio,0,0,0,16,21,37,27,49,76,51,56,107,44,70,114,0,0,0,138,196,334
wi08,81,MUIR,BIOL,Microbiol,0,0,0,0,0,0,1,1,2,3,4,7,8,7,15,0,0,0,12,12,24
wi08,81,MUIR,BIOL,Molec Biol,0,0,0,2,3,5,5,9,14,7,5,12,7,12,19,0,0,0,21,29,50
wi08,81,MUIR,BIOL,PhyslNeuro,0,0,0,5,2,7,6,11,17,14,21,35,6,9,15,0,0,0,31,43,74
wi08,81,MUIR,BIOL,Pr-BioBinf,0,0,0,0,0,0,0,0,0,0,1,1,0,0,0,0,0,0,0,1,1
wi08,81,MUIR,CENG,Chem Engin,0,0,0,0,3,3,5,3,8,12,2,14,8,2,10,0,0,0,25,10,35
wi08,81,MUIR,CGS,CritGendSt,0,0,0,0,0,0,0,1,1,0,1,1,1,2,3,0,0,0,1,4,5
wi08,81,MUIR,CHEM,Bioch/Chem,0,0,0,9,7,16,7,7,14,14,18,32,27,5,32,0,0,0,57,37,94
wi08,81,MUIR,CHEM,Chem Educ,0,0,0,0,0,0,0,0,0,0,0,0,1,1,2,0,0,0,1,1,2
wi08,81,MUIR,CHEM,Chem Phys,0,0,0,0,0,0,0,0,0,1,0,1,0,1,1,0,0,0,1,1,2
wi08,81,MUIR,CHEM,Chemistry,0,0,0,1,0,1,5,5,10,8,4,12,6,8,14,0,0,0,20,17,37
wi08,81,MUIR,CHEM,Envir Chem,0,0,0,0,0,0,0,0,0,0,1,1,0,0,0,0,0,0,0,1,1
wi08,81,MUIR,CHEM,MolecSynth,0,0,0,0,0,0,0,0,0,1,1,2,0,0,0,0,0,0,1,1,2
wi08,81,MUIR,CHEM,Pharm Chem,0,0,0,6,3,9,12,8,20,6,10,16,6,15,21,0,0,0,30,36,66
wi08,81,MUIR,CHIN,Chinese St,0,0,0,1,0,1,0,0,0,0,1,1,0,2,2,0,0,0,1,3,4
wi08,81,MUIR,CLAS,Classic St,0,0,0,0,0,0,0,0,0,1,1,2,1,1,2,0,0,0,2,2,4
wi08,81,MUIR,COGS,Cog Sci,0,0,0,1,2,3,6,4,10,9,9,18,10,9,19,0,0,0,26,24,50
wi08,81,MUIR,COGS,CogSc/ClAs,0,0,0,0,0,0,1,1,2,2,1,3,2,2,4,0,0,0,5,4,9
wi08,81,MUIR,COGS,CogSc/Comp,0,0,0,1,0,1,0,0,0,0,0,0,0,0,0,0,0,0,1,0,1
wi08,81,MUIR,COGS,CogSc/HCI,0,0,0,0,0,0,1,0,1,3,1,4,5,1,6,0,0,0,9,2,11
wi08,81,MUIR,COGS,CogSc/HCog,0,0,0,0,0,0,0,0,0,1,1,2,2,0,2,0,0,0,3,1,4
wi08,81,MUIR,COGS,CogSc/Neur,0,0,0,0,0,0,0,2,2,2,3,5,5,4,9,0,0,0,7,9,16
wi08,81,MUIR,COMM,Communic,0,0,0,2,7,9,3,30,33,29,50,79,18,50,68,0,0,0,52,137,189
wi08,81,MUIR,CSE,Comp Sci,0,0,0,0,2,2,11,3,14,14,0,14,27,3,30,0,0,0,52,8,60
wi08,81,MUIR,CSE,CompEngCSE,0,0,0,1,0,1,6,0,6,5,0,5,5,0,5,0,0,0,17,0,17
wi08,81,MUIR,CSE,CompScBinf,0,0,0,0,0,0,0,0,0,0,0,0,1,0,1,0,0,0,1,0,1
wi08,81,MUIR,ECE,CompEngECE,0,0,0,2,0,2,3,2,5,3,0,3,3,0,3,0,0,0,11,2,13
wi08,81,MUIR,ECE,Electr Eng,1,0,1,0,0,0,3,0,3,8,4,12,17,3,20,0,0,0,29,7,36
wi08,81,MUIR,ECE,Engin Phys,0,0,0,0,0,0,1,0,1,0,0,0,0,0,0,0,0,0,1,0,1
wi08,81,MUIR,ECE,Pr-EngPhys,0,0,0,0,0,0,0,0,0,1,0,1,0,0,0,0,0,0,1,0,1
wi08,81,MUIR,ECON,Ec-Mth&Ecn,0,0,0,3,1,4,4,2,6,3,1,4,0,1,1,0,0,0,10,5,15
wi08,81,MUIR,ECON,Econ-MgtSc,0,0,0,5,1,6,12,9,21,14,22,36,31,25,56,0,0,0,62,57,119
wi08,81,MUIR,ECON,Economics,0,0,0,11,2,13,23,22,45,53,27,80,71,36,107,0,0,0,158,87,245
wi08,81,MUIR,ERTH,ErSc-GeoCh,0,0,0,0,0,0,0,1,1,0,0,0,1,0,1,0,0,0,1,1,2
wi08,81,MUIR,ESYS,EnvSys(EB),0,0,0,0,3,3,0,4,4,0,3,3,6,8,14,0,0,0,6,18,24
wi08,81,MUIR,ESYS,EnvSys(EC),0,0,0,0,0,0,0,0,0,0,0,0,3,0,3,0,0,0,3,0,3
wi08,81,MUIR,ESYS,EnvSys(EP),0,0,0,0,0,0,0,3,3,1,2,3,1,2,3,0,0,0,2,7,9
wi08,81,MUIR,ESYS,EnvSys(ES),0,0,0,1,0,1,1,0,1,3,0,3,0,1,1,0,0,0,5,1,6
wi08,81,MUIR,ETHN,Ethnic St,0,0,0,0,1,1,1,3,4,0,1,1,6,7,13,0,0,0,7,12,19
wi08,81,MUIR,HDP,Human Dev,0,0,0,0,0,0,0,1,1,0,5,5,1,23,24,0,0,0,1,29,30
wi08,81,MUIR,HDP,Pr-HumnDev,0,0,0,0,4,4,0,9,9,1,11,12,0,5,5,0,0,0,1,29,30
wi08,81,MUIR,HIST,History,0,0,0,3,0,3,3,3,6,14,8,22,22,23,45,0,0,0,42,34,76
wi08,81,MUIR,INTD,Muir Sp Pr,0,0,0,0,0,0,0,0,0,0,0,0,1,0,1,0,0,0,1,0,1
wi08,81,MUIR,INTL,IntSt-Anth,0,0,0,0,0,0,0,1,1,1,5,6,2,5,7,0,0,0,3,11,14
wi08,81,MUIR,INTL,IntSt-Econ,0,0,0,0,9,9,1,7,8,9,8,17,7,12,19,0,0,0,17,36,53
wi08,81,MUIR,INTL,IntSt-Hist,0,0,0,1,0,1,1,1,2,1,1,2,1,3,4,0,0,0,4,5,9
wi08,81,MUIR,INTL,IntSt-Ling,0,0,0,0,1,1,1,0,1,1,0,1,0,1,1,0,0,0,2,2,4
wi08,81,MUIR,INTL,IntSt-Lit,0,0,0,0,0,0,0,0,0,0,1,1,0,2,2,0,0,0,0,3,3
wi08,81,MUIR,INTL,IntSt-PolS,0,0,0,1,2,3,0,5,5,6,5,11,2,18,20,0,0,0,9,30,39
wi08,81,MUIR,INTL,IntSt-Soc,0,0,0,0,0,0,0,4,4,3,11,14,2,12,14,0,0,0,5,27,32
wi08,81,MUIR,JAPN,JapaneseSt,0,0,0,1,0,1,1,0,1,1,0,1,1,1,2,0,0,0,4,1,5
wi08,81,MUIR,JUDA,Judaic Stu,0,0,0,0,0,0,0,0,0,0,1,1,0,0,0,0,0,0,0,1,1
wi08,81,MUIR,LATI,LatinAm St,0,0,0,0,0,0,0,0,0,1,2,3,1,3,4,0,0,0,2,5,7
wi08,81,MUIR,LING,Lang Stu,0,0,0,0,0,0,1,2,3,0,2,2,1,3,4,0,0,0,2,7,9
wi08,81,MUIR,LING,Ling-CogLn,0,0,0,0,0,0,0,0,0,0,1,1,0,3,3,0,0,0,0,4,4
wi08,81,MUIR,LING,Ling-LSoc,0,0,0,0,0,0,0,1,1,0,0,0,0,3,3,0,0,0,0,4,4
wi08,81,MUIR,LING,Linguistcs,0,0,0,0,0,0,0,1,1,0,1,1,0,3,3,0,0,0,0,5,5
wi08,81,MUIR,LIT,French Lit,0,0,0,0,0,0,0,0,0,0,1,1,0,0,0,0,0,0,0,1,1
wi08,81,MUIR,LIT,German Lit,0,0,0,0,0,0,0,0,0,0,1,1,0,0,0,0,0,0,0,1,1
wi08,81,MUIR,LIT,Lit/Compos,0,0,0,0,0,0,0,0,0,0,2,2,1,1,2,0,0,0,1,3,4
wi08,81,MUIR,LIT,Lit/Engl,0,0,0,0,1,1,1,4,5,5,8,13,6,10,16,0,0,0,12,23,35
wi08,81,MUIR,LIT,Lit/World,0,0,0,0,0,0,1,0,1,1,5,6,2,5,7,0,0,0,4,10,14
wi08,81,MUIR,LIT,Lit/Writng,0,0,0,0,0,0,0,0,0,1,1,2,4,16,20,0,0,0,5,17,22
wi08,81,MUIR,LIT,Pre-Lit/Wr,0,0,0,0,2,2,4,9,13,7,9,16,0,7,7,0,0,0,11,27,38
wi08,81,MUIR,LIT,Spanish Lt,0,0,0,0,0,0,0,0,0,0,3,3,2,1,3,0,0,0,2,4,6
wi08,81,MUIR,MAE,Aerosp Eng,0,0,0,5,0,5,8,2,10,5,1,6,16,4,20,0,0,0,34,7,41
wi08,81,MUIR,MAE,Envir Eng,0,0,0,1,0,1,0,3,3,1,2,3,1,2,3,0,0,0,3,7,10
wi08,81,MUIR,MAE,Mech Engin,0,0,0,9,2,11,13,2,15,19,2,21,39,4,43,0,0,0,80,10,90
wi08,81,MUIR,MATH,Appld Math,0,0,0,3,1,4,3,0,3,3,1,4,4,2,6,0,0,0,13,4,17
wi08,81,MUIR,MATH,Math/SecEd,0,0,0,0,0,0,0,0,0,2,1,3,4,1,5,0,0,0,6,2,8
wi08,81,MUIR,MATH,Mathematcs,0,0,0,1,3,4,6,4,10,11,8,19,9,4,13,0,0,0,27,19,46
wi08,81,MUIR,MATH,Mth-CompSc,0,0,0,0,0,0,0,0,0,1,1,2,1,1,2,0,0,0,2,2,4
wi08,81,MUIR,MATH,Mth-Mth&Ec,0,0,0,0,1,1,0,3,3,0,3,3,4,3,7,0,0,0,4,10,14
wi08,81,MUIR,MATH,Mth-SciCom,0,0,0,0,0,0,0,1,1,0,0,0,1,0,1,0,0,0,1,1,2
wi08,81,MUIR,MATH,Mth/ApldSc,0,0,0,0,0,0,0,1,1,0,1,1,0,1,1,0,0,0,0,3,3
wi08,81,MUIR,MATH,Pr-Math CS,0,0,0,0,0,0,0,0,0,1,0,1,0,0,0,0,0,0,1,0,1
wi08,81,MUIR,MATH,Prob&Stats,0,0,0,0,0,0,0,0,0,0,0,0,1,0,1,0,0,0,1,0,1
wi08,81,MUIR,MUS,Mu-CompArt,0,0,0,0,0,0,3,0,3,5,2,7,4,3,7,0,0,0,12,5,17
wi08,81,MUIR,MUS,Music,0,0,0,2,1,3,2,2,4,2,1,3,4,3,7,0,0,0,10,7,17
wi08,81,MUIR,MUS,Music Hum,0,0,0,0,0,0,0,0,0,1,0,1,0,0,0,0,0,0,1,0,1
wi08,81,MUIR,PHIL,Philosophy,0,0,0,1,0,1,3,0,3,5,6,11,7,5,12,0,0,0,16,11,27
wi08,81,MUIR,PHYS,Biophysics,0,0,0,1,0,1,1,0,1,1,0,1,7,1,8,0,0,0,10,1,11
wi08,81,MUIR,PHYS,Gen Physcs,0,0,0,0,1,1,0,0,0,0,0,0,0,0,0,0,0,0,0,1,1
wi08,81,MUIR,PHYS,Phy/ErthSc,0,0,0,0,0,0,1,0,1,0,0,0,0,0,0,0,0,0,1,0,1
wi08,81,MUIR,PHYS,Phys/Astro,0,0,0,0,1,1,0,1,1,1,0,1,2,2,4,0,0,0,3,4,7
wi08,81,MUIR,PHYS,Physics,0,0,0,0,0,0,3,1,4,4,1,5,6,0,6,0,0,0,13,2,15
wi08,81,MUIR,POLI,Polit Sci,0,0,0,1,4,5,5,4,9,17,17,34,28,15,43,0,0,0,51,40,91
wi08,81,MUIR,POLI,PolSc-Amer,0,0,0,1,0,1,0,3,3,1,1,2,1,3,4,0,0,0,3,7,10
wi08,81,MUIR,POLI,PolSc-Comp,0,0,0,0,0,0,1,0,1,0,0,0,1,1,2,0,0,0,2,1,3
wi08,81,MUIR,POLI,PolSc-Intl,0,0,0,3,0,3,2,5,7,6,8,14,14,14,28,0,0,0,25,27,52
wi08,81,MUIR,POLI,PolSc-PLaw,0,0,0,2,3,5,2,6,8,9,1,10,4,4,8,0,0,0,17,14,31
wi08,81,MUIR,POLI,PolSc-PPol,0,0,0,0,0,0,1,0,1,0,0,0,0,0,0,0,0,0,1,0,1
wi08,81,MUIR,POLI,PolSc-Thry,0,0,0,0,0,0,0,1,1,2,0,2,1,1,2,0,0,0,3,2,5
wi08,81,MUIR,PSYC,Psychology,0,0,0,6,28,34,14,41,55,22,71,93,36,88,124,0,0,0,78,228,306
wi08,81,MUIR,RELI,Relig/Stu,0,0,0,1,0,1,1,0,1,2,1,3,1,2,3,0,0,0,5,3,8
wi08,81,MUIR,RUSS,Russ&SovSt,0,0,0,0,0,0,0,0,0,0,0,0,0,1,1,0,0,0,0,1,1
wi08,81,MUIR,SE,Engin Sci,0,0,0,1,0,1,0,0,0,1,0,1,0,0,0,0,0,0,2,0,2
wi08,81,MUIR,SE,Struct Eng,0,0,0,5,1,6,11,4,15,11,6,17,29,4,33,0,0,0,56,15,71
wi08,81,MUIR,SOC,Sociology,0,0,0,0,1,1,1,6,7,7,22,29,12,25,37,0,0,0,20,54,74
wi08,81,MUIR,THEA,Dance,0,0,0,0,0,0,0,0,0,0,2,2,0,3,3,0,0,0,0,5,5
wi08,81,MUIR,THEA,Theatre,0,0,0,0,1,1,3,5,8,7,9,16,7,11,18,0,0,0,17,26,43
wi08,81,MUIR,TWS,ThirdWldSt,0,0,0,0,1,1,0,0,0,0,0,0,0,1,1,0,0,0,0,2,2
wi08,81,MUIR,UNAF,Limited St,0,0,0,0,0,0,0,0,0,0,0,0,0,0,0,1,1,2,1,1,2
wi08,81,MUIR,UNAF,UndecBiolS,0,0,0,7,9,16,9,20,29,3,2,5,0,0,0,0,0,0,19,31,50
wi08,81,MUIR,UNAF,UndecHumAr,0,0,0,1,9,10,4,7,11,0,1,1,0,0,0,0,0,0,5,17,22
wi08,81,MUIR,UNAF,Undeclared,0,0,0,31,34,65,29,51,80,9,6,15,0,0,0,0,0,0,69,91,160
wi08,81,MUIR,UNAF,UndecPhysS,0,0,0,4,3,7,4,4,8,1,0,1,0,0,0,0,0,0,9,7,16
wi08,81,MUIR,UNAF,UndecSocSc,0,0,0,5,8,13,10,5,15,0,2,2,0,0,0,0,0,0,15,15,30
wi08,81,MUIR,USP,Urb Stu&Pl,0,0,0,0,0,0,2,2,4,5,7,12,11,4,15,0,0,0,18,13,31
wi08,81,MUIR,VIS,Art Hst/Cr,0,0,0,0,0,0,0,4,4,0,4,4,1,7,8,0,0,0,1,15,16
wi08,81,MUIR,VIS,Media,0,0,0,2,4,6,4,11,15,13,8,21,10,5,15,0,0,0,29,28,57
wi08,81,MUIR,VIS,Studio VA,0,0,0,2,1,3,0,2,2,0,6,6,2,8,10,0,0,0,4,17,21
wi08,81,MUIR,VIS,VA-CompArt,0,0,0,1,0,1,3,2,5,4,0,4,1,1,2,0,0,0,9,3,12
wi08,81,REVELLE,ANTH,Anth-Arch,0,0,0,0,0,0,0,0,0,0,1,1,0,3,3,0,0,0,0,4,4
wi08,81,REVELLE,ANTH,Anth-Biol,0,0,0,0,0,0,0,1,1,0,1,1,0,7,7,0,0,0,0,9,9
wi08,81,REVELLE,ANTH,Anth-Soci,0,0,0,1,1,2,0,1,1,2,0,2,0,0,0,0,0,0,3,2,5
wi08,81,REVELLE,ANTH,Anthropol,0,0,0,0,0,0,0,0,0,0,0,0,0,3,3,0,0,0,0,3,3
wi08,81,REVELLE,BENG,Bioen:Binf,0,0,0,0,0,0,0,0,0,0,0,0,2,0,2,0,0,0,2,0,2
wi08,81,REVELLE,BENG,Bioeng:PM,0,0,0,0,0,0,0,0,0,4,4,8,28,14,42,0,0,0,32,18,50
wi08,81,REVELLE,BENG,BioengBiot,0,0,0,1,1,2,3,3,6,3,3,6,19,4,23,0,0,0,26,11,37
wi08,81,REVELLE,BENG,Bioengin,0,0,0,2,3,5,4,5,9,5,6,11,13,8,21,0,0,0,24,22,46
wi08,81,REVELLE,BENG,Pr-BioenBf,0,0,0,0,0,0,0,0,0,1,0,1,0,0,0,0,0,0,1,0,1
wi08,81,REVELLE,BENG,Pr-BioenPM,0,0,0,13,12,25,23,7,30,9,7,16,2,0,2,0,0,0,47,26,73
wi08,81,REVELLE,BIOL,Anml Physl,0,0,0,0,0,0,0,0,0,0,0,0,8,10,18,0,0,0,8,10,18
wi08,81,REVELLE,BIOL,Bioc/CellB,0,0,0,11,15,26,17,27,44,36,34,70,75,69,144,0,0,0,139,145,284
wi08,81,REVELLE,BIOL,BiolBioinf,0,0,0,0,0,0,0,0,0,0,0,0,2,0,2,0,0,0,2,0,2
wi08,81,REVELLE,BIOL,Ec/Beh/Evo,0,0,0,1,0,1,0,0,0,5,3,8,6,5,11,0,0,0,12,8,20
wi08,81,REVELLE,BIOL,Genl Biol,0,0,0,20,30,50,11,31,42,33,38,71,28,66,94,0,0,0,92,165,257
wi08,81,REVELLE,BIOL,Human Bio,0,0,0,22,52,74,39,60,99,56,75,131,67,112,179,0,1,1,184,300,484
wi08,81,REVELLE,BIOL,Microbiol,0,0,0,4,1,5,2,3,5,3,8,11,10,10,20,0,0,0,19,22,41
wi08,81,REVELLE,BIOL,Molec Biol,0,0,0,3,5,8,7,5,12,8,4,12,15,20,35,0,0,0,33,34,67
wi08,81,REVELLE,BIOL,PhyslNeuro,0,0,0,3,9,12,10,10,20,12,16,28,9,20,29,0,0,0,34,55,89
wi08,81,REVELLE,CENG,Chem Engin,0,0,0,6,5,11,4,4,8,6,4,10,8,6,14,0,0,0,24,19,43
wi08,81,REVELLE,CGS,CritGendSt,0,0,0,0,0,0,0,1,1,0,2,2,0,2,2,0,0,0,0,5,5
wi08,81,REVELLE,CHEM,Bioch/Chem,0,0,0,12,20,32,11,17,28,8,18,26,21,25,46,0,0,0,52,80,132
wi08,81,REVELLE,CHEM,Chem Phys,0,0,0,0,0,0,0,0,0,1,0,1,3,0,3,0,0,0,4,0,4
wi08,81,REVELLE,CHEM,Chemistry,0,0,0,4,3,7,7,7,14,6,5,11,9,10,19,0,0,0,26,25,51
wi08,81,REVELLE,CHEM,Envir Chem,0,0,0,1,0,1,0,1,1,1,0,1,0,1,1,0,0,0,2,2,4
wi08,81,REVELLE,CHEM,MolecSynth,0,0,0,0,0,0,0,0,0,2,0,2,1,0,1,0,0,0,3,0,3
wi08,81,REVELLE,CHEM,Pharm Chem,0,0,0,7,9,16,7,15,22,15,18,33,21,21,42,0,0,0,50,63,113
wi08,81,REVELLE,CHIN,Chinese St,0,0,0,0,1,1,0,0,0,0,0,0,1,2,3,0,0,0,1,3,4
wi08,81,REVELLE,COGS,Cog Sci,0,0,0,0,2,2,3,1,4,1,3,4,4,4,8,0,0,0,8,10,18
wi08,81,REVELLE,COGS,CogSc/ClAs,0,0,0,1,0,1,0,0,0,0,0,0,1,1,2,0,0,0,2,1,3
wi08,81,REVELLE,COGS,CogSc/Clin,0,0,0,0,0,0,0,1,1,0,0,0,0,0,0,0,0,0,0,1,1
wi08,81,REVELLE,COGS,CogSc/HCI,0,0,0,0,0,0,0,1,1,3,0,3,4,2,6,0,0,0,7,3,10
wi08,81,REVELLE,COGS,CogSc/HCog,0,0,0,0,0,0,0,0,0,0,0,0,0,1,1,0,0,0,0,1,1
wi08,81,REVELLE,COGS,CogSc/Neur,0,0,0,0,1,1,1,1,2,0,3,3,6,5,11,0,0,0,7,10,17
wi08,81,REVELLE,COMM,Communic,0,0,0,1,6,7,1,11,12,5,20,25,4,10,14,0,0,0,11,47,58
wi08,81,REVELLE,CSE,Comp Sci,0,0,0,5,0,5,10,1,11,7,0,7,24,2,26,0,0,0,46,3,49
wi08,81,REVELLE,CSE,CompEngCSE,0,0,0,4,1,5,4,1,5,2,2,4,4,0,4,0,0,0,14,4,18
wi08,81,REVELLE,CSE,CompScBinf,0,0,0,0,0,0,0,0,0,0,0,0,4,0,4,0,0,0,4,0,4
wi08,81,REVELLE,ECE,CompEngECE,0,0,0,0,0,0,2,0,2,0,0,0,3,0,3,0,0,0,5,0,5
wi08,81,REVELLE,ECE,Electr Eng,0,0,0,1,0,1,6,0,6,10,1,11,30,2,32,0,0,0,47,3,50
wi08,81,REVELLE,ECE,Engin Phys,0,0,0,0,0,0,1,0,1,0,0,0,1,0,1,0,0,0,2,0,2
wi08,81,REVELLE,ECE,Pr-ElecEng,0,0,0,0,0,0,0,0,0,1,1,2,0,0,0,0,0,0,1,1,2
wi08,81,REVELLE,ECE,Pr-EngPhys,0,0,0,1,0,1,0,0,0,1,0,1,0,0,0,0,0,0,2,0,2
wi08,81,REVELLE,ECON,Ec-Mth&Ecn,0,0,0,0,1,1,3,1,4,1,1,2,2,3,5,0,0,0,6,6,12
wi08,81,REVELLE,ECON,Econ-MgtSc,0,0,0,3,1,4,9,7,16,12,24,36,35,22,57,0,0,0,59,54,113
wi08,81,REVELLE,ECON,Economics,0,0,0,2,3,5,11,7,18,34,16,50,31,21,52,0,0,0,78,47,125
wi08,81,REVELLE,ERTH,ErSc-Geol,0,0,0,0,0,0,0,0,0,0,0,0,0,1,1,0,0,0,0,1,1
wi08,81,REVELLE,ERTH,ErSc-GeoPh,0,0,0,0,0,0,0,0,0,0,0,0,1,0,1,0,0,0,1,0,1
wi08,81,REVELLE,ERTH,ErthSc-Chm,0,0,0,0,0,0,0,0,0,0,0,0,0,1,1,0,0,0,0,1,1
wi08,81,REVELLE,ERTH,ErthSc-Phy,0,0,0,0,0,0,0,0,0,0,0,0,1,0,1,0,0,0,1,0,1
wi08,81,REVELLE,ESYS,EnvSys(EB),0,0,0,1,0,1,0,2,2,3,4,7,3,2,5,0,0,0,7,8,15
wi08,81,REVELLE,ESYS,EnvSys(EC),0,0,0,0,0,0,0,0,0,0,1,1,0,1,1,0,0,0,0,2,2
wi08,81,REVELLE,ESYS,EnvSys(EP),0,0,0,0,0,0,1,0,1,0,0,0,1,3,4,0,0,0,2,3,5
wi08,81,REVELLE,ESYS,EnvSys(ES),0,0,0,0,0,0,0,0,0,1,1,2,2,0,2,0,0,0,3,1,4
wi08,81,REVELLE,ETHN,Ethnic St,0,0,0,0,0,0,0,0,0,0,2,2,0,1,1,0,0,0,0,3,3
wi08,81,REVELLE,HDP,Human Dev,0,0,0,0,0,0,0,0,0,0,2,2,2,13,15,0,0,0,2,15,17
wi08,81,REVELLE,HDP,Pr-HumnDev,0,0,0,1,3,4,0,8,8,1,5,6,0,6,6,0,0,0,2,22,24
wi08,81,REVELLE,HIST,History,0,0,0,2,1,3,2,4,6,8,5,13,9,5,14,0,0,0,21,15,36
wi08,81,REVELLE,INTL,IntSt-Anth,0,0,0,0,0,0,0,0,0,1,0,1,0,3,3,0,0,0,1,3,4
wi08,81,REVELLE,INTL,IntSt-Econ,0,0,0,0,2,2,1,0,1,4,3,7,6,7,13,0,0,0,11,12,23
wi08,81,REVELLE,INTL,IntSt-Hist,0,0,0,0,0,0,0,1,1,0,0,0,0,5,5,0,0,0,0,6,6
wi08,81,REVELLE,INTL,IntSt-Ling,0,0,0,0,0,0,0,1,1,0,1,1,0,1,1,0,0,0,0,3,3
wi08,81,REVELLE,INTL,IntSt-Lit,0,0,0,0,0,0,0,0,0,0,2,2,0,2,2,0,0,0,0,4,4
wi08,81,REVELLE,INTL,IntSt-PolS,0,0,0,0,0,0,1,6,7,0,3,3,2,8,10,0,0,0,3,17,20
wi08,81,REVELLE,INTL,IntSt-Soc,0,0,0,0,1,1,0,2,2,1,2,3,0,1,1,0,0,0,1,6,7
wi08,81,REVELLE,ITAL,Italian St,0,0,0,0,0,0,0,0,0,0,0,0,0,1,1,0,0,0,0,1,1
wi08,81,REVELLE,JAPN,JapaneseSt,0,0,0,0,1,1,1,0,1,0,0,0,2,0,2,0,0,0,3,1,4
wi08,81,REVELLE,LATI,LatinAm St,0,0,0,0,0,0,0,0,0,0,0,0,0,1,1,0,0,0,0,1,1
wi08,81,REVELLE,LING,Lang Stu,0,0,0,0,0,0,0,0,0,0,1,1,0,1,1,0,0,0,0,2,2
wi08,81,REVELLE,LING,Ling-CogLn,0,0,0,0,0,0,1,0,1,0,1,1,0,0,0,0,0,0,1,1,2
wi08,81,REVELLE,LING,Ling-LSoc,0,0,0,0,1,1,0,0,0,0,0,0,0,0,0,0,0,0,0,1,1
wi08,81,REVELLE,LING,Linguistcs,0,0,0,0,0,0,0,0,0,0,0,0,2,1,3,0,0,0,2,1,3
wi08,81,REVELLE,LIT,Ital Lit,0,0,0,0,0,0,0,0,0,0,1,1,0,0,0,0,0,0,0,1,1
wi08,81,REVELLE,LIT,Lit/Compos,0,0,0,0,1,1,1,0,1,0,0,0,0,0,0,0,0,0,1,1,2
wi08,81,REVELLE,LIT,Lit/CultSt,0,0,0,0,0,0,0,0,0,0,1,1,0,0,0,0,0,0,0,1,1
wi08,81,REVELLE,LIT,Lit/Engl,0,0,0,1,1,2,1,0,1,1,11,12,3,8,11,0,0,0,6,20,26
wi08,81,REVELLE,LIT,Lit/World,0,0,0,0,0,0,0,0,0,0,0,0,0,3,3,0,0,0,0,3,3
wi08,81,REVELLE,LIT,Lit/Writng,0,0,0,0,0,0,0,0,0,0,1,1,6,4,10,0,0,0,6,5,11
wi08,81,REVELLE,LIT,Pre-Lit/Wr,0,0,0,2,1,3,2,2,4,1,3,4,4,1,5,0,0,0,9,7,16
wi08,81,REVELLE,LIT,Russian Lt,0,0,0,0,0,0,0,0,0,0,0,0,1,0,1,0,0,0,1,0,1
wi08,81,REVELLE,LIT,Spanish Lt,0,0,0,0,1,1,0,1,1,0,1,1,0,1,1,0,0,0,0,4,4
wi08,81,REVELLE,MAE,Aerosp Eng,0,0,0,3,0,3,10,2,12,10,4,14,27,6,33,0,0,0,50,12,62
wi08,81,REVELLE,MAE,Engin Sci,0,0,0,0,0,0,1,0,1,1,1,2,0,0,0,0,0,0,2,1,3
wi08,81,REVELLE,MAE,Envir Eng,0,0,0,0,0,0,0,1,1,1,0,1,0,1,1,0,0,0,1,2,3
wi08,81,REVELLE,MAE,Mech Engin,0,0,0,8,1,9,10,2,12,23,5,28,47,7,54,0,0,0,88,15,103
wi08,81,REVELLE,MATH,Appld Math,0,0,0,0,0,0,2,1,3,3,1,4,1,2,3,0,0,0,6,4,10
wi08,81,REVELLE,MATH,Math/SecEd,0,0,0,0,1,1,0,1,1,0,2,2,1,2,3,0,0,0,1,6,7
wi08,81,REVELLE,MATH,Mathematcs,0,0,0,6,5,11,5,7,12,6,5,11,9,2,11,0,0,0,26,19,45
wi08,81,REVELLE,MATH,Mth-CompSc,0,0,0,0,0,0,0,0,0,1,0,1,6,0,6,0,0,0,7,0,7
wi08,81,REVELLE,MATH,Mth-Mth&Ec,0,0,0,1,1,2,2,1,3,1,1,2,4,3,7,0,0,0,8,6,14
wi08,81,REVELLE,MATH,Mth-SciCom,0,0,0,0,0,0,0,1,1,1,0,1,0,0,0,0,0,0,1,1,2
wi08,81,REVELLE,MATH,Mth/ApldSc,0,0,0,1,1,2,0,1,1,0,1,1,0,1,1,0,0,0,1,4,5
wi08,81,REVELLE,MATH,Pr-Math CS,0,0,0,0,0,0,0,0,0,1,0,1,0,0,0,0,0,0,1,0,1
wi08,81,REVELLE,MUS,Mu-CompArt,0,0,0,0,0,0,0,0,0,2,1,3,3,0,3,0,0,0,5,1,6
wi08,81,REVELLE,MUS,Music,0,0,0,0,0,0,1,1,2,1,1,2,2,0,2,0,0,0,4,2,6
wi08,81,REVELLE,MUS,Music Hum,0,0,0,0,0,0,1,0,1,0,0,0,0,0,0,0,0,0,1,0,1
wi08,81,REVELLE,PHIL,Philosophy,0,0,0,1,0,1,1,1,2,2,1,3,2,3,5,0,0,0,6,5,11
wi08,81,REVELLE,PHYS,Biophysics,0,0,0,0,0,0,1,0,1,0,2,2,2,0,2,0,0,0,3,2,5
wi08,81,REVELLE,PHYS,Gen Physcs,0,0,0,0,0,0,0,0,0,1,0,1,0,0,0,0,0,0,1,0,1
wi08,81,REVELLE,PHYS,Phys/Astro,0,0,0,2,0,2,1,1,2,2,0,2,3,2,5,0,0,0,8,3,11
wi08,81,REVELLE,PHYS,Phys/Comp,0,0,0,0,0,0,0,0,0,0,0,0,1,0,1,0,0,0,1,0,1
wi08,81,REVELLE,PHYS,Phys/Mtrls,0,0,0,0,0,0,0,0,0,1,0,1,1,0,1,0,0,0,2,0,2
wi08,81,REVELLE,PHYS,Physics,0,0,0,0,1,1,3,1,4,4,1,5,10,2,12,0,0,0,17,5,22
wi08,81,REVELLE,POLI,Polit Sci,0,0,0,4,2,6,2,5,7,5,2,7,10,16,26,0,0,0,21,25,46
wi08,81,REVELLE,POLI,PolSc-Amer,0,0,0,0,0,0,0,3,3,0,0,0,2,3,5,0,0,0,2,6,8
wi08,81,REVELLE,POLI,PolSc-Comp,0,0,0,0,0,0,0,0,0,0,0,0,1,0,1,0,0,0,1,0,1
wi08,81,REVELLE,POLI,PolSc-Intl,0,0,0,0,1,1,0,2,2,7,2,9,5,4,9,0,0,0,12,9,21
wi08,81,REVELLE,POLI,PolSc-PLaw,0,0,0,1,1,2,0,0,0,3,4,7,1,0,1,0,0,0,5,5,10
wi08,81,REVELLE,POLI,PolSc-PPol,0,0,0,0,1,1,0,0,0,1,0,1,0,0,0,0,0,0,1,1,2
wi08,81,REVELLE,POLI,PolSc-Thry,0,0,0,0,0,0,0,0,0,0,1,1,0,0,0,0,0,0,0,1,1
wi08,81,REVELLE,PSYC,Psychology,0,0,0,4,11,15,7,33,40,21,45,66,27,94,121,0,0,0,59,183,242
wi08,81,REVELLE,SE,Struct Eng,0,0,0,2,3,5,9,3,12,11,4,15,19,5,24,0,0,0,41,15,56
wi08,81,REVELLE,SIO,ErSc-Geol,0,0,0,0,0,0,0,0,0,1,1,2,0,0,0,0,0,0,1,1,2
wi08,81,REVELLE,SOC,Sociology,0,0,0,0,0,0,0,1,1,1,6,7,0,6,6,0,0,0,1,13,14
wi08,81,REVELLE,THEA,Dance,0,0,0,0,0,0,1,0,1,0,0,0,0,0,0,0,0,0,1,0,1
wi08,81,REVELLE,THEA,Theatre,0,0,0,1,0,1,1,3,4,1,2,3,1,2,3,0,0,0,4,7,11
wi08,81,REVELLE,UNAF,Limited St,0,0,0,0,0,0,0,0,0,0,0,0,0,0,0,5,12,17,5,12,17
wi08,81,REVELLE,UNAF,Spec-Emply,0,0,0,0,0,0,0,0,0,0,0,0,0,0,0,2,4,6,2,4,6
wi08,81,REVELLE,UNAF,UndecBiolS,0,0,0,17,17,34,16,23,39,2,3,5,0,0,0,0,0,0,35,43,78
wi08,81,REVELLE,UNAF,UndecHumAr,0,0,0,0,9,9,2,4,6,0,0,0,0,0,0,0,0,0,2,13,15
wi08,81,REVELLE,UNAF,Undeclared,1,0,1,17,38,55,27,28,55,5,2,7,0,0,0,0,0,0,50,68,118
wi08,81,REVELLE,UNAF,UndecPhysS,0,0,0,4,3,7,8,4,12,0,1,1,0,0,0,0,0,0,12,8,20
wi08,81,REVELLE,UNAF,UndecSocSc,0,0,0,5,2,7,1,9,10,2,0,2,0,0,0,0,0,0,8,11,19
wi08,81,REVELLE,USP,Urb Stu&Pl,0,0,0,0,2,2,0,0,0,3,2,5,2,4,6,0,0,0,5,8,13
wi08,81,REVELLE,VIS,Art Hst/Cr,0,0,0,0,0,0,0,1,1,0,0,0,0,9,9,0,0,0,0,10,10
wi08,81,REVELLE,VIS,Media,0,0,0,1,0,1,1,1,2,1,2,3,5,2,7,0,0,0,8,5,13
wi08,81,REVELLE,VIS,Studio VA,0,0,0,0,0,0,0,1,1,1,0,1,2,4,6,0,0,0,3,5,8
wi08,81,REVELLE,VIS,VA-CompArt,0,0,0,0,0,0,0,0,0,1,0,1,1,2,3,0,0,0,2,2,4
wi08,81,ROOSEVELT,ANTH,Anth-Arch,0,0,0,0,0,0,2,3,5,1,4,5,0,3,3,0,0,0,3,10,13
wi08,81,ROOSEVELT,ANTH,Anth-Biol,0,0,0,0,0,0,0,2,2,0,5,5,3,6,9,0,0,0,3,13,16
wi08,81,ROOSEVELT,ANTH,Anth-Soci,0,0,0,0,0,0,0,2,2,0,2,2,0,0,0,0,0,0,0,4,4
wi08,81,ROOSEVELT,ANTH,Anthropol,0,0,0,0,0,0,0,1,1,0,4,4,2,3,5,0,0,0,2,8,10
wi08,81,ROOSEVELT,BENG,Bioen:Binf,0,0,0,0,0,0,0,0,0,0,0,0,1,0,1,0,0,0,1,0,1
wi08,81,ROOSEVELT,BENG,Bioeng:PM,0,0,0,0,0,0,0,0,0,1,1,2,4,5,9,0,0,0,5,6,11
wi08,81,ROOSEVELT,BENG,BioengBiot,0,0,0,1,0,1,0,0,0,1,1,2,4,3,7,0,0,0,6,4,10
wi08,81,ROOSEVELT,BENG,Bioengin,0,0,0,1,0,1,1,1,2,1,1,2,5,1,6,0,0,0,8,3,11
wi08,81,ROOSEVELT,BENG,Pr-BioenPM,0,0,0,7,5,12,3,2,5,6,5,11,2,1,3,0,0,0,18,13,31
wi08,81,ROOSEVELT,BIOL,Anml Physl,0,0,0,0,0,0,0,0,0,0,0,0,5,8,13,0,0,0,5,8,13
wi08,81,ROOSEVELT,BIOL,Bioc/CellB,0,0,0,4,9,13,5,10,15,12,17,29,22,36,58,0,0,0,43,72,115
wi08,81,ROOSEVELT,BIOL,BiolBioinf,0,0,0,0,0,0,0,0,0,0,0,0,1,0,1,0,0,0,1,0,1
wi08,81,ROOSEVELT,BIOL,Ec/Beh/Evo,0,0,0,1,1,2,0,1,1,1,2,3,5,5,10,0,0,0,7,9,16
wi08,81,ROOSEVELT,BIOL,Genl Biol,0,0,0,2,10,12,8,6,14,14,28,42,24,33,57,0,0,0,48,77,125
wi08,81,ROOSEVELT,BIOL,Human Bio,0,0,0,6,24,30,13,28,41,16,45,61,24,42,66,0,0,0,59,139,198
wi08,81,ROOSEVELT,BIOL,Microbiol,0,0,0,1,0,1,0,0,0,1,7,8,3,3,6,0,0,0,5,10,15
wi08,81,ROOSEVELT,BIOL,Molec Biol,0,0,0,0,2,2,2,2,4,5,4,9,6,7,13,0,0,0,13,15,28
wi08,81,ROOSEVELT,BIOL,PhyslNeuro,0,0,0,1,2,3,0,9,9,4,9,13,10,8,18,0,0,0,15,28,43
wi08,81,ROOSEVELT,CENG,Chem Engin,0,0,0,0,1,1,3,4,7,0,3,3,2,4,6,0,0,0,5,12,17
wi08,81,ROOSEVELT,CGS,CritGendSt,0,0,0,0,0,0,0,0,0,0,2,2,0,1,1,0,0,0,0,3,3
wi08,81,ROOSEVELT,CHEM,Bioch/Chem,0,0,0,1,10,11,3,3,6,3,8,11,5,7,12,0,0,0,12,28,40
wi08,81,ROOSEVELT,CHEM,Chem Phys,0,0,0,0,0,0,0,0,0,0,0,0,1,0,1,0,0,0,1,0,1
wi08,81,ROOSEVELT,CHEM,Chemistry,0,0,0,1,1,2,3,2,5,1,4,5,3,2,5,0,0,0,8,9,17
wi08,81,ROOSEVELT,CHEM,Chm/ErthSc,0,0,0,0,1,1,0,0,0,0,0,0,0,0,0,0,0,0,0,1,1
wi08,81,ROOSEVELT,CHEM,Envir Chem,0,0,0,0,0,0,0,0,0,0,0,0,1,0,1,0,0,0,1,0,1
wi08,81,ROOSEVELT,CHEM,MolecSynth,0,0,0,0,0,0,0,0,0,1,0,1,0,0,0,0,0,0,1,0,1
wi08,81,ROOSEVELT,CHEM,Pharm Chem,0,0,0,0,3,3,2,2,4,6,2,8,13,8,21,0,0,0,21,15,36
wi08,81,ROOSEVELT,CHIN,Chinese St,0,0,0,0,0,0,1,0,1,0,2,2,3,1,4,0,0,0,4,3,7
wi08,81,ROOSEVELT,CLAS,Classic St,0,0,0,0,0,0,0,1,1,0,0,0,0,0,0,0,0,0,0,1,1
wi08,81,ROOSEVELT,COGS,Cog Sci,0,0,0,0,3,3,1,3,4,2,4,6,4,7,11,0,0,0,7,17,24
wi08,81,ROOSEVELT,COGS,CogSc/ClAs,0,0,0,0,0,0,0,0,0,0,1,1,1,0,1,0,0,0,1,1,2
wi08,81,ROOSEVELT,COGS,CogSc/Comp,0,0,0,0,0,0,0,0,0,0,0,0,1,1,2,0,0,0,1,1,2
wi08,81,ROOSEVELT,COGS,CogSc/HCI,0,0,0,0,0,0,0,0,0,0,2,2,2,0,2,0,0,0,2,2,4
wi08,81,ROOSEVELT,COGS,CogSc/HCog,0,0,0,0,0,0,0,0,0,0,0,0,1,1,2,0,0,0,1,1,2
wi08,81,ROOSEVELT,COGS,CogSc/Neur,0,0,0,0,0,0,0,1,1,0,1,1,6,4,10,0,0,0,6,6,12
wi08,81,ROOSEVELT,COMM,Communic,0,0,0,1,13,14,6,30,36,8,45,53,17,46,63,0,0,0,32,134,166
wi08,81,ROOSEVELT,CSE,Comp Sci,0,0,0,3,0,3,4,1,5,5,1,6,22,2,24,0,0,0,34,4,38
wi08,81,ROOSEVELT,CSE,CompEngCSE,0,0,0,2,0,2,2,0,2,3,1,4,4,1,5,0,0,0,11,2,13
wi08,81,ROOSEVELT,ECE,CompEngECE,0,0,0,1,0,1,0,0,0,0,0,0,0,1,1,0,0,0,1,1,2
wi08,81,ROOSEVELT,ECE,Electr Eng,0,0,0,3,2,5,1,0,1,17,2,19,20,5,25,0,0,0,41,9,50
wi08,81,ROOSEVELT,ECON,Ec-Mth&Ecn,0,0,0,1,2,3,1,1,2,4,2,6,3,2,5,0,0,0,9,7,16
wi08,81,ROOSEVELT,ECON,Econ-MgtSc,0,0,0,7,5,12,11,9,20,31,16,47,31,35,66,0,0,0,80,65,145
wi08,81,ROOSEVELT,ECON,Economics,0,0,0,2,9,11,18,12,30,63,32,95,43,42,85,0,0,0,126,95,221
wi08,81,ROOSEVELT,ERTH,Earth Scis,0,0,0,0,0,0,0,0,0,0,0,0,1,0,1,0,0,0,1,0,1
wi08,81,ROOSEVELT,ERTH,ErSc-Geol,0,0,0,0,0,0,0,1,1,0,0,0,1,0,1,0,0,0,1,1,2
wi08,81,ROOSEVELT,ERTH,ErthSc-Phy,0,0,0,0,0,0,0,0,0,0,1,1,0,0,0,0,0,0,0,1,1
wi08,81,ROOSEVELT,ESYS,EnvSys(EB),0,0,0,0,0,0,0,1,1,2,1,3,2,9,11,0,0,0,4,11,15
wi08,81,ROOSEVELT,ESYS,EnvSys(EC),0,0,0,0,0,0,0,1,1,0,1,1,2,1,3,0,0,0,2,3,5
wi08,81,ROOSEVELT,ESYS,EnvSys(EP),0,0,0,0,0,0,0,1,1,0,0,0,1,1,2,0,0,0,1,2,3
wi08,81,ROOSEVELT,ESYS,EnvSys(ES),0,0,0,0,0,0,0,0,0,1,0,1,1,0,1,0,0,0,2,0,2
wi08,81,ROOSEVELT,ETHN,Ethnic St,0,0,0,0,0,0,0,3,3,1,5,6,3,4,7,0,0,0,4,12,16
wi08,81,ROOSEVELT,GMST,German Stu,0,0,0,0,1,1,0,0,0,0,0,0,1,0,1,0,0,0,1,1,2
wi08,81,ROOSEVELT,HDP,Human Dev,0,0,0,0,0,0,0,3,3,1,4,5,2,24,26,0,0,0,3,31,34
wi08,81,ROOSEVELT,HDP,Pr-HumnDev,0,0,0,0,2,2,2,8,10,2,4,6,0,4,4,0,0,0,4,18,22
wi08,81,ROOSEVELT,HIST,History,0,0,0,1,4,5,6,6,12,11,19,30,21,27,48,0,0,0,39,56,95
wi08,81,ROOSEVELT,INTL,IntSt-Anth,0,0,0,0,0,0,0,1,1,1,6,7,0,5,5,0,0,0,1,12,13
wi08,81,ROOSEVELT,INTL,IntSt-Econ,0,0,0,6,13,19,9,23,32,12,25,37,5,15,20,0,0,0,32,76,108
wi08,81,ROOSEVELT,INTL,IntSt-Hist,0,0,0,1,0,1,1,4,5,1,2,3,2,14,16,0,0,0,5,20,25
wi08,81,ROOSEVELT,INTL,IntSt-Ling,0,0,0,0,1,1,1,7,8,1,5,6,0,3,3,0,0,0,2,16,18
wi08,81,ROOSEVELT,INTL,IntSt-Lit,0,0,0,0,1,1,0,2,2,0,4,4,0,2,2,0,0,0,0,9,9
wi08,81,ROOSEVELT,INTL,IntSt-PolS,0,0,0,3,13,16,5,13,18,12,31,43,13,24,37,0,0,0,33,81,114
wi08,81,ROOSEVELT,INTL,IntSt-Soc,0,0,0,1,6,7,1,11,12,1,15,16,5,19,24,0,0,0,8,51,59
wi08,81,ROOSEVELT,ITAL,Italian St,0,0,0,0,0,0,0,0,0,0,0,0,0,1,1,0,0,0,0,1,1
wi08,81,ROOSEVELT,JAPN,JapaneseSt,0,0,0,0,1,1,1,1,2,1,1,2,1,3,4,0,0,0,3,6,9
wi08,81,ROOSEVELT,JUDA,Judaic Stu,0,0,0,0,0,0,0,1,1,0,0,0,0,1,1,0,0,0,0,2,2
wi08,81,ROOSEVELT,LATI,LatinAm St,0,0,0,1,1,2,1,0,1,0,1,1,0,3,3,0,0,0,2,5,7
wi08,81,ROOSEVELT,LING,Lang Stu,0,0,0,0,2,2,0,1,1,1,0,1,2,0,2,0,0,0,3,3,6
wi08,81,ROOSEVELT,LING,Ling-LSoc,0,0,0,0,0,0,1,2,3,1,0,1,2,2,4,0,0,0,4,4,8
wi08,81,ROOSEVELT,LING,Linguistcs,0,0,0,0,1,1,0,0,0,1,4,5,0,4,4,0,0,0,1,9,10
wi08,81,ROOSEVELT,LIT,French Lit,0,0,0,0,0,0,0,0,0,0,1,1,0,0,0,0,0,0,0,1,1
wi08,81,ROOSEVELT,LIT,German Lit,0,0,0,0,0,0,0,0,0,0,0,0,1,0,1,0,0,0,1,0,1
wi08,81,ROOSEVELT,LIT,Lit/Compos,0,0,0,1,1,2,0,0,0,0,0,0,0,0,0,0,0,0,1,1,2
wi08,81,ROOSEVELT,LIT,Lit/Engl,0,0,0,0,5,5,1,2,3,1,3,4,1,11,12,0,0,0,3,21,24
wi08,81,ROOSEVELT,LIT,Lit/World,0,0,0,0,0,0,0,2,2,0,1,1,1,4,5,0,0,0,1,7,8
wi08,81,ROOSEVELT,LIT,Lit/Writng,0,0,0,0,0,0,0,0,0,0,1,1,6,11,17,0,0,0,6,12,18
wi08,81,ROOSEVELT,LIT,Pre-Lit/Wr,0,0,0,0,3,3,1,6,7,4,5,9,4,3,7,0,0,0,9,17,26
wi08,81,ROOSEVELT,LIT,Spanish Lt,0,0,0,0,1,1,0,2,2,1,1,2,1,5,6,0,0,0,2,9,11
wi08,81,ROOSEVELT,MAE,Aerosp Eng,0,0,0,3,1,4,6,1,7,2,3,5,13,2,15,0,0,0,24,7,31
wi08,81,ROOSEVELT,MAE,Engin Sci,0,0,0,0,0,0,0,1,1,0,0,0,1,0,1,0,0,0,1,1,2
wi08,81,ROOSEVELT,MAE,Envir Eng,0,0,0,0,0,0,0,1,1,0,0,0,0,0,0,0,0,0,0,1,1
wi08,81,ROOSEVELT,MAE,Mech Engin,0,0,0,4,0,4,2,3,5,9,6,15,30,7,37,0,0,0,45,16,61
wi08,81,ROOSEVELT,MATH,Appld Math,0,0,0,0,2,2,1,0,1,0,1,1,1,2,3,0,0,0,2,5,7
wi08,81,ROOSEVELT,MATH,Math/SecEd,0,0,0,0,1,1,0,2,2,0,3,3,0,0,0,0,0,0,0,6,6
wi08,81,ROOSEVELT,MATH,Mathematcs,0,0,0,2,1,3,1,1,2,6,2,8,4,0,4,0,0,0,13,4,17
wi08,81,ROOSEVELT,MATH,Mth-CompSc,0,0,0,0,0,0,0,0,0,0,0,0,1,1,2,0,0,0,1,1,2
wi08,81,ROOSEVELT,MATH,Mth-Mth&Ec,0,0,0,1,1,2,3,1,4,1,2,3,3,3,6,0,0,0,8,7,15
wi08,81,ROOSEVELT,MATH,Mth-SciCom,0,0,0,0,1,1,0,0,0,0,0,0,0,0,0,0,0,0,0,1,1
wi08,81,ROOSEVELT,MATH,Mth/ApldSc,0,0,0,0,0,0,0,0,0,1,0,1,2,0,2,0,0,0,3,0,3
wi08,81,ROOSEVELT,MATH,Pr-Math CS,0,0,0,0,0,0,0,1,1,0,0,0,0,1,1,0,0,0,0,2,2
wi08,81,ROOSEVELT,MUS,Mu-CompArt,0,0,0,0,0,0,3,0,3,0,0,0,7,0,7,0,0,0,10,0,10
wi08,81,ROOSEVELT,MUS,Music,0,0,0,0,1,1,0,0,0,1,1,2,1,3,4,0,0,0,2,5,7
wi08,81,ROOSEVELT,PHIL,Philosophy,0,0,0,1,1,2,0,4,4,3,1,4,3,1,4,0,0,0,7,7,14
wi08,81,ROOSEVELT,PHYS,Biophysics,0,0,0,0,1,1,1,0,1,0,1,1,1,0,1,0,0,0,2,2,4
wi08,81,ROOSEVELT,PHYS,Gen Physcs,0,0,0,0,0,0,0,0,0,0,1,1,0,0,0,0,0,0,0,1,1
wi08,81,ROOSEVELT,PHYS,Phys/Astro,0,0,0,0,0,0,3,0,3,0,1,1,3,0,3,0,0,0,6,1,7
wi08,81,ROOSEVELT,PHYS,Phys/Comp,0,0,0,0,0,0,0,0,0,0,0,0,1,0,1,0,0,0,1,0,1
wi08,81,ROOSEVELT,PHYS,Physics,0,0,0,0,1,1,1,0,1,3,0,3,1,0,1,0,0,0,5,1,6
wi08,81,ROOSEVELT,POLI,Polit Sci,0,0,0,3,8,11,11,9,20,17,20,37,17,27,44,0,0,0,48,64,112
wi08,81,ROOSEVELT,POLI,PolSc-Amer,0,0,0,1,1,2,0,2,2,0,2,2,2,4,6,0,0,0,3,9,12
wi08,81,ROOSEVELT,POLI,PolSc-Comp,0,0,0,1,0,1,0,0,0,2,1,3,0,3,3,0,0,0,3,4,7
wi08,81,ROOSEVELT,POLI,PolSc-Intl,0,0,0,1,11,12,7,23,30,14,22,36,10,20,30,0,0,0,32,76,108
wi08,81,ROOSEVELT,POLI,PolSc-PLaw,0,0,0,3,7,10,3,4,7,4,12,16,4,8,12,0,0,0,14,31,45
wi08,81,ROOSEVELT,POLI,PolSc-PPol,0,0,0,0,0,0,0,0,0,1,2,3,1,0,1,0,0,0,2,2,4
wi08,81,ROOSEVELT,POLI,PolSc-Thry,0,0,0,0,0,0,0,0,0,0,0,0,3,1,4,0,0,0,3,1,4
wi08,81,ROOSEVELT,PSYC,Psychology,0,0,0,10,19,29,8,31,39,13,40,53,22,65,87,0,0,0,53,155,208
wi08,81,ROOSEVELT,RELI,Relig/Stu,0,0,0,0,0,0,0,1,1,1,0,1,0,2,2,0,0,0,1,3,4
wi08,81,ROOSEVELT,RUSS,Russ&SovSt,0,0,0,0,0,0,0,0,0,0,1,1,0,0,0,0,0,0,0,1,1
wi08,81,ROOSEVELT,SE,Struct Eng,0,0,0,5,1,6,5,2,7,10,2,12,15,10,25,0,0,0,35,15,50
wi08,81,ROOSEVELT,SOC,Sociology,0,0,0,0,2,2,1,8,9,3,20,23,9,23,32,0,0,0,13,53,66
wi08,81,ROOSEVELT,THEA,Dance,0,0,0,0,0,0,1,0,1,0,2,2,0,0,0,0,0,0,1,2,3
wi08,81,ROOSEVELT,THEA,Theatre,0,0,0,1,0,1,0,2,2,3,6,9,2,4,6,0,0,0,6,12,18
wi08,81,ROOSEVELT,TWS,ThirdWldSt,0,0,0,1,0,1,0,1,1,0,0,0,1,1,2,0,0,0,2,2,4
wi08,81,ROOSEVELT,UNAF,UndecBiolS,0,0,0,4,14,18,5,13,18,1,2,3,0,0,0,0,0,0,10,29,39
wi08,81,ROOSEVELT,UNAF,UndecHumAr,0,0,0,1,12,13,3,15,18,0,4,4,0,0,0,0,0,0,4,31,35
wi08,81,ROOSEVELT,UNAF,Undeclared,0,0,0,24,46,70,24,29,53,3,3,6,0,0,0,0,0,0,51,78,129
wi08,81,ROOSEVELT,UNAF,UndecPhysS,0,0,0,2,2,4,3,2,5,0,0,0,0,0,0,0,0,0,5,4,9
wi08,81,ROOSEVELT,UNAF,UndecSocSc,0,0,0,7,12,19,6,7,13,2,1,3,0,0,0,0,0,0,15,20,35
wi08,81,ROOSEVELT,USP,Urb Stu&Pl,0,0,0,1,0,1,1,1,2,4,3,7,4,7,11,0,0,0,10,11,21
wi08,81,ROOSEVELT,VIS,Art Hst/Cr,0,0,0,0,2,2,1,3,4,1,7,8,0,5,5,0,0,0,2,17,19
wi08,81,ROOSEVELT,VIS,Media,0,0,0,1,5,6,4,4,8,5,5,10,5,9,14,0,0,0,15,23,38
wi08,81,ROOSEVELT,VIS,Studio VA,0,0,0,0,2,2,1,4,5,0,1,1,2,2,4,0,0,0,3,9,12
wi08,81,ROOSEVELT,VIS,VA-CompArt,0,0,0,0,0,0,1,0,1,0,0,0,1,1,2,0,0,0,2,1,3
wi08,81,SIXTH,ANTH,Anth-Arch,0,0,0,0,0,0,0,1,1,1,0,1,0,1,1,0,0,0,1,2,3
wi08,81,SIXTH,ANTH,Anth-Biol,0,0,0,0,2,2,0,1,1,0,1,1,1,4,5,0,0,0,1,8,9
wi08,81,SIXTH,ANTH,Anth-Soci,0,0,0,0,1,1,0,0,0,1,3,4,1,0,1,0,0,0,2,4,6
wi08,81,SIXTH,ANTH,Anthropol,0,0,0,0,0,0,2,0,2,0,2,2,0,3,3,0,0,0,2,5,7
wi08,81,SIXTH,BENG,Bioen:Binf,0,0,0,0,0,0,0,1,1,0,0,0,2,0,2,0,0,0,2,1,3
wi08,81,SIXTH,BENG,Bioeng:PM,0,0,0,0,0,0,0,0,0,2,2,4,4,2,6,0,0,0,6,4,10
wi08,81,SIXTH,BENG,BioengBiot,0,0,0,1,0,1,2,2,4,3,1,4,10,3,13,0,0,0,16,6,22
wi08,81,SIXTH,BENG,Bioengin,0,0,0,3,0,3,2,2,4,3,1,4,8,4,12,0,0,0,16,7,23
wi08,81,SIXTH,BENG,Pr-BioenPM,0,0,0,5,4,9,13,5,18,5,4,9,1,0,1,0,0,0,24,13,37
wi08,81,SIXTH,BIOL,Anml Physl,0,0,0,0,0,0,0,0,0,1,0,1,6,1,7,0,0,0,7,1,8
wi08,81,SIXTH,BIOL,Bioc/CellB,0,0,0,6,6,12,11,8,19,8,16,24,17,17,34,0,0,0,42,47,89
wi08,81,SIXTH,BIOL,BiolBioinf,0,0,0,0,0,0,0,0,0,0,0,0,0,1,1,0,0,0,0,1,1
wi08,81,SIXTH,BIOL,Ec/Beh/Evo,0,0,0,1,0,1,0,2,2,1,2,3,3,4,7,0,0,0,5,8,13
wi08,81,SIXTH,BIOL,Genl Biol,0,0,0,8,17,25,12,12,24,13,12,25,10,20,30,0,0,0,43,61,104
wi08,81,SIXTH,BIOL,Human Bio,0,0,0,11,20,31,16,21,37,19,28,47,23,22,45,0,0,0,69,91,160
wi08,81,SIXTH,BIOL,Microbiol,0,0,0,1,3,4,1,1,2,0,1,1,2,3,5,0,0,0,4,8,12
wi08,81,SIXTH,BIOL,Molec Biol,0,0,0,1,1,2,4,1,5,5,1,6,5,3,8,0,0,0,15,6,21
wi08,81,SIXTH,BIOL,PhyslNeuro,0,0,0,4,2,6,4,5,9,8,6,14,3,1,4,0,0,0,19,14,33
wi08,81,SIXTH,BIOL,Pr-BioBinf,0,0,0,0,0,0,0,0,0,0,0,0,1,0,1,0,0,0,1,0,1
wi08,81,SIXTH,CENG,Chem Engin,0,0,0,3,0,3,5,2,7,5,2,7,3,1,4,0,0,0,16,5,21
wi08,81,SIXTH,CGS,CritGendSt,0,0,0,0,0,0,0,0,0,0,0,0,0,2,2,0,0,0,0,2,2
wi08,81,SIXTH,CHEM,Bioch/Chem,0,0,0,2,9,11,6,4,10,3,5,8,7,8,15,0,0,0,18,26,44
wi08,81,SIXTH,CHEM,Chem Educ,0,0,0,1,0,1,0,0,0,0,0,0,1,0,1,0,0,0,2,0,2
wi08,81,SIXTH,CHEM,Chem Phys,0,0,0,0,0,0,0,0,0,0,0,0,1,0,1,0,0,0,1,0,1
wi08,81,SIXTH,CHEM,Chemistry,0,0,0,2,4,6,7,4,11,2,4,6,5,3,8,0,0,0,16,15,31
wi08,81,SIXTH,CHEM,Envir Chem,0,0,0,0,0,0,0,0,0,0,0,0,0,1,1,0,0,0,0,1,1
wi08,81,SIXTH,CHEM,MolecSynth,0,0,0,0,0,0,1,0,1,0,0,0,1,0,1,0,0,0,2,0,2
wi08,81,SIXTH,CHEM,Pharm Chem,0,0,0,6,9,15,1,4,5,5,8,13,7,8,15,0,0,0,19,29,48
wi08,81,SIXTH,CHIN,Chinese St,0,0,0,1,0,1,0,0,0,0,0,0,0,1,1,0,0,0,1,1,2
wi08,81,SIXTH,CLAS,Classic St,0,0,0,1,0,1,0,0,0,0,0,0,0,0,0,0,0,0,1,0,1
wi08,81,SIXTH,COGS,Cog Sci,0,0,0,3,1,4,4,3,7,8,4,12,8,2,10,0,0,0,23,10,33
wi08,81,SIXTH,COGS,CogSc/ClAs,0,0,0,0,0,0,0,0,0,0,0,0,1,2,3,0,0,0,1,2,3
wi08,81,SIXTH,COGS,CogSc/Comp,0,0,0,0,0,0,1,0,1,0,0,0,2,0,2,0,0,0,3,0,3
wi08,81,SIXTH,COGS,CogSc/HCI,0,0,0,0,0,0,3,0,3,0,1,1,4,1,5,0,0,0,7,2,9
wi08,81,SIXTH,COGS,CogSc/HCog,0,0,0,0,0,0,0,0,0,0,0,0,1,1,2,0,0,0,1,1,2
wi08,81,SIXTH,COGS,CogSc/Neur,0,0,0,0,1,1,0,2,2,0,1,1,4,1,5,0,0,0,4,5,9
wi08,81,SIXTH,COMM,Communic,0,0,0,4,10,14,4,20,24,16,27,43,14,28,42,0,0,0,38,85,123
wi08,81,SIXTH,CSE,Comp Sci,0,0,0,12,2,14,13,5,18,16,6,22,27,6,33,0,0,0,68,19,87
wi08,81,SIXTH,CSE,CompEngCSE,0,0,0,15,1,16,10,1,11,5,2,7,14,0,14,0,0,0,44,4,48
wi08,81,SIXTH,CSE,CompScBinf,0,0,0,0,0,0,0,0,0,0,0,0,0,1,1,0,0,0,0,1,1
wi08,81,SIXTH,ECE,CompEngECE,0,0,0,7,0,7,6,0,6,3,1,4,3,0,3,0,0,0,19,1,20
wi08,81,SIXTH,ECE,Electr Eng,0,0,0,9,0,9,12,2,14,19,3,22,23,2,25,0,0,0,63,7,70
wi08,81,SIXTH,ECE,Engin Phys,0,0,0,0,0,0,1,0,1,0,0,0,2,0,2,0,0,0,3,0,3
wi08,81,SIXTH,ECE,Pr-ElecEng,0,0,0,0,0,0,0,0,0,1,0,1,0,0,0,0,0,0,1,0,1
wi08,81,SIXTH,ECE,Pr-EngPhys,0,0,0,0,0,0,0,1,1,3,0,3,1,0,1,0,0,0,4,1,5
wi08,81,SIXTH,ECON,Ec-Mth&Ecn,0,0,0,2,0,2,2,2,4,5,0,5,3,1,4,0,0,0,12,3,15
wi08,81,SIXTH,ECON,Econ-MgtSc,0,0,0,7,5,12,14,11,25,28,8,36,31,20,51,0,0,0,80,44,124
wi08,81,SIXTH,ECON,Economics,0,0,0,12,6,18,19,7,26,44,23,67,31,21,52,0,0,0,106,57,163
wi08,81,SIXTH,ERTH,Earth Scis,0,0,0,0,1,1,0,0,0,0,0,0,0,0,0,0,0,0,0,1,1
wi08,81,SIXTH,ERTH,ErSc-Geol,0,0,0,0,0,0,0,0,0,0,0,0,1,0,1,0,0,0,1,0,1
wi08,81,SIXTH,ERTH,ErSc-GeoPh,0,0,0,0,0,0,0,1,1,0,0,0,0,0,0,0,0,0,0,1,1
wi08,81,SIXTH,ESYS,EnvSys(EB),0,0,0,1,5,6,0,1,1,4,2,6,1,3,4,0,0,0,6,11,17
wi08,81,SIXTH,ESYS,EnvSys(EC),0,0,0,0,0,0,0,0,0,0,0,0,1,0,1,0,0,0,1,0,1
wi08,81,SIXTH,ESYS,EnvSys(EP),0,0,0,1,1,2,0,0,0,0,1,1,2,1,3,0,0,0,3,3,6
wi08,81,SIXTH,ESYS,EnvSys(ES),0,0,0,1,1,2,0,0,0,0,2,2,0,0,0,0,0,0,1,3,4
wi08,81,SIXTH,ETHN,Ethnic St,0,0,0,1,0,1,1,1,2,1,5,6,1,2,3,0,0,0,4,8,12
wi08,81,SIXTH,GMST,German Stu,0,0,0,0,0,0,0,1,1,0,0,0,0,0,0,0,0,0,0,1,1
wi08,81,SIXTH,HDP,Human Dev,0,0,0,0,0,0,0,0,0,0,2,2,0,11,11,0,0,0,0,13,13
wi08,81,SIXTH,HDP,Pr-HumnDev,0,0,0,0,1,1,2,5,7,1,2,3,0,0,0,0,0,0,3,8,11
wi08,81,SIXTH,HIST,History,0,0,0,1,0,1,2,2,4,3,2,5,9,1,10,0,0,0,15,5,20
wi08,81,SIXTH,INTL,IntSt-Anth,0,0,0,0,0,0,0,0,0,2,0,2,1,2,3,0,0,0,3,2,5
wi08,81,SIXTH,INTL,IntSt-Econ,0,0,0,1,2,3,7,7,14,5,8,13,3,10,13,0,0,0,16,27,43
wi08,81,SIXTH,INTL,IntSt-Hist,0,0,0,0,0,0,0,1,1,0,0,0,1,0,1,0,0,0,1,1,2
wi08,81,SIXTH,INTL,IntSt-Ling,0,0,0,1,0,1,1,0,1,1,0,1,0,2,2,0,0,0,3,2,5
wi08,81,SIXTH,INTL,IntSt-Lit,0,0,0,0,1,1,0,0,0,0,2,2,0,1,1,0,0,0,0,4,4
wi08,81,SIXTH,INTL,IntSt-PolS,0,0,0,1,4,5,1,3,4,5,4,9,2,6,8,0,0,0,9,17,26
wi08,81,SIXTH,INTL,IntSt-Soc,0,0,0,0,0,0,1,2,3,2,2,4,0,3,3,0,0,0,3,7,10
wi08,81,SIXTH,JAPN,JapaneseSt,0,0,0,0,1,1,0,0,0,0,0,0,2,0,2,0,0,0,2,1,3
wi08,81,SIXTH,LING,Ling-CogLn,0,0,0,0,0,0,0,0,0,0,0,0,0,1,1,0,0,0,0,1,1
wi08,81,SIXTH,LING,Ling-LSoc,0,0,0,0,0,0,0,0,0,1,1,2,0,0,0,0,0,0,1,1,2
wi08,81,SIXTH,LING,Linguistcs,0,0,0,0,1,1,0,0,0,0,1,1,1,6,7,0,0,0,1,8,9
wi08,81,SIXTH,LIT,Lit/Engl,0,0,0,1,0,1,1,3,4,2,1,3,0,3,3,0,0,0,4,7,11
wi08,81,SIXTH,LIT,Lit/World,0,0,0,0,0,0,0,0,0,2,0,2,0,0,0,0,0,0,2,0,2
wi08,81,SIXTH,LIT,Lit/Writng,0,0,0,0,0,0,0,0,0,0,2,2,0,10,10,0,0,0,0,12,12
wi08,81,SIXTH,LIT,Pre-Lit/Wr,0,0,0,0,5,5,3,5,8,2,2,4,1,3,4,0,0,0,6,15,21
wi08,81,SIXTH,LIT,Spanish Lt,0,0,0,0,0,0,0,0,0,1,0,1,0,1,1,0,0,0,1,1,2
wi08,81,SIXTH,MAE,Aerosp Eng,0,0,0,8,1,9,10,1,11,14,2,16,16,2,18,0,0,0,48,6,54
wi08,81,SIXTH,MAE,Engin Sci,0,0,0,0,0,0,0,1,1,0,0,0,0,0,0,0,0,0,0,1,1
wi08,81,SIXTH,MAE,Envir Eng,0,0,0,3,0,3,0,0,0,0,2,2,1,1,2,0,0,0,4,3,7
wi08,81,SIXTH,MAE,Mech Engin,0,0,0,17,2,19,23,4,27,21,4,25,44,4,48,0,0,0,105,14,119
wi08,81,SIXTH,MATH,Appld Math,0,0,0,3,0,3,0,0,0,1,1,2,1,1,2,0,0,0,5,2,7
wi08,81,SIXTH,MATH,Math/SecEd,0,0,0,2,0,2,1,1,2,0,1,1,0,1,1,0,0,0,3,3,6
wi08,81,SIXTH,MATH,Mathematcs,0,0,0,1,8,9,4,1,5,1,2,3,4,1,5,0,0,0,10,12,22
wi08,81,SIXTH,MATH,Mth-Mth&Ec,0,0,0,0,0,0,3,2,5,0,1,1,1,0,1,0,0,0,4,3,7
wi08,81,SIXTH,MATH,Mth-SciCom,0,0,0,0,0,0,1,0,1,0,0,0,1,0,1,0,0,0,2,0,2
wi08,81,SIXTH,MATH,Mth/ApldSc,0,0,0,1,1,2,0,0,0,0,0,0,1,0,1,0,0,0,2,1,3
wi08,81,SIXTH,MATH,Pr-Math CS,0,0,0,0,0,0,1,0,1,1,0,1,0,0,0,0,0,0,2,0,2
wi08,81,SIXTH,MATH,Prob&Stats,0,0,0,0,0,0,0,0,0,1,0,1,0,0,0,0,0,0,1,0,1
wi08,81,SIXTH,MUS,Mu-CompArt,0,0,0,0,0,0,1,1,2,5,2,7,5,1,6,0,0,0,11,4,15
wi08,81,SIXTH,MUS,Music,0,0,0,1,0,1,1,0,1,2,4,6,4,2,6,0,0,0,8,6,14
wi08,81,SIXTH,PHIL,Philosophy,0,0,0,2,0,2,0,1,1,2,0,2,3,3,6,0,0,0,7,4,11
wi08,81,SIXTH,PHYS,Biophysics,0,0,0,0,0,0,2,1,3,1,1,2,1,1,2,0,0,0,4,3,7
wi08,81,SIXTH,PHYS,Phys/Astro,0,0,0,2,0,2,3,1,4,0,0,0,2,1,3,0,0,0,7,2,9
wi08,81,SIXTH,PHYS,Phys/Mtrls,0,0,0,1,0,1,0,0,0,0,0,0,2,0,2,0,0,0,3,0,3
wi08,81,SIXTH,PHYS,Physics,0,0,0,2,0,2,6,0,6,5,1,6,8,1,9,0,0,0,21,2,23
wi08,81,SIXTH,POLI,Polit Sci,0,0,0,0,3,3,5,2,7,2,8,10,3,6,9,0,0,0,10,19,29
wi08,81,SIXTH,POLI,PolSc-Amer,0,0,0,1,1,2,1,1,2,2,0,2,0,1,1,0,0,0,4,3,7
wi08,81,SIXTH,POLI,PolSc-Comp,0,0,0,0,0,0,0,0,0,0,0,0,0,1,1,0,0,0,0,1,1
wi08,81,SIXTH,POLI,PolSc-Intl,0,0,0,1,3,4,7,4,11,11,5,16,4,7,11,0,0,0,23,19,42
wi08,81,SIXTH,POLI,PolSc-PLaw,0,0,0,0,0,0,2,6,8,2,6,8,3,0,3,0,0,0,7,12,19
wi08,81,SIXTH,POLI,PolSc-PPol,0,0,0,1,0,1,1,0,1,1,1,2,0,0,0,0,0,0,3,1,4
wi08,81,SIXTH,POLI,PolSc-Thry,0,0,0,0,0,0,1,0,1,0,0,0,0,0,0,0,0,0,1,0,1
wi08,81,SIXTH,PSYC,Psychology,0,0,0,4,13,17,7,24,31,14,21,35,14,29,43,0,0,0,39,87,126
wi08,81,SIXTH,RELI,Relig/Stu,0,0,0,0,0,0,0,0,0,0,0,0,1,0,1,0,0,0,1,0,1
wi08,81,SIXTH,SE,Engin Sci,0,0,0,0,0,0,3,1,4,0,0,0,0,0,0,0,0,0,3,1,4
wi08,81,SIXTH,SE,Struct Eng,0,0,0,6,4,10,9,9,18,12,2,14,18,10,28,0,0,0,45,25,70
wi08,81,SIXTH,SIO,ErSc-Geol,0,0,0,0,0,0,1,0,1,0,0,0,0,0,0,0,0,0,1,0,1
wi08,81,SIXTH,SOC,Sociology,0,0,0,1,6,7,1,6,7,5,11,16,3,11,14,0,0,0,10,34,44
wi08,81,SIXTH,THEA,Dance,0,0,0,0,0,0,0,1,1,1,3,4,0,3,3,0,0,0,1,7,8
wi08,81,SIXTH,THEA,Theatre,0,0,0,1,1,2,2,4,6,0,3,3,5,7,12,0,0,0,8,15,23
wi08,81,SIXTH,TWS,ThirdWldSt,0,0,0,0,2,2,0,1,1,0,0,0,0,1,1,0,0,0,0,4,4
wi08,81,SIXTH,UNAF,UndecBiolS,0,0,0,6,11,17,3,7,10,1,2,3,0,0,0,0,0,0,10,20,30
wi08,81,SIXTH,UNAF,UndecHumAr,0,0,0,7,3,10,1,4,5,0,0,0,0,0,0,0,0,0,8,7,15
wi08,81,SIXTH,UNAF,Undeclared,0,0,0,32,37,69,27,17,44,2,1,3,0,0,0,0,0,0,61,55,116
wi08,81,SIXTH,UNAF,UndecPhysS,0,0,0,5,4,9,6,2,8,0,1,1,0,0,0,0,0,0,11,7,18
wi08,81,SIXTH,UNAF,UndecSocSc,0,0,0,0,8,8,5,2,7,0,1,1,0,0,0,0,0,0,5,11,16
wi08,81,SIXTH,USP,Urb Stu&Pl,0,0,0,0,0,0,2,0,2,1,3,4,2,6,8,0,0,0,5,9,14
wi08,81,SIXTH,VIS,Art Hst/Cr,0,0,0,0,2,2,0,4,4,0,5,5,2,4,6,0,0,0,2,15,17
wi08,81,SIXTH,VIS,Media,0,0,0,5,3,8,6,9,15,14,11,25,24,14,38,0,0,0,49,37,86
wi08,81,SIXTH,VIS,Studio VA,0,0,0,1,0,1,0,1,1,1,4,5,5,6,11,0,0,0,7,11,18
wi08,81,SIXTH,VIS,VA-CompArt,0,0,0,2,4,6,4,2,6,4,4,8,9,5,14,0,0,0,19,15,34
wi08,81,WARREN,ANTH,Anth-Arch,0,0,0,0,0,0,1,0,1,0,3,3,2,5,7,0,0,0,3,8,11
wi08,81,WARREN,ANTH,Anth-Biol,0,0,0,0,0,0,1,1,2,0,5,5,1,5,6,0,0,0,2,11,13
wi08,81,WARREN,ANTH,Anth-Soci,0,0,0,0,1,1,0,0,0,0,0,0,0,0,0,0,0,0,0,1,1
wi08,81,WARREN,ANTH,Anthropol,0,0,0,0,0,0,0,0,0,0,1,1,2,5,7,0,0,0,2,6,8
wi08,81,WARREN,BENG,Bioen:Binf,0,0,0,0,0,0,0,0,0,1,0,1,2,1,3,0,0,0,3,1,4
wi08,81,WARREN,BENG,Bioeng:PM,0,0,0,0,0,0,0,1,1,10,4,14,11,7,18,0,0,0,21,12,33
wi08,81,WARREN,BENG,BioengBiot,0,0,0,0,3,3,13,3,16,11,3,14,22,16,38,0,0,0,46,25,71
wi08,81,WARREN,BENG,Bioengin,0,0,0,2,2,4,8,2,10,6,10,16,15,6,21,0,0,0,31,20,51
wi08,81,WARREN,BENG,Pr-BioenBf,0,0,0,0,0,0,0,0,0,1,0,1,0,0,0,0,0,0,1,0,1
wi08,81,WARREN,BENG,Pr-BioenPM,0,0,0,6,4,10,20,13,33,14,7,21,6,0,6,0,0,0,46,24,70
wi08,81,WARREN,BIOL,Anml Physl,0,0,0,0,0,0,0,0,0,0,0,0,5,7,12,0,0,0,5,7,12
wi08,81,WARREN,BIOL,Bioc/CellB,0,0,0,4,7,11,13,14,27,26,34,60,43,61,104,0,0,0,86,116,202
wi08,81,WARREN,BIOL,Ec/Beh/Evo,0,0,0,0,2,2,0,3,3,1,4,5,2,6,8,0,0,0,3,15,18
wi08,81,WARREN,BIOL,Genl Biol,0,0,0,3,9,12,7,9,16,23,30,53,44,73,117,0,0,0,77,121,198
wi08,81,WARREN,BIOL,Human Bio,0,0,0,10,29,39,22,31,53,34,59,93,64,76,140,0,0,0,130,195,325
wi08,81,WARREN,BIOL,Microbiol,0,0,0,0,0,0,3,3,6,1,5,6,8,6,14,0,0,0,12,14,26
wi08,81,WARREN,BIOL,Molec Biol,0,0,0,0,1,1,4,7,11,8,4,12,6,9,15,0,0,0,18,21,39
wi08,81,WARREN,BIOL,PhyslNeuro,0,0,0,0,8,8,6,5,11,7,14,21,10,8,18,0,0,0,23,35,58
wi08,81,WARREN,BIOL,Pr-BiochCB,0,0,0,0,0,0,0,0,0,0,0,0,1,0,1,0,0,0,1,0,1
wi08,81,WARREN,CENG,Chem Engin,0,0,0,3,1,4,7,5,12,9,9,18,16,5,21,0,0,0,35,20,55
wi08,81,WARREN,CGS,CritGendSt,0,0,0,0,0,0,0,1,1,0,0,0,0,0,0,0,0,0,0,1,1
wi08,81,WARREN,CHEM,Bioch/Chem,0,0,0,8,6,14,7,7,14,14,17,31,21,21,42,0,0,0,50,51,101
wi08,81,WARREN,CHEM,Chem Educ,0,0,0,0,0,0,0,0,0,0,0,0,0,1,1,0,0,0,0,1,1
wi08,81,WARREN,CHEM,Chem Phys,0,0,0,0,0,0,1,0,1,0,0,0,0,1,1,0,0,0,1,1,2
wi08,81,WARREN,CHEM,Chemistry,0,0,0,2,2,4,3,3,6,5,5,10,9,4,13,0,0,0,19,14,33
wi08,81,WARREN,CHEM,Envir Chem,0,0,0,0,0,0,1,0,1,1,0,1,2,1,3,0,0,0,4,1,5
wi08,81,WARREN,CHEM,MolecSynth,0,0,0,0,0,0,0,0,0,1,0,1,0,0,0,0,0,0,1,0,1
wi08,81,WARREN,CHEM,Pharm Chem,0,0,0,4,10,14,5,7,12,12,10,22,13,32,45,0,0,0,34,59,93
wi08,81,WARREN,CHIN,Chinese St,0,0,0,0,0,0,0,0,0,0,4,4,1,5,6,0,0,0,1,9,10
wi08,81,WARREN,COGS,Cog Sci,0,0,0,0,5,5,3,2,5,5,8,13,4,1,5,0,0,0,12,16,28
wi08,81,WARREN,COGS,CogSc/ClAs,0,0,0,0,0,0,0,1,1,0,0,0,0,0,0,0,0,0,0,1,1
wi08,81,WARREN,COGS,CogSc/HCI,0,0,0,0,0,0,0,1,1,0,0,0,5,1,6,0,0,0,5,2,7
wi08,81,WARREN,COGS,CogSc/HCog,0,0,0,0,1,1,0,0,0,0,0,0,1,3,4,0,0,0,1,4,5
wi08,81,WARREN,COGS,CogSc/Neur,0,0,0,0,0,0,0,0,0,1,1,2,4,4,8,0,0,0,5,5,10
wi08,81,WARREN,COMM,Communic,0,0,0,2,5,7,6,19,25,12,32,44,18,38,56,0,0,0,38,94,132
wi08,81,WARREN,CSE,Comp Sci,0,0,0,13,2,15,18,2,20,23,6,29,45,7,52,0,0,0,99,17,116
wi08,81,WARREN,CSE,CompEngCSE,0,0,0,7,2,9,11,4,15,5,1,6,11,2,13,0,0,0,34,9,43
wi08,81,WARREN,CSE,CompScBinf,0,0,0,0,0,0,0,0,0,0,0,0,4,0,4,0,0,0,4,0,4
wi08,81,WARREN,ECE,CompEngECE,0,0,0,6,0,6,4,0,4,5,0,5,6,2,8,0,0,0,21,2,23
wi08,81,WARREN,ECE,Electr Eng,0,0,0,5,0,5,21,3,24,33,2,35,67,9,76,0,0,0,126,14,140
wi08,81,WARREN,ECE,Engin Phys,0,0,0,0,0,0,0,0,0,0,0,0,3,0,3,0,0,0,3,0,3
wi08,81,WARREN,ECE,Pr-ElecEng,0,0,0,0,0,0,0,0,0,0,0,0,2,0,2,0,0,0,2,0,2
wi08,81,WARREN,ECE,Pr-EngPhys,0,0,0,1,0,1,1,0,1,3,1,4,0,0,0,0,0,0,5,1,6
wi08,81,WARREN,ECON,Ec-Mth&Ecn,0,0,0,2,0,2,3,2,5,4,4,8,1,0,1,0,0,0,10,6,16
wi08,81,WARREN,ECON,Econ-MgtSc,0,0,0,3,1,4,15,9,24,25,26,51,42,33,75,0,0,0,85,69,154
wi08,81,WARREN,ECON,Economics,0,0,0,8,9,17,24,9,33,52,35,87,70,26,96,0,0,0,154,79,233
wi08,81,WARREN,ERTH,ErSc-Geol,0,0,0,0,0,0,0,0,0,0,0,0,1,0,1,0,0,0,1,0,1
wi08,81,WARREN,ESYS,EnvSys(EB),0,0,0,0,0,0,0,1,1,0,3,3,1,2,3,0,0,0,1,6,7
wi08,81,WARREN,ESYS,EnvSys(EC),0,0,0,0,0,0,0,0,0,0,1,1,0,1,1,0,0,0,0,2,2
wi08,81,WARREN,ESYS,EnvSys(EP),0,0,0,0,0,0,0,0,0,1,2,3,0,1,1,0,0,0,1,3,4
wi08,81,WARREN,ESYS,EnvSys(ES),0,0,0,0,1,1,0,1,1,0,0,0,1,4,5,0,0,0,1,6,7
wi08,81,WARREN,ETHN,Ethnic St,0,0,0,0,1,1,0,0,0,0,1,1,2,2,4,0,0,0,2,4,6
wi08,81,WARREN,HDP,Human Dev,0,0,0,0,0,0,0,2,2,0,3,3,1,14,15,0,0,0,1,19,20
wi08,81,WARREN,HDP,Pr-HumnDev,0,0,0,0,0,0,1,4,5,2,11,13,2,3,5,0,0,0,5,18,23
wi08,81,WARREN,HIST,History,0,0,0,3,4,7,7,5,12,7,11,18,19,17,36,0,0,0,36,37,73
wi08,81,WARREN,INTD,Wa Ind St,0,0,0,0,0,0,0,0,0,0,0,0,1,2,3,0,0,0,1,2,3
wi08,81,WARREN,INTL,IntSt-Anth,0,0,0,0,1,1,0,1,1,1,0,1,0,0,0,0,0,0,1,2,3
wi08,81,WARREN,INTL,IntSt-Econ,0,0,0,1,1,2,3,5,8,4,6,10,4,6,10,0,0,0,12,18,30
wi08,81,WARREN,INTL,IntSt-Hist,0,0,0,0,0,0,1,2,3,1,1,2,2,4,6,0,0,0,4,7,11
wi08,81,WARREN,INTL,IntSt-Ling,0,0,0,0,0,0,0,0,0,1,1,2,1,0,1,0,0,0,2,1,3
wi08,81,WARREN,INTL,IntSt-PolS,0,0,0,0,2,2,2,2,4,3,8,11,5,9,14,0,0,0,10,21,31
wi08,81,WARREN,INTL,IntSt-Soc,0,0,0,0,0,0,0,2,2,1,1,2,1,3,4,0,0,0,2,6,8
wi08,81,WARREN,ITAL,Italian St,0,0,0,0,0,0,0,0,0,1,0,1,0,1,1,0,0,0,1,1,2
wi08,81,WARREN,JAPN,JapaneseSt,0,0,0,0,0,0,0,0,0,1,1,2,2,2,4,0,0,0,3,3,6
wi08,81,WARREN,LING,Lang Stu,0,0,0,0,0,0,0,1,1,0,2,2,0,0,0,0,0,0,0,3,3
wi08,81,WARREN,LING,Ling-CogLn,0,0,0,0,1,1,0,0,0,0,0,0,1,0,1,0,0,0,1,1,2
wi08,81,WARREN,LING,Ling-LSoc,0,0,0,0,0,0,0,0,0,0,0,0,0,1,1,0,0,0,0,1,1
wi08,81,WARREN,LING,Linguistcs,0,0,0,0,0,0,1,0,1,1,1,2,0,0,0,0,0,0,2,1,3
wi08,81,WARREN,LIT,Lit/Engl,0,0,0,0,3,3,1,0,1,2,3,5,0,5,5,0,0,0,3,11,14
wi08,81,WARREN,LIT,Lit/World,0,0,0,0,0,0,0,0,0,0,2,2,2,2,4,0,0,0,2,4,6
wi08,81,WARREN,LIT,Lit/Writng,0,0,0,0,0,0,0,0,0,0,1,1,4,4,8,0,0,0,4,5,9
wi08,81,WARREN,LIT,Pre-Lit/Wr,0,0,0,0,3,3,1,3,4,1,4,5,0,0,0,0,0,0,2,10,12
wi08,81,WARREN,LIT,Spanish Lt,0,0,0,0,0,0,0,1,1,2,0,2,1,4,5,0,0,0,3,5,8
wi08,81,WARREN,MAE,Aerosp Eng,0,0,0,7,2,9,13,2,15,22,2,24,45,6,51,0,0,0,87,12,99
wi08,81,WARREN,MAE,Engin Sci,0,0,0,0,1,1,0,0,0,1,0,1,1,0,1,0,0,0,2,1,3
wi08,81,WARREN,MAE,Envir Eng,0,0,0,0,0,0,1,1,2,0,2,2,3,0,3,0,0,0,4,3,7
wi08,81,WARREN,MAE,Mech Engin,0,0,0,15,4,19,28,4,32,31,4,35,100,13,113,0,0,0,174,25,199
wi08,81,WARREN,MATH,Appld Math,0,0,0,2,3,5,1,2,3,1,3,4,2,2,4,0,0,0,6,10,16
wi08,81,WARREN,MATH,Math/SecEd,0,0,0,1,0,1,0,0,0,1,3,4,0,1,1,0,0,0,2,4,6
wi08,81,WARREN,MATH,Mathematcs,0,0,0,2,2,4,1,3,4,6,2,8,10,6,16,0,0,0,19,13,32
wi08,81,WARREN,MATH,Mth-CompSc,0,0,0,0,0,0,0,0,0,1,0,1,4,0,4,0,0,0,5,0,5
wi08,81,WARREN,MATH,Mth-Mth&Ec,0,0,0,0,0,0,3,0,3,1,3,4,5,2,7,0,0,0,9,5,14
wi08,81,WARREN,MATH,Mth-SciCom,0,0,0,1,0,1,2,0,2,0,1,1,1,2,3,0,0,0,4,3,7
wi08,81,WARREN,MATH,Mth/ApldSc,0,0,0,0,2,2,0,1,1,0,1,1,2,1,3,0,0,0,2,5,7
wi08,81,WARREN,MATH,Pr-Math CS,0,0,0,0,0,0,1,1,2,1,1,2,1,0,1,0,0,0,3,2,5
wi08,81,WARREN,MATH,Prob&Stats,0,0,0,0,0,0,0,0,0,1,0,1,3,0,3,0,0,0,4,0,4
wi08,81,WARREN,MUS,Mu-CompArt,0,0,0,1,0,1,0,1,1,1,1,2,3,2,5,0,0,0,5,4,9
wi08,81,WARREN,MUS,Music,0,0,0,0,0,0,0,0,0,4,0,4,9,1,10,0,0,0,13,1,14
wi08,81,WARREN,MUS,Music Hum,0,0,0,0,0,0,0,0,0,0,1,1,0,0,0,0,0,0,0,1,1
wi08,81,WARREN,PHIL,Philosophy,0,0,0,2,0,2,0,0,0,5,5,10,8,6,14,0,0,0,15,11,26
wi08,81,WARREN,PHYS,Biophysics,0,0,0,0,0,0,0,0,0,3,3,6,2,0,2,0,0,0,5,3,8
wi08,81,WARREN,PHYS,Gen Physcs,0,0,0,0,0,0,0,0,0,0,0,0,1,0,1,0,0,0,1,0,1
wi08,81,WARREN,PHYS,GenPys/SEd,0,0,0,0,0,0,0,0,0,0,0,0,1,0,1,0,0,0,1,0,1
wi08,81,WARREN,PHYS,Phys/Astro,0,0,0,1,0,1,1,0,1,2,0,2,3,0,3,0,0,0,7,0,7
wi08,81,WARREN,PHYS,Phys/Comp,0,0,0,0,0,0,0,0,0,1,0,1,3,0,3,0,0,0,4,0,4
wi08,81,WARREN,PHYS,Phys/Mtrls,0,0,0,0,0,0,0,0,0,0,0,0,1,0,1,0,0,0,1,0,1
wi08,81,WARREN,PHYS,Physics,0,0,0,2,0,2,4,1,5,6,1,7,5,4,9,0,0,0,17,6,23
wi08,81,WARREN,POLI,Polit Sci,0,0,0,2,5,7,12,4,16,19,23,42,23,18,41,0,0,0,56,50,106
wi08,81,WARREN,POLI,PolSc-Amer,0,0,0,0,1,1,6,1,7,0,1,1,2,4,6,0,0,0,8,7,15
wi08,81,WARREN,POLI,PolSc-Comp,0,0,0,0,0,0,1,0,1,0,0,0,0,0,0,0,0,0,1,0,1
wi08,81,WARREN,POLI,PolSc-Intl,0,0,0,1,6,7,7,5,12,13,13,26,12,6,18,0,0,0,33,30,63
wi08,81,WARREN,POLI,PolSc-PLaw,0,0,0,3,3,6,1,7,8,3,8,11,8,10,18,0,0,0,15,28,43
wi08,81,WARREN,POLI,PolSc-PPol,0,0,0,1,2,3,0,1,1,1,1,2,0,2,2,0,0,0,2,6,8
wi08,81,WARREN,POLI,PolSc-Thry,0,0,0,0,0,0,1,0,1,0,0,0,1,1,2,0,0,0,2,1,3
wi08,81,WARREN,PSYC,Psychology,0,0,0,6,18,24,7,29,36,20,41,61,28,63,91,0,0,0,61,151,212
wi08,81,WARREN,RELI,Relig/Stu,0,0,0,0,0,0,0,0,0,0,0,0,2,0,2,0,0,0,2,0,2
wi08,81,WARREN,RUSS,Russ&SovSt,0,0,0,1,0,1,0,0,0,0,0,0,0,0,0,0,0,0,1,0,1
wi08,81,WARREN,SE,Engin Sci,0,0,0,1,0,1,1,1,2,0,0,0,0,0,0,0,0,0,2,1,3
wi08,81,WARREN,SE,Struct Eng,0,0,0,16,4,20,17,8,25,25,11,36,55,26,81,0,0,0,113,49,162
wi08,81,WARREN,SIO,ErSc-Geol,0,0,0,0,0,0,0,0,0,0,1,1,0,0,0,0,0,0,0,1,1
wi08,81,WARREN,SOC,Sociology,0,0,0,1,1,2,0,3,3,3,11,14,9,19,28,0,0,0,13,34,47
wi08,81,WARREN,THEA,Dance,0,0,0,0,0,0,0,0,0,0,1,1,1,1,2,0,0,0,1,2,3
wi08,81,WARREN,THEA,Theatre,0,0,0,0,0,0,0,3,3,2,4,6,4,6,10,0,0,0,6,13,19
wi08,81,WARREN,UNAF,IntcampVis,0,0,0,0,0,0,0,1,1,2,0,2,2,4,6,0,0,0,4,5,9
wi08,81,WARREN,UNAF,Limited St,0,0,0,0,0,0,0,0,0,0,0,0,0,0,0,1,1,2,1,1,2
wi08,81,WARREN,UNAF,UndecBiolS,0,0,0,5,8,13,6,13,19,0,1,1,0,0,0,0,0,0,11,22,33
wi08,81,WARREN,UNAF,UndecHumAr,0,0,0,0,4,4,0,3,3,0,1,1,0,0,0,0,0,0,0,8,8
wi08,81,WARREN,UNAF,Undeclared,1,0,1,15,27,42,23,21,44,4,2,6,0,0,0,0,0,0,43,50,93
wi08,81,WARREN,UNAF,UndecPhysS,0,0,0,1,0,1,1,2,3,0,0,0,0,0,0,0,0,0,2,2,4
wi08,81,WARREN,UNAF,UndecSocSc,0,0,0,3,3,6,4,5,9,0,0,0,0,0,0,0,0,0,7,8,15
wi08,81,WARREN,USP,Urb Stu&Pl,0,0,0,0,0,0,1,1,2,4,3,7,6,7,13,0,0,0,11,11,22
wi08,81,WARREN,VIS,Art Hst/Cr,0,0,0,0,0,0,0,1,1,1,5,6,1,5,6,0,0,0,2,11,13
wi08,81,WARREN,VIS,Media,0,0,0,0,2,2,3,3,6,3,4,7,5,5,10,0,0,0,11,14,25
wi08,81,WARREN,VIS,Studio VA,0,0,0,1,0,1,0,2,2,1,5,6,6,4,10,0,0,0,8,11,19
wi08,81,WARREN,VIS,VA-CompArt,0,0,0,0,1,1,2,0,2,0,2,2,0,4,4,0,0,0,2,7,9
fa13,133,MARSHALL,ANTH,Anth-Arch,0,0,0,0,0,0,0,0,0,0,0,0,2,0,2,0,0,0,2,0,2
fa13,133,MARSHALL,ANTH,Anth-Biol,0,0,0,0,0,0,0,0,0,0,2,2,1,6,7,0,0,0,1,8,9
fa13,133,MARSHALL,ANTH,Anth-Soci,0,1,1,0,0,0,0,1,1,1,3,4,0,5,5,0,0,0,1,10,11
fa13,133,MARSHALL,BENG,Bioen:Binf,1,2,3,0,0,0,2,1,3,1,2,3,3,3,6,0,0,0,7,8,15
fa13,133,MARSHALL,BENG,Bioeng:PM,0,0,0,0,0,0,0,0,0,0,0,0,0,1,1,0,0,0,0,1,1
fa13,133,MARSHALL,BENG,BioengBioS,4,3,7,0,0,0,1,0,1,0,0,0,0,0,0,0,0,0,5,3,8
fa13,133,MARSHALL,BENG,BioengBiot,1,0,1,0,0,0,2,2,4,5,0,5,9,7,16,0,0,0,17,9,26
fa13,133,MARSHALL,BENG,Bioengin,1,2,3,0,0,0,0,0,0,3,3,6,3,3,6,0,0,0,7,8,15
fa13,133,MARSHALL,BIOL,Bioc/CellB,20,22,42,2,0,2,10,19,29,19,39,58,24,32,56,0,0,0,75,112,187
fa13,133,MARSHALL,BIOL,BiolBioinf,0,1,1,0,1,1,1,0,1,2,0,2,0,0,0,0,0,0,3,2,5
fa13,133,MARSHALL,BIOL,Ec/Beh/Evo,0,1,1,0,0,0,1,1,2,0,0,0,4,4,8,0,0,0,5,6,11
fa13,133,MARSHALL,BIOL,Genl Biol,10,25,35,1,4,5,6,14,20,15,26,41,30,43,73,0,0,0,62,112,174
fa13,133,MARSHALL,BIOL,Human Bio,25,59,84,0,2,2,14,26,40,35,50,85,31,45,76,0,0,0,105,182,287
fa13,133,MARSHALL,BIOL,Microbiol,2,2,4,1,0,1,1,1,2,3,6,9,2,5,7,0,0,0,9,14,23
fa13,133,MARSHALL,BIOL,Molec Biol,3,4,7,0,0,0,4,0,4,3,2,5,4,3,7,0,0,0,14,9,23
fa13,133,MARSHALL,BIOL,PhyslNeuro,14,25,39,0,1,1,8,9,17,13,26,39,16,17,33,0,0,0,51,78,129
fa13,133,MARSHALL,CENG,Chem Engin,20,6,26,1,1,2,8,9,17,8,11,19,29,9,38,0,0,0,66,36,102
fa13,133,MARSHALL,CGS,CritGendSt,0,0,0,0,0,0,0,0,0,0,0,0,0,1,1,0,0,0,0,1,1
fa13,133,MARSHALL,CHEM,Bioch/Chem,3,3,6,0,0,0,0,5,5,2,7,9,12,18,30,0,0,0,17,33,50
fa13,133,MARSHALL,CHEM,Bioinform,1,0,1,1,0,1,0,1,1,0,0,0,1,0,1,0,0,0,3,1,4
fa13,133,MARSHALL,CHEM,Chem Phys,0,0,0,0,0,0,0,0,0,1,1,2,1,0,1,0,0,0,2,1,3
fa13,133,MARSHALL,CHEM,Chemistry,2,5,7,0,1,1,2,0,2,6,10,16,7,5,12,0,0,0,17,21,38
fa13,133,MARSHALL,CHEM,Envir Chem,0,0,0,0,0,0,0,0,0,0,0,0,0,1,1,0,0,0,0,1,1
fa13,133,MARSHALL,CHEM,MolecSynth,0,0,0,0,0,0,0,0,0,0,0,0,1,0,1,0,0,0,1,0,1
fa13,133,MARSHALL,CHEM,Pharm Chem,6,7,13,0,0,0,4,6,10,3,8,11,9,20,29,0,0,0,22,41,63
fa13,133,MARSHALL,CLAS,Classic St,0,1,1,0,0,0,0,0,0,0,0,0,0,0,0,0,0,0,0,1,1
fa13,133,MARSHALL,COGS,Cog Sci,3,4,7,0,1,1,3,5,8,3,3,6,5,5,10,0,0,0,14,18,32
fa13,133,MARSHALL,COGS,CogSc/ClAs,0,0,0,0,0,0,0,1,1,0,1,1,1,1,2,0,0,0,1,3,4
fa13,133,MARSHALL,COGS,CogSc/Comp,0,0,0,0,0,0,0,0,0,0,0,0,2,0,2,0,0,0,2,0,2
fa13,133,MARSHALL,COGS,CogSc/HCI,0,1,1,0,0,0,1,2,3,2,2,4,5,10,15,0,0,0,8,15,23
fa13,133,MARSHALL,COGS,CogSc/HCog,0,0,0,0,0,0,1,1,2,1,2,3,0,2,2,0,0,0,2,5,7
fa13,133,MARSHALL,COGS,CogSc/Neur,2,0,2,0,0,0,2,2,4,0,6,6,6,13,19,0,0,0,10,21,31
fa13,133,MARSHALL,COMM,Communic,1,14,15,1,3,4,3,16,19,20,45,65,10,52,62,0,0,0,35,130,165
fa13,133,MARSHALL,CSE,Comp Sci,9,2,11,4,0,4,18,10,28,54,7,61,62,15,77,0,0,0,147,34,181
fa13,133,MARSHALL,CSE,CompEngCSE,3,0,3,1,0,1,11,0,11,10,2,12,15,1,16,0,0,0,40,3,43
fa13,133,MARSHALL,CSE,CompScBinf,7,4,11,0,0,0,0,0,0,1,1,2,4,2,6,0,0,0,12,7,19
fa13,133,MARSHALL,ECE,CompEngECE,4,0,4,0,0,0,5,0,5,5,0,5,3,1,4,0,0,0,17,1,18
fa13,133,MARSHALL,ECE,Electr Eng,25,5,30,0,0,0,12,3,15,37,9,46,37,6,43,0,0,0,111,23,134
fa13,133,MARSHALL,ECE,EleEng&Soc,0,1,1,0,0,0,0,0,0,0,0,0,0,0,0,0,0,0,0,1,1
fa13,133,MARSHALL,ECE,Engin Phys,0,1,1,0,0,0,0,0,0,0,0,0,0,0,0,0,0,0,0,1,1
fa13,133,MARSHALL,ECE,Pr-EngPhys,1,0,1,0,0,0,0,0,0,0,0,0,0,0,0,0,0,0,1,0,1
fa13,133,MARSHALL,ECON,Ec-Mth&Ecn,6,12,18,2,0,2,5,4,9,8,4,12,7,4,11,0,0,0,28,24,52
fa13,133,MARSHALL,ECON,Econ-MgtSc,5,8,13,1,4,5,8,5,13,20,25,45,54,32,86,0,0,0,88,74,162
fa13,133,MARSHALL,ECON,Economics,34,23,57,8,4,12,15,10,25,85,71,156,68,65,133,0,0,0,210,173,383
fa13,133,MARSHALL,ESYS,EnvSys(EB),0,3,3,0,0,0,0,1,1,2,2,4,3,11,14,0,0,0,5,17,22
fa13,133,MARSHALL,ESYS,EnvSys(EC),1,0,1,0,0,0,1,1,2,0,0,0,3,1,4,0,0,0,5,2,7
fa13,133,MARSHALL,ESYS,EnvSys(EP),1,0,1,0,0,0,0,1,1,1,1,2,1,2,3,0,0,0,3,4,7
fa13,133,MARSHALL,ESYS,EnvSys(ES),0,0,0,0,0,0,0,0,0,0,0,0,0,1,1,0,0,0,0,1,1
fa13,133,MARSHALL,ETHN,Ethnic St,0,1,1,0,0,0,0,0,0,0,0,0,3,6,9,0,0,0,3,7,10
fa13,133,MARSHALL,FPMU,Public Hlt,1,2,3,0,1,1,0,10,10,1,5,6,0,0,0,0,0,0,2,18,20
fa13,133,MARSHALL,HDP,Human Dev,0,1,1,0,0,0,0,1,1,0,7,7,4,30,34,0,0,0,4,39,43
fa13,133,MARSHALL,HDP,Pr-HumnDev,0,2,2,0,1,1,0,9,9,0,12,12,0,5,5,0,0,0,0,29,29
fa13,133,MARSHALL,HIST,History,2,2,4,0,1,1,0,0,0,8,3,11,8,7,15,0,0,0,18,13,31
fa13,133,MARSHALL,INTL,Int-5yrEC,0,0,0,0,0,0,0,0,0,0,0,0,1,2,3,0,0,0,1,2,3
fa13,133,MARSHALL,INTL,Int-5yrPS,0,0,0,0,0,0,0,0,0,0,0,0,1,0,1,0,0,0,1,0,1
fa13,133,MARSHALL,INTL,IntSt-Anth,0,0,0,0,0,0,0,1,1,0,1,1,1,1,2,0,0,0,1,3,4
fa13,133,MARSHALL,INTL,IntSt-Econ,2,3,5,0,0,0,0,2,2,2,8,10,4,15,19,0,0,0,8,28,36
fa13,133,MARSHALL,INTL,IntSt-Hist,0,0,0,0,0,0,0,1,1,0,0,0,0,0,0,0,0,0,0,1,1
fa13,133,MARSHALL,INTL,IntSt-Ling,1,0,1,0,0,0,0,0,0,0,0,0,0,2,2,0,0,0,1,2,3
fa13,133,MARSHALL,INTL,IntSt-PolS,0,4,4,1,0,1,0,1,1,2,8,10,5,11,16,0,0,0,8,24,32
fa13,133,MARSHALL,INTL,IntSt-Soc,0,1,1,0,1,1,0,1,1,2,2,4,2,3,5,0,0,0,4,8,12
fa13,133,MARSHALL,JAPN,JapaneseSt,0,0,0,0,0,0,1,0,1,0,0,0,0,1,1,0,0,0,1,1,2
fa13,133,MARSHALL,LATI,LatinAm St,0,0,0,0,0,0,0,1,1,0,0,0,0,0,0,0,0,0,0,1,1
fa13,133,MARSHALL,LING,Lang Stu,0,0,0,0,0,0,0,0,0,1,0,1,0,0,0,0,0,0,1,0,1
fa13,133,MARSHALL,LING,Ling-CogLn,1,0,1,0,0,0,0,2,2,0,1,1,0,0,0,0,0,0,1,3,4
fa13,133,MARSHALL,LING,Ling-LSoc,0,0,0,0,0,0,0,0,0,0,1,1,0,3,3,0,0,0,0,4,4
fa13,133,MARSHALL,LING,Linguistcs,0,0,0,0,0,0,0,0,0,1,0,1,4,3,7,0,0,0,5,3,8
fa13,133,MARSHALL,LIT,Ital Lit,0,0,0,0,0,0,0,0,0,1,0,1,0,0,0,0,0,0,1,0,1
fa13,133,MARSHALL,LIT,Lit/Compos,0,0,0,0,0,0,0,0,0,0,1,1,0,0,0,0,0,0,0,1,1
fa13,133,MARSHALL,LIT,Lit/CultSt,1,0,1,0,0,0,0,1,1,0,1,1,0,1,1,0,0,0,1,3,4
fa13,133,MARSHALL,LIT,Lit/Engl,1,1,2,0,0,0,0,0,0,4,4,8,4,3,7,0,0,0,9,8,17
fa13,133,MARSHALL,LIT,Lit/World,0,0,0,0,0,0,0,0,0,0,0,0,0,1,1,0,0,0,0,1,1
fa13,133,MARSHALL,LIT,Lit/Writng,1,2,3,0,1,1,2,2,4,0,0,0,0,3,3,0,0,0,3,8,11
fa13,133,MARSHALL,LIT,Spanish Lt,0,0,0,0,0,0,0,0,0,0,1,1,0,0,0,0,0,0,0,1,1
fa13,133,MARSHALL,MAE,Aerosp Eng,3,0,3,0,0,0,0,0,0,5,0,5,14,5,19,0,0,0,22,5,27
fa13,133,MARSHALL,MAE,Engin Sci,0,0,0,0,0,0,0,0,0,0,0,0,1,0,1,0,0,0,1,0,1
fa13,133,MARSHALL,MAE,Envir Eng,4,4,8,0,1,1,3,2,5,3,0,3,7,5,12,0,0,0,17,12,29
fa13,133,MARSHALL,MAE,Mech Engin,2,0,2,0,0,0,2,0,2,6,1,7,20,6,26,0,0,0,30,7,37
fa13,133,MARSHALL,MATH,Appld Math,8,5,13,0,0,0,0,3,3,6,6,12,3,4,7,0,0,0,17,18,35
fa13,133,MARSHALL,MATH,Math/SecEd,2,1,3,0,0,0,0,0,0,1,0,1,1,1,2,0,0,0,4,2,6
fa13,133,MARSHALL,MATH,Mathematcs,4,5,9,1,1,2,1,3,4,3,2,5,1,5,6,0,0,0,10,16,26
fa13,133,MARSHALL,MATH,Mth-CompSc,1,0,1,0,0,0,0,0,0,0,1,1,3,1,4,0,0,0,4,2,6
fa13,133,MARSHALL,MATH,Mth-Mth&Ec,3,2,5,1,0,1,3,1,4,7,5,12,4,7,11,0,0,0,18,15,33
fa13,133,MARSHALL,MATH,Mth/ApldSc,1,2,3,0,0,0,0,1,1,0,1,1,1,0,1,0,0,0,2,4,6
fa13,133,MARSHALL,MATH,Pr-Math CS,1,0,1,0,0,0,0,0,0,0,0,0,0,0,0,0,0,0,1,0,1
fa13,133,MARSHALL,MATH,Prob&Stats,1,2,3,0,1,1,2,0,2,0,0,0,2,1,3,0,0,0,5,4,9
fa13,133,MARSHALL,MUS,Music,1,0,1,0,0,0,0,0,0,0,1,1,2,1,3,0,0,0,3,2,5
fa13,133,MARSHALL,MUS,Music Hum,0,0,0,0,0,0,0,1,1,0,0,0,1,0,1,0,0,0,1,1,2
fa13,133,MARSHALL,NENG,NanoEng,9,0,9,0,0,0,7,3,10,8,2,10,10,2,12,0,0,0,34,7,41
fa13,133,MARSHALL,PHIL,Philosophy,0,0,0,0,0,0,1,0,1,2,0,2,4,3,7,0,0,0,7,3,10
fa13,133,MARSHALL,PHYS,Biophysics,2,2,4,0,0,0,0,0,0,1,0,1,1,0,1,0,0,0,4,2,6
fa13,133,MARSHALL,PHYS,GenPys/SEd,0,0,0,0,0,0,0,0,0,0,1,1,1,0,1,0,0,0,1,1,2
fa13,133,MARSHALL,PHYS,Phys/Astro,2,0,2,0,0,0,1,0,1,0,0,0,2,0,2,0,0,0,5,0,5
fa13,133,MARSHALL,PHYS,Phys/Mtrls,1,0,1,0,0,0,0,0,0,0,0,0,0,0,0,0,0,0,1,0,1
fa13,133,MARSHALL,PHYS,Physics,3,0,3,0,0,0,1,2,3,1,1,2,4,2,6,0,0,0,9,5,14
fa13,133,MARSHALL,POLI,Polit Sci,3,6,9,0,0,0,5,2,7,9,12,21,20,7,27,0,0,0,37,27,64
fa13,133,MARSHALL,POLI,PolSc-Amer,0,0,0,0,0,0,0,1,1,3,2,5,3,4,7,0,0,0,6,7,13
fa13,133,MARSHALL,POLI,PolSc-Comp,0,0,0,0,0,0,0,0,0,0,0,0,1,3,4,0,0,0,1,3,4
fa13,133,MARSHALL,POLI,PolSc-Intl,1,2,3,0,0,0,2,4,6,7,3,10,12,11,23,0,0,0,22,20,42
fa13,133,MARSHALL,POLI,PolSc-PLaw,1,3,4,0,0,0,2,4,6,7,6,13,3,3,6,0,0,0,13,16,29
fa13,133,MARSHALL,POLI,PolSc-PPol,0,0,0,0,0,0,1,0,1,2,2,4,3,2,5,0,0,0,6,4,10
fa13,133,MARSHALL,POLI,PolSc-Thry,0,0,0,0,0,0,0,0,0,1,0,1,2,2,4,0,0,0,3,2,5
fa13,133,MARSHALL,PSYC,Psychology,13,23,36,1,1,2,5,23,28,23,51,74,33,75,108,0,0,0,75,173,248
fa13,133,MARSHALL,SE,Engin Sci,0,0,0,0,0,0,1,0,1,0,0,0,0,0,0,0,0,0,1,0,1
fa13,133,MARSHALL,SE,Struct Eng,5,2,7,0,2,2,5,1,6,22,5,27,25,10,35,0,0,0,57,20,77
fa13,133,MARSHALL,SIO,Earth Sci,0,1,1,0,0,0,0,0,0,0,0,0,0,1,1,0,0,0,0,2,2
fa13,133,MARSHALL,SIO,Marine Bio,1,4,5,0,0,0,0,6,6,0,2,2,1,1,2,0,0,0,2,13,15
fa13,133,MARSHALL,SOC,SocAmSt,0,0,0,0,0,0,0,0,0,0,1,1,0,0,0,0,0,0,0,1,1
fa13,133,MARSHALL,SOC,SocCulCom,0,0,0,0,0,0,0,1,1,0,1,1,0,0,0,0,0,0,0,2,2
fa13,133,MARSHALL,SOC,SocEconSoc,0,0,0,0,0,0,0,0,0,0,0,0,2,4,6,0,0,0,2,4,6
fa13,133,MARSHALL,SOC,SocIntlStu,0,0,0,0,0,0,0,0,0,0,1,1,1,0,1,0,0,0,1,1,2
fa13,133,MARSHALL,SOC,Sociology,1,4,5,0,1,1,0,0,0,8,16,24,12,15,27,0,0,0,21,36,57
fa13,133,MARSHALL,SOC,SocLawSoc,0,1,1,0,0,0,0,0,0,1,1,2,2,6,8,0,0,0,3,8,11
fa13,133,MARSHALL,SOC,SocSciMed,0,0,0,0,0,0,0,1,1,2,2,4,2,3,5,0,0,0,4,6,10
fa13,133,MARSHALL,SOC,SocSolneq,0,0,0,0,0,0,0,0,0,0,1,1,1,2,3,0,0,0,1,3,4
fa13,133,MARSHALL,THEA,Dance,0,0,0,0,0,0,0,0,0,0,0,0,1,1,2,0,0,0,1,1,2
fa13,133,MARSHALL,THEA,Theatre,0,0,0,0,0,0,0,0,0,0,3,3,4,5,9,0,0,0,4,8,12
fa13,133,MARSHALL,UNAF,Limited St,0,0,0,0,0,0,0,0,0,0,0,0,0,0,0,1,0,1,1,0,1
fa13,133,MARSHALL,UNAF,UndecHumAr,1,3,4,0,1,1,0,1,1,0,0,0,0,0,0,0,0,0,1,5,6
fa13,133,MARSHALL,UNAF,Undeclared,43,46,89,3,0,3,1,6,7,2,3,5,0,0,0,0,0,0,49,55,104
fa13,133,MARSHALL,UNAF,UndecPhysS,6,4,10,0,0,0,2,0,2,0,0,0,0,0,0,0,0,0,8,4,12
fa13,133,MARSHALL,UNAF,UndecSocSc,6,5,11,0,0,0,1,1,2,0,0,0,0,0,0,0,0,0,7,6,13
fa13,133,MARSHALL,USP,Urb Stu&Pl,0,1,1,0,0,0,0,0,0,4,7,11,8,6,14,0,0,0,12,14,26
fa13,133,MARSHALL,VIS,Art Hst/Cr,0,0,0,0,0,0,0,3,3,0,0,0,0,0,0,0,0,0,0,3,3
fa13,133,MARSHALL,VIS,Media,0,1,1,0,0,0,0,2,2,5,7,12,13,2,15,0,0,0,18,12,30
fa13,133,MARSHALL,VIS,Studio VA,0,1,1,1,0,1,0,0,0,0,1,1,1,5,6,0,0,0,2,7,9
fa13,133,MARSHALL,VIS,VA-CompArt,0,3,3,0,1,1,0,1,1,2,2,4,3,2,5,0,0,0,5,9,14
fa13,133,MUIR,ANTH,Anth-Arch,0,0,0,0,0,0,0,0,0,2,3,5,2,3,5,0,0,0,4,6,10
fa13,133,MUIR,ANTH,Anth-Biol,0,1,1,0,0,0,0,2,2,0,9,9,1,8,9,0,0,0,1,20,21
fa13,133,MUIR,ANTH,Anth-Soci,0,0,0,0,1,1,0,0,0,1,3,4,2,5,7,0,0,0,3,9,12
fa13,133,MUIR,BENG,Bioen:Binf,3,5,8,0,0,0,3,3,6,1,1,2,5,1,6,0,0,0,12,10,22
fa13,133,MUIR,BENG,Bioeng:PM,0,0,0,0,0,0,0,0,0,0,0,0,2,1,3,0,0,0,2,1,3
fa13,133,MUIR,BENG,BioengBioS,3,0,3,0,0,0,0,2,2,0,0,0,1,0,1,0,0,0,4,2,6
fa13,133,MUIR,BENG,BioengBiot,4,6,10,0,0,0,0,0,0,4,1,5,7,7,14,0,0,0,15,14,29
fa13,133,MUIR,BENG,Bioengin,5,5,10,0,0,0,2,0,2,5,5,10,6,5,11,0,0,0,18,15,33
fa13,133,MUIR,BIOL,Bioc/CellB,16,30,46,1,1,2,8,11,19,23,22,45,27,27,54,0,0,0,75,91,166
fa13,133,MUIR,BIOL,BiolBioinf,0,0,0,0,0,0,1,0,1,1,1,2,0,1,1,0,0,0,2,2,4
fa13,133,MUIR,BIOL,Ec/Beh/Evo,0,2,2,0,0,0,2,3,5,3,7,10,4,15,19,0,0,0,9,27,36
fa13,133,MUIR,BIOL,Genl Biol,22,40,62,1,1,2,14,20,34,14,27,41,33,56,89,0,0,0,84,144,228
fa13,133,MUIR,BIOL,Human Bio,27,62,89,1,3,4,14,41,55,19,38,57,38,45,83,0,0,0,99,189,288
fa13,133,MUIR,BIOL,Microbiol,3,5,8,0,0,0,4,0,4,1,1,2,3,5,8,0,0,0,11,11,22
fa13,133,MUIR,BIOL,Molec Biol,3,5,8,0,0,0,5,3,8,4,7,11,1,9,10,0,0,0,13,24,37
fa13,133,MUIR,BIOL,PhyslNeuro,18,28,46,0,0,0,6,19,25,15,17,32,24,23,47,0,0,0,63,87,150
fa13,133,MUIR,CENG,Chem Engin,17,11,28,2,0,2,4,2,6,12,12,24,19,11,30,0,0,0,54,36,90
fa13,133,MUIR,CGS,CritGendSt,1,0,1,0,0,0,0,0,0,0,3,3,0,1,1,0,0,0,1,4,5
fa13,133,MUIR,CHEM,Bioch/Chem,3,10,13,0,0,0,1,1,2,5,17,22,20,18,38,0,0,0,29,46,75
fa13,133,MUIR,CHEM,Bioinform,1,0,1,0,0,0,1,0,1,1,0,1,0,0,0,0,0,0,3,0,3
fa13,133,MUIR,CHEM,Chem Educ,0,1,1,0,0,0,0,0,0,0,0,0,0,0,0,0,0,0,0,1,1
fa13,133,MUIR,CHEM,Chem Phys,2,0,2,0,0,0,0,0,0,0,0,0,0,0,0,0,0,0,2,0,2
fa13,133,MUIR,CHEM,Chemistry,3,5,8,1,0,1,1,0,1,6,4,10,7,4,11,0,0,0,18,13,31
fa13,133,MUIR,CHEM,Envir Chem,0,0,0,0,0,0,1,2,3,1,0,1,0,0,0,0,0,0,2,2,4
fa13,133,MUIR,CHEM,MolecSynth,0,0,0,0,0,0,1,0,1,0,0,0,1,0,1,0,0,0,2,0,2
fa13,133,MUIR,CHEM,Pharm Chem,6,13,19,0,0,0,1,3,4,6,12,18,23,14,37,0,0,0,36,42,78
fa13,133,MUIR,CHIN,Chinese St,0,0,0,0,0,0,0,1,1,0,0,0,1,2,3,0,0,0,1,3,4
fa13,133,MUIR,COGS,Cog Sci,4,13,17,0,0,0,2,9,11,2,5,7,3,6,9,0,0,0,11,33,44
fa13,133,MUIR,COGS,CogSc/ClAs,0,0,0,0,0,0,0,2,2,0,0,0,1,6,7,0,0,0,1,8,9
fa13,133,MUIR,COGS,CogSc/Comp,0,0,0,0,0,0,0,0,0,0,0,0,4,1,5,0,0,0,4,1,5
fa13,133,MUIR,COGS,CogSc/HCI,0,0,0,0,0,0,1,3,4,2,4,6,4,10,14,0,0,0,7,17,24
fa13,133,MUIR,COGS,CogSc/HCog,0,1,1,0,0,0,0,1,1,1,1,2,0,5,5,0,0,0,1,8,9
fa13,133,MUIR,COGS,CogSc/Neur,2,2,4,0,0,0,1,5,6,4,5,9,14,18,32,0,0,0,21,30,51
fa13,133,MUIR,COMM,Communic,5,11,16,1,3,4,3,13,16,15,27,42,11,43,54,0,0,0,35,97,132
fa13,133,MUIR,CSE,Comp Sci,11,6,17,0,0,0,27,11,38,46,13,59,77,15,92,0,0,0,161,45,206
fa13,133,MUIR,CSE,CompEngCSE,5,3,8,0,0,0,8,0,8,14,0,14,15,2,17,0,0,0,42,5,47
fa13,133,MUIR,CSE,CompScBinf,3,2,5,0,0,0,2,0,2,3,1,4,4,0,4,0,0,0,12,3,15
fa13,133,MUIR,ECE,CompEngECE,2,1,3,0,0,0,2,0,2,3,1,4,4,0,4,0,0,0,11,2,13
fa13,133,MUIR,ECE,Electr Eng,32,5,37,2,0,2,16,0,16,15,3,18,29,9,38,0,0,0,94,17,111
fa13,133,MUIR,ECE,Engin Phys,1,0,1,0,0,0,1,0,1,0,0,0,1,0,1,0,0,0,3,0,3
fa13,133,MUIR,ECE,Pr-EngPhys,2,0,2,0,0,0,0,0,0,0,0,0,0,0,0,0,0,0,2,0,2
fa13,133,MUIR,ECON,Ec-Mth&Ecn,3,2,5,0,1,1,3,4,7,5,4,9,8,2,10,0,0,0,19,13,32
fa13,133,MUIR,ECON,Econ-MgtSc,4,2,6,2,2,4,10,11,21,20,20,40,23,24,47,0,0,0,59,59,118
fa13,133,MUIR,ECON,Economics,15,9,24,6,2,8,13,12,25,45,31,76,58,31,89,0,0,0,137,85,222
fa13,133,MUIR,ESYS,EnvSys(EB),1,4,5,0,0,0,2,3,5,1,3,4,10,17,27,0,0,0,14,27,41
fa13,133,MUIR,ESYS,EnvSys(EC),0,0,0,0,0,0,0,0,0,1,1,2,0,0,0,0,0,0,1,1,2
fa13,133,MUIR,ESYS,EnvSys(EP),2,3,5,1,0,1,0,0,0,0,1,1,1,2,3,0,0,0,4,6,10
fa13,133,MUIR,ESYS,EnvSys(ES),0,1,1,0,0,0,1,0,1,1,0,1,2,1,3,0,0,0,4,2,6
fa13,133,MUIR,ETHN,Ethnic St,0,0,0,0,0,0,0,1,1,0,0,0,4,2,6,0,0,0,4,3,7
fa13,133,MUIR,FPMU,Public Hlt,0,3,3,0,0,0,1,2,3,1,8,9,1,0,1,0,0,0,3,13,16
fa13,133,MUIR,HDP,Human Dev,0,0,0,0,0,0,0,0,0,0,3,3,7,28,35,0,0,0,7,31,38
fa13,133,MUIR,HDP,Pr-HumnDev,0,4,4,0,3,3,1,6,7,1,16,17,2,1,3,0,0,0,4,30,34
fa13,133,MUIR,HIST,History,3,2,5,0,0,0,2,1,3,4,4,8,6,5,11,0,0,0,15,12,27
fa13,133,MUIR,INTD,Muir Sp Pr,0,0,0,0,0,0,0,0,0,0,0,0,0,1,1,0,0,0,0,1,1
fa13,133,MUIR,INTL,Int-5yrPS,0,0,0,0,0,0,0,0,0,0,0,0,0,1,1,0,0,0,0,1,1
fa13,133,MUIR,INTL,IntSt-Anth,0,0,0,0,0,0,0,0,0,0,0,0,0,1,1,0,0,0,0,1,1
fa13,133,MUIR,INTL,IntSt-Econ,1,5,6,1,1,2,1,1,2,2,9,11,4,4,8,0,0,0,9,20,29
fa13,133,MUIR,INTL,IntSt-Hist,0,0,0,0,0,0,0,0,0,1,0,1,0,0,0,0,0,0,1,0,1
fa13,133,MUIR,INTL,IntSt-Ling,0,0,0,0,0,0,0,0,0,1,0,1,0,2,2,0,0,0,1,2,3
fa13,133,MUIR,INTL,IntSt-PolS,0,0,0,0,0,0,0,3,3,1,3,4,4,9,13,0,0,0,5,15,20
fa13,133,MUIR,INTL,IntSt-Soc,0,1,1,0,0,0,0,1,1,4,5,9,1,4,5,0,0,0,5,11,16
fa13,133,MUIR,ITAL,Italian St,0,0,0,0,0,0,0,1,1,0,1,1,0,0,0,0,0,0,0,2,2
fa13,133,MUIR,JAPN,JapaneseSt,0,0,0,0,0,0,0,2,2,0,1,1,3,0,3,0,0,0,3,3,6
fa13,133,MUIR,LING,Lang Stu,0,0,0,0,0,0,0,0,0,1,1,2,0,1,1,0,0,0,1,2,3
fa13,133,MUIR,LING,Ling-CogLn,0,0,0,0,0,0,1,0,1,2,3,5,0,4,4,0,0,0,3,7,10
fa13,133,MUIR,LING,Linguistcs,0,0,0,0,1,1,0,0,0,0,4,4,5,1,6,0,0,0,5,6,11
fa13,133,MUIR,LIT,Lit/CultSt,0,0,0,0,0,0,0,0,0,0,1,1,0,0,0,0,0,0,0,1,1
fa13,133,MUIR,LIT,Lit/Engl,0,3,3,0,0,0,0,0,0,1,4,5,3,8,11,0,0,0,4,15,19
fa13,133,MUIR,LIT,Lit/Writng,1,2,3,1,0,1,1,5,6,2,9,11,6,9,15,0,0,0,11,25,36
fa13,133,MUIR,LIT,Spanish Lt,0,0,0,0,0,0,0,1,1,0,2,2,1,3,4,0,0,0,1,6,7
fa13,133,MUIR,MAE,Aerosp Eng,4,1,5,0,0,0,1,0,1,8,0,8,13,5,18,0,0,0,26,6,32
fa13,133,MUIR,MAE,Engin Sci,0,0,0,0,0,0,1,0,1,0,0,0,1,1,2,0,0,0,2,1,3
fa13,133,MUIR,MAE,Envir Eng,8,12,20,0,0,0,5,1,6,6,5,11,10,12,22,0,0,0,29,30,59
fa13,133,MUIR,MAE,Mech Engin,13,1,14,0,0,0,2,2,4,8,2,10,23,2,25,0,0,0,46,7,53
fa13,133,MUIR,MATH,Appld Math,3,5,8,0,0,0,1,2,3,8,1,9,0,5,5,0,0,0,12,13,25
fa13,133,MUIR,MATH,Math/SecEd,0,1,1,0,0,0,0,0,0,3,3,6,0,4,4,0,0,0,3,8,11
fa13,133,MUIR,MATH,Mathematcs,6,4,10,0,0,0,2,4,6,6,3,9,6,2,8,0,0,0,20,13,33
fa13,133,MUIR,MATH,Mth-CompSc,2,1,3,0,0,0,1,0,1,4,0,4,1,2,3,0,0,0,8,3,11
fa13,133,MUIR,MATH,Mth-Mth&Ec,2,4,6,0,0,0,3,1,4,5,3,8,6,2,8,0,0,0,16,10,26
fa13,133,MUIR,MATH,Mth-SciCom,0,1,1,0,0,0,0,0,0,0,0,0,0,0,0,0,0,0,0,1,1
fa13,133,MUIR,MATH,Mth/ApldSc,0,0,0,0,0,0,0,0,0,0,0,0,1,0,1,0,0,0,1,0,1
fa13,133,MUIR,MATH,Prob&Stats,0,0,0,0,0,0,2,0,2,1,2,3,0,2,2,0,0,0,3,4,7
fa13,133,MUIR,MUS,Mu-CompArt,1,0,1,0,0,0,1,1,2,3,1,4,4,1,5,0,0,0,9,3,12
fa13,133,MUIR,MUS,Music,2,2,4,0,0,0,0,0,0,2,3,5,2,0,2,0,0,0,6,5,11
fa13,133,MUIR,MUS,Music Hum,0,0,0,0,0,0,0,0,0,1,1,2,1,0,1,0,0,0,2,1,3
fa13,133,MUIR,NENG,NanoEng,11,4,15,0,1,1,6,1,7,3,1,4,15,4,19,0,0,0,35,11,46
fa13,133,MUIR,PHIL,Philosophy,0,1,1,0,0,0,0,0,0,0,0,0,5,2,7,0,0,0,5,3,8
fa13,133,MUIR,PHYS,Biophysics,1,1,2,0,0,0,0,0,0,0,1,1,3,1,4,0,0,0,4,3,7
fa13,133,MUIR,PHYS,Phy/ErthSc,0,0,0,1,0,1,0,0,0,0,0,0,0,0,0,0,0,0,1,0,1
fa13,133,MUIR,PHYS,Phys/Astro,2,2,4,0,0,0,0,1,1,2,0,2,3,0,3,0,0,0,7,3,10
fa13,133,MUIR,PHYS,Phys/Comp,1,0,1,0,0,0,0,0,0,0,0,0,1,0,1,0,0,0,2,0,2
fa13,133,MUIR,PHYS,Phys/Mtrls,0,0,0,0,0,0,0,0,0,1,0,1,1,0,1,0,0,0,2,0,2
fa13,133,MUIR,PHYS,Physics,6,2,8,0,0,0,4,1,5,3,0,3,8,0,8,0,0,0,21,3,24
fa13,133,MUIR,POLI,Polit Sci,2,11,13,0,0,0,2,2,4,11,8,19,19,12,31,0,0,0,34,33,67
fa13,133,MUIR,POLI,PolSc-Amer,0,0,0,0,0,0,0,1,1,1,3,4,5,1,6,0,0,0,6,5,11
fa13,133,MUIR,POLI,PolSc-Comp,1,0,1,0,0,0,0,0,0,1,0,1,0,0,0,0,0,0,2,0,2
fa13,133,MUIR,POLI,PolSc-Intl,0,2,2,0,0,0,1,2,3,7,9,16,6,8,14,0,0,0,14,21,35
fa13,133,MUIR,POLI,PolSc-PLaw,2,4,6,0,0,0,1,2,3,4,2,6,7,3,10,0,0,0,14,11,25
fa13,133,MUIR,POLI,PolSc-PPol,0,0,0,0,0,0,0,3,3,1,3,4,1,0,1,0,0,0,2,6,8
fa13,133,MUIR,POLI,PolSc-Thry,0,1,1,0,0,0,0,0,0,1,0,1,1,0,1,0,0,0,2,1,3
fa13,133,MUIR,PSYC,Psychology,8,29,37,2,4,6,3,32,35,22,79,101,32,81,113,0,0,0,67,225,292
fa13,133,MUIR,RELI,Relig/Stu,0,0,0,0,0,0,0,0,0,0,0,0,0,1,1,0,0,0,0,1,1
fa13,133,MUIR,RUSS,Russ&SovSt,0,0,0,0,0,0,0,0,0,0,0,0,0,2,2,0,0,0,0,2,2
fa13,133,MUIR,SE,Struct Eng,11,4,15,2,2,4,8,6,14,19,5,24,24,12,36,0,0,0,64,29,93
fa13,133,MUIR,SIO,Earth Sci,2,0,2,0,0,0,0,0,0,2,1,3,3,2,5,0,0,0,7,3,10
fa13,133,MUIR,SIO,Marine Bio,7,8,15,1,0,1,0,5,5,1,7,8,3,3,6,0,0,0,12,23,35
fa13,133,MUIR,SOC,SocAmSt,0,0,0,0,0,0,0,0,0,0,0,0,0,1,1,0,0,0,0,1,1
fa13,133,MUIR,SOC,SocCulCom,0,0,0,0,0,0,0,0,0,0,2,2,2,0,2,0,0,0,2,2,4
fa13,133,MUIR,SOC,SocEconSoc,0,0,0,0,0,0,0,0,0,0,1,1,0,1,1,0,0,0,0,2,2
fa13,133,MUIR,SOC,SocIntlStu,0,0,0,0,0,0,0,1,1,0,0,0,0,1,1,0,0,0,0,2,2
fa13,133,MUIR,SOC,Sociology,0,4,4,0,0,0,1,1,2,5,20,25,6,13,19,0,0,0,12,38,50
fa13,133,MUIR,SOC,SocLawSoc,0,2,2,0,0,0,0,2,2,1,5,6,2,4,6,0,0,0,3,13,16
fa13,133,MUIR,SOC,SocSciMed,0,0,0,0,0,0,0,0,0,0,1,1,1,1,2,0,0,0,1,2,3
fa13,133,MUIR,SOC,SocSolneq,0,0,0,0,0,0,0,2,2,0,1,1,0,2,2,0,0,0,0,5,5
fa13,133,MUIR,THEA,Dance,0,0,0,0,0,0,0,1,1,0,0,0,0,2,2,0,0,0,0,3,3
fa13,133,MUIR,THEA,Theatre,0,6,6,0,1,1,1,2,3,2,3,5,3,4,7,0,0,0,6,16,22
fa13,133,MUIR,TWS,ThirdWldSt,0,1,1,0,0,0,0,0,0,0,0,0,0,1,1,0,0,0,0,2,2
fa13,133,MUIR,UNAF,UndecHumAr,2,7,9,0,0,0,0,1,1,0,0,0,0,0,0,0,0,0,2,8,10
fa13,133,MUIR,UNAF,Undeclared,36,45,81,2,5,7,9,10,19,1,0,1,0,0,0,0,0,0,48,60,108
fa13,133,MUIR,UNAF,UndecPhysS,5,8,13,0,0,0,1,2,3,0,0,0,0,0,0,0,0,0,6,10,16
fa13,133,MUIR,UNAF,UndecSocSc,8,9,17,0,0,0,0,3,3,0,0,0,0,0,0,0,0,0,8,12,20
fa13,133,MUIR,USP,Urb Stu&Pl,1,0,1,0,0,0,1,3,4,4,3,7,9,5,14,0,0,0,15,11,26
fa13,133,MUIR,VIS,Art Hst/Cr,0,0,0,0,0,0,0,0,0,1,2,3,1,1,2,0,0,0,2,3,5
fa13,133,MUIR,VIS,Media,0,0,0,0,0,0,1,4,5,5,3,8,12,7,19,0,0,0,18,14,32
fa13,133,MUIR,VIS,Studio VA,0,1,1,0,1,1,0,1,1,0,4,4,0,6,6,0,0,0,0,13,13
fa13,133,MUIR,VIS,VA-CompArt,1,0,1,0,1,1,0,2,2,2,2,4,3,3,6,0,0,0,6,8,14
fa13,133,REVELLE,ANTH,Anth-Arch,0,1,1,0,0,0,0,0,0,0,0,0,0,3,3,0,0,0,0,4,4
fa13,133,REVELLE,ANTH,Anth-Biol,0,0,0,0,0,0,0,2,2,1,2,3,2,2,4,0,0,0,3,6,9
fa13,133,REVELLE,ANTH,Anth-Soci,0,1,1,0,0,0,0,0,0,0,2,2,0,2,2,0,0,0,0,5,5
fa13,133,REVELLE,BENG,Bioen:Binf,7,2,9,0,0,0,1,0,1,4,4,8,6,5,11,0,0,0,18,11,29
fa13,133,REVELLE,BENG,Bioeng:PM,0,0,0,0,0,0,0,0,0,0,0,0,1,0,1,0,0,0,1,0,1
fa13,133,REVELLE,BENG,BioengBioS,8,3,11,0,0,0,0,0,0,1,0,1,0,0,0,0,0,0,9,3,12
fa13,133,REVELLE,BENG,BioengBiot,5,3,8,0,0,0,3,1,4,11,1,12,19,9,28,0,0,0,38,14,52
fa13,133,REVELLE,BENG,Bioengin,7,2,9,0,0,0,2,1,3,7,9,16,8,7,15,0,0,0,24,19,43
fa13,133,REVELLE,BIOL,Bioc/CellB,32,41,73,1,0,1,13,21,34,35,23,58,36,42,78,0,0,0,117,127,244
fa13,133,REVELLE,BIOL,BiolBioinf,2,0,2,0,0,0,0,0,0,1,1,2,3,0,3,0,0,0,6,1,7
fa13,133,REVELLE,BIOL,Ec/Beh/Evo,1,1,2,0,0,0,2,1,3,0,5,5,5,4,9,0,0,0,8,11,19
fa13,133,REVELLE,BIOL,Genl Biol,17,33,50,3,2,5,12,18,30,24,31,55,27,55,82,0,0,0,83,139,222
fa13,133,REVELLE,BIOL,Human Bio,39,95,134,0,3,3,24,47,71,34,58,92,34,55,89,0,0,0,131,258,389
fa13,133,REVELLE,BIOL,Microbiol,5,7,12,0,0,0,2,5,7,7,5,12,6,3,9,0,0,0,20,20,40
fa13,133,REVELLE,BIOL,Molec Biol,10,12,22,0,0,0,4,3,7,5,6,11,3,7,10,0,0,0,22,28,50
fa13,133,REVELLE,BIOL,PhyslNeuro,21,22,43,1,0,1,16,15,31,24,30,54,19,28,47,0,0,0,81,95,176
fa13,133,REVELLE,CENG,Chem Engin,30,12,42,1,0,1,21,8,29,25,10,35,39,15,54,0,0,0,116,45,161
fa13,133,REVELLE,CGS,CritGendSt,0,0,0,0,0,0,0,0,0,0,0,0,1,0,1,0,0,0,1,0,1
fa13,133,REVELLE,CHEM,Bioch/Chem,5,13,18,0,0,0,5,4,9,8,7,15,23,21,44,0,0,0,41,45,86
fa13,133,REVELLE,CHEM,Bioinform,1,0,1,0,0,0,0,0,0,0,1,1,0,0,0,0,0,0,1,1,2
fa13,133,REVELLE,CHEM,Chem Phys,0,0,0,0,0,0,1,0,1,2,1,3,0,0,0,0,0,0,3,1,4
fa13,133,REVELLE,CHEM,Chemistry,12,10,22,0,0,0,3,2,5,7,4,11,7,8,15,0,0,0,29,24,53
fa13,133,REVELLE,CHEM,Envir Chem,0,0,0,0,0,0,0,1,1,1,1,2,0,2,2,0,0,0,1,4,5
fa13,133,REVELLE,CHEM,Pharm Chem,10,12,22,0,0,0,2,6,8,15,13,28,18,31,49,0,0,0,45,62,107
fa13,133,REVELLE,CLAS,Classic St,0,0,0,0,0,0,0,0,0,0,0,0,1,0,1,0,0,0,1,0,1
fa13,133,REVELLE,COGS,Cog Sci,3,9,12,0,0,0,0,3,3,2,7,9,8,7,15,0,0,0,13,26,39
fa13,133,REVELLE,COGS,CogSc/ClAs,1,0,1,0,1,1,0,1,1,1,2,3,1,5,6,0,0,0,3,9,12
fa13,133,REVELLE,COGS,CogSc/Comp,0,0,0,0,0,0,0,0,0,0,0,0,0,1,1,0,0,0,0,1,1
fa13,133,REVELLE,COGS,CogSc/HCI,1,0,1,0,0,0,1,3,4,1,2,3,4,4,8,0,0,0,7,9,16
fa13,133,REVELLE,COGS,CogSc/HCog,0,0,0,0,1,1,0,0,0,0,1,1,1,2,3,0,0,0,1,4,5
fa13,133,REVELLE,COGS,CogSc/Neur,1,2,3,0,0,0,1,3,4,1,2,3,8,25,33,0,0,0,11,32,43
fa13,133,REVELLE,COMM,Communic,1,4,5,0,0,0,4,4,8,4,10,14,9,7,16,0,0,0,18,25,43
fa13,133,REVELLE,CSE,Comp Sci,10,1,11,3,0,3,25,5,30,64,14,78,79,12,91,0,0,0,181,32,213
fa13,133,REVELLE,CSE,CompEngCSE,2,2,4,2,0,2,6,1,7,12,4,16,16,1,17,0,0,0,38,8,46
fa13,133,REVELLE,CSE,CompScBinf,6,1,7,0,0,0,0,1,1,2,1,3,4,1,5,0,0,0,12,4,16
fa13,133,REVELLE,ECE,CompEngECE,5,1,6,0,0,0,2,0,2,7,1,8,8,0,8,0,0,0,22,2,24
fa13,133,REVELLE,ECE,Electr Eng,31,8,39,1,1,2,18,1,19,47,7,54,39,4,43,0,0,0,136,21,157
fa13,133,REVELLE,ECE,EleEng&Soc,0,0,0,0,0,0,0,0,0,0,0,0,1,0,1,0,0,0,1,0,1
fa13,133,REVELLE,ECE,Engin Phys,1,0,1,0,0,0,0,0,0,2,0,2,4,0,4,0,0,0,7,0,7
fa13,133,REVELLE,ECE,Pr-EngPhys,4,2,6,0,0,0,1,0,1,1,0,1,0,0,0,0,0,0,6,2,8
fa13,133,REVELLE,ECON,Ec-Mth&Ecn,3,1,4,0,1,1,2,1,3,3,3,6,8,2,10,0,0,0,16,8,24
fa13,133,REVELLE,ECON,Econ-MgtSc,2,1,3,2,3,5,9,8,17,14,8,22,27,12,39,0,0,0,54,32,86
fa13,133,REVELLE,ECON,Economics,12,12,24,3,2,5,16,11,27,33,19,52,48,25,73,0,0,0,112,69,181
fa13,133,REVELLE,ESYS,EnvSys(EB),0,1,1,0,0,0,0,2,2,2,0,2,8,12,20,0,0,0,10,15,25
fa13,133,REVELLE,ESYS,EnvSys(EC),0,0,0,0,0,0,1,0,1,0,0,0,0,1,1,0,0,0,1,1,2
fa13,133,REVELLE,ESYS,EnvSys(EP),0,1,1,0,0,0,0,1,1,0,0,0,0,0,0,0,0,0,0,2,2
fa13,133,REVELLE,ESYS,EnvSys(ES),0,0,0,0,0,0,0,1,1,0,0,0,2,0,2,0,0,0,2,1,3
fa13,133,REVELLE,ETHN,Ethnic St,0,0,0,0,0,0,0,0,0,0,4,4,2,1,3,0,0,0,2,5,7
fa13,133,REVELLE,FPMU,Public Hlt,0,2,2,1,0,1,1,8,9,1,5,6,0,2,2,0,0,0,3,17,20
fa13,133,REVELLE,HDP,Human Dev,0,0,0,0,0,0,0,0,0,1,0,1,0,15,15,0,0,0,1,15,16
fa13,133,REVELLE,HDP,Pr-HumnDev,0,2,2,0,1,1,0,4,4,0,3,3,0,4,4,0,0,0,0,14,14
fa13,133,REVELLE,HIST,History,2,3,5,0,0,0,1,4,5,1,1,2,4,1,5,0,0,0,8,9,17
fa13,133,REVELLE,INTL,Int-5yrPS,0,0,0,0,0,0,0,0,0,0,0,0,0,1,1,0,0,0,0,1,1
fa13,133,REVELLE,INTL,IntSt-Anth,0,0,0,0,0,0,0,0,0,0,0,0,1,0,1,0,0,0,1,0,1
fa13,133,REVELLE,INTL,IntSt-Econ,1,0,1,1,0,1,3,1,4,1,2,3,4,2,6,0,0,0,10,5,15
fa13,133,REVELLE,INTL,IntSt-Hist,0,0,0,0,0,0,0,1,1,0,0,0,0,1,1,0,0,0,0,2,2
fa13,133,REVELLE,INTL,IntSt-Ling,0,0,0,0,0,0,0,0,0,0,2,2,0,0,0,0,0,0,0,2,2
fa13,133,REVELLE,INTL,IntSt-PolS,0,1,1,0,0,0,2,0,2,1,3,4,2,7,9,0,0,0,5,11,16
fa13,133,REVELLE,INTL,IntSt-Soc,0,0,0,0,0,0,0,0,0,0,2,2,0,1,1,0,0,0,0,3,3
fa13,133,REVELLE,LING,Ling-CogLn,0,0,0,0,0,0,0,0,0,0,1,1,0,2,2,0,0,0,0,3,3
fa13,133,REVELLE,LING,Linguistcs,1,0,1,0,0,0,1,2,3,0,3,3,2,0,2,0,0,0,4,5,9
fa13,133,REVELLE,LIT,Lit/Compos,0,0,0,0,0,0,0,0,0,0,1,1,1,0,1,0,0,0,1,1,2
fa13,133,REVELLE,LIT,Lit/CultSt,0,0,0,0,0,0,0,1,1,0,0,0,0,0,0,0,0,0,0,1,1
fa13,133,REVELLE,LIT,Lit/Engl,2,1,3,0,0,0,0,0,0,0,1,1,2,1,3,0,0,0,4,3,7
fa13,133,REVELLE,LIT,Lit/World,0,0,0,0,0,0,0,0,0,1,0,1,0,1,1,0,0,0,1,1,2
fa13,133,REVELLE,LIT,Lit/Writng,1,0,1,0,0,0,0,1,1,0,2,2,2,7,9,0,0,0,3,10,13
fa13,133,REVELLE,LIT,Spanish Lt,0,0,0,0,0,0,0,1,1,1,0,1,0,1,1,0,0,0,1,2,3
fa13,133,REVELLE,MAE,Aerosp Eng,15,3,18,0,0,0,5,1,6,12,1,13,17,6,23,0,0,0,49,11,60
fa13,133,REVELLE,MAE,Engin Sci,0,0,0,0,0,0,0,0,0,1,0,1,4,2,6,0,0,0,5,2,7
fa13,133,REVELLE,MAE,Envir Eng,8,7,15,0,0,0,4,3,7,7,3,10,17,3,20,0,0,0,36,16,52
fa13,133,REVELLE,MAE,Mech Engin,11,4,15,0,0,0,3,0,3,14,1,15,32,6,38,0,0,0,60,11,71
fa13,133,REVELLE,MATH,Appld Math,3,5,8,2,2,4,6,3,9,4,3,7,6,2,8,0,0,0,21,15,36
fa13,133,REVELLE,MATH,Math/SecEd,1,0,1,0,0,0,0,1,1,2,0,2,1,0,1,0,0,0,4,1,5
fa13,133,REVELLE,MATH,Mathematcs,3,8,11,0,1,1,2,3,5,4,3,7,3,3,6,0,0,0,12,18,30
fa13,133,REVELLE,MATH,Mth-CompSc,3,0,3,0,0,0,0,0,0,2,1,3,1,1,2,0,0,0,6,2,8
fa13,133,REVELLE,MATH,Mth-Mth&Ec,0,2,2,1,0,1,1,3,4,0,1,1,3,1,4,0,0,0,5,7,12
fa13,133,REVELLE,MATH,Mth-SciCom,0,0,0,0,0,0,0,0,0,0,0,0,0,1,1,0,0,0,0,1,1
fa13,133,REVELLE,MATH,Mth/ApldSc,3,2,5,0,0,0,1,1,2,3,0,3,0,1,1,0,0,0,7,4,11
fa13,133,REVELLE,MATH,Pr-Math CS,1,1,2,0,0,0,0,0,0,0,0,0,0,0,0,0,0,0,1,1,2
fa13,133,REVELLE,MATH,Prob&Stats,0,2,2,0,0,0,2,2,4,3,1,4,3,2,5,0,0,0,8,7,15
fa13,133,REVELLE,MUS,Mu-CompArt,0,0,0,0,0,0,1,0,1,0,0,0,3,0,3,0,0,0,4,0,4
fa13,133,REVELLE,MUS,Music,0,0,0,1,0,1,1,0,1,0,2,2,1,0,1,0,0,0,3,2,5
fa13,133,REVELLE,NENG,NanoEng,14,3,17,0,1,1,8,2,10,16,4,20,21,9,30,0,0,0,59,19,78
fa13,133,REVELLE,PHIL,Philosophy,0,0,0,0,0,0,0,1,1,2,0,2,3,1,4,0,0,0,5,2,7
fa13,133,REVELLE,PHYS,Biophysics,5,0,5,1,0,1,0,1,1,1,3,4,4,1,5,0,0,0,11,5,16
fa13,133,REVELLE,PHYS,GenPys/SEd,0,0,0,0,0,0,0,0,0,0,0,0,1,0,1,0,0,0,1,0,1
fa13,133,REVELLE,PHYS,Phys/Astro,7,1,8,0,0,0,2,0,2,4,3,7,6,2,8,0,0,0,19,6,25
fa13,133,REVELLE,PHYS,Phys/Comp,1,0,1,0,0,0,1,0,1,0,0,0,0,0,0,0,0,0,2,0,2
fa13,133,REVELLE,PHYS,Phys/Mtrls,0,1,1,0,0,0,0,0,0,0,0,0,1,0,1,0,0,0,1,1,2
fa13,133,REVELLE,PHYS,Physics,11,4,15,0,0,0,3,0,3,9,2,11,5,4,9,0,0,0,28,10,38
fa13,133,REVELLE,POLI,Polit Sci,2,0,2,0,0,0,0,3,3,3,1,4,3,11,14,0,0,0,8,15,23
fa13,133,REVELLE,POLI,PolSc-Amer,1,0,1,0,0,0,1,0,1,0,0,0,1,2,3,0,0,0,3,2,5
fa13,133,REVELLE,POLI,PolSc-Comp,0,0,0,0,0,0,0,0,0,1,0,1,0,0,0,0,0,0,1,0,1
fa13,133,REVELLE,POLI,PolSc-Intl,0,2,2,0,2,2,2,1,3,0,1,1,4,3,7,0,0,0,6,9,15
fa13,133,REVELLE,POLI,PolSc-PLaw,0,0,0,1,0,1,0,0,0,0,4,4,2,3,5,0,0,0,3,7,10
fa13,133,REVELLE,POLI,PolSc-PPol,0,0,0,0,0,0,0,0,0,1,1,2,0,1,1,0,0,0,1,2,3
fa13,133,REVELLE,POLI,PolSc-Thry,0,0,0,0,0,0,0,0,0,0,1,1,0,0,0,0,0,0,0,1,1
fa13,133,REVELLE,PSYC,Psychology,3,14,17,0,2,2,11,13,24,10,40,50,28,70,98,0,0,0,52,139,191
fa13,133,REVELLE,RELI,Relig/Stu,0,0,0,0,0,0,0,0,0,0,1,1,0,0,0,0,0,0,0,1,1
fa13,133,REVELLE,RUSS,Russ&SovSt,0,0,0,0,0,0,0,0,0,0,0,0,1,0,1,0,0,0,1,0,1
fa13,133,REVELLE,SE,Engin Sci,1,2,3,0,0,0,1,0,1,0,0,0,0,0,0,0,0,0,2,2,4
fa13,133,REVELLE,SE,Struct Eng,18,4,22,0,1,1,8,8,16,28,4,32,25,7,32,0,0,0,79,24,103
fa13,133,REVELLE,SIO,Earth Sci,0,1,1,0,0,0,1,0,1,2,1,3,1,4,5,0,0,0,4,6,10
fa13,133,REVELLE,SIO,Marine Bio,4,10,14,1,2,3,1,3,4,1,6,7,2,2,4,0,0,0,9,23,32
fa13,133,REVELLE,SOC,SocEconSoc,0,0,0,1,0,1,0,0,0,0,0,0,0,0,0,0,0,0,1,0,1
fa13,133,REVELLE,SOC,Sociology,0,2,2,0,0,0,2,0,2,1,1,2,4,4,8,0,0,0,7,7,14
fa13,133,REVELLE,SOC,SocLawSoc,0,0,0,0,0,0,0,2,2,0,1,1,1,1,2,0,0,0,1,4,5
fa13,133,REVELLE,SOC,SocSciMed,0,0,0,0,0,0,0,0,0,1,0,1,0,4,4,0,0,0,1,4,5
fa13,133,REVELLE,SOC,SocSolneq,0,0,0,0,0,0,0,1,1,0,0,0,0,1,1,0,0,0,0,2,2
fa13,133,REVELLE,THEA,Theatre,0,1,1,0,0,0,0,2,2,0,3,3,1,2,3,0,0,0,1,8,9
fa13,133,REVELLE,UNAF,Limited St,0,0,0,0,0,0,0,0,0,0,0,0,0,0,0,1,2,3,1,2,3
fa13,133,REVELLE,UNAF,Spec-Emply,0,0,0,0,0,0,0,0,0,0,0,0,0,0,0,2,4,6,2,4,6
fa13,133,REVELLE,UNAF,UndecHumAr,0,2,2,0,0,0,0,2,2,0,0,0,0,0,0,0,0,0,0,4,4
fa13,133,REVELLE,UNAF,Undeclared,47,33,80,0,1,1,4,5,9,3,0,3,0,0,0,0,0,0,54,39,93
fa13,133,REVELLE,UNAF,UndecPhysS,7,6,13,0,1,1,1,2,3,0,0,0,0,0,0,0,0,0,8,9,17
fa13,133,REVELLE,UNAF,UndecSocSc,5,4,9,0,0,0,2,1,3,0,0,0,0,0,0,0,0,0,7,5,12
fa13,133,REVELLE,USP,Urb Stu&Pl,0,0,0,0,0,0,0,1,1,0,0,0,1,1,2,0,0,0,1,2,3
fa13,133,REVELLE,VIS,Art Hst/Cr,0,0,0,0,0,0,0,0,0,0,1,1,0,0,0,0,0,0,0,1,1
fa13,133,REVELLE,VIS,Media,0,3,3,0,0,0,0,0,0,2,1,3,2,3,5,0,0,0,4,7,11
fa13,133,REVELLE,VIS,Studio VA,0,0,0,0,0,0,0,0,0,0,1,1,1,2,3,0,0,0,1,3,4
fa13,133,REVELLE,VIS,VA-CompArt,0,0,0,1,1,2,1,0,1,1,0,1,4,2,6,0,0,0,7,3,10
fa13,133,ROOSEVELT,ANTH,Anth-Arch,0,0,0,0,0,0,1,1,2,1,5,6,1,2,3,0,0,0,3,8,11
fa13,133,ROOSEVELT,ANTH,Anth-Biol,0,0,0,0,0,0,0,0,0,0,5,5,1,2,3,0,0,0,1,7,8
fa13,133,ROOSEVELT,ANTH,Anth-Soci,2,0,2,0,0,0,0,3,3,1,9,10,4,9,13,0,0,0,7,21,28
fa13,133,ROOSEVELT,BENG,Bioen:Binf,8,1,9,0,0,0,1,2,3,4,4,8,1,1,2,0,0,0,14,8,22
fa13,133,ROOSEVELT,BENG,Bioeng:PM,0,0,0,0,0,0,0,0,0,0,0,0,2,0,2,0,0,0,2,0,2
fa13,133,ROOSEVELT,BENG,BioengBioS,2,3,5,0,0,0,0,1,1,0,0,0,0,0,0,0,0,0,2,4,6
fa13,133,ROOSEVELT,BENG,BioengBiot,1,1,2,0,0,0,0,2,2,0,3,3,5,3,8,0,0,0,6,9,15
fa13,133,ROOSEVELT,BENG,Bioengin,1,0,1,0,0,0,0,0,0,4,0,4,2,3,5,0,0,0,7,3,10
fa13,133,ROOSEVELT,BIOL,Bioc/CellB,15,27,42,0,0,0,16,9,25,15,14,29,23,28,51,0,0,0,69,78,147
fa13,133,ROOSEVELT,BIOL,BiolBioinf,1,0,1,0,0,0,1,0,1,0,0,0,0,0,0,0,0,0,2,0,2
fa13,133,ROOSEVELT,BIOL,Ec/Beh/Evo,0,2,2,0,0,0,0,0,0,5,3,8,1,7,8,0,0,0,6,12,18
fa13,133,ROOSEVELT,BIOL,Genl Biol,8,40,48,0,1,1,6,17,23,10,17,27,26,28,54,0,0,0,50,103,153
fa13,133,ROOSEVELT,BIOL,Human Bio,28,68,96,1,5,6,4,20,24,25,33,58,27,44,71,0,0,0,85,170,255
fa13,133,ROOSEVELT,BIOL,Microbiol,2,2,4,0,0,0,2,0,2,2,5,7,2,1,3,0,0,0,8,8,16
fa13,133,ROOSEVELT,BIOL,Molec Biol,2,4,6,0,1,1,3,2,5,1,1,2,3,4,7,0,0,0,9,12,21
fa13,133,ROOSEVELT,BIOL,PhyslNeuro,14,26,40,0,1,1,10,9,19,2,19,21,9,11,20,0,0,0,35,66,101
fa13,133,ROOSEVELT,CENG,Chem Engin,5,9,14,0,0,0,5,3,8,9,3,12,20,5,25,0,0,0,39,20,59
fa13,133,ROOSEVELT,CHEM,Bioch/Chem,12,4,16,1,0,1,2,2,4,2,4,6,15,12,27,0,0,0,32,22,54
fa13,133,ROOSEVELT,CHEM,Chem Phys,1,0,1,0,0,0,0,0,0,0,0,0,0,1,1,0,0,0,1,1,2
fa13,133,ROOSEVELT,CHEM,Chemistry,3,8,11,0,0,0,2,4,6,2,2,4,3,2,5,0,0,0,10,16,26
fa13,133,ROOSEVELT,CHEM,Envir Chem,0,0,0,1,0,1,0,1,1,0,0,0,3,1,4,0,0,0,4,2,6
fa13,133,ROOSEVELT,CHEM,MolecSynth,0,0,0,0,0,0,0,0,0,0,0,0,0,2,2,0,0,0,0,2,2
fa13,133,ROOSEVELT,CHEM,Pharm Chem,7,5,12,0,0,0,5,7,12,1,6,7,13,12,25,0,0,0,26,30,56
fa13,133,ROOSEVELT,CHIN,Chinese St,0,0,0,0,0,0,0,0,0,0,0,0,0,2,2,0,0,0,0,2,2
fa13,133,ROOSEVELT,CLAS,Classic St,0,0,0,0,0,0,0,1,1,1,0,1,0,2,2,0,0,0,1,3,4
fa13,133,ROOSEVELT,COGS,Cog Sci,1,4,5,1,0,1,1,2,3,2,7,9,2,7,9,0,0,0,7,20,27
fa13,133,ROOSEVELT,COGS,CogSc/ClAs,0,0,0,0,0,0,0,3,3,0,0,0,0,1,1,0,0,0,0,4,4
fa13,133,ROOSEVELT,COGS,CogSc/Comp,0,0,0,0,0,0,0,0,0,0,1,1,1,0,1,0,0,0,1,1,2
fa13,133,ROOSEVELT,COGS,CogSc/HCI,0,0,0,0,0,0,1,3,4,0,1,1,3,7,10,0,0,0,4,11,15
fa13,133,ROOSEVELT,COGS,CogSc/HCog,0,0,0,0,0,0,0,1,1,0,0,0,2,1,3,0,0,0,2,2,4
fa13,133,ROOSEVELT,COGS,CogSc/Neur,1,1,2,0,0,0,0,3,3,2,2,4,5,21,26,0,0,0,8,27,35
fa13,133,ROOSEVELT,COMM,Communic,2,13,15,1,1,2,3,11,14,10,39,49,6,44,50,0,0,0,22,108,130
fa13,133,ROOSEVELT,CSE,Comp Sci,0,0,0,1,1,2,18,9,27,34,4,38,50,8,58,0,0,0,103,22,125
fa13,133,ROOSEVELT,CSE,CompEngCSE,0,0,0,3,0,3,5,2,7,8,0,8,8,1,9,0,0,0,24,3,27
fa13,133,ROOSEVELT,CSE,CompScBinf,2,0,2,0,0,0,1,0,1,3,2,5,0,0,0,0,0,0,6,2,8
fa13,133,ROOSEVELT,ECE,CompEngECE,4,0,4,0,0,0,1,0,1,2,0,2,1,0,1,0,0,0,8,0,8
fa13,133,ROOSEVELT,ECE,Electr Eng,24,9,33,3,0,3,12,4,16,31,6,37,27,8,35,0,0,0,97,27,124
fa13,133,ROOSEVELT,ECE,EleEng&Soc,2,0,2,0,0,0,0,0,0,0,0,0,0,0,0,0,0,0,2,0,2
fa13,133,ROOSEVELT,ECE,Engin Phys,2,0,2,1,0,1,0,0,0,1,0,1,1,0,1,0,0,0,5,0,5
fa13,133,ROOSEVELT,ECE,Pr-EngPhys,3,0,3,0,0,0,0,0,0,0,0,0,0,0,0,0,0,0,3,0,3
fa13,133,ROOSEVELT,ECON,Ec-Mth&Ecn,5,6,11,1,0,1,4,2,6,1,4,5,8,2,10,0,0,0,19,14,33
fa13,133,ROOSEVELT,ECON,Econ-MgtSc,7,8,15,2,1,3,18,6,24,21,9,30,36,31,67,0,0,0,84,55,139
fa13,133,ROOSEVELT,ECON,Economics,33,32,65,7,0,7,11,14,25,68,46,114,45,46,91,0,0,0,164,138,302
fa13,133,ROOSEVELT,ESYS,EnvSys(EB),0,2,2,0,1,1,1,3,4,1,3,4,2,9,11,0,0,0,4,18,22
fa13,133,ROOSEVELT,ESYS,EnvSys(EC),0,1,1,0,0,0,0,0,0,1,0,1,1,6,7,0,0,0,2,7,9
fa13,133,ROOSEVELT,ESYS,EnvSys(EP),2,2,4,0,0,0,0,0,0,1,2,3,0,1,1,0,0,0,3,5,8
fa13,133,ROOSEVELT,ESYS,EnvSys(ES),1,3,4,0,0,0,0,2,2,0,1,1,0,2,2,0,0,0,1,8,9
fa13,133,ROOSEVELT,ETHN,Ethnic St,0,0,0,0,0,0,0,0,0,0,1,1,1,2,3,0,0,0,1,3,4
fa13,133,ROOSEVELT,FPMU,Public Hlt,0,2,2,0,1,1,4,9,13,1,5,6,0,1,1,0,0,0,5,18,23
fa13,133,ROOSEVELT,GMST,German Stu,0,0,0,0,0,0,0,0,0,1,1,2,0,0,0,0,0,0,1,1,2
fa13,133,ROOSEVELT,HDP,Human Dev,0,0,0,0,0,0,0,0,0,0,7,7,2,17,19,0,0,0,2,24,26
fa13,133,ROOSEVELT,HDP,Pr-HumnDev,0,3,3,0,0,0,0,7,7,2,6,8,0,3,3,0,0,0,2,19,21
fa13,133,ROOSEVELT,HIST,History,5,9,14,0,2,2,2,8,10,7,10,17,17,12,29,0,0,0,31,41,72
fa13,133,ROOSEVELT,INTL,Int-5yrEC,0,0,0,0,0,0,0,0,0,0,0,0,0,2,2,0,0,0,0,2,2
fa13,133,ROOSEVELT,INTL,Int-5yrPS,0,0,0,0,0,0,0,0,0,0,0,0,1,1,2,0,0,0,1,1,2
fa13,133,ROOSEVELT,INTL,IntSt-Anth,0,0,0,0,0,0,0,0,0,0,1,1,0,4,4,0,0,0,0,5,5
fa13,133,ROOSEVELT,INTL,IntSt-Econ,7,9,16,1,1,2,4,6,10,6,12,18,7,17,24,0,0,0,25,45,70
fa13,133,ROOSEVELT,INTL,IntSt-Hist,0,1,1,0,0,0,0,0,0,0,1,1,1,6,7,0,0,0,1,8,9
fa13,133,ROOSEVELT,INTL,IntSt-Ling,1,1,2,0,0,0,1,6,7,1,1,2,0,3,3,0,0,0,3,11,14
fa13,133,ROOSEVELT,INTL,IntSt-Lit,0,1,1,0,0,0,0,0,0,0,0,0,0,1,1,0,0,0,0,2,2
fa13,133,ROOSEVELT,INTL,IntSt-PolS,4,13,17,0,1,1,4,9,13,5,21,26,12,28,40,0,0,0,25,72,97
fa13,133,ROOSEVELT,INTL,IntSt-Soc,0,6,6,0,0,0,2,7,9,2,7,9,4,7,11,0,0,0,8,27,35
fa13,133,ROOSEVELT,ITAL,Italian St,0,0,0,0,0,0,0,0,0,1,1,2,0,0,0,0,0,0,1,1,2
fa13,133,ROOSEVELT,JAPN,JapaneseSt,1,1,2,0,0,0,0,1,1,1,2,3,2,0,2,0,0,0,4,4,8
fa13,133,ROOSEVELT,LATI,LatinAm St,0,1,1,0,0,0,0,0,0,0,0,0,0,1,1,0,0,0,0,2,2
fa13,133,ROOSEVELT,LING,Lang Stu,0,3,3,0,0,0,0,0,0,1,0,1,0,1,1,0,0,0,1,4,5
fa13,133,ROOSEVELT,LING,Ling-CogLn,0,2,2,0,0,0,0,3,3,0,2,2,0,3,3,0,0,0,0,10,10
fa13,133,ROOSEVELT,LING,Ling-LSoc,0,1,1,0,1,1,0,1,1,2,0,2,0,1,1,0,0,0,2,4,6
fa13,133,ROOSEVELT,LING,Linguistcs,1,3,4,0,0,0,0,1,1,2,3,5,0,3,3,0,0,0,3,10,13
fa13,133,ROOSEVELT,LIT,Lit/Compos,0,1,1,0,0,0,0,0,0,0,0,0,0,0,0,0,0,0,0,1,1
fa13,133,ROOSEVELT,LIT,Lit/CultSt,0,0,0,0,0,0,0,1,1,0,0,0,1,1,2,0,0,0,1,2,3
fa13,133,ROOSEVELT,LIT,Lit/Engl,0,2,2,0,0,0,1,2,3,1,1,2,0,8,8,0,0,0,2,13,15
fa13,133,ROOSEVELT,LIT,Lit/World,0,0,0,0,0,0,1,1,2,0,2,2,0,1,1,0,0,0,1,4,5
fa13,133,ROOSEVELT,LIT,Lit/Writng,1,0,1,1,0,1,0,4,4,2,6,8,3,15,18,0,0,0,7,25,32
fa13,133,ROOSEVELT,LIT,Spanish Lt,0,3,3,0,0,0,0,0,0,0,0,0,1,2,3,0,0,0,1,5,6
fa13,133,ROOSEVELT,MAE,Aerosp Eng,1,2,3,0,0,0,2,0,2,4,0,4,14,3,17,0,0,0,21,5,26
fa13,133,ROOSEVELT,MAE,Engin Sci,0,0,0,0,0,0,0,0,0,1,0,1,3,0,3,0,0,0,4,0,4
fa13,133,ROOSEVELT,MAE,Envir Eng,8,1,9,0,0,0,2,4,6,3,3,6,9,2,11,0,0,0,22,10,32
fa13,133,ROOSEVELT,MAE,Mech Engin,0,3,3,0,0,0,0,0,0,2,1,3,18,1,19,0,0,0,20,5,25
fa13,133,ROOSEVELT,MATH,Appld Math,3,6,9,2,0,2,0,2,2,3,3,6,3,2,5,0,0,0,11,13,24
fa13,133,ROOSEVELT,MATH,Math/SecEd,0,0,0,0,0,0,0,1,1,1,1,2,0,0,0,0,0,0,1,2,3
fa13,133,ROOSEVELT,MATH,Mathematcs,4,4,8,0,0,0,2,1,3,0,1,1,1,3,4,0,0,0,7,9,16
fa13,133,ROOSEVELT,MATH,Mth-CompSc,2,1,3,0,0,0,0,0,0,0,1,1,1,2,3,0,0,0,3,4,7
fa13,133,ROOSEVELT,MATH,Mth-Mth&Ec,9,6,15,1,0,1,3,5,8,1,2,3,0,6,6,0,0,0,14,19,33
fa13,133,ROOSEVELT,MATH,Mth/ApldSc,0,0,0,1,0,1,0,0,0,0,0,0,0,0,0,0,0,0,1,0,1
fa13,133,ROOSEVELT,MATH,Pr-Math CS,1,0,1,0,0,0,0,0,0,0,0,0,0,0,0,0,0,0,1,0,1
fa13,133,ROOSEVELT,MATH,Prob&Stats,0,0,0,0,0,0,0,1,1,1,0,1,0,0,0,0,0,0,1,1,2
fa13,133,ROOSEVELT,MUS,Mu-CompArt,0,0,0,0,0,0,0,0,0,0,0,0,2,2,4,0,0,0,2,2,4
fa13,133,ROOSEVELT,MUS,Music,0,1,1,0,0,0,1,0,1,0,1,1,1,1,2,0,0,0,2,3,5
fa13,133,ROOSEVELT,MUS,Music Hum,0,0,0,0,0,0,0,0,0,0,0,0,0,1,1,0,0,0,0,1,1
fa13,133,ROOSEVELT,NENG,NanoEng,3,2,5,0,1,1,1,3,4,5,4,9,16,3,19,0,0,0,25,13,38
fa13,133,ROOSEVELT,PHIL,Philosophy,0,2,2,0,0,0,0,0,0,2,0,2,1,1,2,0,0,0,3,3,6
fa13,133,ROOSEVELT,PHYS,Biophysics,0,0,0,0,0,0,0,0,0,0,0,0,3,1,4,0,0,0,3,1,4
fa13,133,ROOSEVELT,PHYS,Gen Physcs,1,0,1,0,0,0,0,0,0,0,0,0,0,0,0,0,0,0,1,0,1
fa13,133,ROOSEVELT,PHYS,Phy/ErthSc,0,0,0,0,0,0,0,0,0,0,0,0,0,1,1,0,0,0,0,1,1
fa13,133,ROOSEVELT,PHYS,Phys/Astro,1,0,1,0,0,0,0,0,0,0,0,0,0,1,1,0,0,0,1,1,2
fa13,133,ROOSEVELT,PHYS,Phys/Comp,0,0,0,0,0,0,0,0,0,0,0,0,1,0,1,0,0,0,1,0,1
fa13,133,ROOSEVELT,PHYS,Phys/Mtrls,0,0,0,0,0,0,0,0,0,0,0,0,1,0,1,0,0,0,1,0,1
fa13,133,ROOSEVELT,PHYS,Physics,6,1,7,0,0,0,2,0,2,1,1,2,1,1,2,0,0,0,10,3,13
fa13,133,ROOSEVELT,POLI,Polit Sci,6,13,19,0,1,1,2,8,10,14,18,32,15,18,33,0,0,0,37,58,95
fa13,133,ROOSEVELT,POLI,PolSc-Amer,0,2,2,0,0,0,2,2,4,1,1,2,3,1,4,0,0,0,6,6,12
fa13,133,ROOSEVELT,POLI,PolSc-Comp,0,1,1,0,0,0,0,0,0,2,0,2,0,2,2,0,0,0,2,3,5
fa13,133,ROOSEVELT,POLI,PolSc-Intl,3,7,10,1,1,2,6,10,16,17,9,26,19,22,41,0,0,0,46,49,95
fa13,133,ROOSEVELT,POLI,PolSc-PLaw,1,8,9,1,0,1,1,8,9,4,4,8,6,6,12,0,0,0,13,26,39
fa13,133,ROOSEVELT,POLI,PolSc-PPol,1,0,1,1,0,1,2,1,3,2,2,4,1,2,3,0,0,0,7,5,12
fa13,133,ROOSEVELT,POLI,PolSc-Thry,0,2,2,0,0,0,1,1,2,0,0,0,2,0,2,0,0,0,3,3,6
fa13,133,ROOSEVELT,PSYC,Psychology,11,28,39,0,4,4,4,23,27,10,45,55,23,67,90,0,0,0,48,167,215
fa13,133,ROOSEVELT,RELI,Relig/Stu,0,0,0,0,0,0,0,0,0,0,0,0,0,1,1,0,0,0,0,1,1
fa13,133,ROOSEVELT,SE,Engin Sci,1,0,1,0,0,0,0,1,1,0,0,0,1,0,1,0,0,0,2,1,3
fa13,133,ROOSEVELT,SE,Struct Eng,14,0,14,0,0,0,6,7,13,18,3,21,20,5,25,0,0,0,58,15,73
fa13,133,ROOSEVELT,SIO,Earth Sci,0,0,0,0,0,0,0,2,2,1,3,4,1,0,1,0,0,0,2,5,7
fa13,133,ROOSEVELT,SIO,Marine Bio,3,9,12,0,0,0,2,4,6,3,4,7,3,2,5,0,0,0,11,19,30
fa13,133,ROOSEVELT,SOC,SocAmSt,0,0,0,0,0,0,0,0,0,0,0,0,0,1,1,0,0,0,0,1,1
fa13,133,ROOSEVELT,SOC,SocCulCom,0,0,0,0,0,0,0,0,0,0,0,0,0,4,4,0,0,0,0,4,4
fa13,133,ROOSEVELT,SOC,SocEconSoc,0,0,0,0,0,0,0,0,0,0,1,1,0,2,2,0,0,0,0,3,3
fa13,133,ROOSEVELT,SOC,Sociology,2,5,7,0,1,1,1,5,6,5,14,19,2,9,11,0,0,0,10,34,44
fa13,133,ROOSEVELT,SOC,SocLawSoc,0,0,0,0,0,0,0,0,0,1,1,2,2,4,6,0,0,0,3,5,8
fa13,133,ROOSEVELT,SOC,SocSciMed,0,0,0,1,0,1,0,0,0,0,0,0,0,3,3,0,0,0,1,3,4
fa13,133,ROOSEVELT,SOC,SocSolneq,0,0,0,0,0,0,0,1,1,0,1,1,0,2,2,0,0,0,0,4,4
fa13,133,ROOSEVELT,THEA,Dance,0,2,2,0,0,0,0,0,0,0,0,0,0,1,1,0,0,0,0,3,3
fa13,133,ROOSEVELT,THEA,Theatre,1,0,1,0,0,0,0,2,2,0,2,2,1,4,5,0,0,0,2,8,10
fa13,133,ROOSEVELT,TWS,ThirdWldSt,0,0,0,0,0,0,0,0,0,0,1,1,0,1,1,0,0,0,0,2,2
fa13,133,ROOSEVELT,UNAF,UndecHumAr,0,13,13,1,0,1,0,0,0,0,1,1,0,0,0,0,0,0,1,14,15
fa13,133,ROOSEVELT,UNAF,Undeclared,44,52,96,3,3,6,6,7,13,1,1,2,0,0,0,0,0,0,54,63,117
fa13,133,ROOSEVELT,UNAF,UndecPhysS,5,5,10,0,0,0,0,1,1,0,0,0,0,0,0,0,0,0,5,6,11
fa13,133,ROOSEVELT,UNAF,UndecSocSc,4,15,19,1,0,1,0,0,0,0,0,0,0,0,0,0,0,0,5,15,20
fa13,133,ROOSEVELT,USP,Urb Stu&Pl,0,0,0,0,0,0,0,0,0,2,2,4,4,7,11,0,0,0,6,9,15
fa13,133,ROOSEVELT,VIS,Art Hst/Cr,0,0,0,0,0,0,0,1,1,0,3,3,0,3,3,0,0,0,0,7,7
fa13,133,ROOSEVELT,VIS,Media,0,1,1,0,0,0,3,1,4,4,3,7,4,5,9,0,0,0,11,10,21
fa13,133,ROOSEVELT,VIS,Studio VA,1,1,2,0,0,0,1,2,3,1,2,3,1,2,3,0,0,0,4,7,11
fa13,133,ROOSEVELT,VIS,VA-CompArt,0,1,1,0,0,0,1,1,2,0,1,1,1,1,2,0,0,0,2,4,6
fa13,133,SIXTH,ANTH,Anth-Arch,0,0,0,0,0,0,1,0,1,0,1,1,0,1,1,0,0,0,1,2,3
fa13,133,SIXTH,ANTH,Anth-Biol,0,1,1,0,0,0,0,0,0,1,0,1,0,2,2,0,0,0,1,3,4
fa13,133,SIXTH,ANTH,Anth-Soci,0,1,1,0,0,0,1,2,3,0,5,5,1,1,2,0,0,0,2,9,11
fa13,133,SIXTH,BENG,Bioen:Binf,2,6,8,0,0,0,1,1,2,3,5,8,6,3,9,0,0,0,12,15,27
fa13,133,SIXTH,BENG,Bioeng:PM,0,0,0,0,0,0,0,0,0,0,0,0,2,0,2,0,0,0,2,0,2
fa13,133,SIXTH,BENG,BioengBioS,2,3,5,0,0,0,0,0,0,0,0,0,0,0,0,0,0,0,2,3,5
fa13,133,SIXTH,BENG,BioengBiot,3,2,5,0,0,0,0,2,2,7,3,10,8,5,13,0,0,0,18,12,30
fa13,133,SIXTH,BENG,Bioengin,1,1,2,0,0,0,0,0,0,2,1,3,11,7,18,0,0,0,14,9,23
fa13,133,SIXTH,BIOL,Bioc/CellB,25,16,41,2,1,3,9,9,18,20,28,48,25,29,54,0,0,0,81,83,164
fa13,133,SIXTH,BIOL,BiolBioinf,1,1,2,0,0,0,0,0,0,0,1,1,0,0,0,0,0,0,1,2,3
fa13,133,SIXTH,BIOL,Ec/Beh/Evo,1,1,2,0,0,0,3,4,7,0,3,3,3,4,7,0,0,0,7,12,19
fa13,133,SIXTH,BIOL,Genl Biol,10,22,32,2,0,2,5,12,17,12,14,26,24,22,46,0,0,0,53,70,123
fa13,133,SIXTH,BIOL,Human Bio,28,40,68,2,2,4,17,13,30,26,30,56,33,28,61,0,0,0,106,113,219
fa13,133,SIXTH,BIOL,Microbiol,1,4,5,0,0,0,2,4,6,2,2,4,4,5,9,0,0,0,9,15,24
fa13,133,SIXTH,BIOL,Molec Biol,3,5,8,0,0,0,3,2,5,3,1,4,2,5,7,0,0,0,11,13,24
fa13,133,SIXTH,BIOL,PhyslNeuro,14,13,27,0,1,1,5,6,11,17,11,28,13,16,29,0,0,0,49,47,96
fa13,133,SIXTH,CENG,Chem Engin,18,11,29,1,0,1,11,3,14,13,4,17,18,9,27,0,0,0,61,27,88
fa13,133,SIXTH,CGS,CritGendSt,0,0,0,0,0,0,0,0,0,1,1,2,0,0,0,0,0,0,1,1,2
fa13,133,SIXTH,CHEM,Bioch/Chem,7,10,17,1,1,2,2,1,3,2,7,9,26,15,41,0,0,0,38,34,72
fa13,133,SIXTH,CHEM,Bioinform,0,1,1,0,0,0,0,0,0,0,0,0,0,0,0,0,0,0,0,1,1
fa13,133,SIXTH,CHEM,Chem Educ,0,0,0,0,0,0,0,0,0,0,0,0,0,1,1,0,0,0,0,1,1
fa13,133,SIXTH,CHEM,Chem Phys,0,0,0,0,0,0,0,0,0,0,0,0,1,0,1,0,0,0,1,0,1
fa13,133,SIXTH,CHEM,Chemistry,4,5,9,1,0,1,0,2,2,5,2,7,4,2,6,0,0,0,14,11,25
fa13,133,SIXTH,CHEM,Envir Chem,0,0,0,0,0,0,0,0,0,0,1,1,1,2,3,0,0,0,1,3,4
fa13,133,SIXTH,CHEM,MolecSynth,0,0,0,0,0,0,0,0,0,1,1,2,0,0,0,0,0,0,1,1,2
fa13,133,SIXTH,CHEM,Pharm Chem,4,19,23,0,3,3,3,7,10,5,2,7,19,14,33,0,0,0,31,45,76
fa13,133,SIXTH,CHIN,Chinese St,0,0,0,0,0,0,0,0,0,0,0,0,1,0,1,0,0,0,1,0,1
fa13,133,SIXTH,COGS,Cog Sci,4,5,9,1,0,1,3,1,4,2,7,9,5,2,7,0,0,0,15,15,30
fa13,133,SIXTH,COGS,CogSc/ClAs,0,0,0,0,0,0,0,0,0,0,0,0,0,1,1,0,0,0,0,1,1
fa13,133,SIXTH,COGS,CogSc/Comp,0,0,0,0,0,0,0,0,0,1,0,1,3,2,5,0,0,0,4,2,6
fa13,133,SIXTH,COGS,CogSc/HCI,0,0,0,0,0,0,1,3,4,2,0,2,7,13,20,0,0,0,10,16,26
fa13,133,SIXTH,COGS,CogSc/HCog,1,0,1,0,0,0,0,0,0,0,1,1,0,1,1,0,0,0,1,2,3
fa13,133,SIXTH,COGS,CogSc/Neur,0,1,1,0,0,0,0,0,0,3,3,6,8,13,21,0,0,0,11,17,28
fa13,133,SIXTH,COMM,Communic,3,9,12,0,1,1,9,18,27,18,39,57,14,45,59,0,0,0,44,112,156
fa13,133,SIXTH,CSE,Comp Sci,16,3,19,2,1,3,51,16,67,80,19,99,97,22,119,0,0,0,246,61,307
fa13,133,SIXTH,CSE,CompEngCSE,13,1,14,5,0,5,22,2,24,21,1,22,24,1,25,0,0,0,85,5,90
fa13,133,SIXTH,CSE,CompScBinf,7,2,9,0,0,0,1,1,2,2,1,3,4,1,5,0,0,0,14,5,19
fa13,133,SIXTH,ECE,CompEngECE,6,0,6,0,0,0,4,0,4,7,0,7,2,1,3,0,0,0,19,1,20
fa13,133,SIXTH,ECE,Electr Eng,63,4,67,3,0,3,19,2,21,51,7,58,43,3,46,0,0,0,179,16,195
fa13,133,SIXTH,ECE,Engin Phys,0,0,0,0,0,0,0,0,0,1,0,1,1,0,1,0,0,0,2,0,2
fa13,133,SIXTH,ECE,Pr-EngPhys,1,0,1,0,0,0,0,0,0,1,0,1,0,0,0,0,0,0,2,0,2
fa13,133,SIXTH,ECON,Ec-Mth&Ecn,10,1,11,0,1,1,3,4,7,3,1,4,7,0,7,0,0,0,23,7,30
fa13,133,SIXTH,ECON,Econ-MgtSc,6,3,9,1,1,2,11,8,19,16,12,28,39,30,69,0,0,0,73,54,127
fa13,133,SIXTH,ECON,Economics,16,13,29,6,0,6,14,9,23,46,32,78,47,27,74,0,0,0,129,81,210
fa13,133,SIXTH,ESYS,EnvSys(EB),0,0,0,0,0,0,0,3,3,1,2,3,4,12,16,0,0,0,5,17,22
fa13,133,SIXTH,ESYS,EnvSys(EC),0,0,0,0,0,0,0,0,0,0,1,1,3,0,3,0,0,0,3,1,4
fa13,133,SIXTH,ESYS,EnvSys(EP),0,0,0,0,0,0,1,2,3,0,1,1,0,4,4,0,0,0,1,7,8
fa13,133,SIXTH,ESYS,EnvSys(ES),0,0,0,0,1,1,1,0,1,0,2,2,1,2,3,0,0,0,2,5,7
fa13,133,SIXTH,ETHN,Ethnic St,0,0,0,0,0,0,0,1,1,0,0,0,2,2,4,0,0,0,2,3,5
fa13,133,SIXTH,FPMU,Public Hlt,0,2,2,0,3,3,0,7,7,0,4,4,1,2,3,0,0,0,1,18,19
fa13,133,SIXTH,GMST,German Stu,0,0,0,0,0,0,0,0,0,0,0,0,0,1,1,0,0,0,0,1,1
fa13,133,SIXTH,HDP,Human Dev,0,0,0,0,0,0,1,1,2,1,7,8,1,18,19,0,0,0,3,26,29
fa13,133,SIXTH,HDP,Pr-HumnDev,0,0,0,0,1,1,0,7,7,1,8,9,1,4,5,0,0,0,2,20,22
fa13,133,SIXTH,HIST,History,0,0,0,0,0,0,0,0,0,6,4,10,5,2,7,0,0,0,11,6,17
fa13,133,SIXTH,INTL,IntSt-Anth,0,1,1,0,0,0,0,0,0,0,0,0,0,0,0,0,0,0,0,1,1
fa13,133,SIXTH,INTL,IntSt-Econ,0,3,3,0,2,2,5,2,7,2,4,6,6,7,13,0,0,0,13,18,31
fa13,133,SIXTH,INTL,IntSt-Hist,0,0,0,0,0,0,1,1,2,0,0,0,0,1,1,0,0,0,1,2,3
fa13,133,SIXTH,INTL,IntSt-Ling,0,0,0,0,0,0,0,0,0,0,0,0,0,2,2,0,0,0,0,2,2
fa13,133,SIXTH,INTL,IntSt-PolS,0,1,1,0,0,0,0,0,0,1,2,3,2,10,12,0,0,0,3,13,16
fa13,133,SIXTH,INTL,IntSt-Soc,0,1,1,0,0,0,1,2,3,0,0,0,1,2,3,0,0,0,2,5,7
fa13,133,SIXTH,ITAL,Italian St,0,0,0,0,0,0,0,0,0,0,1,1,0,0,0,0,0,0,0,1,1
fa13,133,SIXTH,JAPN,JapaneseSt,0,0,0,0,0,0,0,0,0,0,0,0,0,1,1,0,0,0,0,1,1
fa13,133,SIXTH,JUDA,Judaic Stu,0,0,0,0,0,0,0,0,0,0,1,1,0,0,0,0,0,0,0,1,1
fa13,133,SIXTH,LATI,LatinAm St,0,0,0,0,0,0,0,0,0,1,0,1,0,0,0,0,0,0,1,0,1
fa13,133,SIXTH,LING,Lang Stu,0,0,0,0,0,0,0,0,0,0,0,0,0,1,1,0,0,0,0,1,1
fa13,133,SIXTH,LING,Ling-CogLn,0,0,0,0,0,0,0,2,2,1,1,2,1,1,2,0,0,0,2,4,6
fa13,133,SIXTH,LING,Ling-LSoc,0,0,0,0,0,0,0,1,1,0,1,1,0,1,1,0,0,0,0,3,3
fa13,133,SIXTH,LING,Linguistcs,0,1,1,0,0,0,0,1,1,1,2,3,1,2,3,0,0,0,2,6,8
fa13,133,SIXTH,LIT,Lit/Compos,1,0,1,0,0,0,0,0,0,0,0,0,0,0,0,0,0,0,1,0,1
fa13,133,SIXTH,LIT,Lit/CultSt,0,0,0,0,0,0,0,0,0,0,1,1,0,0,0,0,0,0,0,1,1
fa13,133,SIXTH,LIT,Lit/Engl,0,1,1,0,0,0,0,1,1,1,2,3,0,2,2,0,0,0,1,6,7
fa13,133,SIXTH,LIT,Lit/World,0,0,0,0,0,0,0,0,0,0,0,0,0,2,2,0,0,0,0,2,2
fa13,133,SIXTH,LIT,Lit/Writng,1,7,8,0,0,0,0,2,2,1,1,2,1,3,4,0,0,0,3,13,16
fa13,133,SIXTH,LIT,Spanish Lt,0,0,0,0,0,0,0,0,0,0,0,0,0,1,1,0,0,0,0,1,1
fa13,133,SIXTH,MAE,Aerosp Eng,3,2,5,0,0,0,4,1,5,4,2,6,16,2,18,0,0,0,27,7,34
fa13,133,SIXTH,MAE,Engin Sci,0,0,0,0,0,0,0,0,0,1,0,1,5,0,5,0,0,0,6,0,6
fa13,133,SIXTH,MAE,Envir Eng,12,4,16,0,0,0,3,3,6,6,5,11,10,11,21,0,0,0,31,23,54
fa13,133,SIXTH,MAE,Mech Engin,10,2,12,0,0,0,2,2,4,9,2,11,37,5,42,0,0,0,58,11,69
fa13,133,SIXTH,MATH,Appld Math,3,4,7,1,1,2,2,3,5,3,5,8,4,1,5,0,0,0,13,14,27
fa13,133,SIXTH,MATH,Math/SecEd,0,0,0,0,0,0,1,0,1,0,0,0,0,1,1,0,0,0,1,1,2
fa13,133,SIXTH,MATH,Mathematcs,7,3,10,1,0,1,1,1,2,2,2,4,2,1,3,0,0,0,13,7,20
fa13,133,SIXTH,MATH,Mth-CompSc,9,3,12,0,0,0,0,2,2,2,0,2,4,2,6,0,0,0,15,7,22
fa13,133,SIXTH,MATH,Mth-Mth&Ec,3,0,3,0,1,1,4,1,5,3,3,6,4,2,6,0,0,0,14,7,21
fa13,133,SIXTH,MATH,Mth/ApldSc,0,3,3,0,0,0,1,0,1,0,0,0,0,0,0,0,0,0,1,3,4
fa13,133,SIXTH,MATH,Prob&Stats,0,0,0,0,0,0,0,0,0,1,1,2,2,0,2,0,0,0,3,1,4
fa13,133,SIXTH,MUS,Mu-CompArt,0,1,1,0,0,0,1,0,1,9,1,10,10,1,11,0,0,0,20,3,23
fa13,133,SIXTH,MUS,Music,1,0,1,0,0,0,1,0,1,2,2,4,6,4,10,0,0,0,10,6,16
fa13,133,SIXTH,NENG,NanoEng,13,5,18,0,1,1,6,2,8,14,1,15,17,4,21,0,0,0,50,13,63
fa13,133,SIXTH,PHIL,Philosophy,0,0,0,0,0,0,0,1,1,0,0,0,2,2,4,0,0,0,2,3,5
fa13,133,SIXTH,PHYS,Biophysics,1,0,1,0,0,0,0,0,0,1,0,1,3,0,3,0,0,0,5,0,5
fa13,133,SIXTH,PHYS,GenPys/SEd,1,0,1,0,0,0,0,0,0,0,0,0,0,0,0,0,0,0,1,0,1
fa13,133,SIXTH,PHYS,Phy/ErthSc,2,0,2,0,0,0,0,0,0,0,0,0,1,0,1,0,0,0,3,0,3
fa13,133,SIXTH,PHYS,Phys/Astro,2,2,4,0,0,0,0,0,0,2,1,3,0,1,1,0,0,0,4,4,8
fa13,133,SIXTH,PHYS,Phys/Comp,1,0,1,0,0,0,0,0,0,0,0,0,1,0,1,0,0,0,2,0,2
fa13,133,SIXTH,PHYS,Phys/Mtrls,0,0,0,1,0,1,1,0,1,0,0,0,1,0,1,0,0,0,3,0,3
fa13,133,SIXTH,PHYS,Physics,9,1,10,0,0,0,3,1,4,4,0,4,4,0,4,0,0,0,20,2,22
fa13,133,SIXTH,POLI,Polit Sci,2,2,4,1,1,2,4,4,8,7,5,12,6,7,13,0,0,0,20,19,39
fa13,133,SIXTH,POLI,PolSc-Amer,0,1,1,1,0,1,0,0,0,2,1,3,1,1,2,0,0,0,4,3,7
fa13,133,SIXTH,POLI,PolSc-Comp,0,1,1,0,0,0,0,0,0,0,0,0,0,1,1,0,0,0,0,2,2
fa13,133,SIXTH,POLI,PolSc-Intl,1,1,2,0,0,0,0,0,0,4,5,9,5,4,9,0,0,0,10,10,20
fa13,133,SIXTH,POLI,PolSc-PLaw,0,0,0,0,1,1,0,2,2,3,2,5,4,1,5,0,0,0,7,6,13
fa13,133,SIXTH,POLI,PolSc-PPol,0,0,0,0,0,0,0,0,0,1,0,1,1,2,3,0,0,0,2,2,4
fa13,133,SIXTH,POLI,PolSc-Thry,0,0,0,1,0,1,0,0,0,0,1,1,0,0,0,0,0,0,1,1,2
fa13,133,SIXTH,PSYC,Psychology,10,13,23,1,5,6,7,18,25,16,43,59,24,55,79,0,0,0,58,134,192
fa13,133,SIXTH,RELI,Relig/Stu,0,0,0,0,0,0,0,0,0,0,0,0,0,1,1,0,0,0,0,1,1
fa13,133,SIXTH,SE,Engin Sci,3,0,3,0,0,0,0,0,0,0,0,0,0,0,0,0,0,0,3,0,3
fa13,133,SIXTH,SE,Struct Eng,24,5,29,1,0,1,18,5,23,21,9,30,45,5,50,0,0,0,109,24,133
fa13,133,SIXTH,SIO,Earth Sci,0,0,0,0,0,0,0,0,0,0,1,1,3,2,5,0,0,0,3,3,6
fa13,133,SIXTH,SIO,Marine Bio,0,6,6,0,1,1,1,2,3,2,5,7,0,1,1,0,0,0,3,15,18
fa13,133,SIXTH,SOC,SocCulCom,0,0,0,0,0,0,0,0,0,0,2,2,0,1,1,0,0,0,0,3,3
fa13,133,SIXTH,SOC,SocEconSoc,0,0,0,0,0,0,1,0,1,0,1,1,1,0,1,0,0,0,2,1,3
fa13,133,SIXTH,SOC,SocIntlStu,0,0,0,0,0,0,0,0,0,0,1,1,0,1,1,0,0,0,0,2,2
fa13,133,SIXTH,SOC,Sociology,2,1,3,0,0,0,0,3,3,5,8,13,2,10,12,0,0,0,9,22,31
fa13,133,SIXTH,SOC,SocLawSoc,0,0,0,0,0,0,0,0,0,0,3,3,1,1,2,0,0,0,1,4,5
fa13,133,SIXTH,SOC,SocSciMed,0,0,0,0,0,0,0,1,1,1,0,1,1,0,1,0,0,0,2,1,3
fa13,133,SIXTH,SOC,SocSolneq,0,0,0,0,0,0,0,0,0,0,0,0,0,5,5,0,0,0,0,5,5
fa13,133,SIXTH,THEA,Dance,0,0,0,0,0,0,0,1,1,0,1,1,0,0,0,0,0,0,0,2,2
fa13,133,SIXTH,THEA,Theatre,0,5,5,0,0,0,1,2,3,6,4,10,2,11,13,0,0,0,9,22,31
fa13,133,SIXTH,UNAF,UndecHumAr,2,3,5,0,0,0,0,1,1,0,0,0,0,0,0,0,0,0,2,4,6
fa13,133,SIXTH,UNAF,Undeclared,86,51,137,5,2,7,6,8,14,0,0,0,0,0,0,0,0,0,97,61,158
fa13,133,SIXTH,UNAF,UndecPhysS,11,6,17,0,0,0,1,1,2,0,0,0,0,0,0,0,0,0,12,7,19
fa13,133,SIXTH,UNAF,UndecSocSc,6,9,15,0,0,0,0,1,1,1,0,1,0,0,0,0,0,0,7,10,17
fa13,133,SIXTH,USP,Urb Stu&Pl,0,0,0,0,0,0,2,2,4,1,7,8,5,6,11,0,0,0,8,15,23
fa13,133,SIXTH,VIS,Art Hst/Cr,0,0,0,0,0,0,0,0,0,0,4,4,0,5,5,0,0,0,0,9,9
fa13,133,SIXTH,VIS,Media,10,11,21,0,1,1,3,6,9,7,18,25,19,9,28,0,0,0,39,45,84
fa13,133,SIXTH,VIS,Studio VA,0,4,4,0,0,0,0,1,1,2,8,10,1,14,15,0,0,0,3,27,30
fa13,133,SIXTH,VIS,VA-CompArt,1,7,8,0,0,0,1,4,5,3,3,6,7,5,12,0,0,0,12,19,31
fa13,133,WARREN,ANTH,Anth-Arch,0,1,1,0,0,0,0,1,1,1,2,3,0,1,1,0,0,0,1,5,6
fa13,133,WARREN,ANTH,Anth-Biol,0,0,0,0,0,0,0,0,0,0,0,0,0,3,3,0,0,0,0,3,3
fa13,133,WARREN,ANTH,Anth-Soci,0,0,0,0,0,0,0,0,0,1,1,2,1,2,3,0,0,0,2,3,5
fa13,133,WARREN,BENG,Bioen:Binf,3,6,9,1,1,2,3,1,4,4,5,9,3,5,8,0,0,0,14,18,32
fa13,133,WARREN,BENG,Bioeng:PM,0,0,0,0,0,0,0,0,0,0,0,0,2,1,3,0,0,0,2,1,3
fa13,133,WARREN,BENG,BioengBioS,10,0,10,0,0,0,1,0,1,0,1,1,0,0,0,0,0,0,11,1,12
fa13,133,WARREN,BENG,BioengBiot,6,6,12,0,0,0,2,4,6,13,11,24,23,17,40,0,0,0,44,38,82
fa13,133,WARREN,BENG,Bioengin,7,7,14,0,0,0,1,3,4,11,4,15,18,11,29,0,0,0,37,25,62
fa13,133,WARREN,BIOL,Bioc/CellB,14,25,39,2,0,2,13,8,21,17,28,45,33,28,61,0,0,0,79,89,168
fa13,133,WARREN,BIOL,BiolBioinf,0,2,2,0,0,0,0,0,0,2,0,2,0,0,0,0,0,0,2,2,4
fa13,133,WARREN,BIOL,Ec/Beh/Evo,2,1,3,0,1,1,2,1,3,0,0,0,2,7,9,0,0,0,6,10,16
fa13,133,WARREN,BIOL,Genl Biol,6,20,26,1,1,2,3,8,11,14,27,41,29,32,61,0,0,0,53,88,141
fa13,133,WARREN,BIOL,Human Bio,20,36,56,2,1,3,11,24,35,24,30,54,31,37,68,0,0,0,88,128,216
fa13,133,WARREN,BIOL,Microbiol,1,2,3,0,0,0,2,0,2,5,5,10,2,9,11,0,0,0,10,16,26
fa13,133,WARREN,BIOL,Molec Biol,3,1,4,0,0,0,2,2,4,1,4,5,9,7,16,0,0,0,15,14,29
fa13,133,WARREN,BIOL,PhyslNeuro,9,16,25,1,0,1,8,4,12,12,13,25,16,18,34,0,0,0,46,51,97
fa13,133,WARREN,CENG,Chem Engin,30,12,42,0,0,0,12,4,16,28,18,46,51,25,76,0,0,0,121,59,180
fa13,133,WARREN,CGS,CritGendSt,0,0,0,0,0,0,1,0,1,0,0,0,0,0,0,0,0,0,1,0,1
fa13,133,WARREN,CHEM,Bioch/Chem,7,8,15,0,0,0,1,1,2,8,11,19,26,17,43,0,0,0,42,37,79
fa13,133,WARREN,CHEM,Bioinform,0,1,1,0,0,0,0,0,0,0,0,0,0,0,0,0,0,0,0,1,1
fa13,133,WARREN,CHEM,Chem Phys,0,0,0,0,0,0,0,0,0,0,0,0,0,1,1,0,0,0,0,1,1
fa13,133,WARREN,CHEM,Chemistry,3,9,12,0,0,0,0,1,1,5,3,8,3,10,13,0,0,0,11,23,34
fa13,133,WARREN,CHEM,Envir Chem,0,0,0,0,0,0,0,0,0,0,1,1,0,3,3,0,0,0,0,4,4
fa13,133,WARREN,CHEM,MolecSynth,0,0,0,0,0,0,0,0,0,0,0,0,4,0,4,0,0,0,4,0,4
fa13,133,WARREN,CHEM,Pharm Chem,2,3,5,0,2,2,0,1,1,5,12,17,16,24,40,0,0,0,23,42,65
fa13,133,WARREN,CHIN,Chinese St,0,0,0,0,0,0,0,1,1,0,1,1,0,0,0,0,0,0,0,2,2
fa13,133,WARREN,COGS,Cog Sci,3,3,6,0,1,1,0,4,4,1,4,5,8,1,9,0,0,0,12,13,25
fa13,133,WARREN,COGS,CogSc/ClAs,0,0,0,0,0,0,1,1,2,0,1,1,0,2,2,0,0,0,1,4,5
fa13,133,WARREN,COGS,CogSc/Comp,0,0,0,0,0,0,0,0,0,0,0,0,1,0,1,0,0,0,1,0,1
fa13,133,WARREN,COGS,CogSc/HCI,0,0,0,0,0,0,0,0,0,0,0,0,6,5,11,0,0,0,6,5,11
fa13,133,WARREN,COGS,CogSc/HCog,0,0,0,0,0,0,0,0,0,1,2,3,0,1,1,0,0,0,1,3,4
fa13,133,WARREN,COGS,CogSc/Neur,0,1,1,0,0,0,0,0,0,0,5,5,10,16,26,0,0,0,10,22,32
fa13,133,WARREN,COMM,Communic,1,5,6,0,1,1,6,5,11,12,27,39,8,17,25,0,0,0,27,55,82
fa13,133,WARREN,CSE,Comp Sci,39,7,46,3,1,4,60,19,79,102,16,118,150,31,181,0,0,0,354,74,428
fa13,133,WARREN,CSE,CompEngCSE,20,2,22,0,0,0,13,2,15,35,3,38,37,5,42,0,0,0,105,12,117
fa13,133,WARREN,CSE,CompScBinf,15,1,16,0,0,0,1,1,2,2,2,4,8,5,13,0,0,0,26,9,35
fa13,133,WARREN,ECE,CompEngECE,12,2,14,0,0,0,3,0,3,12,0,12,10,0,10,0,0,0,37,2,39
fa13,133,WARREN,ECE,Electr Eng,77,23,100,3,0,3,24,4,28,72,12,84,79,13,92,0,0,0,255,52,307
fa13,133,WARREN,ECE,EleEng&Soc,0,1,1,0,0,0,0,0,0,0,1,1,0,0,0,0,0,0,0,2,2
fa13,133,WARREN,ECE,Engin Phys,3,0,3,0,0,0,2,0,2,1,0,1,2,0,2,0,0,0,8,0,8
fa13,133,WARREN,ECE,Pr-EngPhys,2,1,3,0,0,0,0,0,0,1,0,1,0,0,0,0,0,0,3,1,4
fa13,133,WARREN,ECON,Ec-Mth&Ecn,6,7,13,0,0,0,6,1,7,3,2,5,6,0,6,0,0,0,21,10,31
fa13,133,WARREN,ECON,Econ-MgtSc,5,8,13,2,1,3,12,8,20,20,14,34,32,18,50,0,0,0,71,49,120
fa13,133,WARREN,ECON,Economics,22,7,29,2,3,5,13,6,19,66,32,98,56,34,90,0,0,0,159,82,241
fa13,133,WARREN,ESYS,EnvSys(EB),0,0,0,0,0,0,0,0,0,0,1,1,4,5,9,0,0,0,4,6,10
fa13,133,WARREN,ESYS,EnvSys(EP),2,1,3,0,0,0,0,1,1,0,0,0,1,1,2,0,0,0,3,3,6
fa13,133,WARREN,ESYS,EnvSys(ES),1,0,1,0,0,0,0,0,0,0,2,2,1,0,1,0,0,0,2,2,4
fa13,133,WARREN,ETHN,Ethnic St,0,0,0,0,1,1,1,1,2,1,1,2,0,2,2,0,0,0,2,5,7
fa13,133,WARREN,FPMU,Public Hlt,0,0,0,0,0,0,0,4,4,0,4,4,2,0,2,0,0,0,2,8,10
fa13,133,WARREN,HDP,Human Dev,0,0,0,0,0,0,1,0,1,1,4,5,3,14,17,0,0,0,5,18,23
fa13,133,WARREN,HDP,Pr-HumnDev,1,2,3,0,0,0,0,2,2,1,7,8,0,1,1,0,0,0,2,12,14
fa13,133,WARREN,HIST,History,1,0,1,0,0,0,1,1,2,5,1,6,6,2,8,0,0,0,13,4,17
fa13,133,WARREN,INTD,Wa Ind St,0,0,0,0,0,0,0,0,0,0,0,0,0,1,1,0,0,0,0,1,1
fa13,133,WARREN,INTL,IntSt-Econ,0,2,2,0,0,0,0,0,0,2,3,5,0,11,11,0,0,0,2,16,18
fa13,133,WARREN,INTL,IntSt-Hist,0,0,0,0,0,0,0,0,0,0,0,0,0,2,2,0,0,0,0,2,2
fa13,133,WARREN,INTL,IntSt-Ling,0,0,0,0,0,0,0,0,0,0,1,1,0,1,1,0,0,0,0,2,2
fa13,133,WARREN,INTL,IntSt-PolS,0,1,1,0,0,0,0,4,4,3,1,4,3,0,3,0,0,0,6,6,12
fa13,133,WARREN,INTL,IntSt-Soc,0,0,0,0,1,1,0,0,0,0,1,1,0,1,1,0,0,0,0,3,3
fa13,133,WARREN,JAPN,JapaneseSt,0,0,0,0,0,0,0,0,0,1,0,1,0,0,0,0,0,0,1,0,1
fa13,133,WARREN,JUDA,Judaic Stu,0,0,0,0,0,0,0,0,0,1,0,1,1,0,1,0,0,0,2,0,2
fa13,133,WARREN,LING,Lang Stu,0,0,0,0,0,0,0,0,0,0,0,0,1,1,2,0,0,0,1,1,2
fa13,133,WARREN,LING,Ling-CogLn,0,1,1,0,0,0,0,0,0,0,1,1,0,1,1,0,0,0,0,3,3
fa13,133,WARREN,LING,Ling-LSoc,1,0,1,0,0,0,1,0,1,0,0,0,0,0,0,0,0,0,2,0,2
fa13,133,WARREN,LING,Linguistcs,0,0,0,0,0,0,0,0,0,0,2,2,2,1,3,0,0,0,2,3,5
fa13,133,WARREN,LIT,Lit/Engl,1,0,1,0,0,0,0,2,2,1,3,4,0,2,2,0,0,0,2,7,9
fa13,133,WARREN,LIT,Lit/World,0,0,0,0,0,0,0,0,0,0,0,0,0,1,1,0,0,0,0,1,1
fa13,133,WARREN,LIT,Lit/Writng,0,1,1,0,0,0,0,1,1,5,5,10,0,7,7,0,0,0,5,14,19
fa13,133,WARREN,LIT,Spanish Lt,0,0,0,0,0,0,0,1,1,1,0,1,1,0,1,0,0,0,2,1,3
fa13,133,WARREN,MAE,Aerosp Eng,18,2,20,1,0,1,9,4,13,14,6,20,28,2,30,0,0,0,70,14,84
fa13,133,WARREN,MAE,Engin Sci,0,0,0,0,0,0,0,0,0,4,0,4,6,1,7,0,0,0,10,1,11
fa13,133,WARREN,MAE,Envir Eng,13,8,21,0,0,0,8,1,9,7,4,11,15,15,30,0,0,0,43,28,71
fa13,133,WARREN,MAE,Mech Engin,27,5,32,1,0,1,11,3,14,30,5,35,50,11,61,0,0,0,119,24,143
fa13,133,WARREN,MATH,Appld Math,7,3,10,1,0,1,3,3,6,6,5,11,7,3,10,0,0,0,24,14,38
fa13,133,WARREN,MATH,Math/SecEd,0,0,0,0,0,0,0,4,4,0,2,2,2,0,2,0,0,0,2,6,8
fa13,133,WARREN,MATH,Mathematcs,4,4,8,0,0,0,2,1,3,0,6,6,5,2,7,0,0,0,11,13,24
fa13,133,WARREN,MATH,Mth-CompSc,8,2,10,0,0,0,0,0,0,0,0,0,4,2,6,0,0,0,12,4,16
fa13,133,WARREN,MATH,Mth-Mth&Ec,3,5,8,2,1,3,2,4,6,5,7,12,6,7,13,0,0,0,18,24,42
fa13,133,WARREN,MATH,Mth-SciCom,1,0,1,0,0,0,0,0,0,0,0,0,0,0,0,0,0,0,1,0,1
fa13,133,WARREN,MATH,Mth/ApldSc,1,0,1,1,0,1,0,0,0,2,1,3,0,3,3,0,0,0,4,4,8
fa13,133,WARREN,MATH,Pr-Math CS,0,1,1,0,0,0,0,0,0,0,0,0,0,0,0,0,0,0,0,1,1
fa13,133,WARREN,MATH,Prob&Stats,2,1,3,1,0,1,0,2,2,1,3,4,4,2,6,0,0,0,8,8,16
fa13,133,WARREN,MUS,Mu-CompArt,0,0,0,0,0,0,1,1,2,1,2,3,1,1,2,0,0,0,3,4,7
fa13,133,WARREN,MUS,Music,1,0,1,0,0,0,0,0,0,1,1,2,2,0,2,0,0,0,4,1,5
fa13,133,WARREN,MUS,Music Hum,0,0,0,0,0,0,0,0,0,0,0,0,1,0,1,0,0,0,1,0,1
fa13,133,WARREN,NENG,NanoEng,15,3,18,0,0,0,11,1,12,14,2,16,32,9,41,0,0,0,72,15,87
fa13,133,WARREN,PHIL,Philosophy,0,2,2,0,0,0,0,0,0,6,2,8,7,1,8,0,0,0,13,5,18
fa13,133,WARREN,PHYS,Biophysics,0,1,1,0,0,0,0,0,0,3,1,4,1,2,3,0,0,0,4,4,8
fa13,133,WARREN,PHYS,Phys/Astro,4,0,4,1,0,1,1,0,1,0,2,2,2,0,2,0,0,0,8,2,10
fa13,133,WARREN,PHYS,Phys/Comp,1,0,1,0,0,0,0,0,0,0,0,0,1,1,2,0,0,0,2,1,3
fa13,133,WARREN,PHYS,Physics,4,0,4,0,0,0,3,0,3,3,1,4,4,2,6,0,0,0,14,3,17
fa13,133,WARREN,POLI,Polit Sci,4,1,5,0,1,1,4,5,9,16,12,28,22,13,35,0,0,0,46,32,78
fa13,133,WARREN,POLI,PolSc-Amer,2,0,2,0,0,0,0,1,1,6,2,8,6,5,11,0,0,0,14,8,22
fa13,133,WARREN,POLI,PolSc-Comp,0,0,0,0,0,0,0,0,0,0,0,0,0,1,1,0,0,0,0,1,1
fa13,133,WARREN,POLI,PolSc-Intl,1,2,3,0,0,0,5,0,5,4,2,6,6,3,9,0,0,0,16,7,23
fa13,133,WARREN,POLI,PolSc-PLaw,1,2,3,1,0,1,2,4,6,5,5,10,3,3,6,0,0,0,12,14,26
fa13,133,WARREN,POLI,PolSc-PPol,0,1,1,0,0,0,0,0,0,2,1,3,3,2,5,0,0,0,5,4,9
fa13,133,WARREN,POLI,PolSc-Thry,0,0,0,0,0,0,0,0,0,1,0,1,1,1,2,0,0,0,2,1,3
fa13,133,WARREN,PSYC,Psychology,2,20,22,0,2,2,4,15,19,21,38,59,24,53,77,0,0,0,51,128,179
fa13,133,WARREN,RELI,Relig/Stu,0,0,0,0,0,0,0,0,0,1,0,1,0,1,1,0,0,0,1,1,2
fa13,133,WARREN,SE,Engin Sci,0,2,2,0,0,0,2,0,2,0,0,0,0,0,0,0,0,0,2,2,4
fa13,133,WARREN,SE,Struct Eng,29,14,43,3,0,3,22,6,28,37,13,50,62,16,78,0,0,0,153,49,202
fa13,133,WARREN,SIO,Earth Sci,0,0,0,0,0,0,1,0,1,1,1,2,2,3,5,0,0,0,4,4,8
fa13,133,WARREN,SIO,Marine Bio,1,2,3,0,0,0,0,1,1,0,3,3,2,1,3,0,0,0,3,7,10
fa13,133,WARREN,SOC,SocCulCom,0,0,0,0,0,0,0,0,0,0,0,0,0,1,1,0,0,0,0,1,1
fa13,133,WARREN,SOC,SocEconSoc,0,0,0,0,0,0,0,0,0,0,0,0,0,1,1,0,0,0,0,1,1
fa13,133,WARREN,SOC,Sociology,0,0,0,0,1,1,0,0,0,5,12,17,7,5,12,0,0,0,12,18,30
fa13,133,WARREN,SOC,SocLawSoc,0,0,0,0,0,0,1,2,3,1,2,3,1,3,4,0,0,0,3,7,10
fa13,133,WARREN,SOC,SocSciMed,0,0,0,0,0,0,0,0,0,0,0,0,0,2,2,0,0,0,0,2,2
fa13,133,WARREN,SOC,SocSolneq,0,0,0,0,0,0,0,1,1,0,1,1,0,2,2,0,0,0,0,4,4
fa13,133,WARREN,THEA,Theatre,0,0,0,0,0,0,0,0,0,0,1,1,4,3,7,0,0,0,4,4,8
fa13,133,WARREN,UNAF,IntcampVis,0,0,0,0,0,0,0,1,1,0,0,0,0,1,1,0,0,0,0,2,2
fa13,133,WARREN,UNAF,Limited St,0,0,0,0,0,0,0,0,0,0,0,0,0,0,0,3,0,3,3,0,3
fa13,133,WARREN,UNAF,UndecHumAr,0,1,1,0,0,0,0,0,0,0,0,0,0,0,0,0,0,0,0,1,1
fa13,133,WARREN,UNAF,Undeclared,54,29,83,2,0,2,3,3,6,1,1,2,0,0,0,0,0,0,60,33,93
fa13,133,WARREN,UNAF,UndecPhysS,3,0,3,0,0,0,0,1,1,0,0,0,0,0,0,0,0,0,3,1,4
fa13,133,WARREN,UNAF,UndecSocSc,1,3,4,0,0,0,1,0,1,0,0,0,0,0,0,0,0,0,2,3,5
fa13,133,WARREN,USP,Urb Stu&Pl,0,1,1,1,0,1,0,0,0,2,1,3,4,1,5,0,0,0,7,3,10
fa13,133,WARREN,VIS,Art Hst/Cr,0,0,0,0,0,0,0,0,0,0,1,1,1,0,1,0,0,0,1,1,2
fa13,133,WARREN,VIS,Media,0,2,2,0,0,0,2,0,2,3,2,5,6,5,11,0,0,0,11,9,20
fa13,133,WARREN,VIS,Studio VA,0,1,1,0,0,0,0,0,0,1,0,1,3,2,5,0,0,0,4,3,7
fa13,133,WARREN,VIS,VA-CompArt,0,0,0,0,0,0,1,0,1,0,1,1,1,0,1,0,0,0,2,1,3
fa15,153,MARSHALL,ANTH,Anth-Arch,0,0,0,0,0,0,0,0,0,1,1,2,1,0,1,0,0,0,2,1,3
fa15,153,MARSHALL,ANTH,Anth-Biol,0,0,0,0,0,0,0,0,0,0,1,1,0,0,0,0,0,0,0,1,1
fa15,153,MARSHALL,ANTH,Anth-Soci,0,1,1,0,0,0,0,0,0,0,3,3,2,3,5,0,0,0,2,7,9
fa15,153,MARSHALL,BENG,Bioen:Binf,1,2,3,0,0,0,1,0,1,1,2,3,4,7,11,0,0,0,7,11,18
fa15,153,MARSHALL,BENG,BioengBioS,2,1,3,0,0,0,1,0,1,3,1,4,4,0,4,0,0,0,10,2,12
fa15,153,MARSHALL,BENG,BioengBiot,2,2,4,0,0,0,0,0,0,1,3,4,3,4,7,0,0,0,6,9,15
fa15,153,MARSHALL,BENG,Bioengin,1,1,2,0,0,0,0,0,0,0,1,1,6,4,10,0,0,0,7,6,13
fa15,153,MARSHALL,BIOL,Bioc/CellB,18,22,40,1,0,1,5,14,19,22,40,62,37,60,97,0,0,0,83,136,219
fa15,153,MARSHALL,BIOL,BiolBioinf,2,2,4,0,0,0,1,1,2,3,3,6,0,2,2,0,0,0,6,8,14
fa15,153,MARSHALL,BIOL,Ec/Beh/Evo,0,3,3,0,0,0,0,2,2,1,4,5,1,1,2,0,0,0,2,10,12
fa15,153,MARSHALL,BIOL,Genl Biol,17,25,42,0,1,1,8,11,19,14,34,48,27,47,74,0,0,0,66,118,184
fa15,153,MARSHALL,BIOL,Human Bio,25,58,83,1,3,4,14,33,47,30,46,76,31,70,101,0,0,0,101,210,311
fa15,153,MARSHALL,BIOL,Microbiol,1,4,5,0,0,0,2,2,4,4,6,10,7,8,15,0,0,0,14,20,34
fa15,153,MARSHALL,BIOL,Molec Biol,7,4,11,0,0,0,1,0,1,5,5,10,6,4,10,0,0,0,19,13,32
fa15,153,MARSHALL,BIOL,PhyslNeuro,18,19,37,1,1,2,4,7,11,19,35,54,22,29,51,0,0,0,64,91,155
fa15,153,MARSHALL,CENG,Chem Engin,3,4,7,0,0,0,0,0,0,12,2,14,31,23,54,0,0,0,46,29,75
fa15,153,MARSHALL,CGS,CritGendSt,0,1,1,0,0,0,0,0,0,0,0,0,0,0,0,0,0,0,0,1,1
fa15,153,MARSHALL,CHEM,Bioch/Chem,6,7,13,0,0,0,1,1,2,6,3,9,7,13,20,0,0,0,20,24,44
fa15,153,MARSHALL,CHEM,Bioinform,0,0,0,0,0,0,0,0,0,2,0,2,2,0,2,0,0,0,4,0,4
fa15,153,MARSHALL,CHEM,Chem Educ,0,0,0,0,0,0,0,0,0,0,0,0,1,0,1,0,0,0,1,0,1
fa15,153,MARSHALL,CHEM,Chem Phys,0,0,0,0,0,0,0,0,0,0,0,0,0,1,1,0,0,0,0,1,1
fa15,153,MARSHALL,CHEM,Chemistry,8,7,15,0,2,2,3,2,5,6,12,18,2,7,9,0,0,0,19,30,49
fa15,153,MARSHALL,CHEM,Envir Chem,0,0,0,0,0,0,0,1,1,1,0,1,0,1,1,0,0,0,1,2,3
fa15,153,MARSHALL,CHEM,MolecSynth,0,0,0,0,0,0,0,0,0,1,0,1,1,2,3,0,0,0,2,2,4
fa15,153,MARSHALL,CHEM,Pharm Chem,2,10,12,1,0,1,1,2,3,6,9,15,6,5,11,0,0,0,16,26,42
fa15,153,MARSHALL,CLAS,Classic St,0,0,0,0,0,0,0,0,0,0,0,0,0,1,1,0,0,0,0,1,1
fa15,153,MARSHALL,COGS,Cog Sci,4,3,7,0,1,1,1,4,5,3,6,9,1,6,7,0,0,0,9,20,29
fa15,153,MARSHALL,COGS,CogSc/ClAs,0,1,1,0,0,0,0,1,1,0,1,1,0,1,1,0,0,0,0,4,4
fa15,153,MARSHALL,COGS,CogSc/Comp,0,0,0,0,0,0,1,1,2,0,1,1,0,1,1,0,0,0,1,3,4
fa15,153,MARSHALL,COGS,CogSc/HCI,0,0,0,0,1,1,3,6,9,1,5,6,6,7,13,0,0,0,10,19,29
fa15,153,MARSHALL,COGS,CogSc/HCog,0,1,1,0,0,0,0,0,0,2,1,3,0,3,3,0,0,0,2,5,7
fa15,153,MARSHALL,COGS,CogSc/Neur,2,2,4,0,0,0,0,2,2,1,2,3,2,6,8,0,0,0,5,12,17
fa15,153,MARSHALL,COMM,Communic,1,7,8,0,1,1,3,9,12,24,47,71,14,60,74,0,0,0,42,124,166
fa15,153,MARSHALL,CSE,Comp Sci,15,1,16,1,0,1,13,3,16,41,12,53,129,27,156,0,0,0,199,43,242
fa15,153,MARSHALL,CSE,CompEngCSE,3,0,3,0,0,0,0,0,0,5,1,6,18,3,21,0,0,0,26,4,30
fa15,153,MARSHALL,CSE,CompScBinf,2,1,3,0,0,0,0,1,1,0,2,2,5,1,6,0,0,0,7,5,12
fa15,153,MARSHALL,ECE,CompEngECE,5,2,7,0,0,0,3,0,3,13,2,15,16,2,18,0,0,0,37,6,43
fa15,153,MARSHALL,ECE,Electr Eng,6,1,7,0,0,0,8,1,9,14,3,17,66,12,78,0,0,0,94,17,111
fa15,153,MARSHALL,ECE,Engin Phys,0,0,0,0,0,0,0,0,0,1,0,1,0,0,0,0,0,0,1,0,1
fa15,153,MARSHALL,ECE,Pr-EngPhys,0,0,0,0,0,0,0,0,0,0,1,1,0,0,0,0,0,0,0,1,1
fa15,153,MARSHALL,ECON,Ec-Mth&Ecn,9,10,19,2,1,3,6,10,16,15,9,24,12,6,18,0,0,0,44,36,80
fa15,153,MARSHALL,ECON,Econ-MgtSc,2,4,6,1,1,2,4,9,13,19,32,51,37,44,81,0,0,0,63,90,153
fa15,153,MARSHALL,ECON,Economics,7,17,24,1,0,1,15,15,30,90,70,160,102,70,172,0,0,0,215,172,387
fa15,153,MARSHALL,ECON,EnvSys(EB),1,0,1,0,0,0,0,1,1,1,3,4,2,4,6,0,0,0,4,8,12
fa15,153,MARSHALL,ECON,EnvSys(EC),1,1,2,0,0,0,0,0,0,1,0,1,1,3,4,0,0,0,3,4,7
fa15,153,MARSHALL,ECON,EnvSys(EP),0,2,2,0,0,0,0,0,0,2,2,4,1,2,3,0,0,0,3,6,9
fa15,153,MARSHALL,ECON,EnvSys(ES),0,1,1,0,0,0,0,1,1,1,3,4,1,0,1,0,0,0,2,5,7
fa15,153,MARSHALL,ETHN,Ethnic St,0,1,1,0,0,0,0,3,3,2,3,5,0,2,2,0,0,0,2,9,11
fa15,153,MARSHALL,FPMU,Public Hlt,1,8,9,1,1,2,0,11,11,6,23,29,10,43,53,0,0,0,18,86,104
fa15,153,MARSHALL,GLBH,Global Hlt,0,2,2,0,0,0,2,0,2,4,1,5,1,2,3,0,0,0,7,5,12
fa15,153,MARSHALL,HDP,Human Dev,0,0,0,0,0,0,0,0,0,0,5,5,2,15,17,0,0,0,2,20,22
fa15,153,MARSHALL,HDP,Pr-HumnDev,0,3,3,0,0,0,0,6,6,1,12,13,0,2,2,0,0,0,1,23,24
fa15,153,MARSHALL,HIST,History,1,3,4,0,0,0,0,1,1,4,3,7,4,4,8,0,0,0,9,11,20
fa15,153,MARSHALL,INTD,Mar Ind St,0,0,0,0,0,0,0,0,0,0,0,0,1,0,1,0,0,0,1,0,1
fa15,153,MARSHALL,INTL,InSt-InBus,0,5,5,0,0,0,0,6,6,10,9,19,1,2,3,0,0,0,11,22,33
fa15,153,MARSHALL,INTL,Int-5yrEC,0,0,0,0,0,0,0,0,0,0,0,0,1,0,1,0,0,0,1,0,1
fa15,153,MARSHALL,INTL,Int-5yrPS,0,0,0,0,0,0,0,0,0,0,0,0,0,1,1,0,0,0,0,1,1
fa15,153,MARSHALL,INTL,IntSt-Anth,0,0,0,0,0,0,0,0,0,0,1,1,0,0,0,0,0,0,0,1,1
fa15,153,MARSHALL,INTL,IntSt-Econ,1,3,4,0,1,1,2,1,3,5,5,10,3,4,7,0,0,0,11,14,25
fa15,153,MARSHALL,INTL,IntSt-Hist,1,0,1,0,0,0,0,0,0,0,1,1,0,0,0,0,0,0,1,1,2
fa15,153,MARSHALL,INTL,IntSt-Ling,0,0,0,0,0,0,1,0,1,1,0,1,0,0,0,0,0,0,2,0,2
fa15,153,MARSHALL,INTL,IntSt-PolS,0,1,1,1,0,1,0,4,4,0,7,7,3,5,8,0,0,0,4,17,21
fa15,153,MARSHALL,INTL,IntSt-Soc,0,0,0,0,0,0,2,0,2,1,2,3,0,1,1,0,0,0,3,3,6
fa15,153,MARSHALL,JAPN,JapaneseSt,0,0,0,0,0,0,1,1,2,0,0,0,0,0,0,0,0,0,1,1,2
fa15,153,MARSHALL,JAPN,LatinAm St,0,0,0,0,0,0,0,0,0,0,0,0,0,1,1,0,0,0,0,1,1
fa15,153,MARSHALL,LING,Lang Stu,1,0,1,0,0,0,0,0,0,0,0,0,0,0,0,0,0,0,1,0,1
fa15,153,MARSHALL,LING,Ling-CogLn,0,1,1,0,0,0,0,0,0,0,2,2,0,1,1,0,0,0,0,4,4
fa15,153,MARSHALL,LING,Ling-LSoc,0,0,0,0,0,0,0,1,1,1,0,1,0,0,0,0,0,0,1,1,2
fa15,153,MARSHALL,LING,Linguistcs,0,0,0,0,0,0,0,0,0,0,1,1,0,0,0,0,0,0,0,1,1
fa15,153,MARSHALL,LIT,Lit/CultSt,0,0,0,0,0,0,1,0,1,1,0,1,0,0,0,0,0,0,2,0,2
fa15,153,MARSHALL,LIT,Lit/Engl,0,4,4,0,0,0,0,3,3,1,4,5,2,1,3,0,0,0,3,12,15
fa15,153,MARSHALL,LIT,Lit/World,0,1,1,0,0,0,0,0,0,0,0,0,0,2,2,0,0,0,0,3,3
fa15,153,MARSHALL,LIT,Lit/Writng,0,3,3,0,0,0,1,1,2,3,5,8,3,3,6,0,0,0,7,12,19
fa15,153,MARSHALL,MAE,Aerosp Eng,6,0,6,0,0,0,1,1,2,3,1,4,9,0,9,0,0,0,19,2,21
fa15,153,MARSHALL,MAE,Envir Eng,1,2,3,0,0,0,4,0,4,3,3,6,10,4,14,0,0,0,18,9,27
fa15,153,MARSHALL,MAE,Mech Engin,5,0,5,1,0,1,7,1,8,8,0,8,9,3,12,0,0,0,30,4,34
fa15,153,MARSHALL,MATH,Appld Math,11,9,20,0,0,0,7,8,15,10,7,17,9,9,18,0,0,0,37,33,70
fa15,153,MARSHALL,MATH,Math/SecEd,3,0,3,0,0,0,0,0,0,1,0,1,0,2,2,0,0,0,4,2,6
fa15,153,MARSHALL,MATH,Mathematcs,7,6,13,0,2,2,1,0,1,4,4,8,3,2,5,0,0,0,15,14,29
fa15,153,MARSHALL,MATH,Mth-CompSc,22,6,28,0,0,0,12,1,13,24,6,30,4,3,7,0,0,0,62,16,78
fa15,153,MARSHALL,MATH,Mth-Mth&Ec,3,1,4,1,0,1,5,5,10,4,7,11,5,7,12,0,0,0,18,20,38
fa15,153,MARSHALL,MATH,Mth/ApldSc,1,0,1,0,0,0,0,0,0,0,2,2,1,0,1,0,0,0,2,2,4
fa15,153,MARSHALL,MATH,Prob&Stats,4,2,6,0,0,0,2,7,9,9,9,18,3,3,6,0,0,0,18,21,39
fa15,153,MARSHALL,MUS,Mu-CompArt,0,1,1,0,0,0,1,0,1,1,0,1,0,1,1,0,0,0,2,2,4
fa15,153,MARSHALL,MUS,Music,0,0,0,0,0,0,0,1,1,0,0,0,2,0,2,0,0,0,2,1,3
fa15,153,MARSHALL,MUS,Music Hum,0,0,0,0,0,0,0,0,0,0,0,0,0,1,1,0,0,0,0,1,1
fa15,153,MARSHALL,NENG,NanoEng,3,0,3,0,0,0,4,2,6,5,3,8,19,4,23,0,0,0,31,9,40
fa15,153,MARSHALL,NENG,Philosophy,0,1,1,0,0,0,0,0,0,2,0,2,3,1,4,0,0,0,5,2,7
fa15,153,MARSHALL,PHYS,Biophysics,2,0,2,0,0,0,0,0,0,3,0,3,1,0,1,0,0,0,6,0,6
fa15,153,MARSHALL,PHYS,Phy/ErthSc,0,1,1,0,0,0,0,0,0,0,1,1,1,0,1,0,0,0,1,2,3
fa15,153,MARSHALL,PHYS,Phys/Astro,1,0,1,0,0,0,0,0,0,3,0,3,0,0,0,0,0,0,4,0,4
fa15,153,MARSHALL,PHYS,Phys/Comp,0,0,0,0,0,0,0,0,0,2,0,2,0,1,1,0,0,0,2,1,3
fa15,153,MARSHALL,PHYS,Phys/Mtrls,0,1,1,0,0,0,0,1,1,0,0,0,0,0,0,0,0,0,0,2,2
fa15,153,MARSHALL,PHYS,Physics,13,0,13,0,1,1,4,1,5,6,1,7,3,2,5,0,0,0,26,5,31
fa15,153,MARSHALL,POLI,Polit Sci,4,7,11,0,0,0,5,5,10,10,10,20,9,8,17,0,0,0,28,30,58
fa15,153,MARSHALL,POLI,PolSc-Amer,1,1,2,0,0,0,0,0,0,2,3,5,3,1,4,0,0,0,6,5,11
fa15,153,MARSHALL,POLI,PolSc-Comp,0,0,0,0,0,0,0,0,0,1,0,1,2,3,5,0,0,0,3,3,6
fa15,153,MARSHALL,POLI,PolSc-Intl,3,2,5,0,0,0,2,2,4,4,5,9,7,5,12,0,0,0,16,14,30
fa15,153,MARSHALL,POLI,PolSc-PLaw,2,2,4,0,1,1,1,2,3,3,5,8,5,9,14,0,0,0,11,19,30
fa15,153,MARSHALL,POLI,PolSc-PPol,0,2,2,0,0,0,0,0,0,2,2,4,0,3,3,0,0,0,2,7,9
fa15,153,MARSHALL,POLI,PolSc-Thry,0,0,0,0,0,0,0,0,0,1,1,2,1,1,2,0,0,0,2,2,4
fa15,153,MARSHALL,PSYC,Psyc/ClPsy,1,5,6,1,1,2,0,3,3,2,8,10,6,8,14,0,0,0,10,25,35
fa15,153,MARSHALL,PSYC,Psyc/CogPs,1,2,3,0,0,0,0,1,1,0,2,2,0,2,2,0,0,0,1,7,8
fa15,153,MARSHALL,PSYC,Psyc/DelPs,1,1,2,0,0,0,0,1,1,0,2,2,0,4,4,0,0,0,1,8,9
fa15,153,MARSHALL,PSYC,Psyc/HumHl,0,0,0,0,1,1,0,0,0,2,0,2,2,8,10,0,0,0,4,9,13
fa15,153,MARSHALL,PSYC,Psyc/SenPr,0,0,0,0,0,0,0,0,0,1,0,1,0,1,1,0,0,0,1,1,2
fa15,153,MARSHALL,PSYC,Psyc/SocPs,1,3,4,0,0,0,0,1,1,2,3,5,0,5,5,0,0,0,3,12,15
fa15,153,MARSHALL,PSYC,Psychology,5,13,18,0,1,1,6,13,19,22,37,59,17,39,56,0,0,0,50,103,153
fa15,153,MARSHALL,RELI,Relig/Stu,1,0,1,0,0,0,0,0,0,1,0,1,1,0,1,0,0,0,3,0,3
fa15,153,MARSHALL,SE,Engin Sci,1,0,1,0,0,0,0,0,0,0,1,1,0,0,0,0,0,0,1,1,2
fa15,153,MARSHALL,SE,Struct Eng,1,0,1,0,0,0,3,3,6,13,6,19,36,7,43,0,0,0,53,16,69
fa15,153,MARSHALL,SE,Earth Sci,1,0,1,0,0,0,0,1,1,1,0,1,1,2,3,0,0,0,3,3,6
fa15,153,MARSHALL,SE,Marine Bio,2,3,5,0,0,0,0,3,3,2,2,4,0,7,7,0,0,0,4,15,19
fa15,153,MARSHALL,SOC,SocAmSt,0,0,0,0,0,0,0,0,0,0,0,0,0,1,1,0,0,0,0,1,1
fa15,153,MARSHALL,SOC,SocCulCom,1,1,2,0,0,0,0,0,0,1,2,3,1,3,4,0,0,0,3,6,9
fa15,153,MARSHALL,SOC,SocEconSoc,0,0,0,0,0,0,0,0,0,0,2,2,1,0,1,0,0,0,1,2,3
fa15,153,MARSHALL,SOC,SocIntlStu,0,0,0,0,0,0,0,0,0,0,0,0,1,0,1,0,0,0,1,0,1
fa15,153,MARSHALL,SOC,Sociology,3,1,4,0,0,0,1,3,4,0,3,3,2,9,11,0,0,0,6,16,22
fa15,153,MARSHALL,SOC,SocLawSoc,0,1,1,0,1,1,0,0,0,3,5,8,1,1,2,0,0,0,4,8,12
fa15,153,MARSHALL,SOC,SocSciMed,1,0,1,0,0,0,0,1,1,0,2,2,0,1,1,0,0,0,1,4,5
fa15,153,MARSHALL,SOC,SocSolneq,0,1,1,0,0,0,0,0,0,0,4,4,0,3,3,0,0,0,0,8,8
fa15,153,MARSHALL,THEA,Dance,0,0,0,0,0,0,0,1,1,0,0,0,0,0,0,0,0,0,0,1,1
fa15,153,MARSHALL,THEA,Theatre,0,2,2,0,0,0,0,2,2,1,3,4,1,1,2,0,0,0,2,8,10
fa15,153,MARSHALL,UNAF,UndecHumAr,2,2,4,0,0,0,1,0,1,0,0,0,0,0,0,0,0,0,3,2,5
fa15,153,MARSHALL,UNAF,Undeclared,62,39,101,2,2,4,14,10,24,11,2,13,0,0,0,0,0,0,89,53,142
fa15,153,MARSHALL,UNAF,UndecPhysS,10,4,14,0,0,0,0,2,2,0,0,0,0,0,0,0,0,0,10,6,16
fa15,153,MARSHALL,UNAF,UndecSocSc,3,10,13,0,0,0,2,1,3,0,1,1,0,0,0,0,0,0,5,12,17
fa15,153,MARSHALL,USP,Urb Stu&Pl,0,1,1,0,0,0,0,1,1,2,5,7,1,3,4,0,0,0,3,10,13
fa15,153,MARSHALL,VIS,Art Hst/Cr,0,0,0,0,0,0,0,0,0,0,0,0,0,2,2,0,0,0,0,2,2
fa15,153,MARSHALL,VIS,Media,0,0,0,0,1,1,1,2,3,2,3,5,3,7,10,0,0,0,6,13,19
fa15,153,MARSHALL,VIS,Studio VA,0,1,1,0,0,0,0,0,0,0,6,6,1,1,2,0,0,0,1,8,9
fa15,153,MARSHALL,VIS,VA-CompArt,0,0,0,1,0,1,0,0,0,0,4,4,3,6,9,0,0,0,4,10,14
fa15,153,MUIR,ANTH,Anth-Arch,0,3,3,0,0,0,0,0,0,1,1,2,0,2,2,0,0,0,1,6,7
fa15,153,MUIR,ANTH,Anth-Biol,0,0,0,0,0,0,1,0,1,1,1,2,1,6,7,0,0,0,3,7,10
fa15,153,MUIR,ANTH,Anth-Soci,0,1,1,1,0,1,0,0,0,2,4,6,0,4,4,0,0,0,3,9,12
fa15,153,MUIR,BENG,Bioen:Binf,2,1,3,0,0,0,1,1,2,4,2,6,7,5,12,0,0,0,14,9,23
fa15,153,MUIR,BENG,BioengBioS,2,1,3,0,0,0,0,2,2,4,0,4,3,2,5,0,0,0,9,5,14
fa15,153,MUIR,BENG,BioengBiot,3,2,5,0,0,0,1,0,1,3,7,10,9,6,15,0,0,0,16,15,31
fa15,153,MUIR,BENG,Bioengin,2,5,7,0,0,0,3,1,4,7,6,13,12,6,18,0,0,0,24,18,42
fa15,153,MUIR,BIOL,Bioc/CellB,33,35,68,0,1,1,8,25,33,33,36,69,44,65,109,0,0,0,118,162,280
fa15,153,MUIR,BIOL,BiolBioinf,2,5,7,0,0,0,3,2,5,4,1,5,1,0,1,0,0,0,10,8,18
fa15,153,MUIR,BIOL,Ec/Beh/Evo,0,5,5,0,0,0,0,4,4,3,11,14,6,11,17,0,0,0,9,31,40
fa15,153,MUIR,BIOL,Genl Biol,9,21,30,1,1,2,7,16,23,20,30,50,25,44,69,0,0,0,62,112,174
fa15,153,MUIR,BIOL,Human Bio,18,51,69,0,4,4,16,35,51,43,77,120,29,72,101,0,0,0,106,239,345
fa15,153,MUIR,BIOL,Microbiol,3,2,5,0,0,0,1,2,3,5,7,12,5,4,9,0,0,0,14,15,29
fa15,153,MUIR,BIOL,Molec Biol,4,10,14,0,0,0,5,4,9,6,5,11,10,8,18,0,0,0,25,27,52
fa15,153,MUIR,BIOL,PhyslNeuro,19,27,46,0,0,0,12,23,35,28,36,64,33,40,73,0,0,0,92,126,218
fa15,153,MUIR,CENG,Chem Engin,2,6,8,0,1,1,6,0,6,14,4,18,27,24,51,0,0,0,49,35,84
fa15,153,MUIR,CGS,CritGendSt,1,0,1,0,0,0,0,2,2,2,2,4,1,4,5,0,0,0,4,8,12
fa15,153,MUIR,CHEM,Bioch/Chem,7,9,16,0,0,0,3,4,7,9,10,19,12,9,21,0,0,0,31,32,63
fa15,153,MUIR,CHEM,Bioinform,0,0,0,0,0,0,0,1,1,1,0,1,0,0,0,0,0,0,1,1,2
fa15,153,MUIR,CHEM,Chem Educ,0,0,0,0,0,0,0,0,0,0,1,1,0,0,0,0,0,0,0,1,1
fa15,153,MUIR,CHEM,Chem Phys,1,0,1,0,0,0,0,0,0,1,0,1,0,0,0,0,0,0,2,0,2
fa15,153,MUIR,CHEM,Chemistry,4,3,7,0,1,1,1,3,4,9,6,15,3,5,8,0,0,0,17,18,35
fa15,153,MUIR,CHEM,Envir Chem,0,1,1,0,0,0,2,0,2,1,0,1,1,2,3,0,0,0,4,3,7
fa15,153,MUIR,CHEM,MolecSynth,0,0,0,0,0,0,0,0,0,1,1,2,1,0,1,0,0,0,2,1,3
fa15,153,MUIR,CHEM,Pharm Chem,4,8,12,0,0,0,2,3,5,5,12,17,7,11,18,0,0,0,18,34,52
fa15,153,MUIR,CHIN,Chinese St,0,0,0,0,0,0,0,0,0,0,0,0,0,1,1,0,0,0,0,1,1
fa15,153,MUIR,COGS,Cog Sci,4,10,14,2,0,2,3,4,7,3,10,13,6,10,16,0,0,0,18,34,52
fa15,153,MUIR,COGS,CogSc/ClAs,0,0,0,0,1,1,0,1,1,0,1,1,0,1,1,0,0,0,0,4,4
fa15,153,MUIR,COGS,CogSc/Comp,0,1,1,0,0,0,1,2,3,2,3,5,1,0,1,0,0,0,4,6,10
fa15,153,MUIR,COGS,CogSc/HCI,1,0,1,1,1,2,2,3,5,4,2,6,6,10,16,0,0,0,14,16,30
fa15,153,MUIR,COGS,CogSc/HCog,0,0,0,0,0,0,0,2,2,1,0,1,1,5,6,0,0,0,2,7,9
fa15,153,MUIR,COGS,CogSc/Neur,3,1,4,1,1,2,2,6,8,4,7,11,4,12,16,0,0,0,14,27,41
fa15,153,MUIR,COMM,Communic,6,7,13,0,1,1,4,15,19,13,34,47,8,35,43,0,0,0,31,92,123
fa15,153,MUIR,CSE,Comp Sci,31,5,36,0,0,0,14,6,20,53,20,73,117,28,145,0,0,0,215,59,274
fa15,153,MUIR,CSE,CompEngCSE,11,3,14,0,0,0,3,1,4,9,0,9,18,2,20,0,0,0,41,6,47
fa15,153,MUIR,CSE,CompScBinf,0,0,0,0,0,0,2,0,2,0,1,1,3,3,6,0,0,0,5,4,9
fa15,153,MUIR,ECE,CompEngECE,5,2,7,0,0,0,0,1,1,11,0,11,10,2,12,0,0,0,26,5,31
fa15,153,MUIR,ECE,Electr Eng,11,4,15,0,0,0,9,2,11,21,1,22,41,5,46,0,0,0,82,12,94
fa15,153,MUIR,ECE,Engin Phys,0,0,0,0,0,0,0,0,0,1,0,1,0,0,0,0,0,0,1,0,1
fa15,153,MUIR,ECE,Pr-EngPhys,2,0,2,0,0,0,2,0,2,0,0,0,0,0,0,0,0,0,4,0,4
fa15,153,MUIR,ECON,Ec-Mth&Ecn,6,6,12,1,0,1,5,8,13,7,7,14,3,3,6,0,0,0,22,24,46
fa15,153,MUIR,ECON,Econ-MgtSc,2,2,4,1,0,1,9,9,18,16,16,32,31,20,51,0,0,0,59,47,106
fa15,153,MUIR,ECON,Economics,7,10,17,2,1,3,17,17,34,55,37,92,48,42,90,0,0,0,129,107,236
fa15,153,MUIR,ECON,EnvSys(EB),2,2,4,0,0,0,0,1,1,2,6,8,5,4,9,0,0,0,9,13,22
fa15,153,MUIR,ECON,EnvSys(EC),0,0,0,0,0,0,0,0,0,0,1,1,0,2,2,0,0,0,0,3,3
fa15,153,MUIR,ECON,EnvSys(EP),1,5,6,0,0,0,0,2,2,1,0,1,0,1,1,0,0,0,2,8,10
fa15,153,MUIR,ECON,EnvSys(ES),1,4,5,0,0,0,1,4,5,0,0,0,1,0,1,0,0,0,3,8,11
fa15,153,MUIR,ETHN,Ethnic St,0,0,0,0,0,0,0,2,2,1,4,5,0,2,2,0,0,0,1,8,9
fa15,153,MUIR,FPMU,Public Hlt,1,5,6,0,0,0,5,15,20,6,31,37,13,28,41,0,0,0,25,79,104
fa15,153,MUIR,GLBH,Global Hlt,2,0,2,0,0,0,0,2,2,0,3,3,1,5,6,0,0,0,3,10,13
fa15,153,MUIR,HDP,Human Dev,0,0,0,0,0,0,0,1,1,1,6,7,1,16,17,0,0,0,2,23,25
fa15,153,MUIR,HDP,Pr-HumnDev,0,3,3,0,1,1,1,5,6,1,9,10,0,2,2,0,0,0,2,20,22
fa15,153,MUIR,HIST,History,0,0,0,0,0,0,1,2,3,3,5,8,6,1,7,0,0,0,10,8,18
fa15,153,MUIR,INTL,InSt-InBus,1,3,4,0,1,1,2,3,5,2,5,7,3,2,5,0,0,0,8,14,22
fa15,153,MUIR,INTL,IntSt-Anth,0,1,1,0,0,0,0,0,0,0,1,1,1,0,1,0,0,0,1,2,3
fa15,153,MUIR,INTL,IntSt-Econ,3,0,3,0,0,0,0,2,2,1,7,8,2,3,5,0,0,0,6,12,18
fa15,153,MUIR,INTL,IntSt-Ling,0,0,0,0,0,0,0,0,0,1,0,1,0,0,0,0,0,0,1,0,1
fa15,153,MUIR,INTL,IntSt-Lit,0,0,0,0,0,0,0,0,0,0,1,1,0,0,0,0,0,0,0,1,1
fa15,153,MUIR,INTL,IntSt-PolS,1,3,4,0,0,0,0,1,1,1,5,6,2,7,9,0,0,0,4,16,20
fa15,153,MUIR,INTL,IntSt-Soc,0,1,1,0,0,0,0,2,2,0,2,2,1,3,4,0,0,0,1,8,9
fa15,153,MUIR,ITAL,Italian St,0,0,0,0,0,0,0,0,0,0,0,0,0,1,1,0,0,0,0,1,1
fa15,153,MUIR,JAPN,JapaneseSt,0,0,0,0,0,0,0,0,0,1,2,3,0,2,2,0,0,0,1,4,5
fa15,153,MUIR,LING,Lang Stu,0,0,0,0,0,0,0,1,1,1,2,3,1,0,1,0,0,0,2,3,5
fa15,153,MUIR,LING,Ling-CogLn,0,1,1,0,0,0,1,1,2,1,1,2,2,2,4,0,0,0,4,5,9
fa15,153,MUIR,LING,Linguistcs,1,1,2,0,0,0,1,1,2,0,2,2,1,2,3,0,0,0,3,6,9
fa15,153,MUIR,LIT,Lit/Compos,0,1,1,0,0,0,0,0,0,0,0,0,0,0,0,0,0,0,0,1,1
fa15,153,MUIR,LIT,Lit/CultSt,0,0,0,0,0,0,0,0,0,0,1,1,0,1,1,0,0,0,0,2,2
fa15,153,MUIR,LIT,Lit/Engl,0,1,1,0,0,0,0,0,0,1,7,8,0,7,7,0,0,0,1,15,16
fa15,153,MUIR,LIT,Lit/World,0,0,0,0,0,0,0,0,0,0,1,1,2,1,3,0,0,0,2,2,4
fa15,153,MUIR,LIT,Lit/Writng,0,1,1,0,0,0,1,4,5,1,8,9,5,9,14,0,0,0,7,22,29
fa15,153,MUIR,LIT,Spanish Lt,0,0,0,1,0,1,0,2,2,0,1,1,1,0,1,0,0,0,2,3,5
fa15,153,MUIR,MAE,Aerosp Eng,4,2,6,0,0,0,5,1,6,6,0,6,10,1,11,0,0,0,25,4,29
fa15,153,MUIR,MAE,Envir Eng,6,6,12,0,0,0,5,4,9,9,5,14,11,7,18,0,0,0,31,22,53
fa15,153,MUIR,MAE,Mech Engin,14,4,18,0,0,0,5,3,8,13,2,15,21,7,28,0,0,0,53,16,69
fa15,153,MUIR,MATH,Appld Math,12,7,19,1,1,2,6,6,12,13,7,20,9,4,13,0,0,0,41,25,66
fa15,153,MUIR,MATH,Math/SecEd,1,1,2,0,0,0,0,1,1,0,1,1,1,2,3,0,0,0,2,5,7
fa15,153,MUIR,MATH,Mathematcs,4,6,10,0,0,0,4,6,10,5,3,8,8,4,12,0,0,0,21,19,40
fa15,153,MUIR,MATH,Mth-CompSc,19,3,22,2,2,4,10,5,15,10,5,15,5,1,6,0,0,0,46,16,62
fa15,153,MUIR,MATH,Mth-Mth&Ec,2,4,6,0,1,1,4,4,8,3,3,6,6,1,7,0,0,0,15,13,28
fa15,153,MUIR,MATH,Mth-SciCom,1,0,1,0,0,0,0,0,0,0,0,0,0,0,0,0,0,0,1,0,1
fa15,153,MUIR,MATH,Mth/ApldSc,1,1,2,0,0,0,0,2,2,0,1,1,0,0,0,0,0,0,1,4,5
fa15,153,MUIR,MATH,Prob&Stats,4,3,7,0,0,0,1,3,4,2,3,5,6,0,6,0,0,0,13,9,22
fa15,153,MUIR,MUS,Mu-CompArt,2,0,2,0,0,0,0,0,0,3,3,6,3,3,6,0,0,0,8,6,14
fa15,153,MUIR,MUS,Music,0,2,2,0,0,0,1,0,1,4,2,6,3,3,6,0,0,0,8,7,15
fa15,153,MUIR,MUS,Music Hum,0,0,0,0,0,0,0,0,0,0,0,0,1,0,1,0,0,0,1,0,1
fa15,153,MUIR,NENG,NanoEng,3,1,4,1,0,1,2,0,2,11,0,11,10,5,15,0,0,0,27,6,33
fa15,153,MUIR,PHIL,Philosophy,4,0,4,1,0,1,0,0,0,0,0,0,1,1,2,0,0,0,6,1,7
fa15,153,MUIR,PHIL,Biophysics,0,1,1,0,0,0,0,0,0,1,1,2,0,1,1,0,0,0,1,3,4
fa15,153,MUIR,PHIL,Gen Physcs,0,0,0,0,0,0,1,0,1,1,0,1,0,0,0,0,0,0,2,0,2
fa15,153,MUIR,PHIL,Phy/ErthSc,0,0,0,0,0,0,0,0,0,0,0,0,1,0,1,0,0,0,1,0,1
fa15,153,MUIR,PHIL,Phys/Astro,4,0,4,0,0,0,3,2,5,2,1,3,1,0,1,0,0,0,10,3,13
fa15,153,MUIR,PHIL,Phys/Comp,1,0,1,0,0,0,0,0,0,1,0,1,1,0,1,0,0,0,3,0,3
fa15,153,MUIR,PHIL,Phys/Mtrls,0,0,0,0,0,0,0,1,1,1,0,1,1,0,1,0,0,0,2,1,3
fa15,153,MUIR,PHIL,Physics,4,4,8,0,0,0,2,1,3,8,1,9,6,1,7,0,0,0,20,7,27
fa15,153,MUIR,POLI,Polit Sci,3,4,7,0,0,0,1,1,2,12,9,21,5,8,13,0,0,0,21,22,43
fa15,153,MUIR,POLI,PolSc-Amer,2,0,2,0,0,0,0,0,0,2,0,2,1,2,3,0,0,0,5,2,7
fa15,153,MUIR,POLI,PolSc-Comp,0,0,0,0,0,0,0,0,0,1,0,1,0,1,1,0,0,0,1,1,2
fa15,153,MUIR,POLI,PolSc-Intl,3,2,5,0,0,0,2,2,4,4,7,11,4,0,4,0,0,0,13,11,24
fa15,153,MUIR,POLI,PolSc-PLaw,1,1,2,0,0,0,1,0,1,2,5,7,8,2,10,0,0,0,12,8,20
fa15,153,MUIR,POLI,PolSc-PPol,0,0,0,0,0,0,2,0,2,1,1,2,3,4,7,0,0,0,6,5,11
fa15,153,MUIR,POLI,PolSc-Thry,1,0,1,0,0,0,0,1,1,1,0,1,0,0,0,0,0,0,2,1,3
fa15,153,MUIR,PSYC,Psyc/ClPsy,2,8,10,0,0,0,2,3,5,3,10,13,0,14,14,0,0,0,7,35,42
fa15,153,MUIR,PSYC,Psyc/CogPs,2,0,2,0,0,0,0,0,0,0,2,2,0,0,0,0,0,0,2,2,4
fa15,153,MUIR,PSYC,Psyc/DelPs,0,1,1,0,0,0,0,0,0,0,2,2,0,1,1,0,0,0,0,4,4
fa15,153,MUIR,PSYC,Psyc/HumHl,0,0,0,0,0,0,0,2,2,0,0,0,1,4,5,0,0,0,1,6,7
fa15,153,MUIR,PSYC,Psyc/SocPs,1,0,1,0,1,1,0,4,4,1,4,5,0,2,2,0,0,0,2,11,13
fa15,153,MUIR,PSYC,Psychology,3,15,18,0,4,4,7,13,20,16,34,50,20,62,82,0,0,0,46,128,174
fa15,153,MUIR,RELI,Relig/Stu,0,0,0,0,0,0,0,0,0,0,1,1,1,0,1,0,0,0,1,1,2
fa15,153,MUIR,SE,Engin Sci,2,0,2,0,0,0,0,0,0,0,0,0,0,0,0,0,0,0,2,0,2
fa15,153,MUIR,SE,Struct Eng,4,2,6,0,0,0,5,3,8,11,7,18,22,14,36,0,0,0,42,26,68
fa15,153,MUIR,SIO,Earth Sci,2,0,2,0,0,0,2,2,4,4,1,5,3,4,7,0,0,0,11,7,18
fa15,153,MUIR,SIO,Marine Bio,3,12,15,0,0,0,4,9,13,3,10,13,5,9,14,0,0,0,15,40,55
fa15,153,MUIR,SOC,SocAmSt,0,0,0,0,0,0,0,0,0,0,0,0,0,1,1,0,0,0,0,1,1
fa15,153,MUIR,SOC,SocCulCom,0,2,2,0,0,0,0,0,0,1,2,3,0,1,1,0,0,0,1,5,6
fa15,153,MUIR,SOC,SocEconSoc,1,0,1,0,0,0,0,1,1,1,1,2,0,0,0,0,0,0,2,2,4
fa15,153,MUIR,SOC,SocIntlStu,0,0,0,0,0,0,0,0,0,0,1,1,0,1,1,0,0,0,0,2,2
fa15,153,MUIR,SOC,Sociology,0,3,3,0,0,0,1,3,4,3,11,14,1,9,10,0,0,0,5,26,31
fa15,153,MUIR,SOC,SocLawSoc,0,1,1,0,3,3,1,3,4,0,5,5,0,2,2,0,0,0,1,14,15
fa15,153,MUIR,SOC,SocSciMed,0,0,0,0,0,0,0,1,1,0,1,1,0,1,1,0,0,0,0,3,3
fa15,153,MUIR,SOC,SocSolneq,0,0,0,0,0,0,0,2,2,1,1,2,2,6,8,0,0,0,3,9,12
fa15,153,MUIR,THEA,Dance,0,0,0,0,0,0,0,0,0,0,0,0,0,1,1,0,0,0,0,1,1
fa15,153,MUIR,THEA,Theatre,2,3,5,0,0,0,0,4,4,5,7,12,2,7,9,0,0,0,9,21,30
fa15,153,MUIR,UNAF,UndecHumAr,1,0,1,0,1,1,0,0,0,0,0,0,0,0,0,0,0,0,1,1,2
fa15,153,MUIR,UNAF,Undeclared,66,41,107,5,2,7,14,8,22,6,3,9,1,0,1,0,0,0,92,54,146
fa15,153,MUIR,UNAF,UndecPhysS,10,5,15,0,0,0,0,3,3,0,1,1,0,0,0,0,0,0,10,9,19
fa15,153,MUIR,UNAF,UndecSocSc,1,10,11,1,0,1,3,1,4,1,1,2,0,0,0,0,0,0,6,12,18
fa15,153,MUIR,USP,Urb Stu&Pl,0,3,3,0,0,0,0,2,2,3,4,7,1,5,6,0,0,0,4,14,18
fa15,153,MUIR,VIS,Art Hst/Cr,1,0,1,0,0,0,0,0,0,0,2,2,0,2,2,0,0,0,1,4,5
fa15,153,MUIR,VIS,Media,1,0,1,1,0,1,2,2,4,3,2,5,4,5,9,0,0,0,11,9,20
fa15,153,MUIR,VIS,Studio VA,0,2,2,0,0,0,0,0,0,0,4,4,0,6,6,0,0,0,0,12,12
fa15,153,MUIR,VIS,VA-CompArt,0,2,2,0,0,0,1,1,2,1,1,2,1,3,4,0,0,0,3,7,10
fa15,153,REVELLE,ANTH,Anth-Arch,0,1,1,0,0,0,0,0,0,3,0,3,0,1,1,0,0,0,3,2,5
fa15,153,REVELLE,ANTH,Anth-Biol,0,0,0,0,1,1,0,0,0,0,1,1,0,6,6,0,0,0,0,8,8
fa15,153,REVELLE,ANTH,Anth-Soci,0,0,0,0,0,0,0,0,0,2,0,2,0,2,2,0,0,0,2,2,4
fa15,153,REVELLE,BENG,Bioen:Binf,0,2,2,0,0,0,1,1,2,3,1,4,8,7,15,0,0,0,12,11,23
fa15,153,REVELLE,BENG,BioengBioS,1,4,5,0,0,0,3,1,4,1,3,4,5,2,7,0,0,0,10,10,20
fa15,153,REVELLE,BENG,BioengBiot,9,7,16,0,0,0,1,0,1,8,5,13,22,4,26,0,0,0,40,16,56
fa15,153,REVELLE,BENG,Bioengin,3,12,15,0,0,0,0,0,0,7,3,10,21,10,31,0,0,0,31,25,56
fa15,153,REVELLE,BIOL,Bioc/CellB,37,39,76,2,1,3,18,31,49,46,57,103,72,85,157,0,0,0,175,213,388
fa15,153,REVELLE,BIOL,BiolBioinf,4,0,4,0,0,0,1,2,3,3,5,8,0,1,1,0,0,0,8,8,16
fa15,153,REVELLE,BIOL,Ec/Beh/Evo,2,3,5,0,0,0,0,1,1,6,8,14,2,4,6,0,0,0,10,16,26
fa15,153,REVELLE,BIOL,Genl Biol,16,24,40,1,2,3,7,17,24,25,37,62,34,51,85,0,0,0,83,131,214
fa15,153,REVELLE,BIOL,Human Bio,27,53,80,0,1,1,19,39,58,48,80,128,61,97,158,0,0,0,155,270,425
fa15,153,REVELLE,BIOL,Microbiol,3,3,6,0,0,0,3,1,4,8,6,14,7,10,17,0,0,0,21,20,41
fa15,153,REVELLE,BIOL,Molec Biol,5,14,19,1,0,1,3,6,9,13,11,24,14,12,26,0,0,0,36,43,79
fa15,153,REVELLE,BIOL,PhyslNeuro,24,40,64,1,0,1,11,14,25,43,34,77,50,54,104,0,0,0,129,142,271
fa15,153,REVELLE,CENG,Chem Engin,13,6,19,0,0,0,12,3,15,35,12,47,73,29,102,0,0,0,133,50,183
fa15,153,REVELLE,CHEM,Bioch/Chem,7,5,12,0,0,0,4,5,9,2,12,14,18,6,24,0,0,0,31,28,59
fa15,153,REVELLE,CHEM,Bioinform,0,0,0,0,0,0,0,1,1,1,0,1,0,1,1,0,0,0,1,2,3
fa15,153,REVELLE,CHEM,Chem Phys,0,0,0,0,0,0,0,0,0,1,1,2,1,0,1,0,0,0,2,1,3
fa15,153,REVELLE,CHEM,Chemistry,16,10,26,0,0,0,4,5,9,17,14,31,12,8,20,0,0,0,49,37,86
fa15,153,REVELLE,CHEM,Envir Chem,1,1,2,0,0,0,0,0,0,2,2,4,3,1,4,0,0,0,6,4,10
fa15,153,REVELLE,CHEM,MolecSynth,0,0,0,0,0,0,0,1,1,2,2,4,2,0,2,0,0,0,4,3,7
fa15,153,REVELLE,CHEM,Pharm Chem,6,11,17,0,0,0,3,4,7,17,9,26,18,16,34,0,0,0,44,40,84
fa15,153,REVELLE,CHIN,Chinese St,1,0,1,0,0,0,0,0,0,0,0,0,0,0,0,0,0,0,1,0,1
fa15,153,REVELLE,COGS,Cog Sci,0,4,4,0,0,0,1,4,5,6,2,8,4,8,12,0,0,0,11,18,29
fa15,153,REVELLE,COGS,CogSc/ClAs,0,0,0,0,0,0,0,1,1,0,2,2,0,3,3,0,0,0,0,6,6
fa15,153,REVELLE,COGS,CogSc/Comp,0,0,0,2,0,2,0,1,1,1,2,3,2,1,3,0,0,0,5,4,9
fa15,153,REVELLE,COGS,CogSc/HCI,2,0,2,0,0,0,2,2,4,5,3,8,4,7,11,0,0,0,13,12,25
fa15,153,REVELLE,COGS,CogSc/HCog,0,0,0,0,0,0,1,1,2,2,2,4,0,2,2,0,0,0,3,5,8
fa15,153,REVELLE,COGS,CogSc/Neur,0,1,1,1,0,1,0,1,1,0,6,6,5,11,16,0,0,0,6,19,25
fa15,153,REVELLE,COMM,Communic,1,4,5,0,0,0,2,1,3,7,8,15,8,8,16,0,0,0,18,21,39
fa15,153,REVELLE,CSE,Comp Sci,25,8,33,0,0,0,14,1,15,44,4,48,145,28,173,0,0,0,228,41,269
fa15,153,REVELLE,CSE,CompEngCSE,8,3,11,0,0,0,4,0,4,8,2,10,16,1,17,0,0,0,36,6,42
fa15,153,REVELLE,CSE,CompScBinf,2,0,2,0,0,0,0,0,0,4,1,5,6,2,8,0,0,0,12,3,15
fa15,153,REVELLE,ECE,CompEngECE,12,3,15,0,0,0,3,0,3,13,3,16,15,1,16,0,0,0,43,7,50
fa15,153,REVELLE,ECE,Electr Eng,13,4,17,1,0,1,6,3,9,28,8,36,77,7,84,0,0,0,125,22,147
fa15,153,REVELLE,ECE,EleEng&Soc,0,0,0,0,0,0,0,0,0,0,0,0,1,0,1,0,0,0,1,0,1
fa15,153,REVELLE,ECE,Engin Phys,0,0,0,0,0,0,0,0,0,1,0,1,5,0,5,0,0,0,6,0,6
fa15,153,REVELLE,ECE,Pr-EngPhys,0,0,0,0,0,0,0,0,0,2,0,2,0,0,0,0,0,0,2,0,2
fa15,153,REVELLE,ECON,Ec-Mth&Ecn,4,0,4,1,1,2,7,7,14,7,1,8,10,2,12,0,0,0,29,11,40
fa15,153,REVELLE,ECON,Econ-MgtSc,1,1,2,0,1,1,6,4,10,22,13,35,32,22,54,0,0,0,61,41,102
fa15,153,REVELLE,ECON,Economics,10,4,14,1,0,1,8,8,16,45,31,76,61,21,82,0,0,0,125,64,189
fa15,153,REVELLE,ESYS,EnvSys(EB),0,2,2,0,0,0,0,0,0,0,3,3,1,3,4,0,0,0,1,8,9
fa15,153,REVELLE,ESYS,EnvSys(EC),2,0,2,0,0,0,0,1,1,1,0,1,1,0,1,0,0,0,4,1,5
fa15,153,REVELLE,ESYS,EnvSys(EP),0,1,1,0,0,0,0,0,0,0,0,0,0,0,0,0,0,0,0,1,1
fa15,153,REVELLE,ESYS,EnvSys(ES),0,4,4,0,0,0,0,1,1,1,0,1,4,1,5,0,0,0,5,6,11
fa15,153,REVELLE,ETHN,Ethnic St,0,0,0,0,0,0,0,0,0,0,0,0,0,2,2,0,0,0,0,2,2
fa15,153,REVELLE,FPMU,Public Hlt,1,5,6,0,0,0,1,6,7,3,18,21,6,33,39,0,0,0,11,62,73
fa15,153,REVELLE,GLBH,Global Hlt,0,0,0,0,0,0,0,1,1,0,3,3,1,1,2,0,0,0,1,5,6
fa15,153,REVELLE,GMST,German Stu,0,1,1,0,0,0,0,0,0,0,0,0,0,0,0,0,0,0,0,1,1
fa15,153,REVELLE,HDP,Human Dev,0,0,0,0,0,0,0,1,1,0,2,2,1,7,8,0,0,0,1,10,11
fa15,153,REVELLE,HDP,Pr-HumnDev,0,0,0,0,0,0,0,3,3,0,3,3,0,1,1,0,0,0,0,7,7
fa15,153,REVELLE,HIST,History,0,0,0,0,0,0,1,1,2,2,1,3,2,2,4,0,0,0,5,4,9
fa15,153,REVELLE,INTL,InSt-InBus,0,1,1,0,0,0,0,0,0,3,2,5,0,2,2,0,0,0,3,5,8
fa15,153,REVELLE,INTL,Int-5yrEC,0,0,0,0,0,0,0,0,0,0,0,0,1,1,2,0,0,0,1,1,2
fa15,153,REVELLE,INTL,IntSt-Econ,1,0,1,0,0,0,0,1,1,1,0,1,5,4,9,0,0,0,7,5,12
fa15,153,REVELLE,INTL,IntSt-Hist,0,0,0,0,0,0,0,0,0,0,0,0,1,1,2,0,0,0,1,1,2
fa15,153,REVELLE,INTL,IntSt-Ling,0,1,1,0,0,0,0,0,0,0,0,0,0,0,0,0,0,0,0,1,1
fa15,153,REVELLE,INTL,IntSt-Lit,0,0,0,0,0,0,0,0,0,0,0,0,0,1,1,0,0,0,0,1,1
fa15,153,REVELLE,INTL,IntSt-PolS,1,1,2,0,0,0,0,0,0,1,1,2,0,3,3,0,0,0,2,5,7
fa15,153,REVELLE,JAPN,JapaneseSt,0,0,0,0,0,0,0,0,0,0,1,1,0,0,0,0,0,0,0,1,1
fa15,153,REVELLE,LING,Lang Stu,0,0,0,0,0,0,0,1,1,0,1,1,0,1,1,0,0,0,0,3,3
fa15,153,REVELLE,LING,Ling-CogLn,0,0,0,0,0,0,0,1,1,0,0,0,0,1,1,0,0,0,0,2,2
fa15,153,REVELLE,LING,Ling-LSoc,0,0,0,0,0,0,0,0,0,0,0,0,1,0,1,0,0,0,1,0,1
fa15,153,REVELLE,LING,Linguistcs,0,0,0,0,0,0,0,0,0,0,2,2,1,2,3,0,0,0,1,4,5
fa15,153,REVELLE,LING,Lit/Compos,0,1,1,0,0,0,0,0,0,0,0,0,0,0,0,0,0,0,0,1,1
fa15,153,REVELLE,LING,Lit/CultSt,0,0,0,0,0,0,0,0,0,0,0,0,0,1,1,0,0,0,0,1,1
fa15,153,REVELLE,LING,Lit/Engl,0,1,1,0,0,0,0,0,0,2,0,2,1,1,2,0,0,0,3,2,5
fa15,153,REVELLE,LING,Lit/World,0,0,0,0,0,0,0,0,0,0,2,2,1,2,3,0,0,0,1,4,5
fa15,153,REVELLE,LING,Lit/Writng,0,4,4,0,0,0,1,2,3,0,2,2,1,5,6,0,0,0,2,13,15
fa15,153,REVELLE,LING,Spanish Lt,1,0,1,0,0,0,0,0,0,0,0,0,0,1,1,0,0,0,1,1,2
fa15,153,REVELLE,MAE,Aerosp Eng,16,1,17,0,0,0,6,0,6,12,2,14,28,5,33,0,0,0,62,8,70
fa15,153,REVELLE,MAE,Engin Sci,0,0,0,0,0,0,0,0,0,0,0,0,1,0,1,0,0,0,1,0,1
fa15,153,REVELLE,MAE,Envir Eng,5,2,7,1,0,1,4,2,6,6,5,11,6,7,13,0,0,0,22,16,38
fa15,153,REVELLE,MAE,Mech Engin,13,3,16,3,0,3,9,2,11,17,3,20,32,7,39,0,0,0,74,15,89
fa15,153,REVELLE,MATH,Appld Math,9,5,14,2,1,3,13,0,13,7,7,14,16,9,25,0,0,0,47,22,69
fa15,153,REVELLE,MATH,Math/SecEd,0,1,1,1,0,1,0,0,0,3,2,5,0,1,1,0,0,0,4,4,8
fa15,153,REVELLE,MATH,Mathematcs,8,3,11,3,0,3,7,4,11,5,5,10,7,5,12,0,0,0,30,17,47
fa15,153,REVELLE,MATH,Mth-CompSc,22,10,32,2,2,4,17,6,23,25,5,30,9,3,12,0,0,0,75,26,101
fa15,153,REVELLE,MATH,Mth-Mth&Ec,3,0,3,0,0,0,1,4,5,1,6,7,1,6,7,0,0,0,6,16,22
fa15,153,REVELLE,MATH,Mth-SciCom,1,1,2,0,0,0,0,1,1,0,1,1,1,0,1,0,0,0,2,3,5
fa15,153,REVELLE,MATH,Mth/ApldSc,3,0,3,0,0,0,2,1,3,2,0,2,1,0,1,0,0,0,8,1,9
fa15,153,REVELLE,MATH,Prob&Stats,1,3,4,0,0,0,4,2,6,1,2,3,6,5,11,0,0,0,12,12,24
fa15,153,REVELLE,MUS,Mu-CompArt,1,0,1,0,0,0,1,0,1,2,0,2,2,2,4,0,0,0,6,2,8
fa15,153,REVELLE,MUS,Music,0,0,0,0,0,0,1,0,1,1,0,1,0,1,1,0,0,0,2,1,3
fa15,153,REVELLE,NENG,NanoEng,9,3,12,0,0,0,5,1,6,11,3,14,27,6,33,0,0,0,52,13,65
fa15,153,REVELLE,PHIL,Philosophy,1,0,1,1,0,1,0,0,0,1,1,2,1,2,3,0,0,0,4,3,7
fa15,153,REVELLE,PHYS,Biophysics,2,1,3,0,0,0,1,0,1,1,1,2,6,1,7,0,0,0,10,3,13
fa15,153,REVELLE,PHYS,Gen Physcs,0,0,0,1,0,1,0,0,0,1,0,1,0,0,0,0,0,0,2,0,2
fa15,153,REVELLE,PHYS,GenPys/SEd,0,0,0,0,0,0,0,0,0,0,0,0,1,0,1,0,0,0,1,0,1
fa15,153,REVELLE,PHYS,Phy/ErthSc,0,0,0,0,0,0,0,0,0,0,0,0,1,0,1,0,0,0,1,0,1
fa15,153,REVELLE,PHYS,Phys/Astro,3,5,8,0,0,0,3,2,5,11,3,14,8,2,10,0,0,0,25,12,37
fa15,153,REVELLE,PHYS,Phys/Comp,0,0,0,0,0,0,1,0,1,2,0,2,4,0,4,0,0,0,7,0,7
fa15,153,REVELLE,PHYS,Phys/Mtrls,3,0,3,0,0,0,2,0,2,4,1,5,0,0,0,0,0,0,9,1,10
fa15,153,REVELLE,PHYS,Physics,6,3,9,1,0,1,9,0,9,9,3,12,15,4,19,0,0,0,40,10,50
fa15,153,REVELLE,POLI,Polit Sci,1,1,2,1,0,1,0,0,0,5,3,8,2,2,4,0,0,0,9,6,15
fa15,153,REVELLE,POLI,PolSc-Amer,1,0,1,0,0,0,1,0,1,1,1,2,1,0,1,0,0,0,4,1,5
fa15,153,REVELLE,POLI,PolSc-Comp,0,0,0,0,0,0,0,0,0,0,0,0,0,1,1,0,0,0,0,1,1
fa15,153,REVELLE,POLI,PolSc-Intl,1,0,1,1,0,1,1,2,3,4,1,5,4,7,11,0,0,0,11,10,21
fa15,153,REVELLE,POLI,PolSc-PLaw,1,0,1,0,0,0,2,0,2,1,2,3,0,3,3,0,0,0,4,5,9
fa15,153,REVELLE,POLI,PolSc-PPol,0,0,0,0,0,0,0,0,0,0,0,0,1,1,2,0,0,0,1,1,2
fa15,153,REVELLE,POLI,PolSc-Thry,0,0,0,0,0,0,0,0,0,0,0,0,1,0,1,0,0,0,1,0,1
fa15,153,REVELLE,PSYC,Psyc/ClPsy,1,1,2,0,0,0,0,3,3,1,3,4,2,8,10,0,0,0,4,15,19
fa15,153,REVELLE,PSYC,Psyc/CogPs,0,1,1,0,0,0,0,0,0,1,0,1,1,3,4,0,0,0,2,4,6
fa15,153,REVELLE,PSYC,Psyc/DelPs,0,0,0,0,0,0,0,0,0,0,0,0,0,1,1,0,0,0,0,1,1
fa15,153,REVELLE,PSYC,Psyc/HumHl,0,0,0,0,0,0,0,3,3,0,3,3,3,4,7,0,0,0,3,10,13
fa15,153,REVELLE,PSYC,Psyc/SocPs,1,0,1,0,0,0,1,1,2,2,2,4,2,0,2,0,0,0,6,3,9
fa15,153,REVELLE,PSYC,Psychology,4,10,14,1,1,2,3,8,11,11,13,24,14,32,46,0,0,0,33,64,97
fa15,153,REVELLE,RELI,Relig/Stu,0,0,0,0,0,0,0,0,0,0,0,0,0,1,1,0,0,0,0,1,1
fa15,153,REVELLE,SE,Engin Sci,1,0,1,0,0,0,0,0,0,0,0,0,1,0,1,0,0,0,2,0,2
fa15,153,REVELLE,SE,Struct Eng,11,11,22,0,0,0,8,2,10,15,4,19,40,13,53,0,0,0,74,30,104
fa15,153,REVELLE,SIO,Earth Sci,0,0,0,0,0,0,2,2,4,0,1,1,4,2,6,0,0,0,6,5,11
fa15,153,REVELLE,SIO,Marine Bio,2,10,12,0,0,0,2,5,7,2,14,16,0,9,9,0,0,0,6,38,44
fa15,153,REVELLE,SIO,Sociology,0,1,1,0,0,0,0,1,1,1,3,4,3,2,5,0,0,0,4,7,11
fa15,153,REVELLE,SIO,SocLawSoc,0,0,0,0,0,0,0,1,1,1,0,1,0,1,1,0,0,0,1,2,3
fa15,153,REVELLE,SIO,SocSciMed,0,0,0,0,0,0,0,0,0,0,0,0,1,2,3,0,0,0,1,2,3
fa15,153,REVELLE,SIO,SocSolneq,1,1,2,0,0,0,0,0,0,0,1,1,0,4,4,0,0,0,1,6,7
fa15,153,REVELLE,THEA,Dance,0,0,0,0,0,0,0,0,0,0,0,0,1,0,1,0,0,0,1,0,1
fa15,153,REVELLE,THEA,Theatre,0,0,0,1,1,2,0,1,1,0,1,1,0,5,5,0,0,0,1,8,9
fa15,153,REVELLE,UNAF,Limited St,0,0,0,0,0,0,0,0,0,0,0,0,0,0,0,2,1,3,2,1,3
fa15,153,REVELLE,UNAF,Spec-Emply,0,0,0,0,0,0,0,0,0,0,0,0,0,0,0,1,2,3,1,2,3
fa15,153,REVELLE,UNAF,UndecHumAr,2,3,5,0,0,0,0,0,0,0,0,0,0,0,0,0,0,0,2,3,5
fa15,153,REVELLE,UNAF,Undeclared,87,46,133,6,1,7,19,10,29,16,0,16,0,0,0,0,0,0,128,57,185
fa15,153,REVELLE,UNAF,UndecPhysS,12,6,18,0,0,0,3,0,3,0,0,0,0,0,0,0,0,0,15,6,21
fa15,153,REVELLE,UNAF,UndecSocSc,1,4,5,0,2,2,0,0,0,0,0,0,0,0,0,0,0,0,1,6,7
fa15,153,REVELLE,USP,Urb Stu&Pl,0,0,0,0,0,0,0,0,0,0,2,2,1,2,3,0,0,0,1,4,5
fa15,153,REVELLE,VIS,Art Hst/Cr,0,0,0,0,0,0,0,0,0,0,0,0,0,1,1,0,0,0,0,1,1
fa15,153,REVELLE,VIS,Media,2,1,3,0,0,0,0,1,1,3,1,4,1,2,3,0,0,0,6,5,11
fa15,153,REVELLE,VIS,Studio VA,0,1,1,0,0,0,0,0,0,1,0,1,1,1,2,0,0,0,2,2,4
fa15,153,REVELLE,VIS,VA-CompArt,1,0,1,0,0,0,1,2,3,1,1,2,2,6,8,0,0,0,5,9,14
fa15,153,ROOSEVELT,ANTH,Anth-Arch,0,0,0,0,0,0,0,1,1,0,0,0,4,3,7,0,0,0,4,4,8
fa15,153,ROOSEVELT,ANTH,Anth-Biol,0,1,1,0,0,0,0,1,1,1,6,7,1,1,2,0,0,0,2,9,11
fa15,153,ROOSEVELT,ANTH,Anth-Soci,1,1,2,0,0,0,0,0,0,3,5,8,2,6,8,0,0,0,6,12,18
fa15,153,ROOSEVELT,BENG,Bioen:Binf,2,2,4,0,0,0,0,0,0,2,3,5,5,5,10,0,0,0,9,10,19
fa15,153,ROOSEVELT,BENG,BioengBioS,0,1,1,0,0,0,0,0,0,1,2,3,2,3,5,0,0,0,3,6,9
fa15,153,ROOSEVELT,BENG,BioengBiot,1,1,2,0,0,0,0,0,0,0,2,2,4,2,6,0,0,0,5,5,10
fa15,153,ROOSEVELT,BENG,Bioengin,0,0,0,0,0,0,0,0,0,0,0,0,5,2,7,0,0,0,5,2,7
fa15,153,ROOSEVELT,BIOL,Bioc/CellB,16,32,48,0,3,3,15,17,32,24,28,52,37,39,76,0,0,0,92,119,211
fa15,153,ROOSEVELT,BIOL,BiolBioinf,1,2,3,0,0,0,0,6,6,0,0,0,2,2,4,0,0,0,3,10,13
fa15,153,ROOSEVELT,BIOL,Ec/Beh/Evo,1,4,5,0,0,0,1,2,3,3,4,7,9,4,13,0,0,0,14,14,28
fa15,153,ROOSEVELT,BIOL,Genl Biol,19,35,54,2,1,3,6,13,19,16,20,36,18,43,61,0,0,0,61,112,173
fa15,153,ROOSEVELT,BIOL,Human Bio,21,46,67,3,4,7,14,36,50,31,51,82,25,51,76,0,0,0,94,188,282
fa15,153,ROOSEVELT,BIOL,Microbiol,3,3,6,0,0,0,4,0,4,5,2,7,5,6,11,0,0,0,17,11,28
fa15,153,ROOSEVELT,BIOL,Molec Biol,5,8,13,1,0,1,0,2,2,0,4,4,1,9,10,0,0,0,7,23,30
fa15,153,ROOSEVELT,BIOL,PhyslNeuro,14,20,34,2,1,3,11,18,29,12,33,45,22,34,56,0,0,0,61,106,167
fa15,153,ROOSEVELT,CENG,Chem Engin,1,1,2,0,0,0,4,1,5,8,3,11,23,11,34,0,0,0,36,16,52
fa15,153,ROOSEVELT,CGS,CritGendSt,0,1,1,0,0,0,0,0,0,1,0,1,0,1,1,0,0,0,1,2,3
fa15,153,ROOSEVELT,CHEM,Bioch/Chem,6,5,11,0,0,0,3,4,7,6,8,14,7,10,17,0,0,0,22,27,49
fa15,153,ROOSEVELT,CHEM,Bioinform,0,0,0,0,0,0,0,1,1,3,0,3,0,0,0,0,0,0,3,1,4
fa15,153,ROOSEVELT,CHEM,Chem Phys,0,1,1,0,0,0,0,0,0,0,1,1,0,0,0,0,0,0,0,2,2
fa15,153,ROOSEVELT,CHEM,Chemistry,7,13,20,0,0,0,3,1,4,3,4,7,4,5,9,0,0,0,17,23,40
fa15,153,ROOSEVELT,CHEM,MolecSynth,1,1,2,0,0,0,0,0,0,0,0,0,0,1,1,0,0,0,1,2,3
fa15,153,ROOSEVELT,CHEM,Pharm Chem,1,4,5,0,1,1,3,3,6,3,11,14,7,7,14,0,0,0,14,26,40
fa15,153,ROOSEVELT,CHIN,Chinese St,0,1,1,0,0,0,0,2,2,0,0,0,0,1,1,0,0,0,0,4,4
fa15,153,ROOSEVELT,CLAS,Classic St,0,0,0,0,0,0,0,1,1,0,0,0,1,1,2,0,0,0,1,2,3
fa15,153,ROOSEVELT,COGS,Cog Sci,1,7,8,0,0,0,7,4,11,4,6,10,2,4,6,0,0,0,14,21,35
fa15,153,ROOSEVELT,COGS,CogSc/ClAs,0,0,0,0,0,0,0,0,0,0,1,1,0,2,2,0,0,0,0,3,3
fa15,153,ROOSEVELT,COGS,CogSc/Comp,0,1,1,0,0,0,1,0,1,0,0,0,0,0,0,0,0,0,1,1,2
fa15,153,ROOSEVELT,COGS,CogSc/HCI,0,0,0,0,0,0,2,2,4,4,4,8,3,10,13,0,0,0,9,16,25
fa15,153,ROOSEVELT,COGS,CogSc/HCog,0,1,1,0,0,0,0,2,2,0,0,0,0,2,2,0,0,0,0,5,5
fa15,153,ROOSEVELT,COGS,CogSc/Neur,0,1,1,0,0,0,1,1,2,2,5,7,2,7,9,0,0,0,5,14,19
fa15,153,ROOSEVELT,COMM,Communic,2,17,19,1,2,3,4,14,18,11,37,48,11,46,57,0,0,0,29,116,145
fa15,153,ROOSEVELT,CSE,Comp Sci,4,2,6,1,0,1,15,2,17,20,4,24,78,20,98,0,0,0,118,28,146
fa15,153,ROOSEVELT,CSE,CompEngCSE,1,0,1,0,0,0,4,1,5,3,3,6,12,2,14,0,0,0,20,6,26
fa15,153,ROOSEVELT,CSE,CompScBinf,0,1,1,0,0,0,0,0,0,1,0,1,6,3,9,0,0,0,7,4,11
fa15,153,ROOSEVELT,ECE,CompEngECE,3,0,3,0,0,0,2,2,4,9,2,11,12,3,15,0,0,0,26,7,33
fa15,153,ROOSEVELT,ECE,Electr Eng,9,0,9,1,0,1,4,0,4,19,6,25,48,8,56,0,0,0,81,14,95
fa15,153,ROOSEVELT,ECE,EleEng&Soc,0,0,0,0,0,0,0,0,0,1,0,1,0,0,0,0,0,0,1,0,1
fa15,153,ROOSEVELT,ECE,Engin Phys,0,0,0,0,0,0,0,0,0,0,0,0,2,0,2,0,0,0,2,0,2
fa15,153,ROOSEVELT,ECE,Pr-EngPhys,0,0,0,0,0,0,0,0,0,2,0,2,0,0,0,0,0,0,2,0,2
fa15,153,ROOSEVELT,ECON,Ec-Mth&Ecn,4,4,8,2,0,2,6,9,15,15,7,22,9,6,15,0,0,0,36,26,62
fa15,153,ROOSEVELT,ECON,Econ-MgtSc,6,5,11,2,2,4,12,14,26,23,15,38,42,20,62,0,0,0,85,56,141
fa15,153,ROOSEVELT,ECON,Economics,21,24,45,9,2,11,28,22,50,67,45,112,52,39,91,0,0,0,177,132,309
fa15,153,ROOSEVELT,ECON,EnvSys(EB),0,3,3,0,0,0,2,2,4,0,1,1,1,7,8,0,0,0,3,13,16
fa15,153,ROOSEVELT,ECON,EnvSys(EC),2,0,2,0,0,0,0,0,0,0,0,0,0,0,0,0,0,0,2,0,2
fa15,153,ROOSEVELT,ECON,EnvSys(EP),0,1,1,0,0,0,2,1,3,3,1,4,0,3,3,0,0,0,5,6,11
fa15,153,ROOSEVELT,ECON,EnvSys(ES),1,3,4,0,0,0,0,0,0,0,0,0,3,1,4,0,0,0,4,4,8
fa15,153,ROOSEVELT,ETHN,Ethnic St,0,0,0,0,0,0,0,0,0,0,1,1,1,2,3,0,0,0,1,3,4
fa15,153,ROOSEVELT,FPMU,Public Hlt,1,10,11,0,1,1,1,10,11,5,27,32,6,26,32,0,0,0,13,74,87
fa15,153,ROOSEVELT,GLBH,Global Hlt,1,5,6,0,1,1,1,7,8,3,7,10,1,6,7,0,0,0,6,26,32
fa15,153,ROOSEVELT,HDP,Human Dev,0,0,0,0,0,0,0,0,0,0,5,5,1,18,19,0,0,0,1,23,24
fa15,153,ROOSEVELT,HDP,Pr-HumnDev,1,1,2,0,1,1,1,12,13,0,10,10,0,2,2,0,0,0,2,26,28
fa15,153,ROOSEVELT,HIST,History,1,2,3,0,0,0,5,4,9,5,11,16,14,18,32,0,0,0,25,35,60
fa15,153,ROOSEVELT,INTL,InSt-InBus,2,7,9,2,1,3,3,5,8,5,9,14,8,5,13,0,0,0,20,27,47
fa15,153,ROOSEVELT,INTL,IntSt-Anth,0,2,2,0,0,0,0,1,1,0,1,1,0,0,0,0,0,0,0,4,4
fa15,153,ROOSEVELT,INTL,IntSt-Econ,5,8,13,0,2,2,3,2,5,6,13,19,8,11,19,0,0,0,22,36,58
fa15,153,ROOSEVELT,INTL,IntSt-Hist,1,0,1,0,0,0,0,0,0,0,3,3,1,4,5,0,0,0,2,7,9
fa15,153,ROOSEVELT,INTL,IntSt-Ling,2,1,3,0,0,0,0,0,0,0,2,2,1,4,5,0,0,0,3,7,10
fa15,153,ROOSEVELT,INTL,IntSt-Lit,0,0,0,0,0,0,0,0,0,0,1,1,1,0,1,0,0,0,1,1,2
fa15,153,ROOSEVELT,INTL,IntSt-PolS,2,7,9,1,0,1,3,11,14,7,14,21,14,22,36,0,0,0,27,54,81
fa15,153,ROOSEVELT,INTL,IntSt-Soc,2,1,3,0,0,0,1,0,1,1,4,5,3,17,20,0,0,0,7,22,29
fa15,153,ROOSEVELT,ITAL,Italian St,0,0,0,0,0,0,0,1,1,0,0,0,0,0,0,0,0,0,0,1,1
fa15,153,ROOSEVELT,JAPN,JapaneseSt,2,1,3,0,0,0,1,0,1,0,0,0,0,3,3,0,0,0,3,4,7
fa15,153,ROOSEVELT,JAPN,LatinAm St,0,0,0,0,0,0,0,0,0,1,1,2,0,0,0,0,0,0,1,1,2
fa15,153,ROOSEVELT,LING,Lang Stu,0,1,1,0,0,0,0,0,0,0,4,4,0,2,2,0,0,0,0,7,7
fa15,153,ROOSEVELT,LING,Ling-CogLn,0,0,0,0,0,0,0,2,2,0,4,4,1,3,4,0,0,0,1,9,10
fa15,153,ROOSEVELT,LING,Ling-LSoc,1,1,2,0,0,0,0,1,1,0,1,1,0,3,3,0,0,0,1,6,7
fa15,153,ROOSEVELT,LING,Linguistcs,1,2,3,0,0,0,0,1,1,4,4,8,0,6,6,0,0,0,5,13,18
fa15,153,ROOSEVELT,LIT,French Lit,0,0,0,0,0,0,0,0,0,0,2,2,0,0,0,0,0,0,0,2,2
fa15,153,ROOSEVELT,LIT,Lit/Compos,0,0,0,0,0,0,1,0,1,0,0,0,0,0,0,0,0,0,1,0,1
fa15,153,ROOSEVELT,LIT,Lit/CultSt,0,0,0,0,0,0,0,0,0,0,0,0,0,2,2,0,0,0,0,2,2
fa15,153,ROOSEVELT,LIT,Lit/Engl,0,1,1,0,0,0,0,3,3,2,5,7,0,5,5,0,0,0,2,14,16
fa15,153,ROOSEVELT,LIT,Lit/World,0,0,0,0,0,0,0,1,1,1,0,1,0,1,1,0,0,0,1,2,3
fa15,153,ROOSEVELT,LIT,Lit/Writng,2,3,5,0,0,0,0,2,2,4,3,7,2,7,9,0,0,0,8,15,23
fa15,153,ROOSEVELT,LIT,Russian Lt,1,0,1,0,0,0,0,0,0,0,0,0,0,0,0,0,0,0,1,0,1
fa15,153,ROOSEVELT,LIT,Spanish Lt,0,0,0,0,0,0,0,1,1,0,0,0,0,1,1,0,0,0,0,2,2
fa15,153,ROOSEVELT,MAE,Aerosp Eng,5,3,8,0,0,0,6,0,6,0,2,2,5,0,5,0,0,0,16,5,21
fa15,153,ROOSEVELT,MAE,Engin Sci,0,0,0,0,0,0,0,0,0,0,0,0,1,0,1,0,0,0,1,0,1
fa15,153,ROOSEVELT,MAE,Envir Eng,4,3,7,0,0,0,3,2,5,4,4,8,6,8,14,0,0,0,17,17,34
fa15,153,ROOSEVELT,MAE,Mech Engin,1,1,2,1,0,1,6,0,6,1,0,1,3,1,4,0,0,0,12,2,14
fa15,153,ROOSEVELT,MATH,Appld Math,15,6,21,0,1,1,9,10,19,8,7,15,4,8,12,0,0,0,36,32,68
fa15,153,ROOSEVELT,MATH,Math/SecEd,0,2,2,0,0,0,0,0,0,1,1,2,0,3,3,0,0,0,1,6,7
fa15,153,ROOSEVELT,MATH,Mathematcs,6,5,11,0,0,0,4,2,6,5,4,9,1,1,2,0,0,0,16,12,28
fa15,153,ROOSEVELT,MATH,Mth-CompSc,18,6,24,3,4,7,14,2,16,29,5,34,4,0,4,0,0,0,68,17,85
fa15,153,ROOSEVELT,MATH,Mth-Mth&Ec,4,2,6,1,2,3,4,5,9,4,6,10,8,2,10,0,0,0,21,17,38
fa15,153,ROOSEVELT,MATH,Mth/ApldSc,0,5,5,0,0,0,2,0,2,1,0,1,0,0,0,0,0,0,3,5,8
fa15,153,ROOSEVELT,MATH,Prob&Stats,3,4,7,0,0,0,7,4,11,3,2,5,2,1,3,0,0,0,15,11,26
fa15,153,ROOSEVELT,MATH,Mu-CompArt,1,0,1,0,0,0,3,0,3,1,0,1,1,0,1,0,0,0,6,0,6
fa15,153,ROOSEVELT,MATH,Music,0,2,2,0,0,0,0,1,1,1,0,1,1,0,1,0,0,0,2,3,5
fa15,153,ROOSEVELT,MATH,Music Hum,1,0,1,0,0,0,0,0,0,0,0,0,0,0,0,0,0,0,1,0,1
fa15,153,ROOSEVELT,NENG,NanoEng,5,0,5,0,0,0,1,1,2,4,3,7,15,6,21,0,0,0,25,10,35
fa15,153,ROOSEVELT,PHIL,Philosophy,1,0,1,0,0,0,0,2,2,1,1,2,3,3,6,0,0,0,5,6,11
fa15,153,ROOSEVELT,PHYS,Biophysics,2,0,2,0,0,0,0,0,0,2,0,2,0,1,1,0,0,0,4,1,5
fa15,153,ROOSEVELT,PHYS,Gen Physcs,1,1,2,0,0,0,0,0,0,0,0,0,0,0,0,0,0,0,1,1,2
fa15,153,ROOSEVELT,PHYS,Phys/Astro,1,2,3,0,0,0,4,1,5,2,1,3,0,0,0,0,0,0,7,4,11
fa15,153,ROOSEVELT,PHYS,Phys/Comp,0,0,0,0,0,0,0,1,1,0,0,0,0,0,0,0,0,0,0,1,1
fa15,153,ROOSEVELT,PHYS,Phys/Mtrls,0,0,0,0,0,0,1,0,1,0,0,0,0,0,0,0,0,0,1,0,1
fa15,153,ROOSEVELT,PHYS,Physics,15,2,17,1,0,1,4,0,4,4,0,4,2,2,4,0,0,0,26,4,30
fa15,153,ROOSEVELT,POLI,Polit Sci,3,7,10,3,0,3,6,11,17,10,21,31,11,13,24,0,0,0,33,52,85
fa15,153,ROOSEVELT,POLI,PolSc-Amer,1,2,3,0,1,1,1,2,3,3,3,6,4,4,8,0,0,0,9,12,21
fa15,153,ROOSEVELT,POLI,PolSc-Comp,1,0,1,0,0,0,0,0,0,2,0,2,3,3,6,0,0,0,6,3,9
fa15,153,ROOSEVELT,POLI,PolSc-Intl,6,8,14,1,0,1,5,6,11,20,14,34,15,16,31,0,0,0,47,44,91
fa15,153,ROOSEVELT,POLI,PolSc-PLaw,0,2,2,0,0,0,0,2,2,5,8,13,4,7,11,0,0,0,9,19,28
fa15,153,ROOSEVELT,POLI,PolSc-PPol,0,0,0,0,1,1,0,1,1,2,1,3,2,5,7,0,0,0,4,8,12
fa15,153,ROOSEVELT,POLI,PolSc-Thry,1,0,1,0,0,0,1,1,2,2,0,2,0,4,4,0,0,0,4,5,9
fa15,153,ROOSEVELT,PSYC,Psyc/ClPsy,2,3,5,0,0,0,1,5,6,1,3,4,4,9,13,0,0,0,8,20,28
fa15,153,ROOSEVELT,PSYC,Psyc/CogPs,0,1,1,0,0,0,0,0,0,2,2,4,0,2,2,0,0,0,2,5,7
fa15,153,ROOSEVELT,PSYC,Psyc/DelPs,0,3,3,0,0,0,0,0,0,0,4,4,0,0,0,0,0,0,0,7,7
fa15,153,ROOSEVELT,PSYC,Psyc/HumHl,0,0,0,0,0,0,0,1,1,2,5,7,1,3,4,0,0,0,3,9,12
fa15,153,ROOSEVELT,PSYC,Psyc/SocPs,1,2,3,0,0,0,0,4,4,1,1,2,1,0,1,0,0,0,3,7,10
fa15,153,ROOSEVELT,PSYC,Psychology,4,20,24,0,0,0,3,17,20,11,39,50,10,44,54,0,0,0,28,120,148
fa15,153,ROOSEVELT,PSYC,RusEE&EStd,0,0,0,0,0,0,0,0,0,1,0,1,0,0,0,0,0,0,1,0,1
fa15,153,ROOSEVELT,SE,Engin Sci,0,0,0,0,0,0,0,1,1,1,0,1,0,0,0,0,0,0,1,1,2
fa15,153,ROOSEVELT,SE,Struct Eng,8,3,11,1,0,1,4,2,6,9,3,12,22,9,31,0,0,0,44,17,61
fa15,153,ROOSEVELT,SIO,Earth Sci,0,0,0,0,0,0,0,0,0,2,0,2,2,6,8,0,0,0,4,6,10
fa15,153,ROOSEVELT,SIO,Marine Bio,2,4,6,0,1,1,1,3,4,3,9,12,4,5,9,0,0,0,10,22,32
fa15,153,ROOSEVELT,SOC,SocCulCom,0,4,4,0,0,0,0,0,0,0,2,2,0,1,1,0,0,0,0,7,7
fa15,153,ROOSEVELT,SOC,SocEconSoc,1,1,2,0,0,0,0,0,0,0,0,0,0,0,0,0,0,0,1,1,2
fa15,153,ROOSEVELT,SOC,SocIntlStu,0,0,0,0,0,0,0,0,0,0,1,1,0,2,2,0,0,0,0,3,3
fa15,153,ROOSEVELT,SOC,Sociology,0,6,6,0,0,0,1,1,2,5,4,9,0,5,5,0,0,0,6,16,22
fa15,153,ROOSEVELT,SOC,SocLawSoc,0,3,3,0,0,0,0,3,3,0,3,3,1,2,3,0,0,0,1,11,12
fa15,153,ROOSEVELT,SOC,SocSciMed,0,0,0,0,1,1,0,0,0,0,4,4,0,2,2,0,0,0,0,7,7
fa15,153,ROOSEVELT,SOC,SocSolneq,0,0,0,0,0,0,0,0,0,0,2,2,0,1,1,0,0,0,0,3,3
fa15,153,ROOSEVELT,THEA,Dance,0,0,0,0,0,0,0,0,0,0,1,1,1,0,1,0,0,0,1,1,2
fa15,153,ROOSEVELT,THEA,Theatre,1,3,4,0,2,2,1,1,2,2,1,3,1,6,7,0,0,0,5,13,18
fa15,153,ROOSEVELT,TWS,ThirdWldSt,0,0,0,0,0,0,0,0,0,0,0,0,0,1,1,0,0,0,0,1,1
fa15,153,ROOSEVELT,UNAF,UndecHumAr,1,5,6,0,1,1,0,1,1,0,0,0,0,0,0,0,0,0,1,7,8
fa15,153,ROOSEVELT,UNAF,Undeclared,73,53,126,8,3,11,22,15,37,19,2,21,1,0,1,0,0,0,123,73,196
fa15,153,ROOSEVELT,UNAF,UndecPhysS,15,10,25,2,1,3,1,4,5,1,0,1,0,0,0,0,0,0,19,15,34
fa15,153,ROOSEVELT,UNAF,UndecSocSc,5,14,19,0,0,0,3,4,7,1,0,1,0,0,0,0,0,0,9,18,27
fa15,153,ROOSEVELT,USP,Urb Stu&Pl,1,0,1,0,0,0,1,0,1,1,1,2,0,2,2,0,0,0,3,3,6
fa15,153,ROOSEVELT,VIS,Art Hst/Cr,0,0,0,0,0,0,0,0,0,0,1,1,0,3,3,0,0,0,0,4,4
fa15,153,ROOSEVELT,VIS,Media,0,3,3,1,1,2,1,2,3,5,1,6,2,4,6,0,0,0,9,11,20
fa15,153,ROOSEVELT,VIS,Studio VA,0,1,1,0,0,0,1,2,3,0,4,4,0,5,5,0,0,0,1,12,13
fa15,153,ROOSEVELT,VIS,VA-CompArt,2,2,4,0,0,0,0,2,2,1,2,3,2,4,6,0,0,0,5,10,15
fa15,153,SIXTH,ANTH,Anth-Arch,0,0,0,0,0,0,0,0,0,0,0,0,0,2,2,0,0,0,0,2,2
fa15,153,SIXTH,ANTH,Anth-Biol,0,0,0,0,0,0,0,0,0,0,2,2,0,1,1,0,0,0,0,3,3
fa15,153,SIXTH,ANTH,Anth-Soci,0,2,2,0,0,0,0,0,0,0,1,1,0,1,1,0,0,0,0,4,4
fa15,153,SIXTH,BENG,Bioen:Binf,1,2,3,0,0,0,0,1,1,1,1,2,5,9,14,0,0,0,7,13,20
fa15,153,SIXTH,BENG,BioengBioS,1,4,5,0,0,0,0,1,1,5,1,6,2,4,6,0,0,0,8,10,18
fa15,153,SIXTH,BENG,BioengBiot,1,0,1,0,0,0,1,2,3,3,3,6,7,4,11,0,0,0,12,9,21
fa15,153,SIXTH,BENG,Bioengin,0,0,0,0,0,0,0,0,0,0,2,2,8,3,11,0,0,0,8,5,13
fa15,153,SIXTH,BIOL,Bioc/CellB,22,23,45,1,1,2,18,12,30,25,31,56,41,35,76,0,0,0,107,102,209
fa15,153,SIXTH,BIOL,BiolBioinf,2,2,4,0,0,0,3,1,4,3,2,5,2,1,3,0,0,0,10,6,16
fa15,153,SIXTH,BIOL,Ec/Beh/Evo,2,3,5,0,0,0,1,2,3,2,5,7,2,4,6,0,0,0,7,14,21
fa15,153,SIXTH,BIOL,Genl Biol,12,20,32,0,0,0,11,8,19,11,25,36,20,27,47,0,0,0,54,80,134
fa15,153,SIXTH,BIOL,Human Bio,15,40,55,0,1,1,14,35,49,33,39,72,44,48,92,0,0,0,106,163,269
fa15,153,SIXTH,BIOL,Microbiol,2,2,4,0,0,0,3,4,7,7,2,9,2,7,9,0,0,0,14,15,29
fa15,153,SIXTH,BIOL,Molec Biol,6,5,11,0,0,0,3,6,9,3,4,7,8,6,14,0,0,0,20,21,41
fa15,153,SIXTH,BIOL,PhyslNeuro,13,22,35,1,0,1,8,9,17,21,25,46,22,20,42,0,0,0,65,76,141
fa15,153,SIXTH,CENG,Chem Engin,1,0,1,0,0,0,1,0,1,15,6,21,35,18,53,0,0,0,52,24,76
fa15,153,SIXTH,CGS,CritGendSt,0,0,0,0,0,0,0,0,0,1,0,1,2,0,2,0,0,0,3,0,3
fa15,153,SIXTH,CHEM,Bioch/Chem,5,7,12,0,0,0,4,3,7,2,8,10,8,5,13,0,0,0,19,23,42
fa15,153,SIXTH,CHEM,Bioinform,0,2,2,0,0,0,1,1,2,2,0,2,0,0,0,0,0,0,3,3,6
fa15,153,SIXTH,CHEM,Chem Educ,0,0,0,0,0,0,0,0,0,0,0,0,0,1,1,0,0,0,0,1,1
fa15,153,SIXTH,CHEM,Chemistry,7,7,14,0,0,0,4,4,8,5,5,10,4,3,7,0,0,0,20,19,39
fa15,153,SIXTH,CHEM,Envir Chem,0,1,1,0,0,0,0,0,0,1,0,1,0,2,2,0,0,0,1,3,4
fa15,153,SIXTH,CHEM,MolecSynth,0,0,0,0,0,0,0,1,1,0,0,0,1,0,1,0,0,0,1,1,2
fa15,153,SIXTH,CHEM,Pharm Chem,2,8,10,0,0,0,3,10,13,6,13,19,8,8,16,0,0,0,19,39,58
fa15,153,SIXTH,CHIN,Chinese St,0,0,0,0,0,0,0,0,0,0,2,2,0,0,0,0,0,0,0,2,2
fa15,153,SIXTH,COGS,Cog Sci,3,3,6,0,0,0,1,6,7,6,2,8,3,2,5,0,0,0,13,13,26
fa15,153,SIXTH,COGS,CogSc/ClAs,0,0,0,0,0,0,0,2,2,0,2,2,2,0,2,0,0,0,2,4,6
fa15,153,SIXTH,COGS,CogSc/Comp,1,0,1,0,0,0,9,2,11,2,2,4,2,0,2,0,0,0,14,4,18
fa15,153,SIXTH,COGS,CogSc/HCI,2,0,2,1,0,1,3,3,6,7,7,14,9,5,14,0,0,0,22,15,37
fa15,153,SIXTH,COGS,CogSc/HCog,0,0,0,0,0,0,1,3,4,1,1,2,2,1,3,0,0,0,4,5,9
fa15,153,SIXTH,COGS,CogSc/Neur,1,2,3,0,0,0,3,2,5,2,2,4,7,6,13,0,0,0,13,12,25
fa15,153,SIXTH,COMM,Communic,4,14,18,1,0,1,5,11,16,19,49,68,16,50,66,0,0,0,45,124,169
fa15,153,SIXTH,CSE,Comp Sci,9,4,13,1,0,1,25,6,31,87,13,100,185,39,224,0,0,0,307,62,369
fa15,153,SIXTH,CSE,CompEngCSE,2,0,2,0,0,0,3,0,3,10,1,11,33,2,35,0,0,0,48,3,51
fa15,153,SIXTH,CSE,CompScBinf,1,0,1,0,0,0,1,0,1,1,0,1,5,5,10,0,0,0,8,5,13
fa15,153,SIXTH,ECE,CompEngECE,9,4,13,0,0,0,4,0,4,24,2,26,19,3,22,0,0,0,56,9,65
fa15,153,SIXTH,ECE,Electr Eng,15,4,19,1,0,1,12,0,12,38,6,44,100,14,114,0,0,0,166,24,190
fa15,153,SIXTH,ECE,EleEng&Soc,0,0,0,0,0,0,0,0,0,0,0,0,0,1,1,0,0,0,0,1,1
fa15,153,SIXTH,ECE,Engin Phys,0,0,0,0,0,0,0,1,1,0,0,0,0,0,0,0,0,0,0,1,1
fa15,153,SIXTH,ECE,Pr-EngPhys,0,1,1,0,0,0,1,0,1,1,0,1,0,0,0,0,0,0,2,1,3
fa15,153,SIXTH,ECON,Ec-Mth&Ecn,6,8,14,0,1,1,1,5,6,11,8,19,8,4,12,0,0,0,26,26,52
fa15,153,SIXTH,ECON,Econ-MgtSc,4,6,10,0,1,1,10,4,14,36,16,52,42,21,63,0,0,0,92,48,140
fa15,153,SIXTH,ECON,Economics,34,23,57,6,1,7,26,13,39,58,40,98,60,30,90,0,0,0,184,107,291
fa15,153,SIXTH,ECON,EnvSys(EB),0,1,1,0,0,0,0,0,0,1,1,2,0,4,4,0,0,0,1,6,7
fa15,153,SIXTH,ECON,EnvSys(EC),1,1,2,0,0,0,0,1,1,2,0,2,0,0,0,0,0,0,3,2,5
fa15,153,SIXTH,ECON,EnvSys(EP),2,0,2,0,0,0,0,1,1,1,1,2,1,0,1,0,0,0,4,2,6
fa15,153,SIXTH,ECON,EnvSys(ES),3,0,3,0,0,0,3,0,3,1,2,3,1,3,4,0,0,0,8,5,13
fa15,153,SIXTH,FPMU,Public Hlt,0,2,2,1,0,1,2,12,14,2,16,18,7,26,33,0,0,0,12,56,68
fa15,153,SIXTH,GLBH,Global Hlt,0,3,3,0,0,0,0,1,1,0,3,3,1,0,1,0,0,0,1,7,8
fa15,153,SIXTH,GMST,German Stu,0,1,1,0,0,0,0,0,0,0,0,0,0,0,0,0,0,0,0,1,1
fa15,153,SIXTH,HDP,Human Dev,0,0,0,0,0,0,0,0,0,1,6,7,3,14,17,0,0,0,4,20,24
fa15,153,SIXTH,HDP,Pr-HumnDev,0,2,2,0,0,0,0,8,8,0,1,1,0,1,1,0,0,0,0,12,12
fa15,153,SIXTH,HIST,History,1,1,2,0,0,0,2,1,3,2,3,5,1,1,2,0,0,0,6,6,12
fa15,153,SIXTH,INTL,InSt-InBus,4,1,5,0,0,0,2,2,4,7,10,17,3,1,4,0,0,0,16,14,30
fa15,153,SIXTH,INTL,Int-5yrEC,0,0,0,0,0,0,0,0,0,0,0,0,1,0,1,0,0,0,1,0,1
fa15,153,SIXTH,INTL,IntSt-Anth,0,0,0,0,0,0,0,0,0,1,1,2,0,1,1,0,0,0,1,2,3
fa15,153,SIXTH,INTL,IntSt-Econ,2,6,8,0,0,0,2,4,6,2,3,5,3,2,5,0,0,0,9,15,24
fa15,153,SIXTH,INTL,IntSt-Hist,0,1,1,0,0,0,0,0,0,0,0,0,0,0,0,0,0,0,0,1,1
fa15,153,SIXTH,INTL,IntSt-Ling,0,0,0,0,0,0,0,0,0,0,0,0,0,1,1,0,0,0,0,1,1
fa15,153,SIXTH,INTL,IntSt-Lit,0,1,1,0,0,0,0,1,1,0,0,0,0,1,1,0,0,0,0,3,3
fa15,153,SIXTH,INTL,IntSt-PolS,2,3,5,0,0,0,1,1,2,2,2,4,2,4,6,0,0,0,7,10,17
fa15,153,SIXTH,INTL,IntSt-Soc,0,2,2,0,0,0,0,1,1,1,1,2,0,1,1,0,0,0,1,5,6
fa15,153,SIXTH,JAPN,JapaneseSt,0,2,2,0,0,0,0,1,1,0,1,1,0,0,0,0,0,0,0,4,4
fa15,153,SIXTH,JUDA,Judaic Stu,0,0,0,0,0,0,0,0,0,0,0,0,0,1,1,0,0,0,0,1,1
fa15,153,SIXTH,JUDA,Lang Stu,0,0,0,0,0,0,0,0,0,1,0,1,0,1,1,0,0,0,1,1,2
fa15,153,SIXTH,JUDA,Ling-CogLn,0,2,2,0,0,0,0,0,0,0,2,2,0,1,1,0,0,0,0,5,5
fa15,153,SIXTH,JUDA,Ling-LSoc,0,0,0,0,0,0,0,0,0,0,0,0,0,1,1,0,0,0,0,1,1
fa15,153,SIXTH,JUDA,Linguistcs,0,0,0,0,0,0,0,1,1,0,2,2,1,2,3,0,0,0,1,5,6
fa15,153,SIXTH,LIT,Ital Lit,0,0,0,0,0,0,0,0,0,0,0,0,0,1,1,0,0,0,0,1,1
fa15,153,SIXTH,LIT,Lit/CultSt,0,0,0,0,0,0,0,0,0,0,1,1,0,0,0,0,0,0,0,1,1
fa15,153,SIXTH,LIT,Lit/Engl,1,0,1,0,0,0,0,1,1,0,1,1,0,4,4,0,0,0,1,6,7
fa15,153,SIXTH,LIT,Lit/Writng,0,0,0,0,0,0,1,3,4,4,5,9,4,5,9,0,0,0,9,13,22
fa15,153,SIXTH,MAE,Aerosp Eng,10,3,13,1,0,1,3,1,4,14,2,16,12,4,16,0,0,0,40,10,50
fa15,153,SIXTH,MAE,Envir Eng,4,1,5,0,0,0,4,3,7,5,4,9,14,8,22,0,0,0,27,16,43
fa15,153,SIXTH,MAE,Mech Engin,5,1,6,0,0,0,4,3,7,10,3,13,25,8,33,0,0,0,44,15,59
fa15,153,SIXTH,MATH,Appld Math,19,13,32,1,0,1,5,12,17,7,9,16,6,6,12,0,0,0,38,40,78
fa15,153,SIXTH,MATH,Math/SecEd,1,1,2,0,0,0,0,0,0,1,0,1,0,1,1,0,0,0,2,2,4
fa15,153,SIXTH,MATH,Mathematcs,10,8,18,1,0,1,2,2,4,3,5,8,8,2,10,0,0,0,24,17,41
fa15,153,SIXTH,MATH,Mth-CompSc,27,20,47,3,1,4,25,10,35,35,7,42,8,7,15,0,0,0,98,45,143
fa15,153,SIXTH,MATH,Mth-Mth&Ec,3,4,7,0,0,0,1,4,5,4,0,4,6,6,12,0,0,0,14,14,28
fa15,153,SIXTH,MATH,Mth/ApldSc,2,1,3,0,0,0,1,0,1,0,1,1,1,1,2,0,0,0,4,3,7
fa15,153,SIXTH,MATH,Prob&Stats,2,1,3,1,0,1,4,5,9,6,3,9,3,0,3,0,0,0,16,9,25
fa15,153,SIXTH,MUS,Mu-CompArt,5,2,7,0,0,0,3,1,4,1,3,4,8,2,10,0,0,0,17,8,25
fa15,153,SIXTH,MUS,Music,1,3,4,0,0,0,0,0,0,3,0,3,2,1,3,0,0,0,6,4,10
fa15,153,SIXTH,MUS,Music Hum,0,0,0,0,0,0,0,0,0,0,0,0,1,0,1,0,0,0,1,0,1
fa15,153,SIXTH,NENG,NanoEng,9,2,11,1,0,1,3,0,3,15,1,16,22,5,27,0,0,0,50,8,58
fa15,153,SIXTH,PHIL,Philosophy,0,0,0,0,0,0,2,0,2,4,2,6,2,0,2,0,0,0,8,2,10
fa15,153,SIXTH,PHIL,Biophysics,2,1,3,0,0,0,0,0,0,1,0,1,0,1,1,0,0,0,3,2,5
fa15,153,SIXTH,PHIL,Gen Physcs,1,0,1,0,0,0,1,0,1,1,0,1,1,0,1,0,0,0,4,0,4
fa15,153,SIXTH,PHIL,Phys/Astro,2,3,5,0,0,0,0,0,0,1,1,2,4,2,6,0,0,0,7,6,13
fa15,153,SIXTH,PHIL,Phys/Comp,1,1,2,0,0,0,1,0,1,0,1,1,1,0,1,0,0,0,3,2,5
fa15,153,SIXTH,PHIL,Phys/Mtrls,1,1,2,0,0,0,2,1,3,2,0,2,2,0,2,0,0,0,7,2,9
fa15,153,SIXTH,PHIL,Physics,13,5,18,0,0,0,9,1,10,8,1,9,9,1,10,0,0,0,39,8,47
fa15,153,SIXTH,POLI,Polit Sci,3,2,5,0,0,0,2,2,4,4,9,13,5,8,13,0,0,0,14,21,35
fa15,153,SIXTH,POLI,PolSc-Amer,0,0,0,0,0,0,0,1,1,0,0,0,2,2,4,0,0,0,2,3,5
fa15,153,SIXTH,POLI,PolSc-Intl,1,1,2,0,0,0,1,0,1,4,1,5,2,5,7,0,0,0,8,7,15
fa15,153,SIXTH,POLI,PolSc-PLaw,0,1,1,1,0,1,0,1,1,3,6,9,0,3,3,0,0,0,4,11,15
fa15,153,SIXTH,POLI,PolSc-PPol,0,0,0,0,0,0,1,1,2,0,0,0,3,2,5,0,0,0,4,3,7
fa15,153,SIXTH,POLI,PolSc-Thry,0,0,0,0,0,0,0,0,0,0,0,0,0,1,1,0,0,0,0,1,1
fa15,153,SIXTH,PSYC,Psyc/ClPsy,1,0,1,0,0,0,0,8,8,4,8,12,4,13,17,0,0,0,9,29,38
fa15,153,SIXTH,PSYC,Psyc/CogPs,0,1,1,0,0,0,0,1,1,0,0,0,0,1,1,0,0,0,0,3,3
fa15,153,SIXTH,PSYC,Psyc/DelPs,0,0,0,0,1,1,0,1,1,0,2,2,0,2,2,0,0,0,0,6,6
fa15,153,SIXTH,PSYC,Psyc/HumHl,0,1,1,0,0,0,0,2,2,1,3,4,1,1,2,0,0,0,2,7,9
fa15,153,SIXTH,PSYC,Psyc/SenPr,0,0,0,0,0,0,0,0,0,0,0,0,0,1,1,0,0,0,0,1,1
fa15,153,SIXTH,PSYC,Psyc/SocPs,0,2,2,0,0,0,0,1,1,2,2,4,1,2,3,0,0,0,3,7,10
fa15,153,SIXTH,PSYC,Psychology,6,14,20,0,2,2,2,4,6,8,23,31,19,31,50,0,0,0,35,74,109
fa15,153,SIXTH,RELI,Relig/Stu,0,0,0,0,0,0,0,0,0,1,0,1,1,0,1,0,0,0,2,0,2
fa15,153,SIXTH,SE,Engin Sci,0,1,1,1,0,1,0,0,0,0,0,0,0,0,0,0,0,0,1,1,2
fa15,153,SIXTH,SE,Struct Eng,10,4,14,1,0,1,7,3,10,31,6,37,46,18,64,0,0,0,95,31,126
fa15,153,SIXTH,SIO,Earth Sci,0,2,2,0,0,0,1,0,1,1,0,1,0,0,0,0,0,0,2,2,4
fa15,153,SIXTH,SIO,Marine Bio,3,4,7,0,0,0,2,5,7,3,5,8,2,7,9,0,0,0,10,21,31
fa15,153,SIXTH,SIO,SocCulCom,0,0,0,0,0,0,0,0,0,1,3,4,0,2,2,0,0,0,1,5,6
fa15,153,SIXTH,SIO,SocEconSoc,0,0,0,0,0,0,0,1,1,0,0,0,2,0,2,0,0,0,2,1,3
fa15,153,SIXTH,SIO,SocIntlStu,0,0,0,0,0,0,0,0,0,0,0,0,0,1,1,0,0,0,0,1,1
fa15,153,SIXTH,SIO,Sociology,1,2,3,0,0,0,2,3,5,1,5,6,1,7,8,0,0,0,5,17,22
fa15,153,SIXTH,SIO,SocLawSoc,1,0,1,0,0,0,0,1,1,3,2,5,0,3,3,0,0,0,4,6,10
fa15,153,SIXTH,SIO,SocSciMed,0,1,1,0,0,0,0,0,0,0,0,0,0,0,0,0,0,0,0,1,1
fa15,153,SIXTH,SIO,SocSolneq,0,0,0,0,0,0,0,0,0,0,0,0,0,3,3,0,0,0,0,3,3
fa15,153,SIXTH,THEA,Dance,1,1,2,0,0,0,0,0,0,0,0,0,0,0,0,0,0,0,1,1,2
fa15,153,SIXTH,THEA,Theatre,2,7,9,0,1,1,1,1,2,3,7,10,4,5,9,0,0,0,10,21,31
fa15,153,SIXTH,UNAF,UndecHumAr,3,5,8,0,0,0,1,0,1,0,0,0,0,0,0,0,0,0,4,5,9
fa15,153,SIXTH,UNAF,Undeclared,112,55,167,9,1,10,27,7,34,14,3,17,2,0,2,0,0,0,164,66,230
fa15,153,SIXTH,UNAF,UndecPhysS,7,7,14,0,0,0,2,1,3,0,0,0,0,0,0,0,0,0,9,8,17
fa15,153,SIXTH,UNAF,UndecSocSc,9,8,17,0,0,0,2,0,2,0,0,0,0,0,0,0,0,0,11,8,19
fa15,153,SIXTH,USP,Urb Stu&Pl,2,0,2,0,0,0,0,2,2,1,5,6,5,5,10,0,0,0,8,12,20
fa15,153,SIXTH,VIS,Art Hst/Cr,0,0,0,0,0,0,0,0,0,1,6,7,0,2,2,0,0,0,1,8,9
fa15,153,SIXTH,VIS,Media,9,15,24,3,0,3,5,5,10,15,13,28,12,19,31,0,0,0,44,52,96
fa15,153,SIXTH,VIS,Spec Desgn,0,2,2,0,0,0,2,1,3,0,0,0,0,0,0,0,0,0,2,3,5
fa15,153,SIXTH,VIS,Studio VA,1,7,8,0,0,0,0,4,4,3,8,11,3,6,9,0,0,0,7,25,32
fa15,153,SIXTH,VIS,VA-CompArt,3,5,8,0,0,0,6,6,12,4,11,15,8,12,20,0,0,0,21,34,55
fa15,153,WARREN,ANTH,Anth-Arch,0,0,0,0,0,0,0,0,0,0,1,1,0,1,1,0,0,0,0,2,2
fa15,153,WARREN,ANTH,Anth-Biol,0,1,1,0,0,0,0,0,0,2,1,3,0,0,0,0,0,0,2,2,4
fa15,153,WARREN,ANTH,Anth-Soci,1,0,1,0,0,0,0,0,0,1,0,1,0,2,2,0,0,0,2,2,4
fa15,153,WARREN,BENG,Bioen:Binf,5,2,7,0,0,0,1,1,2,6,3,9,6,11,17,0,0,0,18,17,35
fa15,153,WARREN,BENG,BioengBioS,2,4,6,0,0,0,1,0,1,4,3,7,4,0,4,0,0,0,11,7,18
fa15,153,WARREN,BENG,BioengBiot,5,2,7,0,0,0,4,1,5,8,7,15,17,26,43,0,0,0,34,36,70
fa15,153,WARREN,BENG,Bioengin,4,3,7,0,0,0,2,1,3,10,8,18,18,12,30,0,0,0,34,24,58
fa15,153,WARREN,BIOL,Bioc/CellB,14,20,34,0,0,0,12,12,24,20,28,48,34,44,78,0,0,0,80,104,184
fa15,153,WARREN,BIOL,BiolBioinf,3,0,3,0,0,0,0,1,1,3,1,4,0,1,1,0,0,0,6,3,9
fa15,153,WARREN,BIOL,Ec/Beh/Evo,1,1,2,0,0,0,0,0,0,0,2,2,4,8,12,0,0,0,5,11,16
fa15,153,WARREN,BIOL,Genl Biol,10,11,21,0,1,1,4,1,5,4,22,26,25,40,65,0,0,0,43,75,118
fa15,153,WARREN,BIOL,Human Bio,12,20,32,2,1,3,5,8,13,22,30,52,32,45,77,0,0,0,73,104,177
fa15,153,WARREN,BIOL,Microbiol,2,2,4,0,0,0,3,0,3,3,1,4,3,7,10,0,0,0,11,10,21
fa15,153,WARREN,BIOL,Molec Biol,2,4,6,0,0,0,1,0,1,6,2,8,7,4,11,0,0,0,16,10,26
fa15,153,WARREN,BIOL,PhyslNeuro,6,14,20,0,1,1,3,9,12,8,12,20,35,21,56,0,0,0,52,57,109
fa15,153,WARREN,CENG,Chem Engin,8,4,12,0,0,0,4,3,7,23,11,34,69,31,100,0,0,0,104,49,153
fa15,153,WARREN,CGS,CritGendSt,0,0,0,0,0,0,0,0,0,0,0,0,1,0,1,0,0,0,1,0,1
fa15,153,WARREN,CHEM,Bioch/Chem,3,4,7,0,0,0,5,3,8,5,6,11,6,9,15,0,0,0,19,22,41
fa15,153,WARREN,CHEM,Bioinform,0,0,0,0,0,0,0,0,0,0,0,0,0,1,1,0,0,0,0,1,1
fa15,153,WARREN,CHEM,Chemistry,5,7,12,0,0,0,3,3,6,2,5,7,1,5,6,0,0,0,11,20,31
fa15,153,WARREN,CHEM,Envir Chem,0,0,0,0,0,0,0,0,0,2,0,2,2,0,2,0,0,0,4,0,4
fa15,153,WARREN,CHEM,Pharm Chem,1,4,5,0,0,0,0,2,2,1,5,6,4,11,15,0,0,0,6,22,28
fa15,153,WARREN,CHIN,Chinese St,0,0,0,0,0,0,0,0,0,0,1,1,0,2,2,0,0,0,0,3,3
fa15,153,WARREN,COGS,Cog Sci,2,2,4,0,0,0,1,4,5,3,1,4,1,4,5,0,0,0,7,11,18
fa15,153,WARREN,COGS,CogSc/ClAs,0,0,0,0,0,0,0,0,0,0,0,0,2,2,4,0,0,0,2,2,4
fa15,153,WARREN,COGS,CogSc/Comp,0,0,0,0,0,0,2,0,2,0,0,0,0,2,2,0,0,0,2,2,4
fa15,153,WARREN,COGS,CogSc/HCI,1,1,2,0,0,0,4,2,6,3,1,4,4,8,12,0,0,0,12,12,24
fa15,153,WARREN,COGS,CogSc/HCog,0,0,0,0,0,0,0,0,0,0,1,1,0,1,1,0,0,0,0,2,2
fa15,153,WARREN,COGS,CogSc/Neur,0,0,0,0,1,1,1,2,3,0,2,2,1,9,10,0,0,0,2,14,16
fa15,153,WARREN,COMM,Communic,1,5,6,0,1,1,3,7,10,5,22,27,10,14,24,0,0,0,19,49,68
fa15,153,WARREN,CSE,Comp Sci,51,18,69,2,2,4,47,7,54,121,28,149,254,55,309,0,0,0,475,110,585
fa15,153,WARREN,CSE,CompEngCSE,14,3,17,0,0,0,6,1,7,23,3,26,65,6,71,0,0,0,108,13,121
fa15,153,WARREN,CSE,CompScBinf,0,0,0,0,0,0,2,0,2,3,3,6,0,1,1,0,0,0,5,4,9
fa15,153,WARREN,ECE,CompEngECE,18,3,21,0,0,0,9,0,9,38,3,41,23,4,27,0,0,0,88,10,98
fa15,153,WARREN,ECE,Electr Eng,38,8,46,3,0,3,14,3,17,56,15,71,121,20,141,0,0,0,232,46,278
fa15,153,WARREN,ECE,Engin Phys,0,0,0,0,0,0,1,0,1,0,0,0,2,0,2,0,0,0,3,0,3
fa15,153,WARREN,ECE,Pr-EngPhys,1,2,3,0,0,0,0,0,0,2,0,2,0,0,0,0,0,0,3,2,5
fa15,153,WARREN,ECON,Ec-Mth&Ecn,10,6,16,0,0,0,3,5,8,17,5,22,6,2,8,0,0,0,36,18,54
fa15,153,WARREN,ECON,Econ-MgtSc,2,4,6,0,1,1,8,3,11,16,14,30,41,16,57,0,0,0,67,38,105
fa15,153,WARREN,ECON,Economics,16,11,27,1,2,3,12,2,14,54,38,92,58,35,93,0,0,0,141,88,229
fa15,153,WARREN,ESYS,EnvSys(EB),0,0,0,0,0,0,0,1,1,0,0,0,1,2,3,0,0,0,1,3,4
fa15,153,WARREN,ESYS,EnvSys(EP),0,1,1,0,0,0,0,0,0,0,0,0,0,0,0,0,0,0,0,1,1
fa15,153,WARREN,ESYS,EnvSys(ES),0,0,0,0,0,0,0,0,0,1,1,2,0,0,0,0,0,0,1,1,2
fa15,153,WARREN,ESYS,Ethnic St,0,0,0,0,0,0,0,2,2,0,0,0,1,2,3,0,0,0,1,4,5
fa15,153,WARREN,FPMU,Public Hlt,1,2,3,0,0,0,0,4,4,5,5,10,3,12,15,0,0,0,9,23,32
fa15,153,WARREN,GLBH,Global Hlt,0,1,1,0,0,0,0,1,1,0,1,1,0,5,5,0,0,0,0,8,8
fa15,153,WARREN,HDP,Human Dev,0,0,0,0,0,0,0,0,0,0,2,2,2,9,11,0,0,0,2,11,13
fa15,153,WARREN,HDP,Pr-HumnDev,0,1,1,0,1,1,0,1,1,0,7,7,0,1,1,0,0,0,0,11,11
fa15,153,WARREN,HIST,History,1,2,3,0,0,0,1,1,2,2,1,3,5,1,6,0,0,0,9,5,14
fa15,153,WARREN,INTL,InSt-InBus,3,2,5,0,0,0,1,3,4,2,1,3,0,0,0,0,0,0,6,6,12
fa15,153,WARREN,INTL,Int-5yrEC,0,0,0,0,0,0,0,0,0,0,0,0,1,0,1,0,0,0,1,0,1
fa15,153,WARREN,INTL,Int-5yrPS,0,0,0,0,0,0,0,0,0,0,0,0,1,1,2,0,0,0,1,1,2
fa15,153,WARREN,INTL,IntSt-Anth,0,0,0,0,0,0,0,0,0,0,0,0,1,0,1,0,0,0,1,0,1
fa15,153,WARREN,INTL,IntSt-Econ,1,0,1,0,0,0,0,0,0,2,1,3,1,2,3,0,0,0,4,3,7
fa15,153,WARREN,INTL,IntSt-Hist,0,0,0,0,0,0,0,0,0,0,1,1,0,0,0,0,0,0,0,1,1
fa15,153,WARREN,INTL,IntSt-Ling,0,0,0,0,0,0,0,1,1,0,0,0,0,0,0,0,0,0,0,1,1
fa15,153,WARREN,INTL,IntSt-Lit,0,0,0,0,0,0,0,0,0,0,1,1,0,0,0,0,0,0,0,1,1
fa15,153,WARREN,INTL,IntSt-PolS,0,1,1,0,0,0,0,1,1,0,5,5,1,5,6,0,0,0,1,12,13
fa15,153,WARREN,INTL,IntSt-Soc,0,0,0,0,0,0,0,1,1,0,3,3,0,0,0,0,0,0,0,4,4
fa15,153,WARREN,LATI,LatinAm St,0,0,0,0,0,0,0,0,0,1,0,1,0,0,0,0,0,0,1,0,1
fa15,153,WARREN,LING,Lang Stu,0,0,0,0,0,0,0,0,0,0,2,2,0,0,0,0,0,0,0,2,2
fa15,153,WARREN,LING,Ling-CogLn,0,1,1,0,0,0,0,0,0,0,1,1,0,0,0,0,0,0,0,2,2
fa15,153,WARREN,LING,Ling-LSoc,1,0,1,0,0,0,0,0,0,0,0,0,0,1,1,0,0,0,1,1,2
fa15,153,WARREN,LING,Linguistcs,1,0,1,0,0,0,0,0,0,1,3,4,1,0,1,0,0,0,3,3,6
fa15,153,WARREN,LING,French Lit,0,0,0,0,0,0,0,0,0,0,0,0,1,0,1,0,0,0,1,0,1
fa15,153,WARREN,LING,Lit/Engl,1,0,1,0,0,0,0,0,0,1,1,2,0,1,1,0,0,0,2,2,4
fa15,153,WARREN,LING,Lit/World,0,1,1,0,0,0,0,0,0,0,0,0,0,1,1,0,0,0,0,2,2
fa15,153,WARREN,LING,Lit/Writng,1,0,1,0,0,0,0,1,1,2,2,4,3,8,11,0,0,0,6,11,17
fa15,153,WARREN,LING,Spanish Lt,0,0,0,0,0,0,0,1,1,0,0,0,1,1,2,0,0,0,1,2,3
fa15,153,WARREN,MAE,Aerosp Eng,24,5,29,0,0,0,10,3,13,17,2,19,39,11,50,0,0,0,90,21,111
fa15,153,WARREN,MAE,Engin Sci,0,0,0,0,0,0,0,0,0,0,0,0,2,0,2,0,0,0,2,0,2
fa15,153,WARREN,MAE,Envir Eng,2,4,6,0,1,1,3,4,7,7,6,13,20,8,28,0,0,0,32,23,55
fa15,153,WARREN,MAE,Mech Engin,32,10,42,0,0,0,18,2,20,32,6,38,73,14,87,0,0,0,155,32,187
fa15,153,WARREN,MATH,Appld Math,13,17,30,1,0,1,7,3,10,8,1,9,5,11,16,0,0,0,34,32,66
fa15,153,WARREN,MATH,Math/SecEd,1,2,3,0,0,0,0,0,0,1,0,1,0,4,4,0,0,0,2,6,8
fa15,153,WARREN,MATH,Mathematcs,7,5,12,0,2,2,1,1,2,9,2,11,4,3,7,0,0,0,21,13,34
fa15,153,WARREN,MATH,Mth-CompSc,51,21,72,1,0,1,13,4,17,25,10,35,7,1,8,0,0,0,97,36,133
fa15,153,WARREN,MATH,Mth-Mth&Ec,3,2,5,1,0,1,1,4,5,4,8,12,7,8,15,0,0,0,16,22,38
fa15,153,WARREN,MATH,Mth-SciCom,0,0,0,0,0,0,1,0,1,0,0,0,0,0,0,0,0,0,1,0,1
fa15,153,WARREN,MATH,Mth/ApldSc,2,1,3,0,0,0,2,0,2,2,3,5,1,2,3,0,0,0,7,6,13
fa15,153,WARREN,MATH,Prob&Stats,2,2,4,0,1,1,0,4,4,7,5,12,1,4,5,0,0,0,10,16,26
fa15,153,WARREN,MUS,Mu-CompArt,1,0,1,1,0,1,0,0,0,1,0,1,3,0,3,0,0,0,6,0,6
fa15,153,WARREN,MUS,Music,1,0,1,0,0,0,0,0,0,2,0,2,2,0,2,0,0,0,5,0,5
fa15,153,WARREN,NENG,NanoEng,4,2,6,0,0,0,1,0,1,11,3,14,29,8,37,0,0,0,45,13,58
fa15,153,WARREN,PHIL,Philosophy,0,0,0,0,0,0,1,1,2,1,1,2,3,3,6,0,0,0,5,5,10
fa15,153,WARREN,PHYS,Biophysics,2,0,2,0,0,0,2,1,3,1,0,1,1,2,3,0,0,0,6,3,9
fa15,153,WARREN,PHYS,Gen Physcs,1,0,1,0,0,0,0,0,0,0,0,0,0,0,0,0,0,0,1,0,1
fa15,153,WARREN,PHYS,Phys/Astro,3,1,4,0,0,0,3,2,5,3,1,4,2,2,4,0,0,0,11,6,17
fa15,153,WARREN,PHYS,Phys/Comp,0,0,0,0,0,0,0,0,0,0,0,0,1,0,1,0,0,0,1,0,1
fa15,153,WARREN,PHYS,Phys/Mtrls,4,0,4,0,0,0,0,0,0,0,0,0,0,0,0,0,0,0,4,0,4
fa15,153,WARREN,PHYS,Physics,12,3,15,0,0,0,7,1,8,4,2,6,6,1,7,0,0,0,29,7,36
fa15,153,WARREN,POLI,Polit Sci,3,5,8,0,1,1,5,3,8,6,6,12,13,13,26,0,0,0,27,28,55
fa15,153,WARREN,POLI,PolSc-Amer,0,1,1,0,0,0,0,0,0,1,0,1,2,1,3,0,0,0,3,2,5
fa15,153,WARREN,POLI,PolSc-Comp,0,0,0,0,0,0,0,0,0,1,0,1,0,0,0,0,0,0,1,0,1
fa15,153,WARREN,POLI,PolSc-Intl,0,2,2,1,0,1,3,0,3,2,2,4,11,5,16,0,0,0,17,9,26
fa15,153,WARREN,POLI,PolSc-PLaw,2,2,4,1,2,3,0,4,4,1,4,5,5,3,8,0,0,0,9,15,24
fa15,153,WARREN,POLI,PolSc-PPol,0,0,0,0,0,0,1,0,1,0,0,0,3,0,3,0,0,0,4,0,4
fa15,153,WARREN,POLI,PolSc-Thry,0,0,0,0,0,0,0,0,0,1,0,1,0,1,1,0,0,0,1,1,2
fa15,153,WARREN,PSYC,Psyc/ClPsy,1,1,2,0,0,0,1,0,1,0,3,3,4,3,7,0,0,0,6,7,13
fa15,153,WARREN,PSYC,Psyc/CogPs,0,0,0,0,0,0,1,0,1,0,1,1,0,2,2,0,0,0,1,3,4
fa15,153,WARREN,PSYC,Psyc/DelPs,0,0,0,0,0,0,0,1,1,0,0,0,0,1,1,0,0,0,0,2,2
fa15,153,WARREN,PSYC,Psyc/HumHl,0,0,0,0,0,0,0,0,0,0,3,3,0,4,4,0,0,0,0,7,7
fa15,153,WARREN,PSYC,Psyc/SocPs,0,0,0,0,0,0,1,0,1,3,4,7,1,0,1,0,0,0,5,4,9
fa15,153,WARREN,PSYC,Psychology,1,1,2,0,1,1,4,2,6,4,23,27,14,34,48,0,0,0,23,61,84
fa15,153,WARREN,RELI,Relig/Stu,0,1,1,0,0,0,0,0,0,0,0,0,2,0,2,0,0,0,2,1,3
fa15,153,WARREN,RUSS,RusEE&EStd,0,0,0,0,0,0,0,0,0,0,0,0,0,1,1,0,0,0,0,1,1
fa15,153,WARREN,SE,Engin Sci,0,0,0,0,0,0,0,0,0,1,0,1,0,0,0,0,0,0,1,0,1
fa15,153,WARREN,SE,Struct Eng,6,5,11,1,0,1,2,6,8,32,10,42,64,23,87,0,0,0,105,44,149
fa15,153,WARREN,SIO,Earth Sci,0,1,1,0,0,0,1,1,2,0,2,2,1,1,2,0,0,0,2,5,7
fa15,153,WARREN,SIO,Marine Bio,1,3,4,0,0,0,0,1,1,0,1,1,1,2,3,0,0,0,2,7,9
fa15,153,WARREN,SIO,SocCulCom,0,1,1,0,0,0,0,0,0,0,0,0,0,1,1,0,0,0,0,2,2
fa15,153,WARREN,SIO,SocEconSoc,0,0,0,0,0,0,0,0,0,1,0,1,0,1,1,0,0,0,1,1,2
fa15,153,WARREN,SIO,SocIntlStu,0,0,0,0,0,0,0,0,0,0,0,0,1,0,1,0,0,0,1,0,1
fa15,153,WARREN,SIO,Sociology,0,2,2,1,0,1,0,0,0,0,4,4,3,4,7,0,0,0,4,10,14
fa15,153,WARREN,SIO,SocLawSoc,1,2,3,0,1,1,0,0,0,2,2,4,3,2,5,0,0,0,6,7,13
fa15,153,WARREN,SIO,SocSciMed,0,1,1,0,0,0,0,0,0,0,0,0,0,0,0,0,0,0,0,1,1
fa15,153,WARREN,SIO,SocSolneq,0,0,0,0,0,0,0,0,0,0,0,0,0,2,2,0,0,0,0,2,2
fa15,153,WARREN,THEA,Dance,0,0,0,0,0,0,0,2,2,0,1,1,0,0,0,0,0,0,0,3,3
fa15,153,WARREN,THEA,Theatre,0,1,1,0,0,0,1,0,1,0,4,4,1,1,2,0,0,0,2,6,8
fa15,153,WARREN,UNAF,IntcampVis,0,0,0,0,0,0,0,0,0,0,0,0,0,1,1,0,0,0,0,1,1
fa15,153,WARREN,UNAF,UndecHumAr,1,1,2,0,0,0,0,0,0,0,0,0,0,0,0,0,0,0,1,1,2
fa15,153,WARREN,UNAF,Undeclared,104,47,151,2,1,3,24,9,33,12,4,16,1,0,1,0,0,0,143,61,204
fa15,153,WARREN,UNAF,UndecPhysS,21,7,28,0,0,0,3,1,4,0,0,0,0,0,0,0,0,0,24,8,32
fa15,153,WARREN,UNAF,UndecSocSc,1,5,6,0,0,0,0,0,0,0,0,0,0,0,0,0,0,0,1,5,6
fa15,153,WARREN,USP,Urb Stu&Pl,0,0,0,0,0,0,1,0,1,4,3,7,2,0,2,0,0,0,7,3,10
fa15,153,WARREN,VIS,Media,1,0,1,0,0,0,1,0,1,3,0,3,4,4,8,0,0,0,9,4,13
fa15,153,WARREN,VIS,Spec Desgn,0,0,0,0,0,0,0,1,1,0,0,0,0,0,0,0,0,0,0,1,1
fa15,153,WARREN,VIS,Studio VA,0,0,0,0,0,0,0,2,2,1,0,1,0,3,3,0,0,0,1,5,6
fa15,153,WARREN,VIS,VA-CompArt,1,1,2,0,1,1,0,0,0,1,2,3,1,1,2,0,0,0,3,5,8
wi09,91,MARSHALL,ANTH,Anth-Arch,0,0,0,0,0,0,1,2,3,2,2,4,1,1,2,0,0,0,4,5,9
wi09,91,MARSHALL,ANTH,Anth-Biol,0,0,0,0,0,0,0,1,1,0,2,2,1,4,5,0,0,0,1,7,8
wi09,91,MARSHALL,ANTH,Anth-Soci,0,0,0,0,0,0,0,3,3,1,2,3,0,6,6,0,0,0,1,11,12
wi09,91,MARSHALL,ANTH,Anthropol,0,0,0,0,0,0,0,0,0,0,1,1,1,1,2,0,0,0,1,2,3
wi09,91,MARSHALL,BENG,Bioen:Binf,0,0,0,0,0,0,0,0,0,1,0,1,0,0,0,0,0,0,1,0,1
wi09,91,MARSHALL,BENG,Bioeng:PM,0,0,0,0,0,0,0,0,0,5,0,5,15,4,19,0,0,0,20,4,24
wi09,91,MARSHALL,BENG,BioengBiot,0,0,0,3,1,4,4,0,4,2,1,3,5,5,10,0,0,0,14,7,21
wi09,91,MARSHALL,BENG,Bioengin,0,0,0,1,0,1,3,1,4,1,1,2,3,4,7,0,0,0,8,6,14
wi09,91,MARSHALL,BENG,Pr-BioenPM,0,0,0,5,4,9,10,1,11,2,1,3,0,0,0,0,0,0,17,6,23
wi09,91,MARSHALL,BIOL,Anml Physl,0,0,0,0,0,0,0,0,0,0,0,0,2,2,4,0,0,0,2,2,4
wi09,91,MARSHALL,BIOL,Bioc/CellB,0,0,0,3,10,13,10,16,26,20,28,48,49,44,93,0,0,0,82,98,180
wi09,91,MARSHALL,BIOL,BiolBioinf,0,0,0,0,0,0,0,0,0,0,1,1,1,0,1,0,0,0,1,1,2
wi09,91,MARSHALL,BIOL,Ec/Beh/Evo,0,0,0,0,1,1,1,3,4,6,1,7,2,8,10,0,0,0,9,13,22
wi09,91,MARSHALL,BIOL,Genl Biol,0,0,0,6,14,20,6,19,25,25,40,65,32,41,73,0,0,0,69,114,183
wi09,91,MARSHALL,BIOL,Human Bio,0,0,0,19,46,65,21,56,77,41,63,104,47,66,113,0,0,0,128,231,359
wi09,91,MARSHALL,BIOL,Microbiol,0,0,0,1,0,1,2,4,6,4,4,8,2,3,5,0,0,0,9,11,20
wi09,91,MARSHALL,BIOL,Molec Biol,0,0,0,1,4,5,3,4,7,3,3,6,6,7,13,0,0,0,13,18,31
wi09,91,MARSHALL,BIOL,PhyslNeuro,0,0,0,7,7,14,6,14,20,11,21,32,17,12,29,0,0,0,41,54,95
wi09,91,MARSHALL,BIOL,Pr-BioBinf,0,0,0,0,0,0,0,0,0,1,0,1,1,0,1,0,0,0,2,0,2
wi09,91,MARSHALL,CENG,Chem Engin,0,0,0,3,2,5,1,1,2,5,2,7,11,6,17,0,0,0,20,11,31
wi09,91,MARSHALL,CGS,CritGendSt,0,0,0,0,0,0,0,0,0,0,1,1,0,3,3,0,0,0,0,4,4
wi09,91,MARSHALL,CHEM,Bioch/Chem,0,0,0,1,12,13,9,4,13,4,11,15,12,10,22,0,0,0,26,37,63
wi09,91,MARSHALL,CHEM,Chemistry,0,0,0,2,1,3,2,2,4,5,4,9,4,4,8,0,0,0,13,11,24
wi09,91,MARSHALL,CHEM,Pharm Chem,0,0,0,2,10,12,0,4,4,5,8,13,8,14,22,0,0,0,15,36,51
wi09,91,MARSHALL,CHIN,Chinese St,0,0,0,0,0,0,0,0,0,0,1,1,0,1,1,0,0,0,0,2,2
wi09,91,MARSHALL,CLAS,Classic St,0,0,0,0,0,0,0,0,0,0,0,0,1,1,2,0,0,0,1,1,2
wi09,91,MARSHALL,COGS,Cog Sci,0,0,0,1,2,3,1,4,5,2,3,5,5,4,9,0,0,0,9,13,22
wi09,91,MARSHALL,COGS,CogSc/ClAs,0,0,0,0,0,0,0,1,1,0,1,1,0,1,1,0,0,0,0,3,3
wi09,91,MARSHALL,COGS,CogSc/Comp,0,0,0,0,0,0,0,0,0,1,0,1,1,0,1,0,0,0,2,0,2
wi09,91,MARSHALL,COGS,CogSc/HCI,0,0,0,0,0,0,0,0,0,1,1,2,5,1,6,0,0,0,6,2,8
wi09,91,MARSHALL,COGS,CogSc/HCog,0,0,0,0,0,0,0,1,1,0,0,0,0,2,2,0,0,0,0,3,3
wi09,91,MARSHALL,COGS,CogSc/Neur,0,0,0,1,2,3,3,2,5,5,7,12,6,7,13,0,0,0,15,18,33
wi09,91,MARSHALL,COMM,Communic,0,0,0,2,21,23,3,12,15,16,32,48,17,58,75,0,0,0,38,123,161
wi09,91,MARSHALL,CSE,Comp Sci,0,0,0,3,3,6,10,2,12,18,0,18,23,4,27,0,0,0,54,9,63
wi09,91,MARSHALL,CSE,CompEngCSE,0,0,0,5,2,7,6,0,6,5,0,5,8,0,8,0,0,0,24,2,26
wi09,91,MARSHALL,CSE,CompScBinf,0,0,0,0,0,0,0,0,0,0,1,1,1,0,1,0,0,0,1,1,2
wi09,91,MARSHALL,ECE,CompEngECE,0,0,0,0,1,1,1,0,1,2,0,2,1,0,1,0,0,0,4,1,5
wi09,91,MARSHALL,ECE,Electr Eng,0,0,0,7,3,10,9,1,10,19,0,19,22,11,33,0,0,0,57,15,72
wi09,91,MARSHALL,ECE,Pr-EngPhys,0,0,0,0,0,0,2,0,2,0,0,0,0,0,0,0,0,0,2,0,2
wi09,91,MARSHALL,ECON,Ec-Mth&Ecn,0,0,0,2,3,5,3,1,4,6,6,12,3,0,3,0,0,0,14,10,24
wi09,91,MARSHALL,ECON,Econ-MgtSc,0,0,0,10,11,21,12,14,26,48,29,77,59,32,91,0,0,0,129,86,215
wi09,91,MARSHALL,ECON,Economics,0,0,0,14,17,31,23,18,41,93,32,125,95,50,145,0,0,0,225,117,342
wi09,91,MARSHALL,ESYS,EnvSys(EB),0,0,0,1,0,1,1,1,2,0,5,5,4,6,10,0,0,0,6,12,18
wi09,91,MARSHALL,ESYS,EnvSys(EC),0,0,0,0,0,0,0,0,0,0,0,0,2,0,2,0,0,0,2,0,2
wi09,91,MARSHALL,ESYS,EnvSys(EP),0,0,0,2,0,2,0,2,2,0,0,0,0,1,1,0,0,0,2,3,5
wi09,91,MARSHALL,ESYS,EnvSys(ES),0,0,0,0,0,0,0,0,0,0,0,0,1,1,2,0,0,0,1,1,2
wi09,91,MARSHALL,ETHN,Ethnic St,0,0,0,0,1,1,1,2,3,0,10,10,2,17,19,0,0,0,3,30,33
wi09,91,MARSHALL,HDP,Human Dev,0,0,0,0,0,0,1,1,2,0,15,15,1,25,26,0,0,0,2,41,43
wi09,91,MARSHALL,HDP,Pr-HumnDev,0,0,0,0,3,3,0,12,12,0,13,13,0,4,4,0,0,0,0,32,32
wi09,91,MARSHALL,HIST,History,0,0,0,1,4,5,3,5,8,12,8,20,16,18,34,0,0,0,32,35,67
wi09,91,MARSHALL,INTD,Mar Ind St,0,0,0,0,0,0,0,0,0,0,0,0,0,1,1,0,0,0,0,1,1
wi09,91,MARSHALL,INTL,Int-5yrEC,0,0,0,0,1,1,0,0,0,0,0,0,0,1,1,0,0,0,0,2,2
wi09,91,MARSHALL,INTL,IntSt-Anth,0,0,0,0,2,2,0,0,0,0,3,3,0,2,2,0,0,0,0,7,7
wi09,91,MARSHALL,INTL,IntSt-Econ,0,0,0,5,5,10,5,7,12,7,9,16,5,9,14,0,0,0,22,30,52
wi09,91,MARSHALL,INTL,IntSt-Hist,0,0,0,0,0,0,0,1,1,1,0,1,1,3,4,0,0,0,2,4,6
wi09,91,MARSHALL,INTL,IntSt-Ling,0,0,0,0,1,1,0,3,3,1,1,2,0,1,1,0,0,0,1,6,7
wi09,91,MARSHALL,INTL,IntSt-Lit,0,0,0,0,1,1,0,0,0,0,1,1,0,0,0,0,0,0,0,2,2
wi09,91,MARSHALL,INTL,IntSt-PolS,0,0,0,0,1,1,1,3,4,5,13,18,4,14,18,0,0,0,10,31,41
wi09,91,MARSHALL,INTL,IntSt-Soc,0,0,0,0,0,0,1,1,2,1,8,9,2,9,11,0,0,0,4,18,22
wi09,91,MARSHALL,JAPN,JapaneseSt,0,0,0,0,0,0,0,1,1,1,0,1,0,2,2,0,0,0,1,3,4
wi09,91,MARSHALL,JUDA,Judaic Stu,0,0,0,0,0,0,0,0,0,1,1,2,0,0,0,0,0,0,1,1,2
wi09,91,MARSHALL,LATI,LatinAm St,0,0,0,0,0,0,0,0,0,0,1,1,1,3,4,0,0,0,1,4,5
wi09,91,MARSHALL,LING,Lang Stu,0,0,0,1,1,2,0,0,0,0,1,1,0,2,2,0,0,0,1,4,5
wi09,91,MARSHALL,LING,Ling-LSoc,0,0,0,0,1,1,0,0,0,0,0,0,0,0,0,0,0,0,0,1,1
wi09,91,MARSHALL,LING,Linguistcs,0,0,0,0,1,1,0,2,2,0,0,0,1,1,2,0,0,0,1,4,5
wi09,91,MARSHALL,LIT,Lit/Compos,0,0,0,0,0,0,0,0,0,0,1,1,0,0,0,0,0,0,0,1,1
wi09,91,MARSHALL,LIT,Lit/Engl,0,0,0,1,3,4,0,1,1,4,3,7,0,5,5,0,0,0,5,12,17
wi09,91,MARSHALL,LIT,Lit/World,0,0,0,0,0,0,0,0,0,1,3,4,0,4,4,0,0,0,1,7,8
wi09,91,MARSHALL,LIT,Lit/Writng,0,0,0,0,0,0,0,1,1,2,3,5,2,3,5,0,0,0,4,7,11
wi09,91,MARSHALL,LIT,Pre-Lit/Wr,0,0,0,0,2,2,0,4,4,4,0,4,1,1,2,0,0,0,5,7,12
wi09,91,MARSHALL,LIT,Spanish Lt,0,0,0,0,0,0,0,1,1,0,1,1,0,4,4,0,0,0,0,6,6
wi09,91,MARSHALL,MAE,Aerosp Eng,0,0,0,6,1,7,4,1,5,7,2,9,21,1,22,0,0,0,38,5,43
wi09,91,MARSHALL,MAE,Engin Sci,0,0,0,0,0,0,0,0,0,0,0,0,1,0,1,0,0,0,1,0,1
wi09,91,MARSHALL,MAE,Envir Eng,0,0,0,0,1,1,1,2,3,1,2,3,0,0,0,0,0,0,2,5,7
wi09,91,MARSHALL,MAE,Mech Engin,0,0,0,11,0,11,8,3,11,28,2,30,50,4,54,0,0,0,97,9,106
wi09,91,MARSHALL,MATH,Appld Math,0,0,0,0,0,0,0,3,3,1,0,1,2,3,5,0,0,0,3,6,9
wi09,91,MARSHALL,MATH,Math/SecEd,0,0,0,0,1,1,1,2,3,1,0,1,2,1,3,0,0,0,4,4,8
wi09,91,MARSHALL,MATH,Mathematcs,0,0,0,3,3,6,3,1,4,1,3,4,3,1,4,0,0,0,10,8,18
wi09,91,MARSHALL,MATH,Mth-CompSc,0,0,0,0,0,0,1,0,1,0,0,0,0,1,1,0,0,0,1,1,2
wi09,91,MARSHALL,MATH,Mth-Mth&Ec,0,0,0,2,2,4,1,2,3,1,3,4,6,1,7,0,0,0,10,8,18
wi09,91,MARSHALL,MATH,Mth/ApldSc,0,0,0,0,2,2,0,0,0,0,0,0,1,0,1,0,0,0,1,2,3
wi09,91,MARSHALL,MATH,Pr-Math CS,0,0,0,0,0,0,0,1,1,0,0,0,0,0,0,0,0,0,0,1,1
wi09,91,MARSHALL,MATH,Prob&Stats,0,0,0,0,0,0,0,0,0,0,1,1,1,1,2,0,0,0,1,2,3
wi09,91,MARSHALL,MUS,Mu-CompArt,0,0,0,0,0,0,2,0,2,1,0,1,1,0,1,0,0,0,4,0,4
wi09,91,MARSHALL,MUS,Music,0,0,0,0,1,1,1,1,2,0,1,1,3,4,7,0,0,0,4,7,11
wi09,91,MARSHALL,MUS,Music Hum,0,0,0,0,0,0,0,0,0,0,1,1,0,1,1,0,0,0,0,2,2
wi09,91,MARSHALL,PHIL,Philosophy,0,0,0,0,1,1,0,2,2,5,2,7,4,2,6,0,0,0,9,7,16
wi09,91,MARSHALL,PHYS,Biophysics,0,0,0,1,0,1,0,0,0,0,0,0,0,0,0,0,0,0,1,0,1
wi09,91,MARSHALL,PHYS,Gen Physcs,0,0,0,0,0,0,0,0,0,0,0,0,1,1,2,0,0,0,1,1,2
wi09,91,MARSHALL,PHYS,Phy/ErthSc,0,0,0,0,0,0,1,0,1,0,0,0,0,0,0,0,0,0,1,0,1
wi09,91,MARSHALL,PHYS,Phys/Astro,0,0,0,0,0,0,0,1,1,0,0,0,2,3,5,0,0,0,2,4,6
wi09,91,MARSHALL,PHYS,Phys/Comp,0,0,0,0,0,0,0,0,0,0,0,0,1,0,1,0,0,0,1,0,1
wi09,91,MARSHALL,PHYS,Physics,0,0,0,3,0,3,0,0,0,0,0,0,3,1,4,0,0,0,6,1,7
wi09,91,MARSHALL,POLI,Polit Sci,0,0,0,4,10,14,7,6,13,35,20,55,20,18,38,0,0,0,66,54,120
wi09,91,MARSHALL,POLI,PolSc-Amer,0,0,0,0,2,2,0,0,0,1,1,2,5,1,6,0,0,0,6,4,10
wi09,91,MARSHALL,POLI,PolSc-Comp,0,0,0,0,1,1,0,0,0,1,0,1,0,2,2,0,0,0,1,3,4
wi09,91,MARSHALL,POLI,PolSc-Intl,0,0,0,3,4,7,3,11,14,19,7,26,12,14,26,0,0,0,37,36,73
wi09,91,MARSHALL,POLI,PolSc-PLaw,0,0,0,2,5,7,12,4,16,6,8,14,4,5,9,0,0,0,24,22,46
wi09,91,MARSHALL,POLI,PolSc-PPol,0,0,0,0,0,0,1,0,1,0,2,2,0,2,2,0,0,0,1,4,5
wi09,91,MARSHALL,POLI,PolSc-Thry,0,0,0,0,0,0,0,1,1,1,0,1,2,0,2,0,0,0,3,1,4
wi09,91,MARSHALL,PSYC,Psychology,0,0,0,5,31,36,7,37,44,23,60,83,27,71,98,0,0,0,62,199,261
wi09,91,MARSHALL,RELI,Relig/Stu,0,0,0,0,0,0,0,0,0,1,1,2,1,2,3,0,0,0,2,3,5
wi09,91,MARSHALL,SE,Struct Eng,0,0,0,3,5,8,8,3,11,11,8,19,15,10,25,0,0,0,37,26,63
wi09,91,MARSHALL,SOC,Sociology,0,0,0,3,7,10,1,6,7,12,28,40,13,23,36,0,0,0,29,64,93
wi09,91,MARSHALL,THEA,Theatre,0,0,0,0,1,1,0,2,2,1,4,5,3,2,5,0,0,0,4,9,13
wi09,91,MARSHALL,TWS,ThirdWldSt,0,0,0,0,0,0,0,0,0,0,0,0,0,1,1,0,0,0,0,1,1
wi09,91,MARSHALL,UNAF,UndecHumAr,0,0,0,1,5,6,1,4,5,1,0,1,0,0,0,0,0,0,3,9,12
wi09,91,MARSHALL,UNAF,Undeclared,0,0,0,26,47,73,13,23,36,1,2,3,0,0,0,0,0,0,40,72,112
wi09,91,MARSHALL,UNAF,UndecPhysS,0,0,0,2,1,3,0,0,0,0,0,0,0,0,0,0,0,0,2,1,3
wi09,91,MARSHALL,UNAF,UndecSocSc,0,0,0,2,10,12,3,8,11,0,1,1,0,0,0,0,0,0,5,19,24
wi09,91,MARSHALL,USP,Urb Stu&Pl,0,0,0,1,0,1,1,6,7,3,6,9,3,10,13,0,0,0,8,22,30
wi09,91,MARSHALL,VIS,Art Hst/Cr,0,0,0,0,0,0,0,1,1,0,5,5,0,4,4,0,0,0,0,10,10
wi09,91,MARSHALL,VIS,Media,0,0,0,2,4,6,3,8,11,5,2,7,7,4,11,0,0,0,17,18,35
wi09,91,MARSHALL,VIS,Studio VA,0,0,0,0,0,0,1,2,3,4,1,5,2,6,8,0,0,0,7,9,16
wi09,91,MARSHALL,VIS,VA-CompArt,0,0,0,1,0,1,0,1,1,0,0,0,2,0,2,0,0,0,3,1,4
wi09,91,MUIR,ANTH,Anth-Arch,0,0,0,0,0,0,1,1,2,2,3,5,3,4,7,0,0,0,6,8,14
wi09,91,MUIR,ANTH,Anth-Biol,0,0,0,0,0,0,0,0,0,3,5,8,1,11,12,0,0,0,4,16,20
wi09,91,MUIR,ANTH,Anth-Soci,0,0,0,0,1,1,1,2,3,2,2,4,4,3,7,0,0,0,7,8,15
wi09,91,MUIR,ANTH,Anthropol,0,0,0,0,0,0,0,0,0,0,0,0,0,1,1,0,0,0,0,1,1
wi09,91,MUIR,BENG,Bioen:Binf,0,0,0,0,0,0,0,0,0,0,0,0,1,0,1,0,0,0,1,0,1
wi09,91,MUIR,BENG,Bioeng:PM,0,0,0,0,0,0,0,0,0,3,2,5,16,11,27,0,0,0,19,13,32
wi09,91,MUIR,BENG,BioengBiot,0,0,0,1,1,2,3,5,8,4,2,6,8,3,11,0,0,0,16,11,27
wi09,91,MUIR,BENG,Bioengin,0,0,0,3,2,5,11,4,15,4,3,7,8,5,13,0,0,0,26,14,40
wi09,91,MUIR,BENG,Pr-BioenPM,0,0,0,7,2,9,7,3,10,3,2,5,2,0,2,0,0,0,19,7,26
wi09,91,MUIR,BIOL,Anml Physl,0,0,0,0,0,0,0,0,0,0,0,0,1,3,4,0,0,0,1,3,4
wi09,91,MUIR,BIOL,Bioc/CellB,0,1,1,6,7,13,17,23,40,30,21,51,53,60,113,0,0,0,106,112,218
wi09,91,MUIR,BIOL,Ec/Beh/Evo,0,0,0,2,3,5,0,6,6,1,9,10,3,16,19,0,0,0,6,34,40
wi09,91,MUIR,BIOL,Genl Biol,0,2,2,4,18,22,11,24,35,20,37,57,37,53,90,0,0,0,72,134,206
wi09,91,MUIR,BIOL,Human Bio,0,6,6,14,30,44,30,47,77,42,65,107,64,77,141,0,0,0,150,225,375
wi09,91,MUIR,BIOL,Microbiol,0,0,0,3,1,4,1,2,3,3,3,6,4,4,8,0,0,0,11,10,21
wi09,91,MUIR,BIOL,Molec Biol,0,0,0,2,1,3,4,6,10,5,6,11,10,6,16,0,0,0,21,19,40
wi09,91,MUIR,BIOL,PhyslNeuro,0,1,1,4,6,10,6,14,20,16,12,28,25,29,54,0,0,0,51,62,113
wi09,91,MUIR,BIOL,Pr-BioBinf,0,0,0,0,0,0,0,0,0,0,0,0,0,1,1,0,0,0,0,1,1
wi09,91,MUIR,CENG,Chem Engin,1,1,2,3,1,4,4,3,7,7,7,14,14,3,17,0,0,0,29,15,44
wi09,91,MUIR,CGS,CritGendSt,0,0,0,0,0,0,0,0,0,0,4,4,0,2,2,0,0,0,0,6,6
wi09,91,MUIR,CHEM,Bioch/Chem,0,0,0,2,3,5,8,10,18,3,7,10,25,16,41,0,0,0,38,36,74
wi09,91,MUIR,CHEM,Chem Educ,0,0,0,0,0,0,0,0,0,1,0,1,1,1,2,0,0,0,2,1,3
wi09,91,MUIR,CHEM,Chem Phys,0,0,0,0,0,0,0,0,0,1,0,1,0,0,0,0,0,0,1,0,1
wi09,91,MUIR,CHEM,Chemistry,0,0,0,0,2,2,4,1,5,1,5,6,5,6,11,0,0,0,10,14,24
wi09,91,MUIR,CHEM,Envir Chem,0,0,0,0,0,0,0,0,0,1,1,2,0,0,0,0,0,0,1,1,2
wi09,91,MUIR,CHEM,MolecSynth,0,0,0,0,0,0,0,0,0,0,0,0,2,1,3,0,0,0,2,1,3
wi09,91,MUIR,CHEM,Pharm Chem,0,1,1,3,5,8,4,7,11,8,6,14,10,14,24,0,0,0,25,33,58
wi09,91,MUIR,CHIN,Chinese St,0,0,0,0,0,0,0,0,0,0,0,0,0,3,3,0,0,0,0,3,3
wi09,91,MUIR,CLAS,Classic St,0,0,0,0,1,1,0,0,0,0,0,0,1,2,3,0,0,0,1,3,4
wi09,91,MUIR,COGS,Cog Sci,0,0,0,1,1,2,4,5,9,10,4,14,15,14,29,0,0,0,30,24,54
wi09,91,MUIR,COGS,CogSc/ClAs,0,0,0,0,1,1,0,2,2,0,0,0,2,5,7,0,0,0,2,8,10
wi09,91,MUIR,COGS,CogSc/Comp,0,0,0,0,0,0,1,0,1,1,0,1,1,0,1,0,0,0,3,0,3
wi09,91,MUIR,COGS,CogSc/HCI,0,0,0,1,0,1,0,0,0,5,1,6,8,2,10,0,0,0,14,3,17
wi09,91,MUIR,COGS,CogSc/HCog,0,0,0,0,0,0,0,1,1,0,1,1,2,1,3,0,0,0,2,3,5
wi09,91,MUIR,COGS,CogSc/Neur,0,0,0,0,1,1,3,2,5,1,5,6,7,7,14,0,0,0,11,15,26
wi09,91,MUIR,COMM,Communic,0,1,1,2,13,15,2,19,21,12,49,61,26,54,80,0,0,0,42,136,178
wi09,91,MUIR,CSE,Comp Sci,3,0,3,1,2,3,7,4,11,19,3,22,29,1,30,0,0,0,59,10,69
wi09,91,MUIR,CSE,CompEngCSE,0,0,0,4,1,5,3,2,5,3,0,3,6,0,6,0,0,0,16,3,19
wi09,91,MUIR,CSE,CompScBinf,0,0,0,0,0,0,0,0,0,0,0,0,1,0,1,0,0,0,1,0,1
wi09,91,MUIR,ECE,CompEngECE,0,0,0,2,0,2,2,1,3,2,1,3,2,0,2,0,0,0,8,2,10
wi09,91,MUIR,ECE,Electr Eng,0,1,1,5,0,5,5,0,5,7,1,8,13,6,19,0,0,0,30,8,38
wi09,91,MUIR,ECE,Engin Phys,0,0,0,0,0,0,0,0,0,1,0,1,0,0,0,0,0,0,1,0,1
wi09,91,MUIR,ECE,Pr-EngPhys,0,0,0,1,0,1,0,0,0,0,1,1,0,0,0,0,0,0,1,1,2
wi09,91,MUIR,ECON,Ec-Mth&Ecn,0,0,0,1,1,2,5,1,6,6,2,8,1,1,2,0,0,0,13,5,18
wi09,91,MUIR,ECON,Econ-MgtSc,1,1,2,5,3,8,16,6,22,31,19,50,38,33,71,0,0,0,91,62,153
wi09,91,MUIR,ECON,Economics,4,0,4,11,7,18,23,12,35,53,42,95,73,43,116,0,0,0,164,104,268
wi09,91,MUIR,ERTH,ErSc-GeoCh,0,0,0,0,0,0,0,0,0,0,1,1,0,0,0,0,0,0,0,1,1
wi09,91,MUIR,ESYS,EnvSys(EB),0,1,1,0,2,2,2,2,4,1,5,6,5,9,14,0,0,0,8,19,27
wi09,91,MUIR,ESYS,EnvSys(EC),0,0,0,0,0,0,0,1,1,0,2,2,2,1,3,0,0,0,2,4,6
wi09,91,MUIR,ESYS,EnvSys(EP),0,0,0,1,2,3,1,1,2,0,3,3,2,3,5,0,0,0,4,9,13
wi09,91,MUIR,ESYS,EnvSys(ES),0,0,0,0,0,0,0,0,0,2,0,2,3,0,3,0,0,0,5,0,5
wi09,91,MUIR,ETHN,Ethnic St,0,1,1,1,1,2,0,3,3,1,7,8,3,4,7,0,0,0,5,16,21
wi09,91,MUIR,HDP,Human Dev,0,0,0,0,0,0,0,1,1,0,11,11,1,21,22,0,0,0,1,33,34
wi09,91,MUIR,HDP,Pr-HumnDev,0,1,1,1,6,7,0,4,4,1,6,7,0,5,5,0,0,0,2,22,24
wi09,91,MUIR,HIST,History,0,2,2,1,3,4,4,2,6,5,8,13,17,10,27,0,0,0,27,25,52
wi09,91,MUIR,INTL,Int-5yrEC,0,0,0,0,0,0,0,0,0,0,1,1,0,0,0,0,0,0,0,1,1
wi09,91,MUIR,INTL,IntSt-Anth,0,0,0,0,1,1,0,0,0,1,1,2,2,4,6,0,0,0,3,6,9
wi09,91,MUIR,INTL,IntSt-Econ,0,1,1,0,2,2,1,4,5,11,8,19,6,13,19,0,0,0,18,28,46
wi09,91,MUIR,INTL,IntSt-Hist,0,0,0,0,0,0,1,1,2,1,2,3,1,2,3,0,0,0,3,5,8
wi09,91,MUIR,INTL,IntSt-Ling,0,0,0,1,0,1,0,1,1,0,1,1,1,2,3,0,0,0,2,4,6
wi09,91,MUIR,INTL,IntSt-Lit,0,0,0,0,0,0,0,3,3,1,0,1,0,1,1,0,0,0,1,4,5
wi09,91,MUIR,INTL,IntSt-PolS,0,1,1,0,0,0,4,10,14,3,12,15,5,16,21,0,0,0,12,39,51
wi09,91,MUIR,INTL,IntSt-Soc,0,0,0,0,2,2,2,0,2,1,7,8,5,6,11,0,0,0,8,15,23
wi09,91,MUIR,ITAL,Italian St,1,0,1,0,0,0,0,0,0,0,0,0,0,0,0,0,0,0,1,0,1
wi09,91,MUIR,JAPN,JapaneseSt,0,0,0,0,2,2,1,1,2,2,2,4,1,1,2,0,0,0,4,6,10
wi09,91,MUIR,LATI,LatinAm St,0,0,0,0,0,0,0,0,0,1,1,2,1,2,3,0,0,0,2,3,5
wi09,91,MUIR,LING,Lang Stu,0,0,0,0,1,1,0,0,0,1,2,3,0,2,2,0,0,0,1,5,6
wi09,91,MUIR,LING,Ling-CogLn,0,0,0,0,0,0,1,0,1,0,2,2,0,1,1,0,0,0,1,3,4
wi09,91,MUIR,LING,Ling-LSoc,0,0,0,0,0,0,0,1,1,0,0,0,0,2,2,0,0,0,0,3,3
wi09,91,MUIR,LING,Linguistcs,0,0,0,0,2,2,1,0,1,1,0,1,0,4,4,0,0,0,2,6,8
wi09,91,MUIR,LIT,French Lit,0,0,0,0,0,0,0,0,0,0,1,1,0,1,1,0,0,0,0,2,2
wi09,91,MUIR,LIT,Lit/Compos,0,0,0,0,1,1,0,0,0,0,0,0,0,1,1,0,0,0,0,2,2
wi09,91,MUIR,LIT,Lit/CultSt,0,0,0,0,0,0,0,0,0,0,1,1,0,1,1,0,0,0,0,2,2
wi09,91,MUIR,LIT,Lit/Engl,0,0,0,1,1,2,1,4,5,2,8,10,9,8,17,0,0,0,13,21,34
wi09,91,MUIR,LIT,Lit/World,0,0,0,0,0,0,1,1,2,1,4,5,2,9,11,0,0,0,4,14,18
wi09,91,MUIR,LIT,Lit/Writng,0,0,0,0,0,0,0,0,0,2,3,5,7,14,21,0,0,0,9,17,26
wi09,91,MUIR,LIT,Pre-Lit/Wr,0,0,0,1,4,5,0,4,4,5,8,13,4,4,8,0,0,0,10,20,30
wi09,91,MUIR,LIT,Spanish Lt,0,0,0,0,0,0,1,0,1,1,1,2,4,3,7,0,0,0,6,4,10
wi09,91,MUIR,MAE,Aerosp Eng,1,0,1,7,1,8,6,1,7,7,1,8,15,5,20,0,0,0,36,8,44
wi09,91,MUIR,MAE,Engin Sci,0,0,0,0,0,0,0,0,0,0,0,0,1,0,1,0,0,0,1,0,1
wi09,91,MUIR,MAE,Envir Eng,0,0,0,3,1,4,2,2,4,0,2,2,2,3,5,0,0,0,7,8,15
wi09,91,MUIR,MAE,Mech Engin,0,0,0,4,1,5,18,2,20,17,3,20,51,5,56,0,0,0,90,11,101
wi09,91,MUIR,MATH,Appld Math,0,0,0,0,1,1,2,0,2,2,2,4,2,2,4,0,0,0,6,5,11
wi09,91,MUIR,MATH,Math/SecEd,0,0,0,0,1,1,1,1,2,1,2,3,3,0,3,0,0,0,5,4,9
wi09,91,MUIR,MATH,Mathematcs,0,0,0,1,3,4,4,5,9,1,2,3,11,10,21,0,0,0,17,20,37
wi09,91,MUIR,MATH,Mth-CompSc,0,0,0,0,0,0,0,0,0,0,0,0,0,2,2,0,0,0,0,2,2
wi09,91,MUIR,MATH,Mth-Mth&Ec,0,0,0,2,1,3,0,1,1,3,3,6,4,2,6,0,0,0,9,7,16
wi09,91,MUIR,MATH,Mth-SciCom,0,0,0,0,0,0,0,0,0,0,0,0,2,0,2,0,0,0,2,0,2
wi09,91,MUIR,MATH,Mth/ApldSc,0,0,0,0,0,0,0,0,0,0,0,0,1,1,2,0,0,0,1,1,2
wi09,91,MUIR,MATH,Prob&Stats,0,0,0,1,0,1,0,0,0,0,0,0,0,0,0,0,0,0,1,0,1
wi09,91,MUIR,MUS,Mu-CompArt,0,0,0,0,0,0,2,0,2,4,1,5,3,4,7,0,0,0,9,5,14
wi09,91,MUIR,MUS,Music,0,0,0,0,0,0,1,3,4,4,4,8,4,5,9,0,0,0,9,12,21
wi09,91,MUIR,MUS,Music Hum,0,0,0,0,0,0,1,0,1,0,1,1,0,0,0,0,0,0,1,1,2
wi09,91,MUIR,PHIL,Philosophy,0,1,1,1,1,2,0,0,0,5,1,6,6,5,11,0,0,0,12,8,20
wi09,91,MUIR,PHYS,Biophysics,0,0,0,0,0,0,0,0,0,1,0,1,3,1,4,0,0,0,4,1,5
wi09,91,MUIR,PHYS,Phy/ErthSc,0,0,0,0,1,1,0,0,0,0,0,0,0,0,0,0,0,0,0,1,1
wi09,91,MUIR,PHYS,Phys/Astro,0,0,0,0,0,0,2,1,3,1,1,2,1,1,2,0,0,0,4,3,7
wi09,91,MUIR,PHYS,Phys/Mtrls,0,0,0,1,0,1,0,0,0,0,0,0,0,0,0,0,0,0,1,0,1
wi09,91,MUIR,PHYS,Physics,0,0,0,4,0,4,2,1,3,1,0,1,8,0,8,0,0,0,15,1,16
wi09,91,MUIR,POLI,Polit Sci,0,1,1,4,9,13,2,6,8,22,14,36,19,20,39,0,0,0,47,50,97
wi09,91,MUIR,POLI,PolSc-Amer,0,0,0,0,1,1,1,1,2,2,2,4,2,1,3,0,0,0,5,5,10
wi09,91,MUIR,POLI,PolSc-Comp,0,0,0,0,0,0,1,0,1,0,0,0,1,0,1,0,0,0,2,0,2
wi09,91,MUIR,POLI,PolSc-Intl,0,0,0,1,2,3,3,6,9,5,5,10,10,15,25,0,0,0,19,28,47
wi09,91,MUIR,POLI,PolSc-PLaw,1,0,1,1,1,2,2,6,8,6,7,13,9,5,14,0,0,0,19,19,38
wi09,91,MUIR,POLI,PolSc-PPol,0,0,0,1,0,1,0,1,1,3,0,3,2,0,2,0,0,0,6,1,7
wi09,91,MUIR,POLI,PolSc-Thry,0,0,0,0,0,0,0,0,0,5,1,6,3,1,4,0,0,0,8,2,10
wi09,91,MUIR,PSYC,Psychology,1,2,3,2,20,22,16,38,54,24,74,98,39,98,137,0,0,0,82,232,314
wi09,91,MUIR,RELI,Relig/Stu,0,0,0,0,0,0,1,1,2,3,0,3,1,1,2,0,0,0,5,2,7
wi09,91,MUIR,SE,Engin Sci,0,0,0,0,0,0,1,0,1,1,0,1,0,0,0,0,0,0,2,0,2
wi09,91,MUIR,SE,Struct Eng,0,0,0,7,3,10,6,3,9,10,5,15,27,9,36,0,0,0,50,20,70
wi09,91,MUIR,SIO,ErSc-Geol,0,0,0,1,0,1,0,0,0,0,0,0,0,0,0,0,0,0,1,0,1
wi09,91,MUIR,SOC,Sociology,1,0,1,1,2,3,0,5,5,2,17,19,10,22,32,0,0,0,14,46,60
wi09,91,MUIR,THEA,Dance,0,0,0,0,0,0,0,0,0,2,2,4,1,3,4,0,0,0,3,5,8
wi09,91,MUIR,THEA,Theatre,0,0,0,1,4,5,0,0,0,4,6,10,5,6,11,0,0,0,10,16,26
wi09,91,MUIR,UNAF,UndecHumAr,0,0,0,2,3,5,2,2,4,0,0,0,0,0,0,0,0,0,4,5,9
wi09,91,MUIR,UNAF,Undeclared,11,4,15,35,44,79,28,46,74,3,3,6,0,0,0,0,0,0,77,97,174
wi09,91,MUIR,UNAF,UndecPhysS,0,0,0,4,4,8,4,6,10,0,1,1,0,0,0,0,0,0,8,11,19
wi09,91,MUIR,UNAF,UndecSocSc,0,0,0,3,8,11,2,4,6,1,0,1,0,0,0,0,0,0,6,12,18
wi09,91,MUIR,USP,Urb Stu&Pl,0,1,1,0,0,0,0,3,3,5,7,12,8,5,13,0,0,0,13,16,29
wi09,91,MUIR,VIS,Art Hst/Cr,0,0,0,0,0,0,1,2,3,1,6,7,0,7,7,0,0,0,2,15,17
wi09,91,MUIR,VIS,Media,1,0,1,0,4,4,3,3,6,8,13,21,16,9,25,0,0,0,28,29,57
wi09,91,MUIR,VIS,Studio VA,0,0,0,0,0,0,0,0,0,0,4,4,1,7,8,0,0,0,1,11,12
wi09,91,MUIR,VIS,VA-CompArt,0,0,0,2,1,3,1,0,1,4,2,6,5,3,8,0,0,0,12,6,18
wi09,91,REVELLE,ANTH,Anth-Arch,0,0,0,0,0,0,0,0,0,0,0,0,0,2,2,0,0,0,0,2,2
wi09,91,REVELLE,ANTH,Anth-Biol,0,0,0,0,0,0,0,0,0,2,1,3,1,2,3,0,0,0,3,3,6
wi09,91,REVELLE,ANTH,Anth-Soci,0,1,1,0,0,0,1,1,2,1,5,6,1,2,3,0,0,0,3,9,12
wi09,91,REVELLE,ANTH,Anthropol,0,0,0,0,0,0,0,0,0,0,0,0,0,1,1,0,0,0,0,1,1
wi09,91,REVELLE,BENG,Bioen:Binf,0,0,0,0,0,0,0,0,0,0,0,0,1,0,1,0,0,0,1,0,1
wi09,91,REVELLE,BENG,Bioeng:PM,0,0,0,0,0,0,0,1,1,13,7,20,27,16,43,0,0,0,40,24,64
wi09,91,REVELLE,BENG,BioengBiot,0,0,0,2,3,5,5,1,6,3,3,6,16,8,24,0,0,0,26,15,41
wi09,91,REVELLE,BENG,Bioengin,0,0,0,2,1,3,8,2,10,5,4,9,12,7,19,0,0,0,27,14,41
wi09,91,REVELLE,BENG,Pr-BioenBf,0,0,0,0,0,0,0,0,0,0,0,0,1,0,1,0,0,0,1,0,1
wi09,91,REVELLE,BENG,Pr-BioenPM,0,0,0,11,3,14,13,8,21,8,2,10,1,0,1,0,0,0,33,13,46
wi09,91,REVELLE,BIOL,Anml Physl,0,0,0,0,0,0,0,0,0,0,0,0,1,4,5,0,0,0,1,4,5
wi09,91,REVELLE,BIOL,Bioc/CellB,0,2,2,11,14,25,29,30,59,53,53,106,75,85,160,0,0,0,168,184,352
wi09,91,REVELLE,BIOL,BiolBioinf,0,0,0,0,0,0,0,0,0,0,0,0,1,0,1,0,0,0,1,0,1
wi09,91,REVELLE,BIOL,Ec/Beh/Evo,1,0,1,0,0,0,1,4,5,5,6,11,5,3,8,0,0,0,12,13,25
wi09,91,REVELLE,BIOL,Genl Biol,1,2,3,12,16,28,22,34,56,22,44,66,48,80,128,0,0,0,105,176,281
wi09,91,REVELLE,BIOL,Human Bio,4,9,13,20,50,70,48,71,119,55,89,144,86,105,191,0,1,1,213,325,538
wi09,91,REVELLE,BIOL,Microbiol,1,0,1,1,1,2,5,4,9,5,5,10,5,12,17,0,0,0,17,22,39
wi09,91,REVELLE,BIOL,Molec Biol,0,2,2,1,0,1,5,4,9,18,7,25,13,17,30,0,0,0,37,30,67
wi09,91,REVELLE,BIOL,PhyslNeuro,0,1,1,4,7,11,16,23,39,18,20,38,19,35,54,0,0,0,57,86,143
wi09,91,REVELLE,CENG,Chem Engin,0,0,0,3,0,3,7,4,11,13,6,19,11,8,19,0,0,0,34,18,52
wi09,91,REVELLE,CGS,CritGendSt,0,0,0,0,0,0,0,0,0,0,0,0,0,3,3,0,0,0,0,3,3
wi09,91,REVELLE,CHEM,Bioch/Chem,0,0,0,5,8,13,9,11,20,11,16,27,21,28,49,0,0,0,46,63,109
wi09,91,REVELLE,CHEM,Chem Phys,0,0,0,0,0,0,0,0,0,0,0,0,5,0,5,0,0,0,5,0,5
wi09,91,REVELLE,CHEM,Chemistry,0,0,0,0,6,6,0,4,4,10,4,14,8,10,18,0,0,0,18,24,42
wi09,91,REVELLE,CHEM,Envir Chem,0,0,0,0,0,0,0,0,0,1,0,1,0,1,1,0,0,0,1,1,2
wi09,91,REVELLE,CHEM,MolecSynth,0,0,0,0,0,0,0,0,0,1,0,1,1,2,3,0,0,0,2,2,4
wi09,91,REVELLE,CHEM,Pharm Chem,2,0,2,6,9,15,4,9,13,7,18,25,17,27,44,0,0,0,36,63,99
wi09,91,REVELLE,CHIN,Chinese St,0,0,0,0,0,0,0,0,0,0,0,0,0,3,3,0,0,0,0,3,3
wi09,91,REVELLE,CLAS,Classic St,0,0,0,0,1,1,0,0,0,0,0,0,1,0,1,0,0,0,1,1,2
wi09,91,REVELLE,COGS,Cog Sci,0,0,0,0,4,4,1,3,4,2,4,6,3,3,6,0,0,0,6,14,20
wi09,91,REVELLE,COGS,CogSc/ClAs,0,1,1,0,0,0,0,1,1,2,0,2,0,0,0,0,0,0,2,2,4
wi09,91,REVELLE,COGS,CogSc/HCI,0,0,0,0,0,0,0,0,0,1,1,2,5,1,6,0,0,0,6,2,8
wi09,91,REVELLE,COGS,CogSc/HCog,0,0,0,0,1,1,0,0,0,0,1,1,1,2,3,0,0,0,1,4,5
wi09,91,REVELLE,COGS,CogSc/Neur,1,0,1,0,0,0,1,3,4,1,2,3,3,7,10,0,0,0,6,12,18
wi09,91,REVELLE,COMM,Communic,0,1,1,0,5,5,2,5,7,7,17,24,9,19,28,0,0,0,18,47,65
wi09,91,REVELLE,CSE,Comp Sci,1,0,1,6,1,7,7,2,9,13,2,15,22,2,24,0,0,0,49,7,56
wi09,91,REVELLE,CSE,CompEngCSE,1,0,1,4,0,4,9,1,10,5,0,5,2,0,2,0,0,0,21,1,22
wi09,91,REVELLE,CSE,CompScBinf,0,0,0,0,0,0,0,0,0,2,0,2,2,0,2,0,0,0,4,0,4
wi09,91,REVELLE,ECE,CompEngECE,0,0,0,1,0,1,1,0,1,2,0,2,2,0,2,0,0,0,6,0,6
wi09,91,REVELLE,ECE,Electr Eng,0,0,0,1,1,2,3,0,3,12,0,12,33,3,36,0,0,0,49,4,53
wi09,91,REVELLE,ECE,Engin Phys,0,0,0,0,0,0,0,0,0,1,0,1,1,0,1,0,0,0,2,0,2
wi09,91,REVELLE,ECE,Pr-EngPhys,0,0,0,0,0,0,0,0,0,1,0,1,0,0,0,0,0,0,1,0,1
wi09,91,REVELLE,ECON,Ec-Mth&Ecn,1,0,1,2,0,2,1,0,1,3,1,4,3,2,5,0,0,0,10,3,13
wi09,91,REVELLE,ECON,Econ-MgtSc,0,0,0,3,1,4,8,10,18,21,11,32,31,30,61,0,0,0,63,52,115
wi09,91,REVELLE,ECON,Economics,4,3,7,6,6,12,9,4,13,33,16,49,41,24,65,0,0,0,93,53,146
wi09,91,REVELLE,ERTH,ErSc-GeoPh,0,0,0,0,0,0,0,0,0,0,0,0,1,0,1,0,0,0,1,0,1
wi09,91,REVELLE,ERTH,ErthSc-Phy,0,0,0,0,0,0,0,0,0,0,0,0,1,0,1,0,0,0,1,0,1
wi09,91,REVELLE,ESYS,EnvSys(EB),0,0,0,0,0,0,0,0,0,0,2,2,4,6,10,0,0,0,4,8,12
wi09,91,REVELLE,ESYS,EnvSys(EC),0,0,0,0,0,0,0,0,0,1,0,1,0,0,0,0,0,0,1,0,1
wi09,91,REVELLE,ESYS,EnvSys(EP),0,0,0,1,0,1,1,0,1,1,1,2,1,1,2,0,0,0,4,2,6
wi09,91,REVELLE,ESYS,EnvSys(ES),0,0,0,0,0,0,0,0,0,0,0,0,2,2,4,0,0,0,2,2,4
wi09,91,REVELLE,ETHN,Ethnic St,0,0,0,0,1,1,0,0,0,1,0,1,0,2,2,0,0,0,1,3,4
wi09,91,REVELLE,HDP,Human Dev,0,0,0,0,0,0,0,0,0,1,2,3,2,13,15,0,0,0,3,15,18
wi09,91,REVELLE,HDP,Pr-HumnDev,0,0,0,0,1,1,0,4,4,0,9,9,1,5,6,0,0,0,1,19,20
wi09,91,REVELLE,HIST,History,1,0,1,0,0,0,2,2,4,6,3,9,11,5,16,0,0,0,20,10,30
wi09,91,REVELLE,INTD,Rev Ind Mj,0,0,0,0,0,0,0,0,0,0,0,0,0,1,1,0,0,0,0,1,1
wi09,91,REVELLE,INTL,IntSt-Anth,0,0,0,0,0,0,0,1,1,0,0,0,0,1,1,0,0,0,0,2,2
wi09,91,REVELLE,INTL,IntSt-Econ,0,1,1,0,5,5,3,1,4,4,7,11,4,4,8,0,0,0,11,18,29
wi09,91,REVELLE,INTL,IntSt-Hist,0,0,0,0,0,0,0,0,0,1,0,1,1,2,3,0,0,0,2,2,4
wi09,91,REVELLE,INTL,IntSt-Ling,0,0,0,0,0,0,1,2,3,0,0,0,0,1,1,0,0,0,1,3,4
wi09,91,REVELLE,INTL,IntSt-Lit,0,0,0,0,0,0,0,0,0,0,0,0,0,1,1,0,0,0,0,1,1
wi09,91,REVELLE,INTL,IntSt-PolS,1,1,2,0,0,0,0,0,0,2,3,5,1,10,11,0,0,0,4,14,18
wi09,91,REVELLE,INTL,IntSt-Soc,0,0,0,0,0,0,0,2,2,0,2,2,0,2,2,0,0,0,0,6,6
wi09,91,REVELLE,ITAL,Italian St,0,0,0,0,0,0,0,0,0,0,0,0,0,1,1,0,0,0,0,1,1
wi09,91,REVELLE,JAPN,JapaneseSt,0,0,0,0,0,0,0,0,0,0,0,0,3,0,3,0,0,0,3,0,3
wi09,91,REVELLE,LATI,LatinAm St,0,0,0,1,0,1,0,0,0,0,0,0,0,0,0,0,0,0,1,0,1
wi09,91,REVELLE,LING,Lang Stu,0,0,0,0,1,1,0,1,1,0,1,1,0,1,1,0,0,0,0,4,4
wi09,91,REVELLE,LING,Ling-CogLn,0,0,0,0,0,0,0,0,0,0,0,0,1,1,2,0,0,0,1,1,2
wi09,91,REVELLE,LING,Ling-LSoc,0,0,0,0,0,0,0,1,1,0,0,0,0,0,0,0,0,0,0,1,1
wi09,91,REVELLE,LING,Linguistcs,0,0,0,0,1,1,0,1,1,2,0,2,1,0,1,0,0,0,3,2,5
wi09,91,REVELLE,LIT,Ital Lit,0,0,0,0,0,0,0,0,0,0,0,0,0,1,1,0,0,0,0,1,1
wi09,91,REVELLE,LIT,Lit/Compos,0,0,0,0,0,0,0,2,2,0,0,0,0,0,0,0,0,0,0,2,2
wi09,91,REVELLE,LIT,Lit/Engl,0,0,0,0,0,0,0,1,1,0,2,2,2,8,10,0,0,0,2,11,13
wi09,91,REVELLE,LIT,Lit/World,0,0,0,0,0,0,1,0,1,1,3,4,1,1,2,0,0,0,3,4,7
wi09,91,REVELLE,LIT,Lit/Writng,0,0,0,0,0,0,0,0,0,0,1,1,4,10,14,0,0,0,4,11,15
wi09,91,REVELLE,LIT,Pre-Lit/Wr,0,1,1,2,2,4,3,2,5,1,1,2,3,1,4,0,0,0,9,7,16
wi09,91,REVELLE,LIT,Russian Lt,0,1,1,0,0,0,0,0,0,0,0,0,0,0,0,0,0,0,0,1,1
wi09,91,REVELLE,LIT,Spanish Lt,0,0,0,0,0,0,0,2,2,0,1,1,0,2,2,0,0,0,0,5,5
wi09,91,REVELLE,MAE,Aerosp Eng,0,0,0,10,0,10,8,5,13,6,0,6,28,5,33,0,0,0,52,10,62
wi09,91,REVELLE,MAE,Engin Sci,0,0,0,0,1,1,0,0,0,1,0,1,0,0,0,0,0,0,1,1,2
wi09,91,REVELLE,MAE,Envir Eng,0,0,0,0,0,0,1,0,1,2,1,3,1,2,3,0,0,0,4,3,7
wi09,91,REVELLE,MAE,Mech Engin,0,0,0,8,1,9,12,5,17,21,2,23,50,10,60,0,0,0,91,18,109
wi09,91,REVELLE,MATH,Appld Math,0,0,0,0,0,0,0,2,2,1,4,5,1,1,2,0,0,0,2,7,9
wi09,91,REVELLE,MATH,Math/SecEd,0,0,0,0,1,1,2,1,3,0,1,1,0,2,2,0,0,0,2,5,7
wi09,91,REVELLE,MATH,Mathematcs,1,0,1,1,0,1,2,2,4,8,4,12,8,8,16,0,0,0,20,14,34
wi09,91,REVELLE,MATH,Mth-CompSc,0,0,0,0,0,0,0,0,0,0,0,0,1,0,1,0,0,0,1,0,1
wi09,91,REVELLE,MATH,Mth-Mth&Ec,0,0,0,1,0,1,2,1,3,3,0,3,6,0,6,0,0,0,12,1,13
wi09,91,REVELLE,MATH,Mth-SciCom,0,0,0,0,0,0,1,0,1,0,1,1,1,1,2,0,0,0,2,2,4
wi09,91,REVELLE,MATH,Mth/ApldSc,0,1,1,1,0,1,1,1,2,0,0,0,0,0,0,0,0,0,2,2,4
wi09,91,REVELLE,MATH,Pr-Math CS,0,0,0,0,0,0,1,0,1,2,0,2,0,0,0,0,0,0,3,0,3
wi09,91,REVELLE,MATH,Prob&Stats,0,0,0,0,0,0,1,0,1,0,0,0,0,0,0,0,0,0,1,0,1
wi09,91,REVELLE,MUS,Mu-CompArt,0,0,0,0,0,0,1,0,1,0,0,0,4,0,4,0,0,0,5,0,5
wi09,91,REVELLE,MUS,Music,0,0,0,1,0,1,1,0,1,0,0,0,2,1,3,0,0,0,4,1,5
wi09,91,REVELLE,MUS,Music Hum,0,0,0,0,0,0,0,0,0,0,0,0,1,0,1,0,0,0,1,0,1
wi09,91,REVELLE,PHIL,Philosophy,1,0,1,0,0,0,3,2,5,3,2,5,1,2,3,0,0,0,8,6,14
wi09,91,REVELLE,PHYS,Biophysics,0,0,0,0,0,0,0,0,0,0,1,1,1,0,1,0,0,0,1,1,2
wi09,91,REVELLE,PHYS,Gen Physcs,0,0,0,0,0,0,1,0,1,0,0,0,0,0,0,0,0,0,1,0,1
wi09,91,REVELLE,PHYS,Phy/ErthSc,0,0,0,0,1,1,1,0,1,0,0,0,0,0,0,0,0,0,1,1,2
wi09,91,REVELLE,PHYS,Phys/Astro,0,0,0,0,0,0,0,0,0,1,1,2,3,3,6,0,0,0,4,4,8
wi09,91,REVELLE,PHYS,Phys/Comp,0,0,0,0,0,0,1,0,1,0,0,0,0,0,0,0,0,0,1,0,1
wi09,91,REVELLE,PHYS,Phys/Mtrls,0,0,0,0,0,0,0,0,0,0,0,0,1,0,1,0,0,0,1,0,1
wi09,91,REVELLE,PHYS,Physics,0,0,0,3,0,3,2,0,2,5,1,6,5,2,7,0,0,0,15,3,18
wi09,91,REVELLE,POLI,Polit Sci,0,1,1,0,3,3,2,2,4,7,5,12,10,6,16,0,0,0,19,17,36
wi09,91,REVELLE,POLI,PolSc-Amer,0,0,0,0,0,0,1,0,1,0,4,4,2,2,4,0,0,0,3,6,9
wi09,91,REVELLE,POLI,PolSc-Comp,0,0,0,0,0,0,0,0,0,0,0,0,1,0,1,0,0,0,1,0,1
wi09,91,REVELLE,POLI,PolSc-Intl,0,0,0,1,1,2,1,1,2,5,6,11,10,2,12,0,0,0,17,10,27
wi09,91,REVELLE,POLI,PolSc-PLaw,0,0,0,0,0,0,2,3,5,0,4,4,1,4,5,0,0,0,3,11,14
wi09,91,REVELLE,POLI,PolSc-PPol,0,0,0,0,0,0,0,3,3,1,1,2,0,0,0,0,0,0,1,4,5
wi09,91,REVELLE,POLI,PolSc-Thry,0,0,0,0,0,0,0,0,0,0,0,0,0,1,1,0,0,0,0,1,1
wi09,91,REVELLE,PSYC,Psychology,1,1,2,3,17,20,11,24,35,20,54,74,31,78,109,0,0,0,66,174,240
wi09,91,REVELLE,SE,Engin Sci,0,0,0,0,0,0,0,0,0,0,0,0,1,0,1,0,0,0,1,0,1
wi09,91,REVELLE,SE,Struct Eng,0,0,0,6,3,9,8,4,12,12,4,16,22,7,29,0,0,0,48,18,66
wi09,91,REVELLE,SIO,ErSc-Geol,0,0,0,0,0,0,0,0,0,0,0,0,1,1,2,0,0,0,1,1,2
wi09,91,REVELLE,SOC,Sociology,0,0,0,1,3,4,0,2,2,2,10,12,2,8,10,0,0,0,5,23,28
wi09,91,REVELLE,THEA,Dance,0,0,0,0,2,2,0,0,0,0,2,2,1,0,1,0,0,0,1,4,5
wi09,91,REVELLE,THEA,Theatre,0,0,0,0,0,0,0,1,1,2,0,2,1,3,4,0,0,0,3,4,7
wi09,91,REVELLE,UNAF,Limited St,0,0,0,0,0,0,0,0,0,0,0,0,0,0,0,8,12,20,8,12,20
wi09,91,REVELLE,UNAF,Spec-Emply,0,0,0,0,0,0,0,0,0,0,0,0,0,0,0,5,2,7,5,2,7
wi09,91,REVELLE,UNAF,UndecHumAr,0,1,1,0,3,3,0,6,6,1,0,1,0,0,0,0,0,0,1,10,11
wi09,91,REVELLE,UNAF,Undeclared,2,7,9,20,29,49,28,22,50,2,2,4,0,0,0,0,0,0,52,60,112
wi09,91,REVELLE,UNAF,UndecPhysS,2,0,2,1,2,3,2,0,2,0,1,1,0,0,0,0,0,0,5,3,8
wi09,91,REVELLE,UNAF,UndecSocSc,1,2,3,3,0,3,2,2,4,0,0,0,0,0,0,0,0,0,6,4,10
wi09,91,REVELLE,USP,Urb Stu&Pl,0,0,0,0,0,0,0,0,0,2,0,2,5,4,9,0,0,0,7,4,11
wi09,91,REVELLE,VIS,Art Hst/Cr,0,0,0,1,0,1,0,1,1,0,2,2,1,4,5,0,0,0,2,7,9
wi09,91,REVELLE,VIS,Media,0,0,0,0,0,0,1,1,2,2,4,6,4,4,8,0,0,0,7,9,16
wi09,91,REVELLE,VIS,Studio VA,0,2,2,0,1,1,0,1,1,0,0,0,1,5,6,0,0,0,1,9,10
wi09,91,REVELLE,VIS,VA-CompArt,0,0,0,1,0,1,1,0,1,0,0,0,0,0,0,0,0,0,2,0,2
wi09,91,ROOSEVELT,ANTH,Anth-Arch,0,0,0,0,2,2,0,5,5,4,3,7,0,7,7,0,0,0,4,17,21
wi09,91,ROOSEVELT,ANTH,Anth-Biol,0,0,0,1,2,3,0,1,1,0,3,3,1,10,11,0,0,0,2,16,18
wi09,91,ROOSEVELT,ANTH,Anth-Soci,0,0,0,0,1,1,0,0,0,0,3,3,0,3,3,0,0,0,0,7,7
wi09,91,ROOSEVELT,ANTH,Anthropol,0,0,0,0,0,0,0,0,0,0,1,1,0,2,2,0,0,0,0,3,3
wi09,91,ROOSEVELT,BENG,Bioeng:PM,0,0,0,0,0,0,0,0,0,3,1,4,5,5,10,0,0,0,8,6,14
wi09,91,ROOSEVELT,BENG,BioengBiot,0,0,0,1,0,1,1,3,4,0,1,1,4,2,6,0,0,0,6,6,12
wi09,91,ROOSEVELT,BENG,Bioengin,0,0,0,2,0,2,2,1,3,3,1,4,4,1,5,0,0,0,11,3,14
wi09,91,ROOSEVELT,BENG,Pr-BioenBf,0,0,0,0,0,0,0,1,1,0,0,0,0,0,0,0,0,0,0,1,1
wi09,91,ROOSEVELT,BENG,Pr-BioenPM,0,0,0,5,4,9,8,6,14,3,1,4,1,0,1,0,0,0,17,11,28
wi09,91,ROOSEVELT,BIOL,Anml Physl,0,0,0,0,0,0,0,0,0,0,1,1,1,0,1,0,0,0,1,1,2
wi09,91,ROOSEVELT,BIOL,Bioc/CellB,0,0,0,6,5,11,10,14,24,12,17,29,23,34,57,0,0,0,51,70,121
wi09,91,ROOSEVELT,BIOL,Ec/Beh/Evo,0,0,0,1,3,4,1,1,2,1,7,8,5,4,9,0,0,0,8,15,23
wi09,91,ROOSEVELT,BIOL,Genl Biol,0,0,0,3,8,11,9,12,21,18,25,43,22,36,58,0,0,0,52,81,133
wi09,91,ROOSEVELT,BIOL,Human Bio,0,0,0,10,38,48,22,47,69,22,42,64,27,53,80,0,0,0,81,180,261
wi09,91,ROOSEVELT,BIOL,Microbiol,0,0,0,1,0,1,1,1,2,2,1,3,1,5,6,0,0,0,5,7,12
wi09,91,ROOSEVELT,BIOL,Molec Biol,0,0,0,0,3,3,2,3,5,2,7,9,8,7,15,0,0,0,12,20,32
wi09,91,ROOSEVELT,BIOL,PhyslNeuro,0,0,0,3,4,7,4,9,13,8,7,15,10,17,27,0,0,0,25,37,62
wi09,91,ROOSEVELT,CENG,Chem Engin,0,0,0,3,1,4,1,1,2,1,4,5,1,5,6,0,0,0,6,11,17
wi09,91,ROOSEVELT,CGS,CritGendSt,0,0,0,0,0,0,0,0,0,0,1,1,0,2,2,0,0,0,0,3,3
wi09,91,ROOSEVELT,CHEM,Bioch/Chem,0,0,0,2,3,5,2,8,10,9,4,13,5,7,12,0,0,0,18,22,40
wi09,91,ROOSEVELT,CHEM,Chem Phys,0,0,0,0,0,0,0,0,0,0,0,0,1,0,1,0,0,0,1,0,1
wi09,91,ROOSEVELT,CHEM,Chemistry,0,0,0,2,0,2,2,3,5,2,0,2,3,1,4,0,0,0,9,4,13
wi09,91,ROOSEVELT,CHEM,Envir Chem,0,0,0,0,0,0,1,0,1,1,0,1,0,1,1,0,0,0,2,1,3
wi09,91,ROOSEVELT,CHEM,MolecSynth,0,0,0,0,0,0,0,0,0,0,0,0,1,0,1,0,0,0,1,0,1
wi09,91,ROOSEVELT,CHEM,Pharm Chem,0,0,0,1,10,11,1,3,4,2,2,4,9,5,14,0,0,0,13,20,33
wi09,91,ROOSEVELT,CHEM,Pr-Bioinf,0,0,0,0,0,0,0,0,0,1,0,1,0,0,0,0,0,0,1,0,1
wi09,91,ROOSEVELT,CHIN,Chinese St,0,0,0,0,1,1,0,0,0,1,0,1,4,2,6,0,0,0,5,3,8
wi09,91,ROOSEVELT,CLAS,Classic St,0,0,0,0,0,0,0,1,1,0,0,0,2,0,2,0,0,0,2,1,3
wi09,91,ROOSEVELT,COGS,Cog Sci,0,0,0,0,0,0,2,7,9,2,4,6,2,6,8,0,0,0,6,17,23
wi09,91,ROOSEVELT,COGS,CogSc/Comp,0,0,0,1,0,1,0,0,0,1,1,2,0,1,1,0,0,0,2,2,4
wi09,91,ROOSEVELT,COGS,CogSc/HCI,0,0,0,0,0,0,1,0,1,1,0,1,1,5,6,0,0,0,3,5,8
wi09,91,ROOSEVELT,COGS,CogSc/HCog,0,0,0,0,0,0,0,1,1,0,0,0,1,1,2,0,0,0,1,2,3
wi09,91,ROOSEVELT,COGS,CogSc/Neur,0,0,0,0,5,5,1,0,1,2,8,10,1,4,5,0,0,0,4,17,21
wi09,91,ROOSEVELT,COMM,Communic,0,0,0,5,17,22,5,16,21,23,54,77,11,50,61,0,0,0,44,137,181
wi09,91,ROOSEVELT,CSE,Comp Sci,0,0,0,8,1,9,5,1,6,12,0,12,19,4,23,0,0,0,44,6,50
wi09,91,ROOSEVELT,CSE,CompEngCSE,0,0,0,1,1,2,2,2,4,3,0,3,3,1,4,0,0,0,9,4,13
wi09,91,ROOSEVELT,CSE,Pr-Comp Sc,0,0,0,0,0,0,0,1,1,0,0,0,0,0,0,0,0,0,0,1,1
wi09,91,ROOSEVELT,ECE,CompEngECE,0,0,0,1,0,1,1,0,1,1,0,1,0,0,0,0,0,0,3,0,3
wi09,91,ROOSEVELT,ECE,Electr Eng,0,0,0,4,2,6,2,2,4,7,2,9,20,4,24,0,0,0,33,10,43
wi09,91,ROOSEVELT,ECE,Pr-EngPhys,0,0,0,2,0,2,1,0,1,0,0,0,0,0,0,0,0,0,3,0,3
wi09,91,ROOSEVELT,ECON,Ec-Mth&Ecn,0,0,0,1,1,2,3,0,3,1,1,2,1,4,5,0,0,0,6,6,12
wi09,91,ROOSEVELT,ECON,Econ-MgtSc,0,0,0,9,9,18,13,4,17,31,22,53,43,31,74,0,0,0,96,66,162
wi09,91,ROOSEVELT,ECON,Economics,0,0,0,22,12,34,12,12,24,51,26,77,57,35,92,0,0,0,142,85,227
wi09,91,ROOSEVELT,ERTH,ErSc-Geol,0,0,0,0,0,0,0,0,0,0,1,1,1,0,1,0,0,0,1,1,2
wi09,91,ROOSEVELT,ESYS,EnvSys(EB),0,0,0,0,4,4,0,4,4,1,1,2,3,3,6,0,0,0,4,12,16
wi09,91,ROOSEVELT,ESYS,EnvSys(EC),0,0,0,0,0,0,0,0,0,0,0,0,2,2,4,0,0,0,2,2,4
wi09,91,ROOSEVELT,ESYS,EnvSys(EP),0,0,0,0,2,2,1,3,4,0,3,3,0,0,0,0,0,0,1,8,9
wi09,91,ROOSEVELT,ESYS,EnvSys(ES),0,0,0,0,1,1,1,1,2,3,0,3,2,2,4,0,0,0,6,4,10
wi09,91,ROOSEVELT,ETHN,Ethnic St,0,0,0,0,0,0,0,3,3,0,4,4,2,11,13,0,0,0,2,18,20
wi09,91,ROOSEVELT,GMST,German Stu,0,0,0,0,0,0,0,0,0,0,1,1,0,0,0,0,0,0,0,1,1
wi09,91,ROOSEVELT,HDP,Human Dev,0,0,0,0,0,0,0,0,0,0,10,10,3,15,18,0,0,0,3,25,28
wi09,91,ROOSEVELT,HDP,Pr-HumnDev,0,0,0,0,0,0,0,7,7,0,4,4,2,5,7,0,0,0,2,16,18
wi09,91,ROOSEVELT,HIST,History,0,0,0,2,2,4,5,7,12,14,16,30,18,21,39,0,0,0,39,46,85
wi09,91,ROOSEVELT,INTL,IntSt-Anth,0,0,0,0,1,1,0,4,4,0,3,3,0,8,8,0,0,0,0,16,16
wi09,91,ROOSEVELT,INTL,IntSt-Econ,0,0,0,5,10,15,6,20,26,21,29,50,12,27,39,0,0,0,44,86,130
wi09,91,ROOSEVELT,INTL,IntSt-Hist,0,0,0,2,2,4,1,5,6,1,4,5,1,5,6,0,0,0,5,16,21
wi09,91,ROOSEVELT,INTL,IntSt-Ling,0,0,0,0,3,3,0,0,0,1,3,4,0,5,5,0,0,0,1,11,12
wi09,91,ROOSEVELT,INTL,IntSt-Lit,0,0,0,0,0,0,0,1,1,0,1,1,0,2,2,0,0,0,0,4,4
wi09,91,ROOSEVELT,INTL,IntSt-PolS,0,0,0,2,7,9,1,18,19,15,25,40,16,45,61,0,0,0,34,95,129
wi09,91,ROOSEVELT,INTL,IntSt-Soc,0,0,0,0,9,9,0,11,11,1,20,21,2,12,14,0,0,0,3,52,55
wi09,91,ROOSEVELT,JAPN,JapaneseSt,0,0,0,0,1,1,0,1,1,1,1,2,3,5,8,0,0,0,4,8,12
wi09,91,ROOSEVELT,JUDA,Judaic Stu,0,0,0,0,0,0,1,0,1,0,1,1,0,0,0,0,0,0,1,1,2
wi09,91,ROOSEVELT,LATI,LatinAm St,0,0,0,0,0,0,0,0,0,0,2,2,0,1,1,0,0,0,0,3,3
wi09,91,ROOSEVELT,LING,Lang Stu,0,0,0,0,1,1,0,1,1,0,2,2,2,1,3,0,0,0,2,5,7
wi09,91,ROOSEVELT,LING,Ling-LSoc,0,0,0,1,0,1,0,1,1,1,1,2,0,1,1,0,0,0,2,3,5
wi09,91,ROOSEVELT,LING,Linguistcs,0,0,0,0,0,0,0,3,3,1,1,2,4,5,9,0,0,0,5,9,14
wi09,91,ROOSEVELT,LIT,French Lit,0,0,0,0,0,0,0,0,0,0,0,0,0,1,1,0,0,0,0,1,1
wi09,91,ROOSEVELT,LIT,Lit/Compos,0,0,0,0,1,1,1,1,2,0,1,1,0,0,0,0,0,0,1,3,4
wi09,91,ROOSEVELT,LIT,Lit/CultSt,0,0,0,0,0,0,0,1,1,0,0,0,0,1,1,0,0,0,0,2,2
wi09,91,ROOSEVELT,LIT,Lit/Engl,0,0,0,1,5,6,1,3,4,2,5,7,2,6,8,0,0,0,6,19,25
wi09,91,ROOSEVELT,LIT,Lit/World,0,0,0,0,0,0,0,1,1,1,1,2,0,4,4,0,0,0,1,6,7
wi09,91,ROOSEVELT,LIT,Lit/Writng,0,0,0,0,0,0,0,0,0,0,2,2,4,5,9,0,0,0,4,7,11
wi09,91,ROOSEVELT,LIT,Pre-Lit/Wr,0,0,0,1,5,6,4,6,10,1,6,7,1,3,4,0,0,0,7,20,27
wi09,91,ROOSEVELT,LIT,Spanish Lt,0,0,0,0,0,0,0,0,0,0,2,2,1,2,3,0,0,0,1,4,5
wi09,91,ROOSEVELT,MAE,Aerosp Eng,0,0,0,3,0,3,8,3,11,4,1,5,9,4,13,0,0,0,24,8,32
wi09,91,ROOSEVELT,MAE,Engin Sci,0,0,0,0,0,0,1,0,1,0,0,0,1,0,1,0,0,0,2,0,2
wi09,91,ROOSEVELT,MAE,Envir Eng,0,0,0,3,0,3,0,0,0,2,1,3,0,0,0,0,0,0,5,1,6
wi09,91,ROOSEVELT,MAE,Mech Engin,0,0,0,12,1,13,7,1,8,10,1,11,23,11,34,0,0,0,52,14,66
wi09,91,ROOSEVELT,MATH,Appld Math,0,0,0,2,0,2,0,0,0,0,1,1,3,0,3,0,0,0,5,1,6
wi09,91,ROOSEVELT,MATH,Math/SecEd,0,0,0,0,1,1,0,0,0,0,0,0,1,1,2,0,0,0,1,2,3
wi09,91,ROOSEVELT,MATH,Mathematcs,0,0,0,2,1,3,0,1,1,2,3,5,5,3,8,0,0,0,9,8,17
wi09,91,ROOSEVELT,MATH,Mth-CompSc,0,0,0,0,0,0,0,0,0,1,0,1,1,1,2,0,0,0,2,1,3
wi09,91,ROOSEVELT,MATH,Mth-Mth&Ec,0,0,0,3,0,3,0,0,0,0,1,1,4,4,8,0,0,0,7,5,12
wi09,91,ROOSEVELT,MATH,Mth-SciCom,0,0,0,0,0,0,0,0,0,0,0,0,0,1,1,0,0,0,0,1,1
wi09,91,ROOSEVELT,MATH,Mth/ApldSc,0,0,0,0,0,0,0,0,0,0,0,0,2,1,3,0,0,0,2,1,3
wi09,91,ROOSEVELT,MATH,Pr-Math CS,0,0,0,1,0,1,0,0,0,0,2,2,0,0,0,0,0,0,1,2,3
wi09,91,ROOSEVELT,MATH,Prob&Stats,0,0,0,1,0,1,0,0,0,0,1,1,0,0,0,0,0,0,1,1,2
wi09,91,ROOSEVELT,MUS,Mu-CompArt,0,0,0,0,1,1,0,0,0,6,0,6,3,1,4,0,0,0,9,2,11
wi09,91,ROOSEVELT,MUS,Music,0,0,0,1,0,1,1,0,1,2,3,5,1,0,1,0,0,0,5,3,8
wi09,91,ROOSEVELT,PHIL,Philosophy,0,0,0,1,0,1,1,1,2,2,2,4,2,0,2,0,0,0,6,3,9
wi09,91,ROOSEVELT,PHYS,Biophysics,0,0,0,0,0,0,0,1,1,0,1,1,1,0,1,0,0,0,1,2,3
wi09,91,ROOSEVELT,PHYS,Phys/Astro,0,0,0,1,0,1,0,1,1,0,1,1,0,0,0,0,0,0,1,2,3
wi09,91,ROOSEVELT,PHYS,Phys/Comp,0,0,0,0,0,0,0,0,0,0,1,1,1,0,1,0,0,0,1,1,2
wi09,91,ROOSEVELT,PHYS,Phys/Mtrls,0,0,0,0,0,0,0,0,0,1,0,1,0,0,0,0,0,0,1,0,1
wi09,91,ROOSEVELT,PHYS,Physics,0,0,0,0,0,0,2,1,3,2,1,3,2,0,2,0,0,0,6,2,8
wi09,91,ROOSEVELT,POLI,Polit Sci,0,0,0,1,8,9,4,10,14,16,23,39,23,28,51,0,0,0,44,69,113
wi09,91,ROOSEVELT,POLI,PolSc-Amer,0,0,0,1,0,1,2,2,4,0,2,2,1,3,4,0,0,0,4,7,11
wi09,91,ROOSEVELT,POLI,PolSc-Comp,0,0,0,0,0,0,0,1,1,0,1,1,4,2,6,0,0,0,4,4,8
wi09,91,ROOSEVELT,POLI,PolSc-Intl,0,0,0,7,10,17,4,8,12,10,25,35,14,26,40,0,0,0,35,69,104
wi09,91,ROOSEVELT,POLI,PolSc-PLaw,0,0,0,3,1,4,2,7,9,7,13,20,6,7,13,0,0,0,18,28,46
wi09,91,ROOSEVELT,POLI,PolSc-PPol,0,0,0,0,0,0,0,2,2,0,0,0,3,1,4,0,0,0,3,3,6
wi09,91,ROOSEVELT,POLI,PolSc-Thry,0,0,0,0,0,0,0,0,0,0,3,3,0,1,1,0,0,0,0,4,4
wi09,91,ROOSEVELT,PSYC,Psychology,0,0,0,7,21,28,8,31,39,19,61,80,16,53,69,0,0,0,50,166,216
wi09,91,ROOSEVELT,RELI,Relig/Stu,0,0,0,0,1,1,0,0,0,0,0,0,1,0,1,0,0,0,1,1,2
wi09,91,ROOSEVELT,RUSS,Russ&SovSt,0,0,0,1,0,1,0,0,0,0,0,0,1,1,2,0,0,0,2,1,3
wi09,91,ROOSEVELT,SE,Engin Sci,0,0,0,1,1,2,0,0,0,0,0,0,0,0,0,0,0,0,1,1,2
wi09,91,ROOSEVELT,SE,Struct Eng,0,0,0,10,0,10,5,1,6,13,6,19,14,6,20,0,0,0,42,13,55
wi09,91,ROOSEVELT,SIO,ErSc-Geol,0,0,0,1,1,2,0,1,1,1,0,1,0,0,0,0,0,0,2,2,4
wi09,91,ROOSEVELT,SOC,Sociology,0,0,0,0,2,2,2,6,8,8,24,32,4,23,27,0,0,0,14,55,69
wi09,91,ROOSEVELT,THEA,Dance,0,0,0,0,0,0,0,0,0,0,0,0,0,1,1,0,0,0,0,1,1
wi09,91,ROOSEVELT,THEA,Theatre,0,0,0,0,3,3,1,4,5,2,4,6,2,7,9,0,0,0,5,18,23
wi09,91,ROOSEVELT,TWS,ThirdWldSt,0,0,0,0,1,1,0,1,1,0,4,4,0,2,2,0,0,0,0,8,8
wi09,91,ROOSEVELT,UNAF,Limited St,0,0,0,0,0,0,0,0,0,0,0,0,0,0,0,0,1,1,0,1,1
wi09,91,ROOSEVELT,UNAF,Spec-Emply,0,0,0,0,0,0,0,0,0,0,0,0,0,0,0,1,0,1,1,0,1
wi09,91,ROOSEVELT,UNAF,UndecHumAr,0,0,0,1,11,12,0,7,7,0,0,0,0,0,0,0,0,0,1,18,19
wi09,91,ROOSEVELT,UNAF,Undeclared,0,0,0,27,54,81,13,36,49,5,1,6,0,0,0,0,0,0,45,91,136
wi09,91,ROOSEVELT,UNAF,UndecPhysS,0,0,0,3,2,5,2,1,3,0,0,0,0,0,0,0,0,0,5,3,8
wi09,91,ROOSEVELT,UNAF,UndecSocSc,0,0,0,2,6,8,4,6,10,0,1,1,0,0,0,0,0,0,6,13,19
wi09,91,ROOSEVELT,USP,Urb Stu&Pl,0,0,0,1,1,2,1,3,4,4,5,9,6,6,12,0,0,0,12,15,27
wi09,91,ROOSEVELT,VIS,Art Hst/Cr,0,0,0,0,0,0,0,2,2,1,8,9,0,8,8,0,0,0,1,18,19
wi09,91,ROOSEVELT,VIS,Media,0,0,0,0,2,2,3,5,8,8,8,16,8,5,13,0,0,0,19,20,39
wi09,91,ROOSEVELT,VIS,Studio VA,0,0,0,0,3,3,1,3,4,2,5,7,1,0,1,0,0,0,4,11,15
wi09,91,ROOSEVELT,VIS,VA-CompArt,0,0,0,1,1,2,0,1,1,0,2,2,1,1,2,0,0,0,2,5,7
wi09,91,SIXTH,ANTH,Anth-Arch,0,0,0,0,0,0,0,0,0,3,1,4,1,0,1,0,0,0,4,1,5
wi09,91,SIXTH,ANTH,Anth-Biol,0,0,0,0,3,3,0,2,2,1,1,2,2,5,7,0,0,0,3,11,14
wi09,91,SIXTH,ANTH,Anth-Soci,0,0,0,0,0,0,0,2,2,0,1,1,3,2,5,0,0,0,3,5,8
wi09,91,SIXTH,ANTH,Anthropol,0,0,0,0,0,0,0,0,0,0,0,0,0,3,3,0,0,0,0,3,3
wi09,91,SIXTH,BENG,Bioen:Binf,0,0,0,0,0,0,0,0,0,0,0,0,1,0,1,0,0,0,1,0,1
wi09,91,SIXTH,BENG,Bioeng:PM,0,0,0,0,0,0,1,0,1,3,0,3,6,5,11,0,0,0,10,5,15
wi09,91,SIXTH,BENG,BioengBiot,0,0,0,3,1,4,5,1,6,2,1,3,6,3,9,0,0,0,16,6,22
wi09,91,SIXTH,BENG,Bioengin,0,0,0,1,0,1,2,1,3,2,1,3,8,3,11,0,0,0,13,5,18
wi09,91,SIXTH,BENG,Pr-BioenBf,0,0,0,0,0,0,1,0,1,0,0,0,1,0,1,0,0,0,2,0,2
wi09,91,SIXTH,BENG,Pr-BioenPM,0,0,0,1,1,2,4,2,6,9,0,9,0,0,0,0,0,0,14,3,17
wi09,91,SIXTH,BIOL,Anml Physl,0,0,0,0,0,0,0,1,1,0,1,1,2,1,3,0,0,0,2,3,5
wi09,91,SIXTH,BIOL,Bioc/CellB,0,0,0,8,5,13,10,10,20,17,15,32,23,35,58,0,0,0,58,65,123
wi09,91,SIXTH,BIOL,BiolBioinf,0,0,0,0,0,0,0,0,0,0,0,0,1,1,2,0,0,0,1,1,2
wi09,91,SIXTH,BIOL,Ec/Beh/Evo,0,0,0,0,3,3,1,5,6,2,8,10,2,4,6,0,0,0,5,20,25
wi09,91,SIXTH,BIOL,Genl Biol,0,0,0,5,6,11,6,13,19,30,26,56,17,20,37,0,0,0,58,65,123
wi09,91,SIXTH,BIOL,Human Bio,0,0,0,20,28,48,30,28,58,30,40,70,26,35,61,0,0,0,106,131,237
wi09,91,SIXTH,BIOL,Microbiol,0,0,0,2,0,2,2,3,5,3,4,7,1,1,2,0,0,0,8,8,16
wi09,91,SIXTH,BIOL,Molec Biol,0,0,0,0,1,1,2,5,7,8,1,9,6,3,9,0,0,0,16,10,26
wi09,91,SIXTH,BIOL,PhyslNeuro,0,0,0,5,4,9,2,3,5,5,8,13,15,9,24,0,0,0,27,24,51
wi09,91,SIXTH,CENG,Chem Engin,0,0,0,1,0,1,4,0,4,7,2,9,6,4,10,0,0,0,18,6,24
wi09,91,SIXTH,CHEM,Bioch/Chem,0,0,0,7,4,11,2,4,6,3,3,6,10,8,18,0,0,0,22,19,41
wi09,91,SIXTH,CHEM,Chem Educ,0,0,0,0,0,0,1,0,1,0,0,0,0,0,0,0,0,0,1,0,1
wi09,91,SIXTH,CHEM,Chemistry,0,0,0,1,1,2,2,2,4,6,4,10,5,1,6,0,0,0,14,8,22
wi09,91,SIXTH,CHEM,Envir Chem,0,0,0,0,0,0,0,0,0,0,1,1,1,0,1,0,0,0,1,1,2
wi09,91,SIXTH,CHEM,MolecSynth,0,0,0,0,0,0,0,0,0,1,1,2,1,0,1,0,0,0,2,1,3
wi09,91,SIXTH,CHEM,Pharm Chem,0,0,0,2,11,13,3,7,10,5,8,13,7,6,13,0,0,0,17,32,49
wi09,91,SIXTH,CHIN,Chinese St,0,0,0,0,0,0,0,0,0,0,0,0,0,1,1,0,0,0,0,1,1
wi09,91,SIXTH,CLAS,Classic St,0,0,0,0,1,1,0,0,0,1,0,1,0,0,0,0,0,0,1,1,2
wi09,91,SIXTH,COGS,Cog Sci,0,0,0,1,0,1,2,1,3,3,3,6,7,3,10,0,0,0,13,7,20
wi09,91,SIXTH,COGS,CogSc/ClAs,0,0,0,0,1,1,0,0,0,0,0,0,0,0,0,0,0,0,0,1,1
wi09,91,SIXTH,COGS,CogSc/Comp,0,0,0,0,0,0,0,0,0,0,0,0,1,0,1,0,0,0,1,0,1
wi09,91,SIXTH,COGS,CogSc/HCI,0,0,0,0,0,0,1,1,2,4,1,5,5,2,7,0,0,0,10,4,14
wi09,91,SIXTH,COGS,CogSc/HCog,0,0,0,0,0,0,0,0,0,1,0,1,1,1,2,0,0,0,2,1,3
wi09,91,SIXTH,COGS,CogSc/Neur,0,0,0,1,0,1,0,3,3,0,2,2,3,1,4,0,0,0,4,6,10
wi09,91,SIXTH,COMM,Communic,0,0,0,2,11,13,6,12,18,16,40,56,19,31,50,0,0,0,43,94,137
wi09,91,SIXTH,CSE,Comp Sci,0,0,0,12,2,14,22,6,28,21,4,25,35,9,44,0,0,0,90,21,111
wi09,91,SIXTH,CSE,CompEngCSE,0,0,0,7,1,8,10,0,10,12,0,12,11,2,13,0,0,0,40,3,43
wi09,91,SIXTH,CSE,CompScBinf,0,0,0,0,0,0,0,0,0,1,0,1,0,1,1,0,0,0,1,1,2
wi09,91,SIXTH,ECE,CompEngECE,0,0,0,3,0,3,3,0,3,4,1,5,5,0,5,0,0,0,15,1,16
wi09,91,SIXTH,ECE,Electr Eng,0,0,0,10,3,13,8,1,9,21,3,24,24,5,29,0,0,0,63,12,75
wi09,91,SIXTH,ECE,Engin Phys,0,0,0,0,0,0,0,0,0,1,0,1,1,0,1,0,0,0,2,0,2
wi09,91,SIXTH,ECE,Pr-EngPhys,0,0,0,1,0,1,0,0,0,0,0,0,1,0,1,0,0,0,2,0,2
wi09,91,SIXTH,ECON,Ec-Mth&Ecn,0,0,0,1,2,3,0,0,0,2,2,4,4,0,4,0,0,0,7,4,11
wi09,91,SIXTH,ECON,Econ-MgtSc,0,0,0,4,5,9,19,12,31,38,21,59,40,12,52,0,0,0,101,50,151
wi09,91,SIXTH,ECON,Economics,0,0,0,12,3,15,20,12,32,55,30,85,47,28,75,0,0,0,134,73,207
wi09,91,SIXTH,ESYS,EnvSys(EB),0,0,0,0,0,0,2,3,5,3,2,5,3,4,7,0,0,0,8,9,17
wi09,91,SIXTH,ESYS,EnvSys(EC),0,0,0,0,0,0,0,0,0,2,0,2,0,0,0,0,0,0,2,0,2
wi09,91,SIXTH,ESYS,EnvSys(EP),0,0,0,0,2,2,1,1,2,0,1,1,1,2,3,0,0,0,2,6,8
wi09,91,SIXTH,ESYS,EnvSys(ES),0,0,0,0,0,0,0,0,0,0,2,2,0,1,1,0,0,0,0,3,3
wi09,91,SIXTH,ETHN,Ethnic St,0,0,0,0,0,0,0,0,0,3,2,5,3,6,9,0,0,0,6,8,14
wi09,91,SIXTH,HDP,Human Dev,0,0,0,0,0,0,0,3,3,1,4,5,0,5,5,0,0,0,1,12,13
wi09,91,SIXTH,HDP,Pr-HumnDev,0,0,0,0,5,5,0,4,4,0,4,4,1,2,3,0,0,0,1,15,16
wi09,91,SIXTH,HIST,History,0,0,0,2,0,2,0,0,0,6,4,10,6,3,9,0,0,0,14,7,21
wi09,91,SIXTH,INTL,IntSt-Anth,0,0,0,0,0,0,1,0,1,0,0,0,2,1,3,0,0,0,3,1,4
wi09,91,SIXTH,INTL,IntSt-Econ,0,0,0,1,4,5,4,5,9,11,6,17,7,7,14,0,0,0,23,22,45
wi09,91,SIXTH,INTL,IntSt-Hist,0,0,0,0,0,0,1,2,3,1,2,3,0,0,0,0,0,0,2,4,6
wi09,91,SIXTH,INTL,IntSt-Ling,0,0,0,0,0,0,1,0,1,4,1,5,0,0,0,0,0,0,5,1,6
wi09,91,SIXTH,INTL,IntSt-Lit,0,0,0,0,0,0,0,0,0,0,0,0,0,2,2,0,0,0,0,2,2
wi09,91,SIXTH,INTL,IntSt-PolS,0,0,0,0,1,1,1,6,7,8,5,13,3,7,10,0,0,0,12,19,31
wi09,91,SIXTH,INTL,IntSt-Soc,0,0,0,0,2,2,0,1,1,3,1,4,0,3,3,0,0,0,3,7,10
wi09,91,SIXTH,ITAL,Italian St,0,0,0,0,1,1,0,0,0,0,0,0,0,0,0,0,0,0,0,1,1
wi09,91,SIXTH,JAPN,JapaneseSt,0,0,0,0,0,0,0,0,0,2,1,3,2,1,3,0,0,0,4,2,6
wi09,91,SIXTH,LATI,LatinAm St,0,0,0,0,0,0,0,0,0,0,0,0,1,0,1,0,0,0,1,0,1
wi09,91,SIXTH,LING,Lang Stu,0,0,0,1,0,1,0,0,0,0,0,0,0,1,1,0,0,0,1,1,2
wi09,91,SIXTH,LING,Ling-CogLn,0,0,0,0,1,1,0,0,0,0,3,3,1,0,1,0,0,0,1,4,5
wi09,91,SIXTH,LING,Ling-LSoc,0,0,0,0,0,0,0,0,0,0,0,0,1,0,1,0,0,0,1,0,1
wi09,91,SIXTH,LING,Linguistcs,0,0,0,0,0,0,1,1,2,0,1,1,0,2,2,0,0,0,1,4,5
wi09,91,SIXTH,LIT,French Lit,0,0,0,0,0,0,0,0,0,0,1,1,0,0,0,0,0,0,0,1,1
wi09,91,SIXTH,LIT,Lit/Compos,0,0,0,0,0,0,0,0,0,0,0,0,0,1,1,0,0,0,0,1,1
wi09,91,SIXTH,LIT,Lit/CultSt,0,0,0,0,0,0,1,1,2,0,2,2,0,1,1,0,0,0,1,4,5
wi09,91,SIXTH,LIT,Lit/Engl,0,0,0,0,1,1,1,1,2,1,3,4,1,1,2,0,0,0,3,6,9
wi09,91,SIXTH,LIT,Lit/World,0,0,0,0,0,0,0,0,0,0,1,1,1,0,1,0,0,0,1,1,2
wi09,91,SIXTH,LIT,Lit/Writng,0,0,0,0,0,0,0,0,0,2,1,3,1,6,7,0,0,0,3,7,10
wi09,91,SIXTH,LIT,Pre-Lit/Wr,0,0,0,1,5,6,2,2,4,3,6,9,3,3,6,0,0,0,9,16,25
wi09,91,SIXTH,LIT,Russian Lt,0,0,0,1,0,1,0,0,0,0,0,0,0,0,0,0,0,0,1,0,1
wi09,91,SIXTH,LIT,Spanish Lt,0,0,0,0,0,0,0,1,1,0,0,0,1,0,1,0,0,0,1,1,2
wi09,91,SIXTH,MAE,Aerosp Eng,0,0,0,13,1,14,11,2,13,13,2,15,23,3,26,0,0,0,60,8,68
wi09,91,SIXTH,MAE,Engin Sci,0,0,0,0,0,0,2,0,2,0,1,1,0,0,0,0,0,0,2,1,3
wi09,91,SIXTH,MAE,Envir Eng,0,0,0,3,2,5,2,2,4,0,0,0,1,3,4,0,0,0,6,7,13
wi09,91,SIXTH,MAE,Mech Engin,0,0,0,14,3,17,16,3,19,34,8,42,49,6,55,0,0,0,113,20,133
wi09,91,SIXTH,MATH,Appld Math,0,0,0,0,1,1,3,0,3,0,0,0,1,2,3,0,0,0,4,3,7
wi09,91,SIXTH,MATH,Math/SecEd,0,0,0,1,0,1,1,1,2,0,3,3,0,1,1,0,0,0,2,5,7
wi09,91,SIXTH,MATH,Mathematcs,0,0,0,1,0,1,2,1,3,5,2,7,4,1,5,0,0,0,12,4,16
wi09,91,SIXTH,MATH,Mth-CompSc,0,0,0,0,0,0,0,0,0,2,0,2,0,0,0,0,0,0,2,0,2
wi09,91,SIXTH,MATH,Mth-Mth&Ec,0,0,0,1,2,3,0,1,1,1,1,2,0,2,2,0,0,0,2,6,8
wi09,91,SIXTH,MATH,Mth/ApldSc,0,0,0,2,0,2,0,0,0,0,0,0,0,0,0,0,0,0,2,0,2
wi09,91,SIXTH,MATH,Pr-Math CS,0,0,0,1,0,1,2,0,2,0,0,0,0,0,0,0,0,0,3,0,3
wi09,91,SIXTH,MUS,Mu-CompArt,0,0,0,2,4,6,2,0,2,8,0,8,5,3,8,0,0,0,17,7,24
wi09,91,SIXTH,MUS,Music,0,0,0,0,0,0,3,0,3,1,1,2,5,5,10,0,0,0,9,6,15
wi09,91,SIXTH,MUS,Music Hum,0,0,0,0,0,0,0,0,0,0,0,0,0,1,1,0,0,0,0,1,1
wi09,91,SIXTH,PHIL,Philosophy,0,0,0,2,0,2,0,0,0,3,1,4,1,3,4,0,0,0,6,4,10
wi09,91,SIXTH,PHYS,Biophysics,0,0,0,0,0,0,2,0,2,0,0,0,2,0,2,0,0,0,4,0,4
wi09,91,SIXTH,PHYS,Phys/Astro,0,0,0,0,0,0,3,0,3,0,0,0,0,1,1,0,0,0,3,1,4
wi09,91,SIXTH,PHYS,Phys/Mtrls,0,0,0,0,0,0,1,0,1,0,1,1,1,0,1,0,0,0,2,1,3
wi09,91,SIXTH,PHYS,Physics,0,0,0,0,0,0,5,0,5,4,0,4,7,1,8,0,0,0,16,1,17
wi09,91,SIXTH,POLI,Polit Sci,0,0,0,0,1,1,6,6,12,15,6,21,6,7,13,0,0,0,27,20,47
wi09,91,SIXTH,POLI,PolSc-Amer,0,0,0,0,1,1,1,1,2,2,2,4,2,2,4,0,0,0,5,6,11
wi09,91,SIXTH,POLI,PolSc-Comp,0,0,0,0,0,0,0,0,0,0,0,0,0,1,1,0,0,0,0,1,1
wi09,91,SIXTH,POLI,PolSc-Intl,0,0,0,0,2,2,6,3,9,8,6,14,11,7,18,0,0,0,25,18,43
wi09,91,SIXTH,POLI,PolSc-PLaw,0,0,0,2,0,2,2,1,3,6,5,11,1,2,3,0,0,0,11,8,19
wi09,91,SIXTH,POLI,PolSc-PPol,0,0,0,0,0,0,1,1,2,1,0,1,1,2,3,0,0,0,3,3,6
wi09,91,SIXTH,POLI,PolSc-Thry,0,0,0,0,0,0,0,0,0,1,0,1,0,1,1,0,0,0,1,1,2
wi09,91,SIXTH,PSYC,Psychology,0,0,0,8,15,23,12,26,38,24,39,63,19,31,50,0,0,0,63,111,174
wi09,91,SIXTH,SE,Engin Sci,0,0,0,0,0,0,1,1,2,0,0,0,0,0,0,0,0,0,1,1,2
wi09,91,SIXTH,SE,Struct Eng,0,0,0,5,3,8,12,3,15,14,7,21,17,10,27,0,0,0,48,23,71
wi09,91,SIXTH,SIO,ErSc-Geol,0,0,0,0,0,0,0,0,0,1,0,1,0,0,0,0,0,0,1,0,1
wi09,91,SIXTH,SOC,Sociology,0,0,0,1,2,3,1,9,10,4,18,22,4,11,15,0,0,0,10,40,50
wi09,91,SIXTH,THEA,Dance,0,0,0,0,0,0,0,0,0,0,2,2,1,3,4,0,0,0,1,5,6
wi09,91,SIXTH,THEA,Theatre,0,0,0,0,1,1,1,1,2,1,3,4,2,6,8,0,0,0,4,11,15
wi09,91,SIXTH,TWS,ThirdWldSt,0,0,0,0,0,0,0,0,0,0,1,1,0,0,0,0,0,0,0,1,1
wi09,91,SIXTH,UNAF,Limited St,0,0,0,0,0,0,0,0,0,0,0,0,0,0,0,2,0,2,2,0,2
wi09,91,SIXTH,UNAF,UndecHumAr,0,0,0,2,3,5,3,1,4,0,0,0,0,0,0,0,0,0,5,4,9
wi09,91,SIXTH,UNAF,Undeclared,0,0,0,27,34,61,12,16,28,3,2,5,0,0,0,0,0,0,42,52,94
wi09,91,SIXTH,UNAF,UndecPhysS,0,0,0,0,5,5,1,2,3,0,0,0,0,0,0,0,0,0,1,7,8
wi09,91,SIXTH,UNAF,UndecSocSc,0,0,0,1,6,7,0,2,2,0,0,0,0,0,0,0,0,0,1,8,9
wi09,91,SIXTH,USP,Urb Stu&Pl,0,0,0,1,0,1,1,2,3,4,2,6,4,2,6,0,0,0,10,6,16
wi09,91,SIXTH,VIS,Art Hst/Cr,0,0,0,0,0,0,1,3,4,0,7,7,2,6,8,0,0,0,3,16,19
wi09,91,SIXTH,VIS,Media,0,0,0,3,4,7,7,5,12,13,22,35,17,12,29,0,0,0,40,43,83
wi09,91,SIXTH,VIS,Studio VA,0,0,0,2,2,4,1,2,3,7,7,14,3,8,11,0,0,0,13,19,32
wi09,91,SIXTH,VIS,VA-CompArt,0,0,0,3,0,3,6,2,8,6,6,12,6,5,11,0,0,0,21,13,34
wi09,91,WARREN,ANTH,Anth-Arch,0,0,0,0,1,1,0,1,1,0,0,0,1,5,6,0,0,0,1,7,8
wi09,91,WARREN,ANTH,Anth-Biol,0,0,0,0,1,1,0,0,0,2,3,5,1,9,10,0,0,0,3,13,16
wi09,91,WARREN,ANTH,Anth-Soci,0,0,0,0,0,0,1,1,2,0,2,2,0,2,2,0,0,0,1,5,6
wi09,91,WARREN,ANTH,Anthropol,0,0,0,0,0,0,0,0,0,0,0,0,0,2,2,0,0,0,0,2,2
wi09,91,WARREN,BENG,Bioen:Binf,0,0,0,0,0,0,1,0,1,0,0,0,2,2,4,0,0,0,3,2,5
wi09,91,WARREN,BENG,Bioeng:PM,0,0,0,0,0,0,0,0,0,13,9,22,28,11,39,0,0,0,41,20,61
wi09,91,WARREN,BENG,BioengBiot,0,0,0,4,2,6,13,1,14,8,2,10,23,12,35,0,0,0,48,17,65
wi09,91,WARREN,BENG,Bioengin,0,0,0,6,2,8,10,5,15,8,2,10,15,9,24,0,0,0,39,18,57
wi09,91,WARREN,BENG,Pr-BioenPM,0,2,2,5,6,11,12,8,20,6,2,8,1,1,2,0,0,0,24,19,43
wi09,91,WARREN,BIOL,Anml Physl,0,0,0,0,0,0,0,1,1,0,0,0,0,1,1,0,0,0,0,2,2
wi09,91,WARREN,BIOL,Bioc/CellB,0,2,2,6,2,8,7,15,22,34,41,75,58,68,126,0,0,0,105,128,233
wi09,91,WARREN,BIOL,BiolBioinf,0,0,0,0,0,0,1,0,1,1,0,1,0,0,0,0,0,0,2,0,2
wi09,91,WARREN,BIOL,Ec/Beh/Evo,0,0,0,2,1,3,3,4,7,3,4,7,3,7,10,0,0,0,11,16,27
wi09,91,WARREN,BIOL,Genl Biol,0,2,2,4,7,11,9,14,23,12,30,42,43,56,99,0,0,0,68,109,177
wi09,91,WARREN,BIOL,Human Bio,1,6,7,14,29,43,24,44,68,35,60,95,54,88,142,0,0,0,128,227,355
wi09,91,WARREN,BIOL,Microbiol,0,0,0,0,1,1,0,1,1,2,4,6,7,7,14,0,0,0,9,13,22
wi09,91,WARREN,BIOL,Molec Biol,1,0,1,1,2,3,1,4,5,11,8,19,11,7,18,0,0,0,25,21,46
wi09,91,WARREN,BIOL,PhyslNeuro,0,0,0,2,6,8,6,13,19,7,15,22,18,18,36,0,0,0,33,52,85
wi09,91,WARREN,CENG,Chem Engin,3,1,4,6,0,6,12,1,13,12,7,19,23,10,33,0,0,0,56,19,75
wi09,91,WARREN,CGS,CritGendSt,0,0,0,0,0,0,0,1,1,0,2,2,0,1,1,0,0,0,0,4,4
wi09,91,WARREN,CHEM,Bioch/Chem,0,2,2,3,2,5,3,2,5,13,6,19,15,25,40,0,0,0,34,37,71
wi09,91,WARREN,CHEM,Chem Phys,0,0,0,0,0,0,0,0,0,1,0,1,1,1,2,0,0,0,2,1,3
wi09,91,WARREN,CHEM,Chemistry,0,0,0,1,2,3,2,2,4,4,6,10,6,5,11,0,0,0,13,15,28
wi09,91,WARREN,CHEM,Chm/ErthSc,0,0,0,0,0,0,1,0,1,0,0,0,0,0,0,0,0,0,1,0,1
wi09,91,WARREN,CHEM,Envir Chem,0,0,0,1,0,1,0,0,0,0,0,0,1,0,1,0,0,0,2,0,2
wi09,91,WARREN,CHEM,MolecSynth,0,0,0,0,0,0,1,0,1,3,0,3,1,1,2,0,0,0,5,1,6
wi09,91,WARREN,CHEM,Pharm Chem,0,1,1,0,3,3,2,7,9,7,11,18,16,26,42,0,0,0,25,48,73
wi09,91,WARREN,CHIN,Chinese St,0,0,0,0,0,0,0,0,0,0,1,1,0,7,7,0,0,0,0,8,8
wi09,91,WARREN,COGS,Cog Sci,0,0,0,0,2,2,1,1,2,6,4,10,6,6,12,0,0,0,13,13,26
wi09,91,WARREN,COGS,CogSc/ClAs,0,0,0,0,0,0,0,1,1,0,0,0,0,0,0,0,0,0,0,1,1
wi09,91,WARREN,COGS,CogSc/Clin,0,0,0,0,0,0,0,1,1,0,0,0,0,0,0,0,0,0,0,1,1
wi09,91,WARREN,COGS,CogSc/HCI,0,0,0,1,0,1,1,1,2,1,0,1,2,3,5,0,0,0,5,4,9
wi09,91,WARREN,COGS,CogSc/HCog,0,0,0,0,0,0,0,0,0,1,0,1,0,1,1,0,0,0,1,1,2
wi09,91,WARREN,COGS,CogSc/Neur,0,0,0,1,2,3,1,1,2,2,1,3,3,3,6,0,0,0,7,7,14
wi09,91,WARREN,COMM,Communic,0,1,1,1,10,11,4,14,18,15,25,40,14,41,55,0,0,0,34,91,125
wi09,91,WARREN,CSE,Comp Sci,1,0,1,8,5,13,18,2,20,31,7,38,35,9,44,0,0,0,93,23,116
wi09,91,WARREN,CSE,CompEngCSE,2,0,2,8,1,9,10,1,11,12,1,13,10,3,13,0,0,0,42,6,48
wi09,91,WARREN,CSE,CompScBinf,0,0,0,0,0,0,0,0,0,0,0,0,2,0,2,0,0,0,2,0,2
wi09,91,WARREN,ECE,CompEngECE,1,0,1,1,0,1,5,1,6,3,0,3,7,1,8,0,0,0,17,2,19
wi09,91,WARREN,ECE,Electr Eng,0,0,0,3,3,6,8,1,9,28,7,35,72,8,80,0,0,0,111,19,130
wi09,91,WARREN,ECE,Engin Phys,0,0,0,0,0,0,0,0,0,0,0,0,3,0,3,0,0,0,3,0,3
wi09,91,WARREN,ECE,Pr-EngPhys,0,0,0,4,0,4,2,0,2,3,0,3,1,0,1,0,0,0,10,0,10
wi09,91,WARREN,ECON,Ec-Mth&Ecn,2,1,3,3,0,3,3,4,7,6,1,7,5,3,8,0,0,0,19,9,28
wi09,91,WARREN,ECON,Econ-MgtSc,0,0,0,2,4,6,11,16,27,38,19,57,51,39,90,0,0,0,102,78,180
wi09,91,WARREN,ECON,Economics,1,0,1,7,5,12,18,14,32,52,14,66,70,37,107,0,0,0,148,70,218
wi09,91,WARREN,ERTH,ErSc-Geol,0,0,0,0,0,0,0,0,0,0,0,0,1,0,1,0,0,0,1,0,1
wi09,91,WARREN,ESYS,EnvSys(EB),0,0,0,0,0,0,0,0,0,0,2,2,2,2,4,0,0,0,2,4,6
wi09,91,WARREN,ESYS,EnvSys(EC),0,0,0,0,0,0,0,0,0,1,0,1,0,1,1,0,0,0,1,1,2
wi09,91,WARREN,ESYS,EnvSys(EP),0,0,0,0,0,0,0,0,0,2,2,4,0,1,1,0,0,0,2,3,5
wi09,91,WARREN,ESYS,EnvSys(ES),0,0,0,0,0,0,0,0,0,0,0,0,2,2,4,0,0,0,2,2,4
wi09,91,WARREN,ETHN,Ethnic St,0,0,0,0,0,0,0,2,2,1,0,1,1,2,3,0,0,0,2,4,6
wi09,91,WARREN,GMST,German Stu,0,0,0,0,0,0,0,0,0,1,0,1,1,0,1,0,0,0,2,0,2
wi09,91,WARREN,HDP,Human Dev,0,0,0,0,0,0,1,0,1,0,5,5,3,19,22,0,0,0,4,24,28
wi09,91,WARREN,HDP,Pr-HumnDev,0,0,0,0,0,0,0,3,3,1,6,7,2,4,6,0,0,0,3,13,16
wi09,91,WARREN,HIST,History,0,0,0,0,1,1,2,2,4,16,9,25,11,17,28,0,0,0,29,29,58
wi09,91,WARREN,INTD,Wa Ind St,0,0,0,0,0,0,0,0,0,0,0,0,0,2,2,0,0,0,0,2,2
wi09,91,WARREN,INTL,Int-5yrPS,0,0,0,0,0,0,0,0,0,0,1,1,0,0,0,0,0,0,0,1,1
wi09,91,WARREN,INTL,IntSt-Anth,0,0,0,0,0,0,0,1,1,0,1,1,1,0,1,0,0,0,1,2,3
wi09,91,WARREN,INTL,IntSt-Econ,0,0,0,3,2,5,3,2,5,4,4,8,3,10,13,0,0,0,13,18,31
wi09,91,WARREN,INTL,IntSt-Hist,0,0,0,0,0,0,0,0,0,1,1,2,2,2,4,0,0,0,3,3,6
wi09,91,WARREN,INTL,IntSt-Ling,0,0,0,0,0,0,0,1,1,0,1,1,1,0,1,0,0,0,1,2,3
wi09,91,WARREN,INTL,IntSt-Lit,0,0,0,0,0,0,0,0,0,0,0,0,1,0,1,0,0,0,1,0,1
wi09,91,WARREN,INTL,IntSt-PolS,0,0,0,1,4,5,1,1,2,4,6,10,2,10,12,0,0,0,8,21,29
wi09,91,WARREN,INTL,IntSt-Soc,0,0,0,0,0,0,0,2,2,1,6,7,1,3,4,0,0,0,2,11,13
wi09,91,WARREN,ITAL,Italian St,0,0,0,0,0,0,0,0,0,0,0,0,1,0,1,0,0,0,1,0,1
wi09,91,WARREN,JAPN,JapaneseSt,0,0,0,0,0,0,0,0,0,0,0,0,1,1,2,0,0,0,1,1,2
wi09,91,WARREN,LATI,LatinAm St,0,0,0,0,0,0,0,0,0,0,0,0,0,1,1,0,0,0,0,1,1
wi09,91,WARREN,LING,Lang Stu,0,0,0,0,0,0,0,0,0,0,1,1,0,1,1,0,0,0,0,2,2
wi09,91,WARREN,LING,Ling-CogLn,0,0,0,0,0,0,0,1,1,0,0,0,0,0,0,0,0,0,0,1,1
wi09,91,WARREN,LING,Ling-LSoc,0,0,0,0,0,0,0,0,0,0,0,0,0,1,1,0,0,0,0,1,1
wi09,91,WARREN,LING,Linguistcs,0,1,1,0,0,0,0,0,0,1,2,3,0,0,0,0,0,0,1,3,4
wi09,91,WARREN,LIT,French Lit,0,0,0,0,0,0,0,0,0,1,0,1,0,0,0,0,0,0,1,0,1
wi09,91,WARREN,LIT,German Lit,0,0,0,0,0,0,0,0,0,0,0,0,0,1,1,0,0,0,0,1,1
wi09,91,WARREN,LIT,Lit/CultSt,0,0,0,0,0,0,0,0,0,0,1,1,0,0,0,0,0,0,0,1,1
wi09,91,WARREN,LIT,Lit/Engl,0,0,0,1,1,2,0,5,5,1,1,2,1,6,7,0,0,0,3,13,16
wi09,91,WARREN,LIT,Lit/World,0,0,0,0,0,0,0,0,0,0,0,0,2,2,4,0,0,0,2,2,4
wi09,91,WARREN,LIT,Lit/Writng,0,0,0,0,0,0,0,0,0,0,1,1,2,3,5,0,0,0,2,4,6
wi09,91,WARREN,LIT,Pre-Lit/Wr,0,0,0,1,0,1,0,4,4,3,3,6,0,2,2,0,0,0,4,9,13
wi09,91,WARREN,LIT,Spanish Lt,0,0,0,0,0,0,0,0,0,0,1,1,5,4,9,0,0,0,5,5,10
wi09,91,WARREN,MAE,Aerosp Eng,1,0,1,9,3,12,8,3,11,14,2,16,48,4,52,0,0,0,80,12,92
wi09,91,WARREN,MAE,Engin Sci,0,0,0,0,0,0,0,1,1,0,0,0,1,0,1,0,0,0,1,1,2
wi09,91,WARREN,MAE,Envir Eng,0,0,0,3,2,5,1,0,1,1,2,3,4,2,6,0,0,0,9,6,15
wi09,91,WARREN,MAE,Mech Engin,1,0,1,19,2,21,31,5,36,42,5,47,94,10,104,0,0,0,187,22,209
wi09,91,WARREN,MATH,Appld Math,0,0,0,0,1,1,1,3,4,3,3,6,2,4,6,0,0,0,6,11,17
wi09,91,WARREN,MATH,Math/SecEd,0,0,0,0,0,0,0,0,0,1,0,1,1,3,4,0,0,0,2,3,5
wi09,91,WARREN,MATH,Mathematcs,0,1,1,0,2,2,1,0,1,6,5,11,7,4,11,0,0,0,14,12,26
wi09,91,WARREN,MATH,Mth-CompSc,0,0,0,0,0,0,0,0,0,0,0,0,5,1,6,0,0,0,5,1,6
wi09,91,WARREN,MATH,Mth-Mth&Ec,0,0,0,0,0,0,0,0,0,4,1,5,6,3,9,0,0,0,10,4,14
wi09,91,WARREN,MATH,Mth-SciCom,0,0,0,0,0,0,0,0,0,1,0,1,1,2,3,0,0,0,2,2,4
wi09,91,WARREN,MATH,Mth/ApldSc,0,0,0,1,0,1,0,0,0,0,0,0,2,0,2,0,0,0,3,0,3
wi09,91,WARREN,MATH,Pr-Math CS,0,0,0,0,0,0,1,0,1,0,0,0,0,0,0,0,0,0,1,0,1
wi09,91,WARREN,MATH,Prob&Stats,0,0,0,0,0,0,1,0,1,1,1,2,6,2,8,0,0,0,8,3,11
wi09,91,WARREN,MUS,Mu-CompArt,0,0,0,0,0,0,2,0,2,5,1,6,4,3,7,0,0,0,11,4,15
wi09,91,WARREN,MUS,Music,0,0,0,1,1,2,0,0,0,1,1,2,9,0,9,0,0,0,11,2,13
wi09,91,WARREN,MUS,Music Hum,0,0,0,0,0,0,0,0,0,0,0,0,0,1,1,0,0,0,0,1,1
wi09,91,WARREN,PHIL,Philosophy,0,0,0,1,0,1,3,1,4,7,2,9,7,5,12,0,0,0,18,8,26
wi09,91,WARREN,PHYS,Biophysics,0,0,0,0,0,0,0,0,0,1,0,1,7,1,8,0,0,0,8,1,9
wi09,91,WARREN,PHYS,GenPys/SEd,0,0,0,0,0,0,0,0,0,0,0,0,1,0,1,0,0,0,1,0,1
wi09,91,WARREN,PHYS,Phys/Astro,0,0,0,2,1,3,2,0,2,1,0,1,5,0,5,0,0,0,10,1,11
wi09,91,WARREN,PHYS,Phys/Comp,0,0,0,0,0,0,0,0,0,0,0,0,1,0,1,0,0,0,1,0,1
wi09,91,WARREN,PHYS,Phys/Mtrls,0,0,0,0,0,0,0,0,0,0,0,0,2,0,2,0,0,0,2,0,2
wi09,91,WARREN,PHYS,Physics,0,0,0,0,0,0,2,0,2,5,1,6,3,1,4,0,0,0,10,2,12
wi09,91,WARREN,POLI,Polit Sci,0,1,1,5,3,8,8,8,16,19,14,33,19,19,38,0,0,0,51,45,96
wi09,91,WARREN,POLI,PolSc-Amer,0,0,0,1,0,1,2,3,5,4,3,7,2,2,4,0,0,0,9,8,17
wi09,91,WARREN,POLI,PolSc-Comp,1,0,1,0,0,0,0,0,0,2,1,3,1,0,1,0,0,0,4,1,5
wi09,91,WARREN,POLI,PolSc-Intl,1,2,3,0,2,2,4,2,6,17,10,27,12,12,24,0,0,0,34,28,62
wi09,91,WARREN,POLI,PolSc-PLaw,0,0,0,3,5,8,5,6,11,6,10,16,4,10,14,0,0,0,18,31,49
wi09,91,WARREN,POLI,PolSc-PPol,0,0,0,0,0,0,1,2,3,0,1,1,0,1,1,0,0,0,1,4,5
wi09,91,WARREN,POLI,PolSc-Thry,1,0,1,1,0,1,0,0,0,3,3,6,0,0,0,0,0,0,5,3,8
wi09,91,WARREN,PSYC,Psychology,0,0,0,5,18,23,8,26,34,16,49,65,29,55,84,0,0,0,58,148,206
wi09,91,WARREN,RELI,Relig/Stu,0,0,0,0,0,0,0,0,0,0,0,0,3,1,4,0,0,0,3,1,4
wi09,91,WARREN,SE,Engin Sci,0,0,0,0,0,0,1,0,1,0,0,0,0,0,0,0,0,0,1,0,1
wi09,91,WARREN,SE,Struct Eng,1,0,1,6,2,8,17,4,21,25,10,35,60,26,86,0,0,0,109,42,151
wi09,91,WARREN,SIO,ErSc-Geoch,0,0,0,0,0,0,0,0,0,0,1,1,0,0,0,0,0,0,0,1,1
wi09,91,WARREN,SIO,ErSc-Geol,0,0,0,0,0,0,1,0,1,0,0,0,0,0,0,0,0,0,1,0,1
wi09,91,WARREN,SOC,Sociology,1,0,1,2,0,2,1,4,5,8,17,25,8,15,23,0,0,0,20,36,56
wi09,91,WARREN,THEA,Dance,0,0,0,0,0,0,1,0,1,0,1,1,1,0,1,0,0,0,2,1,3
wi09,91,WARREN,THEA,Theatre,0,0,0,0,0,0,0,1,1,2,5,7,3,5,8,0,0,0,5,11,16
wi09,91,WARREN,TWS,ThirdWldSt,0,0,0,0,1,1,0,0,0,0,0,0,0,0,0,0,0,0,0,1,1
wi09,91,WARREN,UNAF,IntcampVis,0,0,0,0,0,0,0,1,1,1,2,3,1,1,2,0,0,0,2,4,6
wi09,91,WARREN,UNAF,Limited St,0,0,0,0,0,0,0,0,0,0,0,0,0,0,0,3,2,5,3,2,5
wi09,91,WARREN,UNAF,UndecHumAr,0,0,0,2,7,9,0,0,0,0,0,0,0,0,0,0,0,0,2,7,9
wi09,91,WARREN,UNAF,Undeclared,5,5,10,13,22,35,13,11,24,2,1,3,0,0,0,0,0,0,33,39,72
wi09,91,WARREN,UNAF,UndecPhysS,0,0,0,1,2,3,1,0,1,0,0,0,0,0,0,0,0,0,2,2,4
wi09,91,WARREN,UNAF,UndecSocSc,0,0,0,0,4,4,1,0,1,0,0,0,0,0,0,0,0,0,1,4,5
wi09,91,WARREN,USP,Urb Stu&Pl,0,0,0,1,3,4,2,0,2,2,1,3,7,5,12,0,0,0,12,9,21
wi09,91,WARREN,VIS,Art Hst/Cr,0,0,0,0,0,0,0,1,1,1,3,4,1,4,5,0,0,0,2,8,10
wi09,91,WARREN,VIS,Media,0,0,0,0,3,3,0,2,2,8,4,12,5,6,11,0,0,0,13,15,28
wi09,91,WARREN,VIS,Studio VA,0,0,0,0,1,1,0,0,0,3,1,4,1,8,9,0,0,0,4,10,14
wi09,91,WARREN,VIS,VA-CompArt,0,0,0,0,1,1,0,2,2,2,0,2,0,2,2,0,0,0,2,5,7
sp11,112,MARSHALL,ANTH,Anth-Arch,0,0,0,0,0,0,0,0,0,1,1,2,0,3,3,0,0,0,1,4,5
sp11,112,MARSHALL,ANTH,Anth-Biol,0,0,0,0,0,0,0,1,1,1,4,5,2,3,5,0,0,0,3,8,11
sp11,112,MARSHALL,ANTH,Anth-Soci,0,0,0,0,0,0,0,0,0,0,1,1,4,7,11,0,0,0,4,8,12
sp11,112,MARSHALL,ANTH,Anthropol,0,0,0,0,0,0,0,0,0,0,1,1,0,0,0,0,0,0,0,1,1
sp11,112,MARSHALL,BENG,Bioen:Binf,0,0,0,0,0,0,1,0,1,2,1,3,1,2,3,0,0,0,4,3,7
sp11,112,MARSHALL,BENG,Bioeng:PM,0,0,0,0,0,0,0,0,0,2,2,4,9,3,12,0,0,0,11,5,16
sp11,112,MARSHALL,BENG,BioengBiot,0,0,0,0,0,0,3,3,6,10,4,14,13,6,19,0,0,0,26,13,39
sp11,112,MARSHALL,BENG,Bioengin,0,0,0,0,0,0,1,2,3,4,1,5,2,4,6,0,0,0,7,7,14
sp11,112,MARSHALL,BENG,Pr-BioenPM,0,0,0,0,0,0,0,2,2,1,0,1,0,0,0,0,0,0,1,2,3
sp11,112,MARSHALL,BIOL,Bioc/CellB,0,0,0,1,1,2,2,10,12,17,23,40,46,45,91,0,0,0,66,79,145
sp11,112,MARSHALL,BIOL,BiolBioinf,0,0,0,0,0,0,1,1,2,0,0,0,1,0,1,0,0,0,2,1,3
sp11,112,MARSHALL,BIOL,Ec/Beh/Evo,0,0,0,0,1,1,1,2,3,2,2,4,9,10,19,0,0,0,12,15,27
sp11,112,MARSHALL,BIOL,Genl Biol,0,0,0,0,1,1,4,14,18,17,43,60,31,77,108,0,0,0,52,135,187
sp11,112,MARSHALL,BIOL,Human Bio,0,0,0,1,4,5,13,23,36,39,45,84,53,102,155,0,0,0,106,174,280
sp11,112,MARSHALL,BIOL,Microbiol,0,0,0,0,0,0,1,1,2,2,1,3,5,14,19,0,0,0,8,16,24
sp11,112,MARSHALL,BIOL,Molec Biol,0,0,0,0,0,0,0,1,1,2,1,3,3,5,8,0,0,0,5,7,12
sp11,112,MARSHALL,BIOL,PhyslNeuro,0,0,0,0,0,0,4,2,6,8,10,18,14,41,55,0,0,0,26,53,79
sp11,112,MARSHALL,CENG,Chem Engin,0,0,0,0,1,1,7,2,9,5,5,10,14,8,22,0,0,0,26,16,42
sp11,112,MARSHALL,CGS,CritGendSt,0,0,0,0,0,0,0,0,0,0,0,0,1,3,4,0,0,0,1,3,4
sp11,112,MARSHALL,CHEM,Bioch/Chem,0,0,0,4,3,7,10,16,26,15,12,27,13,22,35,0,0,0,42,53,95
sp11,112,MARSHALL,CHEM,Bioinform,0,0,0,0,0,0,0,1,1,0,0,0,0,0,0,0,0,0,0,1,1
sp11,112,MARSHALL,CHEM,Chem Phys,0,0,0,0,0,0,0,0,0,0,1,1,0,0,0,0,0,0,0,1,1
sp11,112,MARSHALL,CHEM,Chemistry,0,0,0,1,0,1,2,2,4,7,8,15,8,8,16,0,0,0,18,18,36
sp11,112,MARSHALL,CHEM,Envir Chem,0,0,0,0,0,0,0,1,1,0,1,1,2,1,3,0,0,0,2,3,5
sp11,112,MARSHALL,CHEM,Pharm Chem,0,0,0,3,2,5,5,11,16,8,12,20,10,13,23,0,0,0,26,38,64
sp11,112,MARSHALL,CHIN,Chinese St,0,0,0,0,0,0,0,0,0,0,0,0,1,1,2,0,0,0,1,1,2
sp11,112,MARSHALL,CLAS,Classic St,0,0,0,0,0,0,0,1,1,0,0,0,0,1,1,0,0,0,0,2,2
sp11,112,MARSHALL,COGS,Cog Sci,0,0,0,1,1,2,3,5,8,5,4,9,3,5,8,0,0,0,12,15,27
sp11,112,MARSHALL,COGS,CogSc/ClAs,0,0,0,0,0,0,0,1,1,0,3,3,0,4,4,0,0,0,0,8,8
sp11,112,MARSHALL,COGS,CogSc/Comp,0,0,0,0,0,0,1,0,1,0,0,0,1,1,2,0,0,0,2,1,3
sp11,112,MARSHALL,COGS,CogSc/HCI,0,0,0,0,0,0,0,1,1,3,0,3,6,2,8,0,0,0,9,3,12
sp11,112,MARSHALL,COGS,CogSc/HCog,0,0,0,0,0,0,0,1,1,1,1,2,1,0,1,0,0,0,2,2,4
sp11,112,MARSHALL,COGS,CogSc/Neur,0,0,0,1,0,1,4,5,9,3,4,7,2,13,15,0,0,0,10,22,32
sp11,112,MARSHALL,COMM,Communic,0,0,0,0,5,5,3,17,20,17,66,83,30,65,95,0,0,0,50,153,203
sp11,112,MARSHALL,CSE,Comp Sci,0,0,0,3,1,4,4,3,7,10,10,20,54,9,63,0,0,0,71,23,94
sp11,112,MARSHALL,CSE,CompEngCSE,0,0,0,2,0,2,4,2,6,4,0,4,7,2,9,0,0,0,17,4,21
sp11,112,MARSHALL,CSE,CompScBinf,0,0,0,0,0,0,0,0,0,0,0,0,2,1,3,0,0,0,2,1,3
sp11,112,MARSHALL,ECE,CompEngECE,0,0,0,1,0,1,0,0,0,0,0,0,2,0,2,0,0,0,3,0,3
sp11,112,MARSHALL,ECE,Electr Eng,0,0,0,1,1,2,9,1,10,10,2,12,36,7,43,0,0,0,56,11,67
sp11,112,MARSHALL,ECE,EleEng&Soc,0,0,0,0,0,0,0,0,0,0,0,0,1,0,1,0,0,0,1,0,1
sp11,112,MARSHALL,ECE,Engin Phys,0,0,0,0,0,0,0,1,1,0,0,0,1,0,1,0,0,0,1,1,2
sp11,112,MARSHALL,ECON,Ec-Mth&Ecn,0,0,0,0,1,1,1,3,4,3,4,7,5,2,7,0,0,0,9,10,19
sp11,112,MARSHALL,ECON,Econ-MgtSc,0,0,0,3,5,8,10,9,19,36,30,66,60,55,115,0,0,0,109,99,208
sp11,112,MARSHALL,ECON,Economics,0,0,0,6,4,10,13,10,23,62,45,107,111,59,170,0,0,0,192,118,310
sp11,112,MARSHALL,ESYS,EnvSys(EB),0,0,0,0,2,2,2,4,6,2,9,11,4,3,7,0,0,0,8,18,26
sp11,112,MARSHALL,ESYS,EnvSys(EC),0,0,0,0,0,0,0,1,1,1,0,1,1,0,1,0,0,0,2,1,3
sp11,112,MARSHALL,ESYS,EnvSys(EP),0,0,0,0,0,0,0,1,1,0,3,3,0,3,3,0,0,0,0,7,7
sp11,112,MARSHALL,ESYS,EnvSys(ES),0,0,0,0,0,0,0,2,2,2,0,2,3,0,3,0,0,0,5,2,7
sp11,112,MARSHALL,ETHN,Ethnic St,0,0,0,1,1,2,1,1,2,3,4,7,6,14,20,0,0,0,11,20,31
sp11,112,MARSHALL,GMST,German Stu,0,0,0,0,0,0,0,0,0,0,0,0,2,0,2,0,0,0,2,0,2
sp11,112,MARSHALL,HDP,Human Dev,0,0,0,0,0,0,0,1,1,0,7,7,1,39,40,0,0,0,1,47,48
sp11,112,MARSHALL,HDP,Pr-HumnDev,0,0,0,0,2,2,2,10,12,2,15,17,0,7,7,0,0,0,4,34,38
sp11,112,MARSHALL,HIST,History,0,0,0,0,0,0,1,3,4,11,4,15,20,18,38,0,0,0,32,25,57
sp11,112,MARSHALL,INTD,Mar Ind St,0,0,0,0,0,0,0,0,0,0,0,0,1,0,1,0,0,0,1,0,1
sp11,112,MARSHALL,INTL,IntSt-Anth,0,0,0,0,1,1,0,1,1,0,2,2,0,3,3,0,0,0,0,7,7
sp11,112,MARSHALL,INTL,IntSt-Econ,0,0,0,1,0,1,2,6,8,11,9,20,12,10,22,0,0,0,26,25,51
sp11,112,MARSHALL,INTL,IntSt-Hist,0,0,0,0,0,0,1,0,1,0,0,0,1,3,4,0,0,0,2,3,5
sp11,112,MARSHALL,INTL,IntSt-Ling,0,0,0,0,0,0,0,1,1,0,2,2,0,2,2,0,0,0,0,5,5
sp11,112,MARSHALL,INTL,IntSt-Lit,0,0,0,0,0,0,0,1,1,0,0,0,0,1,1,0,0,0,0,2,2
sp11,112,MARSHALL,INTL,IntSt-PolS,0,0,0,0,0,0,2,6,8,1,9,10,9,14,23,0,0,0,12,29,41
sp11,112,MARSHALL,INTL,IntSt-Soc,0,0,0,0,1,1,0,4,4,1,6,7,3,13,16,0,0,0,4,24,28
sp11,112,MARSHALL,ITAL,Italian St,0,0,0,1,0,1,0,0,0,0,0,0,0,0,0,0,0,0,1,0,1
sp11,112,MARSHALL,LATI,LatinAm St,0,0,0,0,0,0,0,0,0,0,1,1,1,2,3,0,0,0,1,3,4
sp11,112,MARSHALL,LING,Lang Stu,0,0,0,0,0,0,0,1,1,0,3,3,0,3,3,0,0,0,0,7,7
sp11,112,MARSHALL,LING,Ling-CogLn,0,0,0,0,1,1,0,1,1,0,1,1,2,0,2,0,0,0,2,3,5
sp11,112,MARSHALL,LING,Ling-LSoc,0,0,0,0,1,1,0,0,0,0,0,0,0,2,2,0,0,0,0,3,3
sp11,112,MARSHALL,LING,Linguistcs,0,0,0,0,0,0,0,0,0,3,3,6,0,2,2,0,0,0,3,5,8
sp11,112,MARSHALL,LIT,Lit/CultSt,0,0,0,0,0,0,0,0,0,0,0,0,0,1,1,0,0,0,0,1,1
sp11,112,MARSHALL,LIT,Lit/Engl,0,0,0,0,1,1,2,1,3,2,4,6,2,6,8,0,0,0,6,12,18
sp11,112,MARSHALL,LIT,Lit/World,0,0,0,0,0,0,0,0,0,0,2,2,0,3,3,0,0,0,0,5,5
sp11,112,MARSHALL,LIT,Lit/Writng,0,0,0,0,0,0,0,3,3,3,4,7,7,8,15,0,0,0,10,15,25
sp11,112,MARSHALL,LIT,Pre-Lit/Wr,0,0,0,0,0,0,0,0,0,1,2,3,1,2,3,0,0,0,2,4,6
sp11,112,MARSHALL,LIT,Spanish Lt,0,0,0,0,0,0,0,0,0,0,1,1,0,2,2,0,0,0,0,3,3
sp11,112,MARSHALL,MAE,Aerosp Eng,0,0,0,1,1,2,6,2,8,8,1,9,18,8,26,0,0,0,33,12,45
sp11,112,MARSHALL,MAE,Engin Sci,0,0,0,0,0,0,0,0,0,2,0,2,0,0,0,0,0,0,2,0,2
sp11,112,MARSHALL,MAE,Envir Eng,0,0,0,1,2,3,2,5,7,3,1,4,2,2,4,0,0,0,8,10,18
sp11,112,MARSHALL,MAE,Mech Engin,0,0,0,1,0,1,6,3,9,18,4,22,59,6,65,0,0,0,84,13,97
sp11,112,MARSHALL,MATH,Appld Math,0,0,0,1,1,2,2,2,4,0,2,2,1,0,1,0,0,0,4,5,9
sp11,112,MARSHALL,MATH,Math/SecEd,0,0,0,0,0,0,1,2,3,1,1,2,2,4,6,0,0,0,4,7,11
sp11,112,MARSHALL,MATH,Mathematcs,0,0,0,0,0,0,2,4,6,4,1,5,8,6,14,0,0,0,14,11,25
sp11,112,MARSHALL,MATH,Mth-CompSc,0,0,0,0,0,0,0,0,0,0,0,0,1,3,4,0,0,0,1,3,4
sp11,112,MARSHALL,MATH,Mth-Mth&Ec,0,0,0,1,0,1,1,2,3,2,1,3,11,4,15,0,0,0,15,7,22
sp11,112,MARSHALL,MATH,Mth-SciCom,0,0,0,0,0,0,0,0,0,1,0,1,0,0,0,0,0,0,1,0,1
sp11,112,MARSHALL,MATH,Mth/ApldSc,0,0,0,1,0,1,0,1,1,0,0,0,1,0,1,0,0,0,2,1,3
sp11,112,MARSHALL,MATH,Pr-Math CS,0,0,0,0,0,0,0,1,1,1,0,1,0,0,0,0,0,0,1,1,2
sp11,112,MARSHALL,MATH,Prob&Stats,0,0,0,0,0,0,0,1,1,0,2,2,2,0,2,0,0,0,2,3,5
sp11,112,MARSHALL,MUS,Mu-CompArt,0,0,0,0,0,0,0,0,0,1,0,1,5,3,8,0,0,0,6,3,9
sp11,112,MARSHALL,MUS,Music,0,0,0,0,0,0,1,0,1,2,2,4,2,4,6,0,0,0,5,6,11
sp11,112,MARSHALL,NENG,NanoEng,0,0,0,0,0,0,1,2,3,4,1,5,0,0,0,0,0,0,5,3,8
sp11,112,MARSHALL,PHIL,Philosophy,0,0,0,0,0,0,1,1,2,0,2,2,10,2,12,0,0,0,11,5,16
sp11,112,MARSHALL,PHYS,Biophysics,0,0,0,1,0,1,0,0,0,0,1,1,1,1,2,0,0,0,2,2,4
sp11,112,MARSHALL,PHYS,Phy/ErthSc,0,0,0,0,0,0,0,0,0,0,0,0,1,0,1,0,0,0,1,0,1
sp11,112,MARSHALL,PHYS,Phys/Astro,0,0,0,1,0,1,0,1,1,0,1,1,1,0,1,0,0,0,2,2,4
sp11,112,MARSHALL,PHYS,Phys/Comp,0,0,0,1,0,1,0,0,0,0,0,0,0,1,1,0,0,0,1,1,2
sp11,112,MARSHALL,PHYS,Physics,0,0,0,0,0,0,1,0,1,2,1,3,3,2,5,0,0,0,6,3,9
sp11,112,MARSHALL,POLI,Polit Sci,0,0,0,3,1,4,8,4,12,16,23,39,32,30,62,0,0,0,59,58,117
sp11,112,MARSHALL,POLI,PolSc-Amer,0,0,0,0,1,1,0,2,2,4,1,5,4,3,7,0,0,0,8,7,15
sp11,112,MARSHALL,POLI,PolSc-Comp,0,0,0,0,0,0,0,0,0,0,2,2,0,1,1,0,0,0,0,3,3
sp11,112,MARSHALL,POLI,PolSc-Intl,0,0,0,0,0,0,4,4,8,9,6,15,21,18,39,0,0,0,34,28,62
sp11,112,MARSHALL,POLI,PolSc-PLaw,0,0,0,1,1,2,6,4,10,4,1,5,11,4,15,0,0,0,22,10,32
sp11,112,MARSHALL,POLI,PolSc-PPol,0,0,0,0,0,0,0,0,0,2,0,2,3,4,7,0,0,0,5,4,9
sp11,112,MARSHALL,POLI,PolSc-Thry,0,0,0,0,0,0,2,0,2,2,1,3,0,2,2,0,0,0,4,3,7
sp11,112,MARSHALL,PSYC,Psychology,0,0,0,5,8,13,8,31,39,31,60,91,33,91,124,0,0,0,77,190,267
sp11,112,MARSHALL,RELI,Relig/Stu,0,0,0,0,0,0,0,0,0,0,0,0,0,3,3,0,0,0,0,3,3
sp11,112,MARSHALL,SE,Struct Eng,0,0,0,4,3,7,12,2,14,11,9,20,26,17,43,0,0,0,53,31,84
sp11,112,MARSHALL,SIO,Earth Sci,0,0,0,0,0,0,1,0,1,2,0,2,1,2,3,0,0,0,4,2,6
sp11,112,MARSHALL,SOC,SocCulCom,0,0,0,0,0,0,0,0,0,0,2,2,0,2,2,0,0,0,0,4,4
sp11,112,MARSHALL,SOC,SocEconSoc,0,0,0,0,0,0,2,0,2,0,1,1,0,1,1,0,0,0,2,2,4
sp11,112,MARSHALL,SOC,SocIntlStu,0,0,0,0,0,0,0,1,1,0,1,1,0,1,1,0,0,0,0,3,3
sp11,112,MARSHALL,SOC,Sociology,0,0,0,0,0,0,1,4,5,7,23,30,8,21,29,0,0,0,16,48,64
sp11,112,MARSHALL,SOC,SocLawSoc,0,0,0,0,0,0,1,1,2,0,3,3,5,6,11,0,0,0,6,10,16
sp11,112,MARSHALL,SOC,SocSciMed,0,0,0,0,1,1,0,2,2,3,1,4,0,2,2,0,0,0,3,6,9
sp11,112,MARSHALL,SOC,SocSolneq,0,0,0,0,0,0,0,1,1,0,2,2,1,5,6,0,0,0,1,8,9
sp11,112,MARSHALL,THEA,Dance,0,0,0,0,0,0,0,0,0,0,0,0,0,3,3,0,0,0,0,3,3
sp11,112,MARSHALL,THEA,Theatre,0,0,0,0,0,0,1,1,2,2,1,3,1,3,4,0,0,0,4,5,9
sp11,112,MARSHALL,UNAF,UndecHumAr,0,0,0,0,2,2,1,0,1,0,0,0,0,0,0,0,0,0,1,2,3
sp11,112,MARSHALL,UNAF,Undeclared,0,0,0,5,12,17,17,16,33,0,0,0,0,0,0,0,0,0,22,28,50
sp11,112,MARSHALL,UNAF,UndecPhysS,0,0,0,3,1,4,1,5,6,0,0,0,0,0,0,0,0,0,4,6,10
sp11,112,MARSHALL,UNAF,UndecSocSc,0,0,0,0,2,2,1,4,5,0,0,0,0,0,0,0,0,0,1,6,7
sp11,112,MARSHALL,USP,Urb Stu&Pl,0,0,0,0,0,0,0,2,2,5,10,15,7,16,23,0,0,0,12,28,40
sp11,112,MARSHALL,VIS,Art Hst/Cr,0,0,0,0,0,0,0,0,0,0,3,3,0,7,7,0,0,0,0,10,10
sp11,112,MARSHALL,VIS,Media,0,0,0,1,0,1,3,1,4,4,4,8,10,8,18,0,0,0,18,13,31
sp11,112,MARSHALL,VIS,Studio VA,0,0,0,0,0,0,0,1,1,0,3,3,4,5,9,0,0,0,4,9,13
sp11,112,MARSHALL,VIS,VA-CompArt,0,0,0,0,1,1,0,0,0,0,1,1,1,2,3,0,0,0,1,4,5
sp11,112,MUIR,ANTH,Anth-Arch,0,0,0,0,0,0,0,3,3,1,2,3,4,2,6,0,0,0,5,7,12
sp11,112,MUIR,ANTH,Anth-Biol,0,0,0,0,0,0,0,0,0,1,1,2,4,11,15,0,0,0,5,12,17
sp11,112,MUIR,ANTH,Anth-Soci,0,0,0,0,1,1,0,2,2,2,9,11,3,6,9,0,0,0,5,18,23
sp11,112,MUIR,BENG,Bioen:Binf,0,0,0,2,0,2,0,0,0,2,1,3,0,0,0,0,0,0,4,1,5
sp11,112,MUIR,BENG,Bioeng:PM,0,0,0,0,0,0,0,0,0,0,0,0,8,3,11,0,0,0,8,3,11
sp11,112,MUIR,BENG,BioengBiot,0,0,0,0,0,0,5,0,5,2,6,8,13,8,21,0,0,0,20,14,34
sp11,112,MUIR,BENG,Bioengin,0,0,0,0,1,1,5,0,5,0,4,4,24,5,29,0,0,0,29,10,39
sp11,112,MUIR,BENG,Pr-BioenPM,0,0,0,0,0,0,1,2,3,4,0,4,0,0,0,0,0,0,5,2,7
sp11,112,MUIR,BIOL,Bioc/CellB,0,0,0,0,2,2,8,6,14,12,10,22,60,72,132,0,0,0,80,90,170
sp11,112,MUIR,BIOL,BiolBioinf,0,0,0,0,0,0,0,0,0,0,1,1,1,0,1,0,0,0,1,1,2
sp11,112,MUIR,BIOL,Ec/Beh/Evo,0,0,0,0,2,2,1,2,3,1,4,5,7,22,29,0,0,0,9,30,39
sp11,112,MUIR,BIOL,Genl Biol,0,0,0,4,4,8,8,24,32,15,36,51,43,86,129,0,0,0,70,150,220
sp11,112,MUIR,BIOL,Human Bio,0,0,0,5,9,14,20,31,51,26,41,67,69,86,155,0,0,0,120,167,287
sp11,112,MUIR,BIOL,Microbiol,0,0,0,0,1,1,2,0,2,1,4,5,8,5,13,0,0,0,11,10,21
sp11,112,MUIR,BIOL,Molec Biol,0,0,0,0,0,0,3,6,9,5,0,5,6,13,19,0,0,0,14,19,33
sp11,112,MUIR,BIOL,PhyslNeuro,0,0,0,2,2,4,11,10,21,13,13,26,32,34,66,0,0,0,58,59,117
sp11,112,MUIR,CENG,Chem Engin,0,0,0,1,0,1,2,3,5,6,2,8,13,12,25,0,0,0,22,17,39
sp11,112,MUIR,CGS,CritGendSt,0,0,0,0,0,0,0,1,1,0,0,0,1,3,4,0,0,0,1,4,5
sp11,112,MUIR,CHEM,Bioch/Chem,0,0,0,3,6,9,18,10,28,15,11,26,17,18,35,0,0,0,53,45,98
sp11,112,MUIR,CHEM,Chem Educ,0,0,0,0,0,0,0,0,0,0,1,1,0,1,1,0,0,0,0,2,2
sp11,112,MUIR,CHEM,Chem Phys,0,0,0,0,0,0,0,0,0,2,0,2,0,0,0,0,0,0,2,0,2
sp11,112,MUIR,CHEM,Chemistry,0,0,0,1,2,3,4,2,6,4,4,8,11,6,17,0,0,0,20,14,34
sp11,112,MUIR,CHEM,Envir Chem,0,0,0,0,0,0,0,0,0,2,0,2,1,1,2,0,0,0,3,1,4
sp11,112,MUIR,CHEM,MolecSynth,0,0,0,0,0,0,0,0,0,0,0,0,0,1,1,0,0,0,0,1,1
sp11,112,MUIR,CHEM,Pharm Chem,0,0,0,4,3,7,10,10,20,7,8,15,14,19,33,0,0,0,35,40,75
sp11,112,MUIR,CHIN,Chinese St,0,0,0,0,0,0,0,2,2,1,0,1,3,2,5,0,0,0,4,4,8
sp11,112,MUIR,CLAS,Classic St,0,0,0,0,0,0,0,0,0,0,1,1,0,1,1,0,0,0,0,2,2
sp11,112,MUIR,COGS,Cog Sci,0,0,0,2,1,3,4,6,10,1,4,5,11,10,21,0,0,0,18,21,39
sp11,112,MUIR,COGS,CogSc/ClAs,0,0,0,0,0,0,0,2,2,0,4,4,0,2,2,0,0,0,0,8,8
sp11,112,MUIR,COGS,CogSc/Comp,0,0,0,0,0,0,0,0,0,1,0,1,3,0,3,0,0,0,4,0,4
sp11,112,MUIR,COGS,CogSc/HCI,0,0,0,1,0,1,1,2,3,0,1,1,5,4,9,0,0,0,7,7,14
sp11,112,MUIR,COGS,CogSc/HCog,0,0,0,1,0,1,1,2,3,0,2,2,1,6,7,0,0,0,3,10,13
sp11,112,MUIR,COGS,CogSc/Neur,0,0,0,1,1,2,6,11,17,6,10,16,13,16,29,0,0,0,26,38,64
sp11,112,MUIR,COMM,Communic,0,0,0,1,3,4,0,9,9,15,41,56,15,60,75,0,0,0,31,113,144
sp11,112,MUIR,CSE,Comp Sci,0,0,0,5,3,8,12,4,16,22,3,25,41,13,54,0,0,0,80,23,103
sp11,112,MUIR,CSE,CompEngCSE,0,0,0,3,0,3,7,0,7,7,2,9,5,0,5,0,0,0,22,2,24
sp11,112,MUIR,CSE,CompScBinf,0,0,0,0,1,1,1,0,1,2,0,2,2,1,3,0,0,0,5,2,7
sp11,112,MUIR,ECE,CompEngECE,0,0,0,0,0,0,1,2,3,0,0,0,1,0,1,0,0,0,2,2,4
sp11,112,MUIR,ECE,Electr Eng,0,0,0,2,0,2,13,2,15,9,2,11,19,1,20,0,0,0,43,5,48
sp11,112,MUIR,ECE,Engin Phys,0,0,0,0,0,0,0,1,1,0,0,0,1,0,1,0,0,0,1,1,2
sp11,112,MUIR,ECON,Ec-Mth&Ecn,0,0,0,0,0,0,2,0,2,1,3,4,5,3,8,0,0,0,8,6,14
sp11,112,MUIR,ECON,Econ-MgtSc,0,0,0,9,5,14,14,12,26,28,15,43,53,25,78,0,0,0,104,57,161
sp11,112,MUIR,ECON,Economics,0,0,0,9,8,17,19,8,27,59,30,89,60,44,104,0,0,0,147,90,237
sp11,112,MUIR,ESYS,EnvSys(EB),0,0,0,2,4,6,3,8,11,5,13,18,8,13,21,0,0,0,18,38,56
sp11,112,MUIR,ESYS,EnvSys(EC),0,0,0,0,0,0,0,0,0,0,1,1,0,1,1,0,0,0,0,2,2
sp11,112,MUIR,ESYS,EnvSys(EP),0,0,0,0,0,0,0,5,5,0,2,2,2,3,5,0,0,0,2,10,12
sp11,112,MUIR,ESYS,EnvSys(ES),0,0,0,1,0,1,0,0,0,1,0,1,0,2,2,0,0,0,2,2,4
sp11,112,MUIR,ETHN,Ethnic St,0,0,0,0,0,0,0,0,0,2,3,5,3,9,12,0,0,0,5,12,17
sp11,112,MUIR,GMST,German Stu,0,0,0,0,0,0,0,0,0,0,0,0,0,1,1,0,0,0,0,1,1
sp11,112,MUIR,HDP,Human Dev,0,0,0,0,0,0,1,0,1,2,6,8,2,19,21,0,0,0,5,25,30
sp11,112,MUIR,HDP,Pr-HumnDev,0,0,0,1,3,4,0,13,13,1,10,11,0,2,2,0,0,0,2,28,30
sp11,112,MUIR,HIST,History,0,0,0,0,1,1,2,3,5,11,8,19,15,21,36,0,0,0,28,33,61
sp11,112,MUIR,INTD,Muir Sp Pr,0,0,0,0,0,0,0,0,0,0,0,0,0,1,1,0,0,0,0,1,1
sp11,112,MUIR,INTL,IntSt-Anth,0,0,0,0,0,0,0,1,1,0,1,1,1,2,3,0,0,0,1,4,5
sp11,112,MUIR,INTL,IntSt-Econ,0,0,0,2,1,3,0,6,6,8,11,19,6,15,21,0,0,0,16,33,49
sp11,112,MUIR,INTL,IntSt-Hist,0,0,0,0,0,0,1,0,1,0,1,1,1,4,5,0,0,0,2,5,7
sp11,112,MUIR,INTL,IntSt-Ling,0,0,0,0,0,0,0,0,0,0,0,0,0,1,1,0,0,0,0,1,1
sp11,112,MUIR,INTL,IntSt-Lit,0,0,0,0,0,0,0,1,1,1,0,1,1,1,2,0,0,0,2,2,4
sp11,112,MUIR,INTL,IntSt-PolS,0,0,0,1,0,1,0,2,2,2,7,9,2,17,19,0,0,0,5,26,31
sp11,112,MUIR,INTL,IntSt-Soc,0,0,0,0,1,1,1,4,5,0,7,7,5,7,12,0,0,0,6,19,25
sp11,112,MUIR,JAPN,JapaneseSt,0,0,0,0,1,1,1,1,2,1,0,1,2,4,6,0,0,0,4,6,10
sp11,112,MUIR,LATI,LatinAm St,0,0,0,0,0,0,0,0,0,0,2,2,0,0,0,0,0,0,0,2,2
sp11,112,MUIR,LING,Lang Stu,0,0,0,0,0,0,0,1,1,0,1,1,2,3,5,0,0,0,2,5,7
sp11,112,MUIR,LING,Ling-CogLn,0,0,0,0,0,0,1,1,2,1,0,1,1,3,4,0,0,0,3,4,7
sp11,112,MUIR,LING,Ling-LSoc,0,0,0,0,0,0,0,1,1,0,1,1,0,0,0,0,0,0,0,2,2
sp11,112,MUIR,LING,Linguistcs,0,0,0,0,0,0,2,0,2,2,0,2,3,9,12,0,0,0,7,9,16
sp11,112,MUIR,LIT,Lit/CultSt,0,0,0,0,1,1,0,0,0,0,0,0,0,3,3,0,0,0,0,4,4
sp11,112,MUIR,LIT,Lit/Engl,0,0,0,0,0,0,1,7,8,1,2,3,5,14,19,0,0,0,7,23,30
sp11,112,MUIR,LIT,Lit/World,0,0,0,0,0,0,0,0,0,0,1,1,0,5,5,0,0,0,0,6,6
sp11,112,MUIR,LIT,Lit/Writng,0,0,0,0,1,1,1,4,5,2,1,3,7,17,24,0,0,0,10,23,33
sp11,112,MUIR,LIT,Pre-Lit/Wr,0,0,0,0,0,0,0,1,1,2,2,4,2,2,4,0,0,0,4,5,9
sp11,112,MUIR,LIT,Spanish Lt,0,0,0,0,0,0,0,1,1,0,1,1,1,8,9,0,0,0,1,10,11
sp11,112,MUIR,MAE,Aerosp Eng,0,0,0,2,2,4,7,3,10,12,3,15,18,2,20,0,0,0,39,10,49
sp11,112,MUIR,MAE,Engin Sci,0,0,0,1,0,1,1,0,1,3,0,3,1,0,1,0,0,0,6,0,6
sp11,112,MUIR,MAE,Envir Eng,0,0,0,1,5,6,4,5,9,5,3,8,7,5,12,0,0,0,17,18,35
sp11,112,MUIR,MAE,Mech Engin,0,0,0,0,0,0,6,1,7,9,0,9,55,6,61,0,0,0,70,7,77
sp11,112,MUIR,MATH,Appld Math,0,0,0,0,0,0,0,0,0,1,2,3,3,3,6,0,0,0,4,5,9
sp11,112,MUIR,MATH,Math/SecEd,0,0,0,0,2,2,0,2,2,0,1,1,4,1,5,0,0,0,4,6,10
sp11,112,MUIR,MATH,Mathematcs,0,0,0,0,0,0,5,1,6,6,3,9,9,4,13,0,0,0,20,8,28
sp11,112,MUIR,MATH,Mth-CompSc,0,0,0,0,0,0,0,0,0,0,0,0,2,0,2,0,0,0,2,0,2
sp11,112,MUIR,MATH,Mth-Mth&Ec,0,0,0,0,0,0,2,1,3,3,2,5,6,0,6,0,0,0,11,3,14
sp11,112,MUIR,MATH,Mth-SciCom,0,0,0,0,0,0,0,0,0,0,0,0,1,0,1,0,0,0,1,0,1
sp11,112,MUIR,MATH,Mth/ApldSc,0,0,0,1,0,1,1,1,2,0,0,0,1,0,1,0,0,0,3,1,4
sp11,112,MUIR,MATH,Pr-Math CS,0,0,0,0,0,0,1,0,1,0,0,0,0,0,0,0,0,0,1,0,1
sp11,112,MUIR,MATH,Prob&Stats,0,0,0,0,0,0,1,0,1,2,0,2,5,0,5,0,0,0,8,0,8
sp11,112,MUIR,MUS,Mu-CompArt,0,0,0,0,0,0,0,0,0,2,0,2,8,0,8,0,0,0,10,0,10
sp11,112,MUIR,MUS,Music,0,0,0,1,0,1,2,0,2,1,1,2,6,5,11,0,0,0,10,6,16
sp11,112,MUIR,MUS,Music Hum,0,0,0,0,0,0,0,0,0,0,0,0,1,2,3,0,0,0,1,2,3
sp11,112,MUIR,NENG,NanoEng,0,0,0,0,0,0,5,1,6,2,1,3,1,0,1,0,0,0,8,2,10
sp11,112,MUIR,PHIL,Philosophy,0,0,0,2,0,2,2,1,3,3,3,6,5,2,7,0,0,0,12,6,18
sp11,112,MUIR,PHYS,Biophysics,0,0,0,1,0,1,2,0,2,2,0,2,4,1,5,0,0,0,9,1,10
sp11,112,MUIR,PHYS,Phy/ErthSc,0,0,0,0,0,0,0,0,0,0,0,0,0,1,1,0,0,0,0,1,1
sp11,112,MUIR,PHYS,Phys/Astro,0,0,0,0,0,0,2,0,2,2,1,3,2,1,3,0,0,0,6,2,8
sp11,112,MUIR,PHYS,Phys/Comp,0,0,0,0,0,0,0,0,0,0,0,0,1,0,1,0,0,0,1,0,1
sp11,112,MUIR,PHYS,Physics,0,0,0,1,0,1,0,1,1,4,0,4,3,2,5,0,0,0,8,3,11
sp11,112,MUIR,POLI,Polit Sci,0,0,0,2,2,4,9,8,17,16,12,28,23,29,52,0,0,0,50,51,101
sp11,112,MUIR,POLI,PolSc-Amer,0,0,0,1,1,2,2,0,2,1,3,4,6,5,11,0,0,0,10,9,19
sp11,112,MUIR,POLI,PolSc-Comp,0,0,0,0,0,0,0,0,0,0,0,0,0,1,1,0,0,0,0,1,1
sp11,112,MUIR,POLI,PolSc-Intl,0,0,0,1,3,4,1,5,6,12,7,19,19,9,28,0,0,0,33,24,57
sp11,112,MUIR,POLI,PolSc-PLaw,0,0,0,2,0,2,4,5,9,3,2,5,8,5,13,0,0,0,17,12,29
sp11,112,MUIR,POLI,PolSc-PPol,0,0,0,0,0,0,0,1,1,2,0,2,2,1,3,0,0,0,4,2,6
sp11,112,MUIR,POLI,PolSc-Thry,0,0,0,0,0,0,0,0,0,0,0,0,2,0,2,0,0,0,2,0,2
sp11,112,MUIR,PSYC,Psychology,0,0,0,4,15,19,19,38,57,27,73,100,40,100,140,0,0,0,90,226,316
sp11,112,MUIR,RELI,Relig/Stu,0,0,0,0,0,0,0,0,0,0,0,0,3,1,4,0,0,0,3,1,4
sp11,112,MUIR,RUSS,Russ&SovSt,0,0,0,0,0,0,0,1,1,0,0,0,1,0,1,0,0,0,1,1,2
sp11,112,MUIR,SE,Struct Eng,0,0,0,3,2,5,12,2,14,12,4,16,29,9,38,0,0,0,56,17,73
sp11,112,MUIR,SIO,Earth Sci,0,0,0,0,1,1,0,1,1,2,1,3,2,0,2,0,0,0,4,3,7
sp11,112,MUIR,SIO,ErSc-Geol,0,0,0,0,0,0,0,0,0,0,0,0,3,0,3,0,0,0,3,0,3
sp11,112,MUIR,SOC,SocCulCom,0,0,0,0,0,0,0,1,1,0,2,2,1,0,1,0,0,0,1,3,4
sp11,112,MUIR,SOC,SocEconSoc,0,0,0,0,0,0,0,0,0,0,0,0,1,0,1,0,0,0,1,0,1
sp11,112,MUIR,SOC,SocIntlStu,0,0,0,0,0,0,0,0,0,0,1,1,0,2,2,0,0,0,0,3,3
sp11,112,MUIR,SOC,Sociology,0,0,0,0,2,2,4,4,8,10,21,31,6,19,25,0,0,0,20,46,66
sp11,112,MUIR,SOC,SocLawSoc,0,0,0,0,3,3,0,1,1,3,1,4,1,3,4,0,0,0,4,8,12
sp11,112,MUIR,SOC,SocSciMed,0,0,0,0,0,0,0,0,0,1,3,4,2,3,5,0,0,0,3,6,9
sp11,112,MUIR,SOC,SocSolneq,0,0,0,0,0,0,0,1,1,0,2,2,0,3,3,0,0,0,0,6,6
sp11,112,MUIR,THEA,Dance,0,0,0,0,1,1,0,0,0,0,0,0,2,2,4,0,0,0,2,3,5
sp11,112,MUIR,THEA,Theatre,0,0,0,0,1,1,2,1,3,3,4,7,2,13,15,0,0,0,7,19,26
sp11,112,MUIR,UNAF,UndecHumAr,0,0,0,0,2,2,1,1,2,0,0,0,0,0,0,0,0,0,1,3,4
sp11,112,MUIR,UNAF,Undeclared,0,0,0,13,26,39,29,30,59,5,1,6,0,0,0,0,0,0,47,57,104
sp11,112,MUIR,UNAF,UndecPhysS,0,0,0,3,1,4,4,5,9,0,1,1,0,0,0,0,0,0,7,7,14
sp11,112,MUIR,UNAF,UndecSocSc,0,0,0,3,3,6,1,4,5,0,0,0,0,0,0,0,0,0,4,7,11
sp11,112,MUIR,USP,Urb Stu&Pl,0,0,0,1,1,2,0,2,2,8,4,12,9,10,19,0,0,0,18,17,35
sp11,112,MUIR,VIS,Art Hst/Cr,0,0,0,0,0,0,0,2,2,0,2,2,1,8,9,0,0,0,1,12,13
sp11,112,MUIR,VIS,Media,0,0,0,1,0,1,4,5,9,2,12,14,17,10,27,0,0,0,24,27,51
sp11,112,MUIR,VIS,Studio VA,0,0,0,0,2,2,0,3,3,3,5,8,1,6,7,0,0,0,4,16,20
sp11,112,MUIR,VIS,VA-CompArt,0,0,0,1,0,1,0,3,3,1,2,3,7,2,9,0,0,0,9,7,16
sp11,112,REVELLE,ANTH,Anth-Arch,0,0,0,1,0,1,0,0,0,1,0,1,0,2,2,0,0,0,2,2,4
sp11,112,REVELLE,ANTH,Anth-Biol,0,0,0,0,0,0,0,2,2,0,2,2,2,6,8,0,0,0,2,10,12
sp11,112,REVELLE,ANTH,Anth-Soci,0,0,0,0,0,0,0,0,0,1,5,6,2,7,9,0,0,0,3,12,15
sp11,112,REVELLE,BENG,Bioen:Binf,0,0,0,1,1,2,1,0,1,2,1,3,2,1,3,0,0,0,6,3,9
sp11,112,REVELLE,BENG,Bioeng:PM,0,0,0,0,0,0,0,0,0,2,0,2,25,9,34,0,0,0,27,9,36
sp11,112,REVELLE,BENG,BioengBiot,0,0,0,0,1,1,8,1,9,15,7,22,15,8,23,0,0,0,38,17,55
sp11,112,REVELLE,BENG,Bioengin,0,0,0,0,2,2,2,4,6,7,1,8,17,12,29,0,0,0,26,19,45
sp11,112,REVELLE,BENG,Pr-BioenPM,0,0,0,0,0,0,1,1,2,3,3,6,2,1,3,0,0,0,6,5,11
sp11,112,REVELLE,BIOL,Anml Physl,0,0,0,0,0,0,0,0,0,0,0,0,1,0,1,0,0,0,1,0,1
sp11,112,REVELLE,BIOL,Bioc/CellB,0,0,0,2,2,4,8,8,16,24,14,38,104,94,198,0,0,0,138,118,256
sp11,112,REVELLE,BIOL,BiolBioinf,0,0,0,0,0,0,0,0,0,2,0,2,1,0,1,0,0,0,3,0,3
sp11,112,REVELLE,BIOL,Ec/Beh/Evo,0,0,0,0,1,1,3,3,6,1,2,3,6,13,19,0,0,0,10,19,29
sp11,112,REVELLE,BIOL,Genl Biol,0,0,0,3,2,5,9,23,32,17,34,51,53,113,166,0,0,0,82,172,254
sp11,112,REVELLE,BIOL,Human Bio,0,0,0,2,9,11,12,38,50,45,60,105,106,133,239,0,0,0,165,240,405
sp11,112,REVELLE,BIOL,Microbiol,0,0,0,0,0,0,2,1,3,2,5,7,11,15,26,0,0,0,15,21,36
sp11,112,REVELLE,BIOL,Molec Biol,0,0,0,0,1,1,1,1,2,8,6,14,18,14,32,0,0,0,27,22,49
sp11,112,REVELLE,BIOL,PhyslNeuro,0,0,0,1,3,4,6,12,18,12,17,29,44,40,84,0,0,0,63,72,135
sp11,112,REVELLE,CENG,Chem Engin,0,0,0,2,1,3,9,2,11,9,7,16,27,9,36,0,0,0,47,19,66
sp11,112,REVELLE,CHEM,Bioch/Chem,0,0,0,4,11,15,18,15,33,17,15,32,20,23,43,0,0,0,59,64,123
sp11,112,REVELLE,CHEM,Chem Phys,0,0,0,0,0,0,0,0,0,0,0,0,1,0,1,0,0,0,1,0,1
sp11,112,REVELLE,CHEM,Chemistry,0,0,0,1,1,2,3,2,5,8,6,14,10,12,22,0,0,0,22,21,43
sp11,112,REVELLE,CHEM,Envir Chem,0,0,0,0,0,0,0,1,1,1,0,1,1,1,2,0,0,0,2,2,4
sp11,112,REVELLE,CHEM,MolecSynth,0,0,0,0,1,1,0,1,1,0,0,0,5,0,5,0,0,0,5,2,7
sp11,112,REVELLE,CHEM,Pharm Chem,0,0,0,2,7,9,8,14,22,12,28,40,20,29,49,0,0,0,42,78,120
sp11,112,REVELLE,CHIN,Chinese St,0,0,0,0,0,0,0,0,0,0,0,0,2,0,2,0,0,0,2,0,2
sp11,112,REVELLE,CLAS,Classic St,0,0,0,0,0,0,1,0,1,0,0,0,0,1,1,0,0,0,1,1,2
sp11,112,REVELLE,COGS,Cog Sci,0,0,0,2,2,4,5,5,10,5,1,6,3,3,6,0,0,0,15,11,26
sp11,112,REVELLE,COGS,CogSc/ClAs,0,0,0,0,0,0,1,0,1,0,4,4,1,2,3,0,0,0,2,6,8
sp11,112,REVELLE,COGS,CogSc/Comp,0,0,0,0,0,0,0,0,0,0,0,0,1,0,1,0,0,0,1,0,1
sp11,112,REVELLE,COGS,CogSc/HCI,0,0,0,0,0,0,0,1,1,0,0,0,2,1,3,0,0,0,2,2,4
sp11,112,REVELLE,COGS,CogSc/HCog,0,0,0,0,0,0,0,4,4,0,3,3,1,0,1,0,0,0,1,7,8
sp11,112,REVELLE,COGS,CogSc/Neur,0,0,0,0,5,5,1,7,8,2,17,19,5,11,16,0,0,0,8,40,48
sp11,112,REVELLE,COMM,Communic,0,0,0,2,1,3,0,9,9,7,7,14,11,20,31,0,0,0,20,37,57
sp11,112,REVELLE,CSE,Comp Sci,0,0,0,2,0,2,13,3,16,21,1,22,50,8,58,0,0,0,86,12,98
sp11,112,REVELLE,CSE,CompEngCSE,0,0,0,0,0,0,6,1,7,6,1,7,8,0,8,0,0,0,20,2,22
sp11,112,REVELLE,CSE,CompScBinf,0,0,0,0,0,0,1,0,1,1,0,1,1,2,3,0,0,0,3,2,5
sp11,112,REVELLE,ECE,CompEngECE,0,0,0,1,0,1,4,1,5,2,0,2,2,0,2,0,0,0,9,1,10
sp11,112,REVELLE,ECE,Electr Eng,0,0,0,1,0,1,6,0,6,16,2,18,29,7,36,0,0,0,52,9,61
sp11,112,REVELLE,ECE,Engin Phys,0,0,0,0,0,0,2,0,2,0,0,0,1,0,1,0,0,0,3,0,3
sp11,112,REVELLE,ECON,Ec-Mth&Ecn,0,0,0,0,1,1,1,1,2,6,0,6,5,4,9,0,0,0,12,6,18
sp11,112,REVELLE,ECON,Econ-MgtSc,0,0,0,0,1,1,10,7,17,18,6,24,33,12,45,0,0,0,61,26,87
sp11,112,REVELLE,ECON,Economics,0,0,0,3,2,5,10,6,16,28,13,41,46,28,74,0,0,0,87,49,136
sp11,112,REVELLE,ESYS,EnvSys(EB),0,0,0,0,0,0,1,6,7,0,7,7,4,3,7,0,0,0,5,16,21
sp11,112,REVELLE,ESYS,EnvSys(EC),0,0,0,0,0,0,0,0,0,0,1,1,1,0,1,0,0,0,1,1,2
sp11,112,REVELLE,ESYS,EnvSys(EP),0,0,0,0,0,0,0,1,1,1,1,2,0,2,2,0,0,0,1,4,5
sp11,112,REVELLE,ESYS,EnvSys(ES),0,0,0,0,0,0,0,0,0,2,0,2,1,2,3,0,0,0,3,2,5
sp11,112,REVELLE,ETHN,Ethnic St,0,0,0,0,0,0,0,0,0,1,3,4,6,3,9,0,0,0,7,6,13
sp11,112,REVELLE,HDP,Human Dev,0,0,0,0,0,0,0,0,0,1,2,3,0,21,21,0,0,0,1,23,24
sp11,112,REVELLE,HDP,Pr-HumnDev,0,0,0,0,1,1,2,6,8,0,5,5,0,1,1,0,0,0,2,13,15
sp11,112,REVELLE,HIST,History,0,0,0,0,0,0,1,1,2,7,4,11,6,11,17,0,0,0,14,16,30
sp11,112,REVELLE,INTD,Rev Ind Mj,0,0,0,0,0,0,0,0,0,0,0,0,0,1,1,0,0,0,0,1,1
sp11,112,REVELLE,INTL,IntSt-Anth,0,0,0,0,0,0,1,0,1,1,0,1,0,0,0,0,0,0,2,0,2
sp11,112,REVELLE,INTL,IntSt-Econ,0,0,0,0,1,1,1,3,4,2,4,6,10,3,13,0,0,0,13,11,24
sp11,112,REVELLE,INTL,IntSt-Hist,0,0,0,0,0,0,0,1,1,0,0,0,0,2,2,0,0,0,0,3,3
sp11,112,REVELLE,INTL,IntSt-Ling,0,0,0,0,0,0,0,1,1,1,0,1,1,2,3,0,0,0,2,3,5
sp11,112,REVELLE,INTL,IntSt-Lit,0,0,0,0,0,0,0,0,0,0,0,0,0,2,2,0,0,0,0,2,2
sp11,112,REVELLE,INTL,IntSt-PolS,0,0,0,0,0,0,0,2,2,1,3,4,5,10,15,0,0,0,6,15,21
sp11,112,REVELLE,INTL,IntSt-Soc,0,0,0,0,0,0,0,0,0,1,2,3,1,3,4,0,0,0,2,5,7
sp11,112,REVELLE,JAPN,JapaneseSt,0,0,0,0,0,0,0,0,0,2,1,3,0,0,0,0,0,0,2,1,3
sp11,112,REVELLE,JUDA,Judaic Stu,0,0,0,0,0,0,0,0,0,1,0,1,0,0,0,0,0,0,1,0,1
sp11,112,REVELLE,LING,Lang Stu,0,0,0,0,0,0,0,0,0,0,1,1,0,0,0,0,0,0,0,1,1
sp11,112,REVELLE,LING,Ling-CogLn,0,0,0,0,0,0,0,1,1,2,2,4,0,3,3,0,0,0,2,6,8
sp11,112,REVELLE,LING,Ling-LSoc,0,0,0,0,0,0,0,0,0,0,2,2,0,0,0,0,0,0,0,2,2
sp11,112,REVELLE,LING,Linguistcs,0,0,0,0,0,0,1,3,4,1,1,2,1,5,6,0,0,0,3,9,12
sp11,112,REVELLE,LIT,Ital Lit,0,0,0,0,0,0,0,0,0,0,0,0,0,3,3,0,0,0,0,3,3
sp11,112,REVELLE,LIT,Lit/Compos,0,0,0,0,0,0,0,1,1,0,0,0,1,0,1,0,0,0,1,1,2
sp11,112,REVELLE,LIT,Lit/CultSt,0,0,0,0,0,0,0,0,0,0,0,0,0,1,1,0,0,0,0,1,1
sp11,112,REVELLE,LIT,Lit/Engl,0,0,0,0,0,0,1,1,2,0,1,1,0,3,3,0,0,0,1,5,6
sp11,112,REVELLE,LIT,Lit/World,0,0,0,0,0,0,0,0,0,0,0,0,1,1,2,0,0,0,1,1,2
sp11,112,REVELLE,LIT,Lit/Writng,0,0,0,0,0,0,1,4,5,0,1,1,7,3,10,0,0,0,8,8,16
sp11,112,REVELLE,LIT,Pre-Lit/Wr,0,0,0,0,0,0,0,0,0,0,2,2,2,0,2,0,0,0,2,2,4
sp11,112,REVELLE,LIT,Spanish Lt,0,0,0,0,0,0,0,1,1,1,0,1,0,3,3,0,0,0,1,4,5
sp11,112,REVELLE,MAE,Aerosp Eng,0,0,0,2,0,2,7,1,8,6,2,8,21,5,26,0,0,0,36,8,44
sp11,112,REVELLE,MAE,Engin Sci,0,0,0,0,0,0,5,1,6,1,1,2,3,2,5,0,0,0,9,4,13
sp11,112,REVELLE,MAE,Envir Eng,0,0,0,1,0,1,6,0,6,4,2,6,3,1,4,0,0,0,14,3,17
sp11,112,REVELLE,MAE,Mech Engin,0,0,0,0,2,2,11,1,12,11,3,14,46,10,56,0,0,0,68,16,84
sp11,112,REVELLE,MATH,Appld Math,0,0,0,0,1,1,3,1,4,1,2,3,3,2,5,0,0,0,7,6,13
sp11,112,REVELLE,MATH,Math/SecEd,0,0,0,0,0,0,0,0,0,0,0,0,3,2,5,0,0,0,3,2,5
sp11,112,REVELLE,MATH,Mathematcs,0,0,0,0,1,1,2,2,4,5,3,8,6,8,14,0,0,0,13,14,27
sp11,112,REVELLE,MATH,Mth-CompSc,0,0,0,0,0,0,0,0,0,1,0,1,1,0,1,0,0,0,2,0,2
sp11,112,REVELLE,MATH,Mth-Mth&Ec,0,0,0,0,0,0,0,1,1,3,1,4,5,2,7,0,0,0,8,4,12
sp11,112,REVELLE,MATH,Mth-SciCom,0,0,0,0,0,0,0,1,1,0,0,0,0,2,2,0,0,0,0,3,3
sp11,112,REVELLE,MATH,Mth/ApldSc,0,0,0,0,0,0,1,0,1,0,0,0,0,2,2,0,0,0,1,2,3
sp11,112,REVELLE,MATH,Pr-Math CS,0,0,0,0,0,0,1,0,1,0,0,0,0,0,0,0,0,0,1,0,1
sp11,112,REVELLE,MATH,Prob&Stats,0,0,0,0,0,0,1,2,3,0,0,0,5,0,5,0,0,0,6,2,8
sp11,112,REVELLE,MUS,Mu-CompArt,0,0,0,0,0,0,0,0,0,1,0,1,4,1,5,0,0,0,5,1,6
sp11,112,REVELLE,MUS,Music,0,0,0,0,0,0,1,0,1,1,1,2,6,1,7,0,0,0,8,2,10
sp11,112,REVELLE,NENG,NanoEng,0,0,0,0,1,1,7,4,11,7,1,8,3,1,4,0,0,0,17,7,24
sp11,112,REVELLE,PHIL,Philosophy,0,0,0,0,0,0,1,0,1,6,0,6,5,2,7,0,0,0,12,2,14
sp11,112,REVELLE,PHYS,Biophysics,0,0,0,0,0,0,2,1,3,0,1,1,1,1,2,0,0,0,3,3,6
sp11,112,REVELLE,PHYS,GenPys/SEd,0,0,0,0,0,0,1,0,1,0,0,0,0,0,0,0,0,0,1,0,1
sp11,112,REVELLE,PHYS,Phy/ErthSc,0,0,0,0,0,0,0,0,0,1,0,1,2,0,2,0,0,0,3,0,3
sp11,112,REVELLE,PHYS,Phys/Astro,0,0,0,0,0,0,2,0,2,0,0,0,6,1,7,0,0,0,8,1,9
sp11,112,REVELLE,PHYS,Phys/Comp,0,0,0,0,0,0,1,0,1,0,1,1,1,0,1,0,0,0,2,1,3
sp11,112,REVELLE,PHYS,Phys/Mtrls,0,0,0,0,1,1,1,0,1,0,0,0,1,0,1,0,0,0,2,1,3
sp11,112,REVELLE,PHYS,Physics,0,0,0,2,0,2,5,1,6,4,0,4,9,1,10,0,0,0,20,2,22
sp11,112,REVELLE,POLI,Polit Sci,0,0,0,0,0,0,1,3,4,7,7,14,16,10,26,0,0,0,24,20,44
sp11,112,REVELLE,POLI,PolSc-Amer,0,0,0,0,0,0,1,1,2,1,2,3,1,4,5,0,0,0,3,7,10
sp11,112,REVELLE,POLI,PolSc-Intl,0,0,0,1,1,2,1,1,2,3,4,7,6,6,12,0,0,0,11,12,23
sp11,112,REVELLE,POLI,PolSc-PLaw,0,0,0,0,1,1,1,0,1,2,1,3,3,5,8,0,0,0,6,7,13
sp11,112,REVELLE,POLI,PolSc-PPol,0,0,0,0,0,0,1,1,2,0,0,0,0,1,1,0,0,0,1,2,3
sp11,112,REVELLE,POLI,PolSc-Thry,0,0,0,0,0,0,1,0,1,0,1,1,0,0,0,0,0,0,1,1,2
sp11,112,REVELLE,PSYC,Psychology,0,0,0,4,8,12,7,28,35,19,48,67,35,83,118,0,0,0,65,167,232
sp11,112,REVELLE,RELI,Relig/Stu,0,0,0,0,0,0,0,0,0,1,1,2,1,0,1,0,0,0,2,1,3
sp11,112,REVELLE,SE,Struct Eng,0,0,0,2,1,3,7,2,9,7,4,11,28,11,39,0,0,0,44,18,62
sp11,112,REVELLE,SIO,Earth Sci,0,0,0,0,1,1,0,2,2,1,0,1,3,1,4,0,0,0,4,4,8
sp11,112,REVELLE,SIO,ErSc-Geoch,0,0,0,0,0,0,0,0,0,0,0,0,0,1,1,0,0,0,0,1,1
sp11,112,REVELLE,SIO,ErSc-Geol,0,0,0,0,0,0,0,0,0,0,0,0,1,0,1,0,0,0,1,0,1
sp11,112,REVELLE,SOC,SocCulCom,0,0,0,0,0,0,0,0,0,0,0,0,0,3,3,0,0,0,0,3,3
sp11,112,REVELLE,SOC,SocEconSoc,0,0,0,0,0,0,0,0,0,0,1,1,2,1,3,0,0,0,2,2,4
sp11,112,REVELLE,SOC,Sociology,0,0,0,0,1,1,0,2,2,1,5,6,3,3,6,0,0,0,4,11,15
sp11,112,REVELLE,SOC,SocLawSoc,0,0,0,0,0,0,0,0,0,0,1,1,2,1,3,0,0,0,2,2,4
sp11,112,REVELLE,SOC,SocSciMed,0,0,0,0,1,1,0,1,1,0,1,1,0,2,2,0,0,0,0,5,5
sp11,112,REVELLE,SOC,SocSolneq,0,0,0,0,0,0,0,0,0,0,0,0,0,1,1,0,0,0,0,1,1
sp11,112,REVELLE,THEA,Dance,0,0,0,1,0,1,0,0,0,0,0,0,0,1,1,0,0,0,1,1,2
sp11,112,REVELLE,THEA,Theatre,0,0,0,1,0,1,1,1,2,0,1,1,1,4,5,0,0,0,3,6,9
sp11,112,REVELLE,TWS,ThirdWldSt,0,0,0,0,0,0,0,0,0,0,0,0,0,1,1,0,0,0,0,1,1
sp11,112,REVELLE,UNAF,Limited St,0,0,0,0,0,0,0,0,0,0,0,0,0,0,0,5,5,10,5,5,10
sp11,112,REVELLE,UNAF,Spec-Emply,0,0,0,0,0,0,0,0,0,0,0,0,0,0,0,5,3,8,5,3,8
sp11,112,REVELLE,UNAF,UndecHumAr,0,0,0,0,0,0,0,4,4,0,1,1,0,0,0,0,0,0,0,5,5
sp11,112,REVELLE,UNAF,Undeclared,0,0,0,8,11,19,19,32,51,5,5,10,0,0,0,0,0,0,32,48,80
sp11,112,REVELLE,UNAF,UndecPhysS,0,0,0,0,0,0,2,5,7,0,0,0,0,0,0,0,0,0,2,5,7
sp11,112,REVELLE,USP,Urb Stu&Pl,0,0,0,0,0,0,1,1,2,3,1,4,1,3,4,0,0,0,5,5,10
sp11,112,REVELLE,VIS,Art Hst/Cr,0,0,0,0,0,0,0,0,0,0,0,0,0,4,4,0,0,0,0,4,4
sp11,112,REVELLE,VIS,Media,0,0,0,0,1,1,0,1,1,1,0,1,4,4,8,0,0,0,5,6,11
sp11,112,REVELLE,VIS,Studio VA,0,0,0,0,0,0,0,0,0,0,1,1,2,3,5,0,0,0,2,4,6
sp11,112,REVELLE,VIS,VA-CompArt,0,0,0,0,0,0,0,0,0,0,1,1,3,2,5,0,0,0,3,3,6
sp11,112,ROOSEVELT,ANTH,Anth-Arch,0,0,0,1,0,1,1,3,4,0,2,2,3,7,10,0,0,0,5,12,17
sp11,112,ROOSEVELT,ANTH,Anth-Biol,0,0,0,0,0,0,0,1,1,0,3,3,1,7,8,0,0,0,1,11,12
sp11,112,ROOSEVELT,ANTH,Anth-Soci,0,0,0,0,1,1,0,2,2,1,7,8,2,3,5,0,0,0,3,13,16
sp11,112,ROOSEVELT,BENG,Bioen:Binf,0,0,0,0,0,0,0,0,0,1,0,1,0,1,1,0,0,0,1,1,2
sp11,112,ROOSEVELT,BENG,Bioeng:PM,0,0,0,0,0,0,1,0,1,3,0,3,8,6,14,0,0,0,12,6,18
sp11,112,ROOSEVELT,BENG,BioengBiot,0,0,0,0,0,0,1,1,2,5,1,6,12,6,18,0,0,0,18,8,26
sp11,112,ROOSEVELT,BENG,Bioengin,0,0,0,0,1,1,1,0,1,5,1,6,3,9,12,0,0,0,9,11,20
sp11,112,ROOSEVELT,BENG,Pr-BioenPM,0,0,0,0,0,0,1,0,1,1,0,1,0,0,0,0,0,0,2,0,2
sp11,112,ROOSEVELT,BIOL,Bioc/CellB,0,0,0,0,0,0,4,5,9,4,9,13,26,38,64,0,0,0,34,52,86
sp11,112,ROOSEVELT,BIOL,Ec/Beh/Evo,0,0,0,0,0,0,2,0,2,2,3,5,0,13,13,0,0,0,4,16,20
sp11,112,ROOSEVELT,BIOL,Genl Biol,0,0,0,1,4,5,7,7,14,8,16,24,27,65,92,0,0,0,43,92,135
sp11,112,ROOSEVELT,BIOL,Human Bio,0,0,0,1,6,7,10,21,31,17,35,52,47,88,135,0,0,0,75,150,225
sp11,112,ROOSEVELT,BIOL,Microbiol,0,0,0,0,0,0,1,1,2,0,0,0,5,4,9,0,0,0,6,5,11
sp11,112,ROOSEVELT,BIOL,Molec Biol,0,0,0,0,0,0,1,2,3,0,1,1,8,8,16,0,0,0,9,11,20
sp11,112,ROOSEVELT,BIOL,PhyslNeuro,0,0,0,1,3,4,4,4,8,8,5,13,15,23,38,0,0,0,28,35,63
sp11,112,ROOSEVELT,CENG,Chem Engin,0,0,0,1,0,1,4,4,8,6,3,9,5,3,8,0,0,0,16,10,26
sp11,112,ROOSEVELT,CGS,CritGendSt,0,0,0,0,0,0,0,0,0,0,0,0,0,2,2,0,0,0,0,2,2
sp11,112,ROOSEVELT,CHEM,Bioch/Chem,0,0,0,3,4,7,10,13,23,7,13,20,11,9,20,0,0,0,31,39,70
sp11,112,ROOSEVELT,CHEM,Bioinform,0,0,0,0,1,1,0,0,0,0,0,0,0,0,0,0,0,0,0,1,1
sp11,112,ROOSEVELT,CHEM,Chem Educ,0,0,0,0,0,0,0,0,0,1,0,1,1,0,1,0,0,0,2,0,2
sp11,112,ROOSEVELT,CHEM,Chemistry,0,0,0,0,3,3,3,4,7,6,1,7,6,2,8,0,0,0,15,10,25
sp11,112,ROOSEVELT,CHEM,Envir Chem,0,0,0,0,0,0,0,3,3,0,1,1,1,1,2,0,0,0,1,5,6
sp11,112,ROOSEVELT,CHEM,Pharm Chem,0,0,0,4,1,5,5,4,9,5,13,18,9,6,15,0,0,0,23,24,47
sp11,112,ROOSEVELT,CHIN,Chinese St,0,0,0,0,0,0,1,3,4,1,1,2,1,4,5,0,0,0,3,8,11
sp11,112,ROOSEVELT,CLAS,Classic St,0,0,0,0,0,0,0,0,0,0,1,1,0,0,0,0,0,0,0,1,1
sp11,112,ROOSEVELT,COGS,Cog Sci,0,0,0,1,0,1,1,3,4,3,7,10,8,7,15,0,0,0,13,17,30
sp11,112,ROOSEVELT,COGS,CogSc/ClAs,0,0,0,0,1,1,0,0,0,0,1,1,0,0,0,0,0,0,0,2,2
sp11,112,ROOSEVELT,COGS,CogSc/Comp,0,0,0,0,0,0,0,0,0,0,0,0,0,1,1,0,0,0,0,1,1
sp11,112,ROOSEVELT,COGS,CogSc/HCI,0,0,0,0,0,0,0,1,1,1,1,2,9,3,12,0,0,0,10,5,15
sp11,112,ROOSEVELT,COGS,CogSc/HCog,0,0,0,0,0,0,2,3,5,2,0,2,0,1,1,0,0,0,4,4,8
sp11,112,ROOSEVELT,COGS,CogSc/Neur,0,0,0,1,2,3,2,8,10,4,7,11,4,17,21,0,0,0,11,34,45
sp11,112,ROOSEVELT,COMM,Communic,0,0,0,2,7,9,1,11,12,21,50,71,26,73,99,0,0,0,50,141,191
sp11,112,ROOSEVELT,CSE,Comp Sci,0,0,0,2,0,2,5,2,7,16,4,20,31,8,39,0,0,0,54,14,68
sp11,112,ROOSEVELT,CSE,CompEngCSE,0,0,0,2,0,2,6,1,7,2,0,2,4,0,4,0,0,0,14,1,15
sp11,112,ROOSEVELT,CSE,CompScBinf,0,0,0,0,0,0,0,0,0,0,0,0,1,0,1,0,0,0,1,0,1
sp11,112,ROOSEVELT,ECE,CompEngECE,0,0,0,0,0,0,0,0,0,2,0,2,0,0,0,0,0,0,2,0,2
sp11,112,ROOSEVELT,ECE,Electr Eng,0,0,0,3,2,5,1,2,3,10,0,10,13,4,17,0,0,0,27,8,35
sp11,112,ROOSEVELT,ECE,Engin Phys,0,0,0,0,0,0,0,0,0,1,0,1,0,0,0,0,0,0,1,0,1
sp11,112,ROOSEVELT,ECON,Ec-Mth&Ecn,0,0,0,1,1,2,2,2,4,3,1,4,11,5,16,0,0,0,17,9,26
sp11,112,ROOSEVELT,ECON,Econ-MgtSc,0,0,0,4,5,9,11,10,21,24,12,36,48,33,81,0,0,0,87,60,147
sp11,112,ROOSEVELT,ECON,Economics,0,0,0,5,6,11,8,11,19,35,43,78,83,37,120,0,0,0,131,97,228
sp11,112,ROOSEVELT,ESYS,EnvSys(EB),0,0,0,0,0,0,1,6,7,5,5,10,3,13,16,0,0,0,9,24,33
sp11,112,ROOSEVELT,ESYS,EnvSys(EC),0,0,0,0,0,0,1,2,3,1,1,2,1,1,2,0,0,0,3,4,7
sp11,112,ROOSEVELT,ESYS,EnvSys(EP),0,0,0,0,0,0,0,0,0,0,1,1,2,3,5,0,0,0,2,4,6
sp11,112,ROOSEVELT,ESYS,EnvSys(ES),0,0,0,0,0,0,0,2,2,2,2,4,1,3,4,0,0,0,3,7,10
sp11,112,ROOSEVELT,ETHN,Ethnic St,0,0,0,0,0,0,0,1,1,0,3,3,0,11,11,0,0,0,0,15,15
sp11,112,ROOSEVELT,HDP,Human Dev,0,0,0,0,0,0,0,0,0,1,11,12,3,19,22,0,0,0,4,30,34
sp11,112,ROOSEVELT,HDP,Pr-HumnDev,0,0,0,0,3,3,0,8,8,1,7,8,0,3,3,0,0,0,1,21,22
sp11,112,ROOSEVELT,HIST,History,0,0,0,1,1,2,6,6,12,4,12,16,22,34,56,0,0,0,33,53,86
sp11,112,ROOSEVELT,INTD,Roos IndSt,0,0,0,0,0,0,0,0,0,0,0,0,1,0,1,0,0,0,1,0,1
sp11,112,ROOSEVELT,INTL,Int-5yrPS,0,0,0,0,0,0,0,0,0,0,0,0,1,1,2,0,0,0,1,1,2
sp11,112,ROOSEVELT,INTL,IntSt-Anth,0,0,0,0,0,0,0,1,1,0,3,3,2,6,8,0,0,0,2,10,12
sp11,112,ROOSEVELT,INTL,IntSt-Econ,0,0,0,2,3,5,2,8,10,3,9,12,23,34,57,0,0,0,30,54,84
sp11,112,ROOSEVELT,INTL,IntSt-Hist,0,0,0,1,0,1,0,4,4,2,4,6,6,16,22,0,0,0,9,24,33
sp11,112,ROOSEVELT,INTL,IntSt-Ling,0,0,0,0,0,0,0,4,4,1,5,6,1,5,6,0,0,0,2,14,16
sp11,112,ROOSEVELT,INTL,IntSt-Lit,0,0,0,0,0,0,0,0,0,0,1,1,0,1,1,0,0,0,0,2,2
sp11,112,ROOSEVELT,INTL,IntSt-PolS,0,0,0,0,5,5,7,13,20,6,25,31,15,53,68,0,0,0,28,96,124
sp11,112,ROOSEVELT,INTL,IntSt-Soc,0,0,0,2,1,3,0,12,12,2,13,15,0,28,28,0,0,0,4,54,58
sp11,112,ROOSEVELT,ITAL,Italian St,0,0,0,0,0,0,0,0,0,0,0,0,1,2,3,0,0,0,1,2,3
sp11,112,ROOSEVELT,JAPN,JapaneseSt,0,0,0,0,0,0,0,1,1,2,1,3,1,2,3,0,0,0,3,4,7
sp11,112,ROOSEVELT,LATI,LatinAm St,0,0,0,0,0,0,0,1,1,0,1,1,2,3,5,0,0,0,2,5,7
sp11,112,ROOSEVELT,LING,Lang Stu,0,0,0,0,0,0,0,1,1,0,0,0,0,3,3,0,0,0,0,4,4
sp11,112,ROOSEVELT,LING,Ling-CogLn,0,0,0,0,0,0,0,0,0,0,2,2,0,0,0,0,0,0,0,2,2
sp11,112,ROOSEVELT,LING,Ling-LSoc,0,0,0,0,0,0,1,0,1,0,4,4,1,0,1,0,0,0,2,4,6
sp11,112,ROOSEVELT,LING,Linguistcs,0,0,0,0,0,0,0,0,0,1,2,3,0,7,7,0,0,0,1,9,10
sp11,112,ROOSEVELT,LIT,French Lit,0,0,0,0,0,0,0,0,0,0,0,0,1,1,2,0,0,0,1,1,2
sp11,112,ROOSEVELT,LIT,Lit/Compos,0,0,0,0,0,0,0,0,0,0,0,0,2,2,4,0,0,0,2,2,4
sp11,112,ROOSEVELT,LIT,Lit/CultSt,0,0,0,0,0,0,0,0,0,0,1,1,0,1,1,0,0,0,0,2,2
sp11,112,ROOSEVELT,LIT,Lit/Engl,0,0,0,0,0,0,0,4,4,1,1,2,4,11,15,0,0,0,5,16,21
sp11,112,ROOSEVELT,LIT,Lit/World,0,0,0,0,0,0,0,0,0,0,1,1,2,4,6,0,0,0,2,5,7
sp11,112,ROOSEVELT,LIT,Lit/Writng,0,0,0,0,1,1,2,2,4,3,5,8,4,18,22,0,0,0,9,26,35
sp11,112,ROOSEVELT,LIT,Pre-Lit/Wr,0,0,0,0,0,0,0,0,0,1,3,4,3,3,6,0,0,0,4,6,10
sp11,112,ROOSEVELT,LIT,Spanish Lt,0,0,0,0,0,0,0,0,0,1,0,1,1,1,2,0,0,0,2,1,3
sp11,112,ROOSEVELT,MAE,Aerosp Eng,0,0,0,0,0,0,2,1,3,13,0,13,13,6,19,0,0,0,28,7,35
sp11,112,ROOSEVELT,MAE,Engin Sci,0,0,0,2,1,3,0,0,0,2,0,2,2,0,2,0,0,0,6,1,7
sp11,112,ROOSEVELT,MAE,Envir Eng,0,0,0,1,0,1,3,1,4,1,2,3,4,2,6,0,0,0,9,5,14
sp11,112,ROOSEVELT,MAE,Mech Engin,0,0,0,2,0,2,2,0,2,19,3,22,31,4,35,0,0,0,54,7,61
sp11,112,ROOSEVELT,MATH,Appld Math,0,0,0,0,1,1,0,2,2,0,1,1,0,1,1,0,0,0,0,5,5
sp11,112,ROOSEVELT,MATH,Math/SecEd,0,0,0,0,1,1,0,1,1,0,0,0,0,1,1,0,0,0,0,3,3
sp11,112,ROOSEVELT,MATH,Mathematcs,0,0,0,1,1,2,0,1,1,3,1,4,4,2,6,0,0,0,8,5,13
sp11,112,ROOSEVELT,MATH,Mth-CompSc,0,0,0,0,0,0,0,1,1,0,0,0,1,0,1,0,0,0,1,1,2
sp11,112,ROOSEVELT,MATH,Mth-Mth&Ec,0,0,0,0,1,1,0,1,1,0,1,1,6,0,6,0,0,0,6,3,9
sp11,112,ROOSEVELT,MATH,Mth-SciCom,0,0,0,0,0,0,0,0,0,0,0,0,0,1,1,0,0,0,0,1,1
sp11,112,ROOSEVELT,MATH,Mth/ApldSc,0,0,0,0,0,0,0,0,0,0,0,0,2,0,2,0,0,0,2,0,2
sp11,112,ROOSEVELT,MATH,Prob&Stats,0,0,0,0,0,0,0,0,0,0,2,2,0,1,1,0,0,0,0,3,3
sp11,112,ROOSEVELT,MUS,Mu-CompArt,0,0,0,0,0,0,1,1,2,0,0,0,3,0,3,0,0,0,4,1,5
sp11,112,ROOSEVELT,MUS,Music,0,0,0,1,0,1,0,1,1,1,1,2,4,4,8,0,0,0,6,6,12
sp11,112,ROOSEVELT,NENG,NanoEng,0,0,0,1,0,1,3,1,4,3,0,3,1,1,2,0,0,0,8,2,10
sp11,112,ROOSEVELT,PHIL,Philosophy,0,0,0,0,0,0,2,0,2,1,2,3,3,2,5,0,0,0,6,4,10
sp11,112,ROOSEVELT,PHYS,Biophysics,0,0,0,0,1,1,0,1,1,2,0,2,0,1,1,0,0,0,2,3,5
sp11,112,ROOSEVELT,PHYS,GenPys/SEd,0,0,0,0,0,0,0,0,0,0,0,0,1,1,2,0,0,0,1,1,2
sp11,112,ROOSEVELT,PHYS,Phys/Astro,0,0,0,0,0,0,0,0,0,0,0,0,2,0,2,0,0,0,2,0,2
sp11,112,ROOSEVELT,PHYS,Physics,0,0,0,0,1,1,1,1,2,1,1,2,3,3,6,0,0,0,5,6,11
sp11,112,ROOSEVELT,POLI,Polit Sci,0,0,0,3,2,5,4,8,12,23,17,40,33,37,70,0,0,0,63,64,127
sp11,112,ROOSEVELT,POLI,PolSc-Amer,0,0,0,0,0,0,1,2,3,1,2,3,8,5,13,0,0,0,10,9,19
sp11,112,ROOSEVELT,POLI,PolSc-Comp,0,0,0,0,0,0,0,0,0,2,1,3,1,3,4,0,0,0,3,4,7
sp11,112,ROOSEVELT,POLI,PolSc-Intl,0,0,0,0,4,4,7,11,18,13,14,27,18,19,37,0,0,0,38,48,86
sp11,112,ROOSEVELT,POLI,PolSc-PLaw,0,0,0,0,5,5,2,4,6,7,2,9,7,10,17,0,0,0,16,21,37
sp11,112,ROOSEVELT,POLI,PolSc-PPol,0,0,0,0,0,0,0,1,1,0,1,1,2,0,2,0,0,0,2,2,4
sp11,112,ROOSEVELT,POLI,PolSc-Thry,0,0,0,0,0,0,0,0,0,0,0,0,2,4,6,0,0,0,2,4,6
sp11,112,ROOSEVELT,PSYC,Psychology,0,0,0,6,15,21,13,27,40,19,62,81,45,102,147,0,0,0,83,206,289
sp11,112,ROOSEVELT,RELI,Relig/Stu,0,0,0,0,0,0,0,1,1,0,2,2,0,2,2,0,0,0,0,5,5
sp11,112,ROOSEVELT,SE,Engin Sci,0,0,0,0,0,0,2,0,2,0,0,0,0,0,0,0,0,0,2,0,2
sp11,112,ROOSEVELT,SE,Struct Eng,0,0,0,2,2,4,3,3,6,11,5,16,32,6,38,0,0,0,48,16,64
sp11,112,ROOSEVELT,SIO,Earth Sci,0,0,0,0,0,0,0,0,0,0,1,1,0,0,0,0,0,0,0,1,1
sp11,112,ROOSEVELT,SIO,ErSc-Geol,0,0,0,0,1,1,0,0,0,0,0,0,0,1,1,0,0,0,0,2,2
sp11,112,ROOSEVELT,SIO,ErSc-Geoph,0,0,0,0,0,0,0,0,0,1,0,1,0,0,0,0,0,0,1,0,1
sp11,112,ROOSEVELT,SOC,SocAmSt,0,0,0,0,0,0,0,0,0,0,1,1,0,1,1,0,0,0,0,2,2
sp11,112,ROOSEVELT,SOC,SocCulCom,0,0,0,0,0,0,0,0,0,2,0,2,0,2,2,0,0,0,2,2,4
sp11,112,ROOSEVELT,SOC,SocIntlStu,0,0,0,0,0,0,0,1,1,0,1,1,2,3,5,0,0,0,2,5,7
sp11,112,ROOSEVELT,SOC,Sociology,0,0,0,0,1,1,0,5,5,2,14,16,7,20,27,0,0,0,9,40,49
sp11,112,ROOSEVELT,SOC,SocLawSoc,0,0,0,0,0,0,0,1,1,3,2,5,2,1,3,0,0,0,5,4,9
sp11,112,ROOSEVELT,SOC,SocSciMed,0,0,0,0,0,0,1,2,3,1,1,2,1,1,2,0,0,0,3,4,7
sp11,112,ROOSEVELT,SOC,SocSolneq,0,0,0,0,0,0,0,1,1,0,1,1,0,5,5,0,0,0,0,7,7
sp11,112,ROOSEVELT,THEA,Dance,0,0,0,0,0,0,0,0,0,0,0,0,0,1,1,0,0,0,0,1,1
sp11,112,ROOSEVELT,THEA,Theatre,0,0,0,0,1,1,0,2,2,2,2,4,4,10,14,0,0,0,6,15,21
sp11,112,ROOSEVELT,TWS,ThirdWldSt,0,0,0,0,1,1,1,2,3,0,1,1,0,1,1,0,0,0,1,5,6
sp11,112,ROOSEVELT,UNAF,UndecHumAr,0,0,0,0,3,3,1,2,3,0,0,0,0,0,0,0,0,0,1,5,6
sp11,112,ROOSEVELT,UNAF,Undeclared,0,0,0,9,17,26,15,26,41,0,1,1,0,0,0,0,0,0,24,44,68
sp11,112,ROOSEVELT,UNAF,UndecPhysS,0,0,0,1,1,2,3,4,7,0,1,1,0,0,0,0,0,0,4,6,10
sp11,112,ROOSEVELT,UNAF,UndecSocSc,0,0,0,0,2,2,1,5,6,0,0,0,0,0,0,0,0,0,1,7,8
sp11,112,ROOSEVELT,USP,Urb Stu&Pl,0,0,0,0,0,0,0,4,4,3,7,10,11,16,27,0,0,0,14,27,41
sp11,112,ROOSEVELT,VIS,Art Hst/Cr,0,0,0,0,0,0,1,1,2,0,1,1,2,3,5,0,0,0,3,5,8
sp11,112,ROOSEVELT,VIS,Media,0,0,0,2,0,2,1,2,3,2,3,5,9,17,26,0,0,0,14,22,36
sp11,112,ROOSEVELT,VIS,Studio VA,0,0,0,0,0,0,1,0,1,0,2,2,1,6,7,0,0,0,2,8,10
sp11,112,ROOSEVELT,VIS,VA-CompArt,0,0,0,0,1,1,1,1,2,0,1,1,1,3,4,0,0,0,2,6,8
sp11,112,SIXTH,ANTH,Anth-Arch,0,0,0,0,0,0,0,1,1,1,2,3,0,3,3,0,0,0,1,6,7
sp11,112,SIXTH,ANTH,Anth-Biol,0,0,0,0,0,0,0,1,1,1,5,6,1,5,6,0,0,0,2,11,13
sp11,112,SIXTH,ANTH,Anth-Soci,0,0,0,0,0,0,0,1,1,0,6,6,0,8,8,0,0,0,0,15,15
sp11,112,SIXTH,BENG,Bioen:Binf,0,0,0,0,0,0,3,1,4,0,1,1,3,0,3,0,0,0,6,2,8
sp11,112,SIXTH,BENG,Bioeng:PM,0,0,0,0,0,0,0,0,0,4,1,5,11,1,12,0,0,0,15,2,17
sp11,112,SIXTH,BENG,BioengBiot,0,0,0,0,0,0,4,2,6,4,3,7,15,4,19,0,0,0,23,9,32
sp11,112,SIXTH,BENG,Bioengin,0,0,0,0,1,1,4,0,4,4,1,5,6,3,9,0,0,0,14,5,19
sp11,112,SIXTH,BENG,Pr-BioenPM,0,0,0,0,0,0,2,0,2,0,0,0,0,0,0,0,0,0,2,0,2
sp11,112,SIXTH,BIOL,Bioc/CellB,0,0,0,0,1,1,4,3,7,11,8,19,34,32,66,0,0,0,49,44,93
sp11,112,SIXTH,BIOL,BiolBioinf,0,0,0,0,0,0,0,0,0,0,0,0,1,0,1,0,0,0,1,0,1
sp11,112,SIXTH,BIOL,Ec/Beh/Evo,0,0,0,0,0,0,0,1,1,0,0,0,3,12,15,0,0,0,3,13,16
sp11,112,SIXTH,BIOL,Genl Biol,0,0,0,0,2,2,5,9,14,10,13,23,32,38,70,0,0,0,47,62,109
sp11,112,SIXTH,BIOL,Human Bio,0,0,0,2,3,5,15,7,22,23,23,46,53,58,111,0,0,0,93,91,184
sp11,112,SIXTH,BIOL,Microbiol,0,0,0,0,1,1,2,0,2,1,3,4,4,6,10,0,0,0,7,10,17
sp11,112,SIXTH,BIOL,Molec Biol,0,0,0,0,0,0,2,3,5,0,1,1,7,10,17,0,0,0,9,14,23
sp11,112,SIXTH,BIOL,PhyslNeuro,0,0,0,1,1,2,3,5,8,5,6,11,16,22,38,0,0,0,25,34,59
sp11,112,SIXTH,CENG,Chem Engin,0,0,0,0,2,2,8,3,11,2,0,2,20,1,21,0,0,0,30,6,36
sp11,112,SIXTH,CGS,CritGendSt,0,0,0,0,0,0,0,0,0,1,2,3,0,1,1,0,0,0,1,3,4
sp11,112,SIXTH,CHEM,Bioch/Chem,0,0,0,1,5,6,19,6,25,13,15,28,13,10,23,0,0,0,46,36,82
sp11,112,SIXTH,CHEM,Chemistry,0,0,0,2,2,4,4,3,7,4,6,10,5,4,9,0,0,0,15,15,30
sp11,112,SIXTH,CHEM,Envir Chem,0,0,0,0,0,0,0,0,0,0,2,2,0,0,0,0,0,0,0,2,2
sp11,112,SIXTH,CHEM,MolecSynth,0,0,0,0,0,0,0,0,0,0,1,1,0,0,0,0,0,0,0,1,1
sp11,112,SIXTH,CHEM,Pharm Chem,0,0,0,5,1,6,9,15,24,7,13,20,7,14,21,0,0,0,28,43,71
sp11,112,SIXTH,CHIN,Chinese St,0,0,0,0,0,0,0,0,0,1,1,2,0,0,0,0,0,0,1,1,2
sp11,112,SIXTH,CLAS,Classic St,0,0,0,0,0,0,0,0,0,0,1,1,1,1,2,0,0,0,1,2,3
sp11,112,SIXTH,COGS,Cog Sci,0,0,0,0,0,0,2,2,4,6,3,9,11,3,14,0,0,0,19,8,27
sp11,112,SIXTH,COGS,CogSc/ClAs,0,0,0,0,1,1,0,0,0,0,3,3,0,1,1,0,0,0,0,5,5
sp11,112,SIXTH,COGS,CogSc/Comp,0,0,0,0,0,0,1,0,1,1,1,2,0,0,0,0,0,0,2,1,3
sp11,112,SIXTH,COGS,CogSc/HCI,0,0,0,0,0,0,1,1,2,2,1,3,5,3,8,0,0,0,8,5,13
sp11,112,SIXTH,COGS,CogSc/HCog,0,0,0,0,0,0,0,1,1,0,0,0,2,0,2,0,0,0,2,1,3
sp11,112,SIXTH,COGS,CogSc/Neur,0,0,0,1,0,1,3,6,9,3,7,10,3,8,11,0,0,0,10,21,31
sp11,112,SIXTH,COMM,Communic,0,0,0,3,5,8,5,25,30,20,33,53,19,59,78,0,0,0,47,122,169
sp11,112,SIXTH,CSE,Comp Sci,0,0,0,4,3,7,23,11,34,37,6,43,73,11,84,0,0,0,137,31,168
sp11,112,SIXTH,CSE,CompEngCSE,0,0,0,5,1,6,7,1,8,4,1,5,20,0,20,0,0,0,36,3,39
sp11,112,SIXTH,CSE,CompScBinf,0,0,0,0,0,0,0,0,0,3,0,3,4,0,4,0,0,0,7,0,7
sp11,112,SIXTH,ECE,CompEngECE,0,0,0,3,1,4,4,0,4,1,0,1,2,0,2,0,0,0,10,1,11
sp11,112,SIXTH,ECE,Electr Eng,0,0,0,9,0,9,11,0,11,16,0,16,52,8,60,0,0,0,88,8,96
sp11,112,SIXTH,ECE,Engin Phys,0,0,0,0,0,0,0,0,0,0,1,1,0,0,0,0,0,0,0,1,1
sp11,112,SIXTH,ECE,Pr-EngPhys,0,0,0,0,0,0,2,0,2,2,0,2,0,0,0,0,0,0,4,0,4
sp11,112,SIXTH,ECON,Ec-Mth&Ecn,0,0,0,0,0,0,4,1,5,2,2,4,5,2,7,0,0,0,11,5,16
sp11,112,SIXTH,ECON,Econ-MgtSc,0,0,0,9,6,15,12,10,22,19,23,42,55,35,90,0,0,0,95,74,169
sp11,112,SIXTH,ECON,Economics,0,0,0,4,1,5,7,6,13,47,22,69,71,33,104,0,0,0,129,62,191
sp11,112,SIXTH,ESYS,EnvSys(EB),0,0,0,0,1,1,1,10,11,4,11,15,4,8,12,0,0,0,9,30,39
sp11,112,SIXTH,ESYS,EnvSys(EC),0,0,0,0,0,0,1,0,1,0,0,0,1,0,1,0,0,0,2,0,2
sp11,112,SIXTH,ESYS,EnvSys(EP),0,0,0,0,1,1,1,2,3,2,2,4,1,1,2,0,0,0,4,6,10
sp11,112,SIXTH,ESYS,EnvSys(ES),0,0,0,0,0,0,1,1,2,2,2,4,1,3,4,0,0,0,4,6,10
sp11,112,SIXTH,ETHN,Ethnic St,0,0,0,1,0,1,0,1,1,1,1,2,4,4,8,0,0,0,6,6,12
sp11,112,SIXTH,HDP,Human Dev,0,0,0,0,0,0,0,0,0,1,12,13,1,22,23,0,0,0,2,34,36
sp11,112,SIXTH,HDP,Pr-HumnDev,0,0,0,0,2,2,0,5,5,0,4,4,0,3,3,0,0,0,0,14,14
sp11,112,SIXTH,HIST,History,0,0,0,1,0,1,2,1,3,4,2,6,11,10,21,0,0,0,18,13,31
sp11,112,SIXTH,INTL,IntSt-Anth,0,0,0,0,0,0,0,1,1,0,0,0,1,4,5,0,0,0,1,5,6
sp11,112,SIXTH,INTL,IntSt-Econ,0,0,0,1,0,1,3,0,3,4,7,11,4,9,13,0,0,0,12,16,28
sp11,112,SIXTH,INTL,IntSt-Hist,0,0,0,0,0,0,0,0,0,0,2,2,1,4,5,0,0,0,1,6,7
sp11,112,SIXTH,INTL,IntSt-Ling,0,0,0,0,0,0,0,2,2,2,3,5,0,0,0,0,0,0,2,5,7
sp11,112,SIXTH,INTL,IntSt-PolS,0,0,0,0,1,1,3,4,7,4,3,7,10,14,24,0,0,0,17,22,39
sp11,112,SIXTH,INTL,IntSt-Soc,0,0,0,0,1,1,0,2,2,0,4,4,3,5,8,0,0,0,3,12,15
sp11,112,SIXTH,ITAL,Italian St,0,0,0,0,0,0,0,0,0,0,0,0,0,2,2,0,0,0,0,2,2
sp11,112,SIXTH,JAPN,JapaneseSt,0,0,0,0,0,0,0,1,1,1,0,1,0,1,1,0,0,0,1,2,3
sp11,112,SIXTH,LATI,LatinAm St,0,0,0,0,0,0,0,0,0,0,0,0,0,1,1,0,0,0,0,1,1
sp11,112,SIXTH,LING,Lang Stu,0,0,0,0,0,0,0,0,0,1,0,1,0,0,0,0,0,0,1,0,1
sp11,112,SIXTH,LING,Ling-CogLn,0,0,0,0,0,0,0,1,1,0,0,0,0,3,3,0,0,0,0,4,4
sp11,112,SIXTH,LING,Ling-LSoc,0,0,0,0,0,0,0,1,1,0,0,0,1,0,1,0,0,0,1,1,2
sp11,112,SIXTH,LING,Linguistcs,0,0,0,0,0,0,0,0,0,1,3,4,3,5,8,0,0,0,4,8,12
sp11,112,SIXTH,LIT,French Lit,0,0,0,0,0,0,0,0,0,0,0,0,0,1,1,0,0,0,0,1,1
sp11,112,SIXTH,LIT,Lit/Compos,0,0,0,0,0,0,1,0,1,0,0,0,0,1,1,0,0,0,1,1,2
sp11,112,SIXTH,LIT,Lit/CultSt,0,0,0,0,0,0,0,0,0,0,0,0,0,2,2,0,0,0,0,2,2
sp11,112,SIXTH,LIT,Lit/Engl,0,0,0,1,0,1,1,3,4,1,0,1,1,2,3,0,0,0,4,5,9
sp11,112,SIXTH,LIT,Lit/World,0,0,0,0,0,0,0,0,0,0,0,0,0,4,4,0,0,0,0,4,4
sp11,112,SIXTH,LIT,Lit/Writng,0,0,0,0,0,0,2,3,5,1,4,5,2,9,11,0,0,0,5,16,21
sp11,112,SIXTH,LIT,Pre-Lit/Wr,0,0,0,0,0,0,0,0,0,0,3,3,2,2,4,0,0,0,2,5,7
sp11,112,SIXTH,MAE,Aerosp Eng,0,0,0,2,1,3,11,3,14,11,2,13,35,4,39,0,0,0,59,10,69
sp11,112,SIXTH,MAE,Engin Sci,0,0,0,0,0,0,3,0,3,3,0,3,3,0,3,0,0,0,9,0,9
sp11,112,SIXTH,MAE,Envir Eng,0,0,0,3,2,5,6,4,10,5,3,8,5,5,10,0,0,0,19,14,33
sp11,112,SIXTH,MAE,Mech Engin,0,0,0,1,1,2,11,1,12,21,3,24,72,14,86,0,0,0,105,19,124
sp11,112,SIXTH,MATH,Appld Math,0,0,0,1,1,2,0,0,0,2,1,3,2,1,3,0,0,0,5,3,8
sp11,112,SIXTH,MATH,Math/SecEd,0,0,0,0,0,0,0,1,1,0,1,1,1,4,5,0,0,0,1,6,7
sp11,112,SIXTH,MATH,Mathematcs,0,0,0,2,1,3,0,1,1,7,3,10,6,6,12,0,0,0,15,11,26
sp11,112,SIXTH,MATH,Mth-CompSc,0,0,0,0,0,0,0,0,0,0,1,1,2,0,2,0,0,0,2,1,3
sp11,112,SIXTH,MATH,Mth-Mth&Ec,0,0,0,0,0,0,2,0,2,1,2,3,4,2,6,0,0,0,7,4,11
sp11,112,SIXTH,MATH,Mth-SciCom,0,0,0,0,0,0,0,0,0,0,1,1,0,0,0,0,0,0,0,1,1
sp11,112,SIXTH,MATH,Mth/ApldSc,0,0,0,0,1,1,0,0,0,1,0,1,0,0,0,0,0,0,1,1,2
sp11,112,SIXTH,MATH,Pr-Math CS,0,0,0,2,0,2,1,0,1,0,0,0,0,0,0,0,0,0,3,0,3
sp11,112,SIXTH,MATH,Prob&Stats,0,0,0,0,0,0,0,0,0,0,0,0,2,0,2,0,0,0,2,0,2
sp11,112,SIXTH,MUS,Mu-CompArt,0,0,0,1,0,1,2,2,4,11,2,13,10,0,10,0,0,0,24,4,28
sp11,112,SIXTH,MUS,Music,0,0,0,1,0,1,0,2,2,5,0,5,4,5,9,0,0,0,10,7,17
sp11,112,SIXTH,MUS,Music Hum,0,0,0,0,0,0,0,0,0,0,1,1,1,0,1,0,0,0,1,1,2
sp11,112,SIXTH,NENG,NanoEng,0,0,0,0,0,0,5,1,6,3,1,4,1,0,1,0,0,0,9,2,11
sp11,112,SIXTH,PHIL,Philosophy,0,0,0,0,0,0,0,0,0,3,0,3,3,1,4,0,0,0,6,1,7
sp11,112,SIXTH,PHYS,Biophysics,0,0,0,1,0,1,2,0,2,0,0,0,3,0,3,0,0,0,6,0,6
sp11,112,SIXTH,PHYS,Phy/ErthSc,0,0,0,0,0,0,0,0,0,1,0,1,0,0,0,0,0,0,1,0,1
sp11,112,SIXTH,PHYS,Phys/Astro,0,0,0,0,0,0,1,0,1,0,0,0,2,0,2,0,0,0,3,0,3
sp11,112,SIXTH,PHYS,Physics,0,0,0,2,0,2,1,0,1,6,1,7,7,0,7,0,0,0,16,1,17
sp11,112,SIXTH,POLI,Polit Sci,0,0,0,2,0,2,7,4,11,10,8,18,28,6,34,0,0,0,47,18,65
sp11,112,SIXTH,POLI,PolSc-Amer,0,0,0,1,0,1,0,1,1,1,2,3,2,3,5,0,0,0,4,6,10
sp11,112,SIXTH,POLI,PolSc-Intl,0,0,0,1,2,3,1,2,3,8,4,12,9,4,13,0,0,0,19,12,31
sp11,112,SIXTH,POLI,PolSc-PLaw,0,0,0,1,1,2,2,1,3,3,7,10,1,1,2,0,0,0,7,10,17
sp11,112,SIXTH,POLI,PolSc-PPol,0,0,0,1,0,1,0,0,0,0,0,0,1,0,1,0,0,0,2,0,2
sp11,112,SIXTH,POLI,PolSc-Thry,0,0,0,0,0,0,0,0,0,1,0,1,3,0,3,0,0,0,4,0,4
sp11,112,SIXTH,PSYC,Psychology,0,0,0,4,9,13,17,20,37,21,35,56,37,69,106,0,0,0,79,133,212
sp11,112,SIXTH,RUSS,Russ&SovSt,0,0,0,0,0,0,0,0,0,0,0,0,0,1,1,0,0,0,0,1,1
sp11,112,SIXTH,SE,Engin Sci,0,0,0,0,0,0,0,1,1,1,0,1,0,0,0,0,0,0,1,1,2
sp11,112,SIXTH,SE,Struct Eng,0,0,0,6,1,7,10,4,14,16,4,20,34,15,49,0,0,0,66,24,90
sp11,112,SIXTH,SIO,Earth Sci,0,0,0,0,0,0,0,0,0,1,1,2,1,0,1,0,0,0,2,1,3
sp11,112,SIXTH,SIO,ErSc-Geoph,0,0,0,0,0,0,0,0,0,0,1,1,0,0,0,0,0,0,0,1,1
sp11,112,SIXTH,SOC,SocCulCom,0,0,0,0,0,0,0,0,0,0,2,2,1,2,3,0,0,0,1,4,5
sp11,112,SIXTH,SOC,SocEconSoc,0,0,0,0,0,0,0,0,0,1,1,2,0,3,3,0,0,0,1,4,5
sp11,112,SIXTH,SOC,SocIntlStu,0,0,0,0,0,0,0,0,0,0,1,1,0,5,5,0,0,0,0,6,6
sp11,112,SIXTH,SOC,Sociology,0,0,0,0,3,3,1,2,3,4,8,12,4,7,11,0,0,0,9,20,29
sp11,112,SIXTH,SOC,SocLawSoc,0,0,0,0,0,0,0,1,1,0,1,1,1,2,3,0,0,0,1,4,5
sp11,112,SIXTH,SOC,SocSciMed,0,0,0,0,1,1,0,1,1,0,0,0,0,3,3,0,0,0,0,5,5
sp11,112,SIXTH,SOC,SocSolneq,0,0,0,0,0,0,0,0,0,0,0,0,1,3,4,0,0,0,1,3,4
sp11,112,SIXTH,THEA,Dance,0,0,0,0,0,0,1,0,1,0,0,0,0,3,3,0,0,0,1,3,4
sp11,112,SIXTH,THEA,Theatre,0,0,0,0,0,0,0,3,3,2,4,6,5,5,10,0,0,0,7,12,19
sp11,112,SIXTH,TWS,ThirdWldSt,0,0,0,0,0,0,0,0,0,0,1,1,0,1,1,0,0,0,0,2,2
sp11,112,SIXTH,UNAF,UndecBiolS,0,0,0,0,1,1,0,0,0,0,0,0,0,0,0,0,0,0,0,1,1
sp11,112,SIXTH,UNAF,UndecHumAr,0,0,0,0,1,1,3,4,7,0,0,0,0,0,0,0,0,0,3,5,8
sp11,112,SIXTH,UNAF,Undeclared,0,0,0,4,16,20,23,24,47,2,0,2,0,0,0,0,0,0,29,40,69
sp11,112,SIXTH,UNAF,UndecPhysS,0,0,0,0,3,3,3,3,6,0,0,0,0,0,0,0,0,0,3,6,9
sp11,112,SIXTH,UNAF,UndecSocSc,0,0,0,1,1,2,1,1,2,0,0,0,0,0,0,0,0,0,2,2,4
sp11,112,SIXTH,USP,Urb Stu&Pl,0,0,0,1,1,2,0,2,2,2,4,6,4,8,12,0,0,0,7,15,22
sp11,112,SIXTH,VIS,Art Hst/Cr,0,0,0,0,0,0,0,0,0,0,1,1,1,13,14,0,0,0,1,14,15
sp11,112,SIXTH,VIS,Media,0,0,0,1,3,4,3,6,9,9,13,22,21,21,42,0,0,0,34,43,77
sp11,112,SIXTH,VIS,Studio VA,0,0,0,1,0,1,2,2,4,1,5,6,10,14,24,0,0,0,14,21,35
sp11,112,SIXTH,VIS,VA-CompArt,0,0,0,1,0,1,1,5,6,3,6,9,11,3,14,0,0,0,16,14,30
sp11,112,WARREN,ANTH,Anth-Arch,0,0,0,0,0,0,0,0,0,2,1,3,1,6,7,0,0,0,3,7,10
sp11,112,WARREN,ANTH,Anth-Biol,0,0,0,0,0,0,0,0,0,0,2,2,0,4,4,0,0,0,0,6,6
sp11,112,WARREN,ANTH,Anth-Soci,0,0,0,0,0,0,0,1,1,1,3,4,0,5,5,0,0,0,1,9,10
sp11,112,WARREN,BENG,Bioen:Binf,0,0,0,0,1,1,1,2,3,1,0,1,7,0,7,0,0,0,9,3,12
sp11,112,WARREN,BENG,Bioeng:PM,0,0,0,0,0,0,0,1,1,8,2,10,26,9,35,0,0,0,34,12,46
sp11,112,WARREN,BENG,BioengBiot,0,0,0,0,1,1,3,7,10,19,6,25,39,14,53,0,0,0,61,28,89
sp11,112,WARREN,BENG,Bioengin,0,0,0,1,0,1,4,4,8,12,5,17,28,9,37,0,0,0,45,18,63
sp11,112,WARREN,BENG,Pr-BioenPM,0,0,0,0,0,0,2,1,3,3,1,4,0,1,1,0,0,0,5,3,8
sp11,112,WARREN,BIOL,Anml Physl,0,0,0,0,0,0,0,0,0,0,0,0,0,1,1,0,0,0,0,1,1
sp11,112,WARREN,BIOL,Bioc/CellB,0,0,0,0,2,2,9,9,18,20,7,27,61,70,131,0,0,0,90,88,178
sp11,112,WARREN,BIOL,Ec/Beh/Evo,0,0,0,0,1,1,1,0,1,1,2,3,10,10,20,0,0,0,12,13,25
sp11,112,WARREN,BIOL,Genl Biol,0,0,0,2,3,5,8,10,18,13,24,37,36,77,113,0,0,0,59,114,173
sp11,112,WARREN,BIOL,Human Bio,0,0,0,2,1,3,15,13,28,29,28,57,48,90,138,0,0,0,94,132,226
sp11,112,WARREN,BIOL,Microbiol,0,0,0,0,0,0,3,1,4,3,2,5,5,6,11,0,0,0,11,9,20
sp11,112,WARREN,BIOL,Molec Biol,0,0,0,0,0,0,3,1,4,7,3,10,7,10,17,0,0,0,17,14,31
sp11,112,WARREN,BIOL,PhyslNeuro,0,0,0,1,2,3,3,5,8,21,7,28,26,27,53,0,0,0,51,41,92
sp11,112,WARREN,CENG,Chem Engin,0,0,0,3,1,4,14,5,19,14,7,21,29,9,38,0,0,0,60,22,82
sp11,112,WARREN,CGS,CritGendSt,0,0,0,0,0,0,0,0,0,0,1,1,1,2,3,0,0,0,1,3,4
sp11,112,WARREN,CHEM,Bioch/Chem,0,0,0,10,3,13,18,16,34,15,14,29,18,12,30,0,0,0,61,45,106
sp11,112,WARREN,CHEM,Chem Phys,0,0,0,0,0,0,1,1,2,0,0,0,1,0,1,0,0,0,2,1,3
sp11,112,WARREN,CHEM,Chemistry,0,0,0,0,2,2,5,2,7,3,6,9,15,6,21,0,0,0,23,16,39
sp11,112,WARREN,CHEM,MolecSynth,0,0,0,1,0,1,1,0,1,0,0,0,3,2,5,0,0,0,5,2,7
sp11,112,WARREN,CHEM,Pharm Chem,0,0,0,1,8,9,7,11,18,10,12,22,15,16,31,0,0,0,33,47,80
sp11,112,WARREN,CHIN,Chinese St,0,0,0,0,0,0,0,0,0,0,1,1,3,4,7,0,0,0,3,5,8
sp11,112,WARREN,CLAS,Classic St,0,0,0,0,0,0,0,0,0,0,1,1,0,0,0,0,0,0,0,1,1
sp11,112,WARREN,COGS,Cog Sci,0,0,0,0,1,1,2,2,4,1,6,7,4,7,11,0,0,0,7,16,23
sp11,112,WARREN,COGS,CogSc/ClAs,0,0,0,0,0,0,1,2,3,0,1,1,2,3,5,0,0,0,3,6,9
sp11,112,WARREN,COGS,CogSc/Comp,0,0,0,1,0,1,0,0,0,0,0,0,2,0,2,0,0,0,3,0,3
sp11,112,WARREN,COGS,CogSc/HCI,0,0,0,0,0,0,0,1,1,3,3,6,2,1,3,0,0,0,5,5,10
sp11,112,WARREN,COGS,CogSc/HCog,0,0,0,0,2,2,0,0,0,1,2,3,0,1,1,0,0,0,1,5,6
sp11,112,WARREN,COGS,CogSc/Neur,0,0,0,0,3,3,2,6,8,6,10,16,5,8,13,0,0,0,13,27,40
sp11,112,WARREN,COMM,Communic,0,0,0,0,2,2,4,9,13,7,24,31,25,42,67,0,0,0,36,77,113
sp11,112,WARREN,CSE,Comp Sci,0,0,0,5,3,8,34,8,42,47,12,59,81,15,96,0,0,0,167,38,205
sp11,112,WARREN,CSE,CompEngCSE,0,0,0,2,2,4,14,4,18,11,1,12,17,1,18,0,0,0,44,8,52
sp11,112,WARREN,CSE,CompScBinf,0,0,0,0,0,0,3,0,3,0,2,2,3,2,5,0,0,0,6,4,10
sp11,112,WARREN,ECE,CompEngECE,0,0,0,2,0,2,6,0,6,5,0,5,2,0,2,0,0,0,15,0,15
sp11,112,WARREN,ECE,Electr Eng,0,0,0,5,1,6,22,3,25,23,6,29,68,12,80,0,0,0,118,22,140
sp11,112,WARREN,ECE,Engin Phys,0,0,0,0,0,0,0,0,0,1,0,1,3,0,3,0,0,0,4,0,4
sp11,112,WARREN,ECE,Pr-EngPhys,0,0,0,0,0,0,1,0,1,1,0,1,0,0,0,0,0,0,2,0,2
sp11,112,WARREN,ECON,Ec-Mth&Ecn,0,0,0,1,0,1,2,2,4,5,0,5,13,8,21,0,0,0,21,10,31
sp11,112,WARREN,ECON,Econ-MgtSc,0,0,0,2,3,5,13,12,25,20,11,31,37,35,72,0,0,0,72,61,133
sp11,112,WARREN,ECON,Economics,0,0,0,2,1,3,13,10,23,38,24,62,74,43,117,0,0,0,127,78,205
sp11,112,WARREN,ESYS,EnvSys(EB),0,0,0,0,0,0,1,3,4,1,8,9,1,4,5,0,0,0,3,15,18
sp11,112,WARREN,ESYS,EnvSys(EC),0,0,0,0,0,0,1,0,1,0,1,1,1,1,2,0,0,0,2,2,4
sp11,112,WARREN,ESYS,EnvSys(EP),0,0,0,0,0,0,0,3,3,1,1,2,1,2,3,0,0,0,2,6,8
sp11,112,WARREN,ESYS,EnvSys(ES),0,0,0,0,0,0,0,1,1,1,0,1,1,0,1,0,0,0,2,1,3
sp11,112,WARREN,ETHN,Ethnic St,0,0,0,0,0,0,0,1,1,0,2,2,3,6,9,0,0,0,3,9,12
sp11,112,WARREN,HDP,Human Dev,0,0,0,0,0,0,0,1,1,0,4,4,2,13,15,0,0,0,2,18,20
sp11,112,WARREN,HDP,Pr-HumnDev,0,0,0,0,3,3,0,11,11,0,5,5,0,4,4,0,0,0,0,23,23
sp11,112,WARREN,HIST,History,0,0,0,0,0,0,3,1,4,10,5,15,27,9,36,0,0,0,40,15,55
sp11,112,WARREN,INTD,Wa Ind St,0,0,0,0,0,0,0,0,0,0,0,0,1,2,3,0,0,0,1,2,3
sp11,112,WARREN,INTL,IntSt-Anth,0,0,0,0,0,0,0,0,0,0,0,0,0,1,1,0,0,0,0,1,1
sp11,112,WARREN,INTL,IntSt-Econ,0,0,0,0,1,1,0,1,1,6,2,8,12,6,18,0,0,0,18,10,28
sp11,112,WARREN,INTL,IntSt-Hist,0,0,0,0,0,0,0,1,1,1,0,1,2,2,4,0,0,0,3,3,6
sp11,112,WARREN,INTL,IntSt-Ling,0,0,0,0,0,0,0,0,0,0,0,0,0,2,2,0,0,0,0,2,2
sp11,112,WARREN,INTL,IntSt-Lit,0,0,0,0,0,0,0,1,1,0,1,1,0,0,0,0,0,0,0,2,2
sp11,112,WARREN,INTL,IntSt-PolS,0,0,0,1,0,1,1,2,3,1,4,5,9,9,18,0,0,0,12,15,27
sp11,112,WARREN,INTL,IntSt-Soc,0,0,0,1,1,2,0,1,1,0,4,4,0,7,7,0,0,0,1,13,14
sp11,112,WARREN,ITAL,Italian St,0,0,0,0,1,1,0,0,0,1,0,1,0,0,0,0,0,0,1,1,2
sp11,112,WARREN,JAPN,JapaneseSt,0,0,0,0,0,0,0,0,0,0,0,0,3,1,4,0,0,0,3,1,4
sp11,112,WARREN,LING,Lang Stu,0,0,0,0,0,0,0,0,0,0,1,1,0,1,1,0,0,0,0,2,2
sp11,112,WARREN,LING,Ling-CogLn,0,0,0,0,0,0,0,0,0,0,1,1,0,2,2,0,0,0,0,3,3
sp11,112,WARREN,LING,Ling-LSoc,0,0,0,0,0,0,0,0,0,0,0,0,1,2,3,0,0,0,1,2,3
sp11,112,WARREN,LING,Linguistcs,0,0,0,0,0,0,1,0,1,1,1,2,0,5,5,0,0,0,2,6,8
sp11,112,WARREN,LIT,French Lit,0,0,0,0,0,0,0,0,0,0,0,0,1,0,1,0,0,0,1,0,1
sp11,112,WARREN,LIT,Lit/Compos,0,0,0,0,0,0,0,0,0,0,0,0,0,1,1,0,0,0,0,1,1
sp11,112,WARREN,LIT,Lit/CultSt,0,0,0,0,0,0,0,0,0,0,0,0,0,1,1,0,0,0,0,1,1
sp11,112,WARREN,LIT,Lit/Engl,0,0,0,0,0,0,0,2,2,2,4,6,0,8,8,0,0,0,2,14,16
sp11,112,WARREN,LIT,Lit/World,0,0,0,0,0,0,0,0,0,0,0,0,0,2,2,0,0,0,0,2,2
sp11,112,WARREN,LIT,Lit/Writng,0,0,0,0,0,0,0,1,1,3,2,5,3,12,15,0,0,0,6,15,21
sp11,112,WARREN,LIT,Pre-Lit/Wr,0,0,0,0,0,0,1,0,1,0,0,0,2,1,3,0,0,0,3,1,4
sp11,112,WARREN,LIT,Spanish Lt,0,0,0,0,0,0,0,0,0,0,0,0,0,2,2,0,0,0,0,2,2
sp11,112,WARREN,MAE,Aerosp Eng,0,0,0,2,0,2,11,1,12,23,4,27,25,4,29,0,0,0,61,9,70
sp11,112,WARREN,MAE,Engin Sci,0,0,0,2,0,2,3,2,5,2,0,2,1,0,1,0,0,0,8,2,10
sp11,112,WARREN,MAE,Envir Eng,0,0,0,1,0,1,7,7,14,7,3,10,7,5,12,0,0,0,22,15,37
sp11,112,WARREN,MAE,Mech Engin,0,0,0,4,1,5,23,3,26,37,3,40,99,11,110,0,0,0,163,18,181
sp11,112,WARREN,MATH,Appld Math,0,0,0,1,0,1,2,1,3,0,0,0,4,2,6,0,0,0,7,3,10
sp11,112,WARREN,MATH,Math/SecEd,0,0,0,0,0,0,0,3,3,1,1,2,1,2,3,0,0,0,2,6,8
sp11,112,WARREN,MATH,Mathematcs,0,0,0,1,2,3,1,2,3,5,4,9,14,5,19,0,0,0,21,13,34
sp11,112,WARREN,MATH,Mth-CompSc,0,0,0,0,0,0,1,0,1,0,1,1,0,0,0,0,0,0,1,1,2
sp11,112,WARREN,MATH,Mth-Mth&Ec,0,0,0,1,0,1,2,2,4,5,1,6,2,4,6,0,0,0,10,7,17
sp11,112,WARREN,MATH,Mth-SciCom,0,0,0,0,0,0,0,0,0,1,0,1,0,0,0,0,0,0,1,0,1
sp11,112,WARREN,MATH,Mth/ApldSc,0,0,0,0,0,0,0,2,2,0,1,1,2,0,2,0,0,0,2,3,5
sp11,112,WARREN,MATH,Prob&Stats,0,0,0,2,0,2,1,0,1,2,1,3,0,1,1,0,0,0,5,2,7
sp11,112,WARREN,MUS,Mu-CompArt,0,0,0,0,0,0,1,0,1,2,0,2,7,0,7,0,0,0,10,0,10
sp11,112,WARREN,MUS,Music,0,0,0,0,0,0,2,1,3,1,3,4,3,3,6,0,0,0,6,7,13
sp11,112,WARREN,NENG,NanoEng,0,0,0,4,0,4,10,2,12,3,0,3,2,0,2,0,0,0,19,2,21
sp11,112,WARREN,PHIL,Philosophy,0,0,0,0,0,0,1,0,1,4,2,6,15,8,23,0,0,0,20,10,30
sp11,112,WARREN,PHYS,Biophysics,0,0,0,0,0,0,1,0,1,0,0,0,1,0,1,0,0,0,2,0,2
sp11,112,WARREN,PHYS,Phys/Astro,0,0,0,0,0,0,1,0,1,1,0,1,2,0,2,0,0,0,4,0,4
sp11,112,WARREN,PHYS,Phys/Comp,0,0,0,0,0,0,1,0,1,1,0,1,0,0,0,0,0,0,2,0,2
sp11,112,WARREN,PHYS,Physics,0,0,0,2,0,2,2,2,4,5,0,5,4,1,5,0,0,0,13,3,16
sp11,112,WARREN,POLI,Polit Sci,0,0,0,1,2,3,9,7,16,15,15,30,30,27,57,0,0,0,55,51,106
sp11,112,WARREN,POLI,PolSc-Amer,0,0,0,0,2,2,3,2,5,2,1,3,4,3,7,0,0,0,9,8,17
sp11,112,WARREN,POLI,PolSc-Comp,0,0,0,0,1,1,0,0,0,0,0,0,1,1,2,0,0,0,1,2,3
sp11,112,WARREN,POLI,PolSc-Intl,0,0,0,3,1,4,4,5,9,13,13,26,15,7,22,0,0,0,35,26,61
sp11,112,WARREN,POLI,PolSc-PLaw,0,0,0,0,2,2,1,7,8,8,7,15,5,6,11,0,0,0,14,22,36
sp11,112,WARREN,POLI,PolSc-PPol,0,0,0,0,0,0,0,0,0,1,2,3,1,1,2,0,0,0,2,3,5
sp11,112,WARREN,POLI,PolSc-Thry,0,0,0,0,0,0,0,0,0,1,0,1,2,1,3,0,0,0,3,1,4
sp11,112,WARREN,PSYC,Psychology,0,0,0,5,7,12,13,25,38,16,45,61,34,75,109,0,0,0,68,152,220
sp11,112,WARREN,RELI,Relig/Stu,0,0,0,0,0,0,0,1,1,0,1,1,0,0,0,0,0,0,0,2,2
sp11,112,WARREN,SE,Engin Sci,0,0,0,1,1,2,2,0,2,0,0,0,0,0,0,0,0,0,3,1,4
sp11,112,WARREN,SE,Struct Eng,0,0,0,8,4,12,30,6,36,28,6,34,58,29,87,0,0,0,124,45,169
sp11,112,WARREN,SIO,Earth Sci,0,0,0,0,0,0,1,1,2,3,1,4,2,1,3,0,0,0,6,3,9
sp11,112,WARREN,SOC,SocCulCom,0,0,0,0,1,1,0,0,0,0,0,0,0,0,0,0,0,0,0,1,1
sp11,112,WARREN,SOC,SocIntlStu,0,0,0,0,0,0,0,0,0,1,0,1,0,1,1,0,0,0,1,1,2
sp11,112,WARREN,SOC,Sociology,0,0,0,0,1,1,0,2,2,3,9,12,5,15,20,0,0,0,8,27,35
sp11,112,WARREN,SOC,SocLawSoc,0,0,0,0,0,0,1,2,3,1,2,3,0,1,1,0,0,0,2,5,7
sp11,112,WARREN,SOC,SocSciMed,0,0,0,0,1,1,0,0,0,0,0,0,0,1,1,0,0,0,0,2,2
sp11,112,WARREN,SOC,SocSolneq,0,0,0,0,0,0,0,0,0,0,1,1,2,2,4,0,0,0,2,3,5
sp11,112,WARREN,THEA,Dance,0,0,0,0,0,0,0,0,0,0,1,1,1,0,1,0,0,0,1,1,2
sp11,112,WARREN,THEA,Theatre,0,0,0,0,0,0,2,0,2,1,2,3,1,0,1,0,0,0,4,2,6
sp11,112,WARREN,TWS,ThirdWldSt,0,0,0,0,0,0,0,0,0,0,0,0,0,1,1,0,0,0,0,1,1
sp11,112,WARREN,UNAF,IntcampVis,0,0,0,0,0,0,1,0,1,0,0,0,2,3,5,0,0,0,3,3,6
sp11,112,WARREN,UNAF,Limited St,0,0,0,0,0,0,0,0,0,0,0,0,0,0,0,2,2,4,2,2,4
sp11,112,WARREN,UNAF,UndecHumAr,0,0,0,0,0,0,0,1,1,0,0,0,0,0,0,0,0,0,0,1,1
sp11,112,WARREN,UNAF,Undeclared,0,0,0,10,15,25,13,19,32,0,1,1,0,0,0,0,0,0,23,35,58
sp11,112,WARREN,UNAF,UndecPhysS,0,0,0,1,1,2,3,3,6,0,0,0,0,0,0,0,0,0,4,4,8
sp11,112,WARREN,UNAF,UndecSocSc,0,0,0,1,1,2,0,3,3,1,0,1,0,0,0,0,0,0,2,4,6
sp11,112,WARREN,USP,Urb Stu&Pl,0,0,0,0,0,0,2,1,3,4,6,10,5,7,12,0,0,0,11,14,25
sp11,112,WARREN,VIS,Art Hst/Cr,0,0,0,0,0,0,0,0,0,0,0,0,2,2,4,0,0,0,2,2,4
sp11,112,WARREN,VIS,Media,0,0,0,0,0,0,1,2,3,6,5,11,6,5,11,0,0,0,13,12,25
sp11,112,WARREN,VIS,Studio VA,0,0,0,1,1,2,1,0,1,1,1,2,2,6,8,0,0,0,5,8,13
sp11,112,WARREN,VIS,VA-CompArt,0,0,0,0,1,1,0,0,0,1,0,1,3,0,3,0,0,0,4,1,5
wi15,151,MARSHALL,ANTH,Anth-Arch,0,0,0,0,1,1,0,0,0,1,0,1,0,0,0,0,0,0,1,1,2
wi15,151,MARSHALL,ANTH,Anth-Biol,0,0,0,0,0,0,0,1,1,0,0,0,0,2,2,0,0,0,0,3,3
wi15,151,MARSHALL,ANTH,Anth-Soci,0,0,0,0,0,0,0,1,1,2,2,4,1,4,5,0,0,0,3,7,10
wi15,151,MARSHALL,BENG,Bioen:Binf,0,0,0,1,0,1,1,3,4,3,3,6,3,6,9,0,0,0,8,12,20
wi15,151,MARSHALL,BENG,BioengBioS,0,0,0,0,0,0,2,1,3,6,0,6,0,0,0,0,0,0,8,1,9
wi15,151,MARSHALL,BENG,BioengBiot,0,0,0,0,0,0,1,2,3,2,2,4,8,3,11,0,0,0,11,7,18
wi15,151,MARSHALL,BENG,Bioengin,0,0,0,0,0,0,0,0,0,1,2,3,9,6,15,0,0,0,10,8,18
wi15,151,MARSHALL,BIOL,Bioc/CellB,0,0,0,2,9,11,19,19,38,20,28,48,36,71,107,0,0,0,77,127,204
wi15,151,MARSHALL,BIOL,BiolBioinf,0,0,0,0,2,2,1,1,2,0,4,4,1,0,1,0,0,0,2,7,9
wi15,151,MARSHALL,BIOL,Ec/Beh/Evo,0,0,0,0,0,0,1,1,2,0,3,3,2,1,3,0,0,0,3,5,8
wi15,151,MARSHALL,BIOL,Genl Biol,0,0,0,5,12,17,8,14,22,9,23,32,24,47,71,0,0,0,46,96,142
wi15,151,MARSHALL,BIOL,Human Bio,0,0,0,4,30,34,20,42,62,21,54,75,47,57,104,0,0,0,92,183,275
wi15,151,MARSHALL,BIOL,Microbiol,0,0,0,1,3,4,1,3,4,5,9,14,6,5,11,0,0,0,13,20,33
wi15,151,MARSHALL,BIOL,Molec Biol,0,0,0,1,0,1,6,0,6,6,4,10,4,4,8,0,0,0,17,8,25
wi15,151,MARSHALL,BIOL,PhyslNeuro,0,0,0,3,4,7,13,15,28,13,23,36,25,35,60,0,0,0,54,77,131
wi15,151,MARSHALL,CENG,Chem Engin,0,0,0,0,0,0,7,1,8,23,7,30,23,23,46,0,0,0,53,31,84
wi15,151,MARSHALL,CHEM,Bioch/Chem,0,0,0,1,1,2,4,6,10,2,8,10,7,14,21,0,0,0,14,29,43
wi15,151,MARSHALL,CHEM,Bioinform,0,0,0,0,0,0,2,0,2,1,0,1,1,0,1,0,0,0,4,0,4
wi15,151,MARSHALL,CHEM,Chem Educ,0,0,0,0,0,0,0,0,0,0,0,0,1,0,1,0,0,0,1,0,1
wi15,151,MARSHALL,CHEM,Chem Phys,0,0,0,1,1,2,0,0,0,0,0,0,0,1,1,0,0,0,1,2,3
wi15,151,MARSHALL,CHEM,Chemistry,0,0,0,4,6,10,7,6,13,4,3,7,7,6,13,0,0,0,22,21,43
wi15,151,MARSHALL,CHEM,Envir Chem,0,0,0,0,0,0,0,0,0,0,0,0,0,2,2,0,0,0,0,2,2
wi15,151,MARSHALL,CHEM,MolecSynth,0,0,0,0,0,0,0,0,0,0,0,0,1,2,3,0,0,0,1,2,3
wi15,151,MARSHALL,CHEM,Pharm Chem,0,0,0,2,1,3,4,7,11,5,6,11,8,7,15,0,0,0,19,21,40
wi15,151,MARSHALL,CLAS,Classic St,0,0,0,0,0,0,0,0,0,0,0,0,0,1,1,0,0,0,0,1,1
wi15,151,MARSHALL,COGS,Cog Sci,0,0,0,2,3,5,0,4,4,1,8,9,5,4,9,0,0,0,8,19,27
wi15,151,MARSHALL,COGS,CogSc/ClAs,0,0,0,0,1,1,0,1,1,0,0,0,0,2,2,0,0,0,0,4,4
wi15,151,MARSHALL,COGS,CogSc/Comp,0,0,0,0,0,0,1,0,1,0,0,0,2,0,2,0,0,0,3,0,3
wi15,151,MARSHALL,COGS,CogSc/HCI,0,0,0,1,0,1,0,1,1,4,4,8,1,9,10,0,0,0,6,14,20
wi15,151,MARSHALL,COGS,CogSc/HCog,0,0,0,0,0,0,1,0,1,0,1,1,0,1,1,0,0,0,1,2,3
wi15,151,MARSHALL,COGS,CogSc/Neur,0,0,0,1,1,2,0,3,3,1,2,3,3,9,12,0,0,0,5,15,20
wi15,151,MARSHALL,COMM,Communic,0,0,0,0,5,5,2,15,17,20,63,83,20,50,70,0,0,0,42,133,175
wi15,151,MARSHALL,CSE,Comp Sci,0,0,0,1,1,2,6,9,15,64,12,76,110,24,134,0,0,0,181,46,227
wi15,151,MARSHALL,CSE,CompEngCSE,0,0,0,0,0,0,2,0,2,13,1,14,18,2,20,0,0,0,33,3,36
wi15,151,MARSHALL,CSE,CompScBinf,0,0,0,0,0,0,1,1,2,3,2,5,2,2,4,0,0,0,6,5,11
wi15,151,MARSHALL,ECE,CompEngECE,0,0,0,0,1,1,13,1,14,14,1,15,7,1,8,0,0,0,34,4,38
wi15,151,MARSHALL,ECE,Electr Eng,0,0,0,2,1,3,7,4,11,45,5,50,48,13,61,0,0,0,102,23,125
wi15,151,MARSHALL,ECE,Pr-EngPhys,0,0,0,0,0,0,1,1,2,0,0,0,0,0,0,0,0,0,1,1,2
wi15,151,MARSHALL,ECON,Ec-Mth&Ecn,0,0,0,3,13,16,5,8,13,9,9,18,10,4,14,0,0,0,27,34,61
wi15,151,MARSHALL,ECON,Econ-MgtSc,0,0,0,5,8,13,5,13,18,25,44,69,42,39,81,0,0,0,77,104,181
wi15,151,MARSHALL,ECON,Economics,0,0,0,8,12,20,15,17,32,95,56,151,82,65,147,0,0,0,200,150,350
wi15,151,MARSHALL,ESYS,EnvSys(EB),0,0,0,0,0,0,0,3,3,2,2,4,3,6,9,0,0,0,5,11,16
wi15,151,MARSHALL,ESYS,EnvSys(EC),0,0,0,0,0,0,0,0,0,1,1,2,0,2,2,0,0,0,1,3,4
wi15,151,MARSHALL,ESYS,EnvSys(EP),0,0,0,0,0,0,0,0,0,0,1,1,1,3,4,0,0,0,1,4,5
wi15,151,MARSHALL,ESYS,EnvSys(ES),0,0,0,0,1,1,0,1,1,0,1,1,0,0,0,0,0,0,0,3,3
wi15,151,MARSHALL,ETHN,Ethnic St,0,0,0,0,1,1,0,2,2,1,0,1,1,3,4,0,0,0,2,6,8
wi15,151,MARSHALL,FPMU,Public Hlt,0,0,0,1,2,3,3,15,18,5,29,34,7,26,33,0,0,0,16,72,88
wi15,151,MARSHALL,GLBH,Global Hlt,0,0,0,0,0,0,0,0,0,0,0,0,1,0,1,0,0,0,1,0,1
wi15,151,MARSHALL,HDP,Human Dev,0,0,0,0,0,0,0,1,1,0,5,5,1,21,22,0,0,0,1,27,28
wi15,151,MARSHALL,HDP,Pr-HumnDev,0,0,0,0,1,1,0,7,7,2,14,16,0,5,5,0,0,0,2,27,29
wi15,151,MARSHALL,HIST,History,0,0,0,0,0,0,0,3,3,4,4,8,8,3,11,0,0,0,12,10,22
wi15,151,MARSHALL,INTL,Int-5yrPS,0,0,0,0,0,0,0,0,0,0,0,0,0,2,2,0,0,0,0,2,2
wi15,151,MARSHALL,INTL,IntSt-Anth,0,0,0,0,0,0,0,0,0,0,0,0,0,1,1,0,0,0,0,1,1
wi15,151,MARSHALL,INTL,IntSt-Econ,0,0,0,2,0,2,2,1,3,2,6,8,4,12,16,0,0,0,10,19,29
wi15,151,MARSHALL,INTL,IntSt-Hist,0,0,0,0,0,0,0,1,1,0,0,0,0,2,2,0,0,0,0,3,3
wi15,151,MARSHALL,INTL,IntSt-Ling,0,0,0,0,0,0,0,0,0,0,0,0,0,1,1,0,0,0,0,1,1
wi15,151,MARSHALL,INTL,IntSt-PolS,0,0,0,1,3,4,0,4,4,3,3,6,2,13,15,0,0,0,6,23,29
wi15,151,MARSHALL,INTL,IntSt-Soc,0,0,0,0,0,0,0,0,0,0,3,3,1,3,4,0,0,0,1,6,7
wi15,151,MARSHALL,JAPN,JapaneseSt,0,0,0,0,0,0,0,1,1,0,0,0,1,0,1,0,0,0,1,1,2
wi15,151,MARSHALL,LATI,LatinAm St,0,0,0,0,0,0,0,0,0,0,1,1,0,0,0,0,0,0,0,1,1
wi15,151,MARSHALL,LING,Lang Stu,0,0,0,0,0,0,0,0,0,0,0,0,1,0,1,0,0,0,1,0,1
wi15,151,MARSHALL,LING,Ling-CogLn,0,0,0,0,0,0,1,0,1,0,2,2,0,2,2,0,0,0,1,4,5
wi15,151,MARSHALL,LING,Ling-LSoc,0,0,0,0,0,0,0,1,1,0,0,0,0,3,3,0,0,0,0,4,4
wi15,151,MARSHALL,LING,Linguistcs,0,0,0,0,0,0,0,0,0,0,0,0,1,1,2,0,0,0,1,1,2
wi15,151,MARSHALL,LIT,Lit/Compos,0,0,0,0,0,0,0,0,0,0,0,0,0,1,1,0,0,0,0,1,1
wi15,151,MARSHALL,LIT,Lit/CultSt,0,0,0,0,0,0,1,0,1,0,0,0,0,0,0,0,0,0,1,0,1
wi15,151,MARSHALL,LIT,Lit/Engl,0,0,0,0,2,2,0,0,0,0,0,0,3,3,6,0,0,0,3,5,8
wi15,151,MARSHALL,LIT,Lit/World,0,0,0,0,0,0,0,0,0,0,0,0,0,3,3,0,0,0,0,3,3
wi15,151,MARSHALL,LIT,Lit/Writng,0,0,0,1,0,1,2,0,2,3,3,6,2,2,4,0,0,0,8,5,13
wi15,151,MARSHALL,MAE,Aerosp Eng,0,0,0,1,0,1,1,1,2,6,0,6,12,2,14,0,0,0,20,3,23
wi15,151,MARSHALL,MAE,Engin Sci,0,0,0,0,0,0,0,0,0,0,0,0,1,0,1,0,0,0,1,0,1
wi15,151,MARSHALL,MAE,Envir Eng,0,0,0,3,1,4,2,2,4,4,6,10,9,1,10,0,0,0,18,10,28
wi15,151,MARSHALL,MAE,Mech Engin,0,0,0,1,1,2,8,0,8,3,0,3,18,4,22,0,0,0,30,5,35
wi15,151,MARSHALL,MATH,Appld Math,0,0,0,4,8,12,9,7,16,5,9,14,5,4,9,0,0,0,23,28,51
wi15,151,MARSHALL,MATH,Math/SecEd,0,0,0,0,0,0,3,1,4,1,2,3,1,0,1,0,0,0,5,3,8
wi15,151,MARSHALL,MATH,Mathematcs,0,0,0,2,3,5,0,3,3,5,2,7,2,4,6,0,0,0,9,12,21
wi15,151,MARSHALL,MATH,Mth-CompSc,0,0,0,9,0,9,13,2,15,4,2,6,2,2,4,0,0,0,28,6,34
wi15,151,MARSHALL,MATH,Mth-Mth&Ec,0,0,0,2,2,4,4,2,6,3,5,8,3,5,8,0,0,0,12,14,26
wi15,151,MARSHALL,MATH,Mth/ApldSc,0,0,0,0,0,0,1,2,3,0,0,0,1,0,1,0,0,0,2,2,4
wi15,151,MARSHALL,MATH,Pr-Math CS,0,0,0,0,0,0,0,0,0,0,1,1,1,0,1,0,0,0,1,1,2
wi15,151,MARSHALL,MATH,Prob&Stats,0,0,0,0,3,3,1,3,4,1,6,7,2,2,4,0,0,0,4,14,18
wi15,151,MARSHALL,MUS,Mu-CompArt,0,0,0,0,0,0,1,0,1,0,1,1,2,0,2,0,0,0,3,1,4
wi15,151,MARSHALL,MUS,Music,0,0,0,0,1,1,0,1,1,2,0,2,1,0,1,0,0,0,3,2,5
wi15,151,MARSHALL,MUS,Music Hum,0,0,0,0,0,0,0,0,0,0,1,1,0,0,0,0,0,0,0,1,1
wi15,151,MARSHALL,NENG,NanoEng,0,0,0,0,0,0,7,2,9,12,3,15,15,3,18,0,0,0,34,8,42
wi15,151,MARSHALL,PHIL,Philosophy,0,0,0,0,0,0,0,0,0,1,0,1,3,0,3,0,0,0,4,0,4
wi15,151,MARSHALL,PHYS,Biophysics,0,0,0,0,0,0,1,0,1,1,0,1,1,0,1,0,0,0,3,0,3
wi15,151,MARSHALL,PHYS,GenPys/SEd,0,0,0,0,0,0,0,0,0,0,0,0,1,1,2,0,0,0,1,1,2
wi15,151,MARSHALL,PHYS,Phy/ErthSc,0,0,0,0,0,0,0,0,0,0,0,0,1,0,1,0,0,0,1,0,1
wi15,151,MARSHALL,PHYS,Phys/Astro,0,0,0,0,0,0,2,0,2,1,0,1,1,0,1,0,0,0,4,0,4
wi15,151,MARSHALL,PHYS,Phys/Comp,0,0,0,1,0,1,0,0,0,0,0,0,0,0,0,0,0,0,1,0,1
wi15,151,MARSHALL,PHYS,Phys/Mtrls,0,0,0,1,1,2,1,0,1,0,0,0,1,0,1,0,0,0,3,1,4
wi15,151,MARSHALL,PHYS,Physics,0,0,0,7,2,9,5,1,6,3,1,4,3,1,4,0,0,0,18,5,23
wi15,151,MARSHALL,POLI,Polit Sci,0,0,0,2,0,2,5,6,11,8,8,16,18,17,35,0,0,0,33,31,64
wi15,151,MARSHALL,POLI,PolSc-Amer,0,0,0,0,1,1,0,0,0,1,3,4,4,2,6,0,0,0,5,6,11
wi15,151,MARSHALL,POLI,PolSc-Comp,0,0,0,0,0,0,0,0,0,0,1,1,0,1,1,0,0,0,0,2,2
wi15,151,MARSHALL,POLI,PolSc-Intl,0,0,0,1,1,2,1,2,3,5,4,9,11,6,17,0,0,0,18,13,31
wi15,151,MARSHALL,POLI,PolSc-PLaw,0,0,0,1,2,3,1,4,5,2,5,7,7,8,15,0,0,0,11,19,30
wi15,151,MARSHALL,POLI,PolSc-PPol,0,0,0,0,0,0,0,1,1,0,4,4,3,1,4,0,0,0,3,6,9
wi15,151,MARSHALL,POLI,PolSc-Thry,0,0,0,0,1,1,1,0,1,1,3,4,2,1,3,0,0,0,4,5,9
wi15,151,MARSHALL,PSYC,Psychology,0,0,0,5,11,16,12,24,36,14,53,67,33,74,107,0,0,0,64,162,226
wi15,151,MARSHALL,RELI,Relig/Stu,0,0,0,0,0,0,0,0,0,1,0,1,0,0,0,0,0,0,1,0,1
wi15,151,MARSHALL,SE,Struct Eng,0,0,0,2,0,2,6,5,11,19,1,20,35,11,46,0,0,0,62,17,79
wi15,151,MARSHALL,SIO,Earth Sci,0,0,0,0,0,0,0,1,1,0,2,2,0,0,0,0,0,0,0,3,3
wi15,151,MARSHALL,SIO,Marine Bio,0,0,0,0,1,1,1,4,5,0,7,7,0,3,3,0,0,0,1,15,16
wi15,151,MARSHALL,SOC,SocAmSt,0,0,0,0,0,0,0,0,0,0,0,0,0,1,1,0,0,0,0,1,1
wi15,151,MARSHALL,SOC,SocCulCom,0,0,0,0,0,0,0,1,1,0,1,1,1,2,3,0,0,0,1,4,5
wi15,151,MARSHALL,SOC,SocEconSoc,0,0,0,0,0,0,0,1,1,0,0,0,0,0,0,0,0,0,0,1,1
wi15,151,MARSHALL,SOC,SocIntlStu,0,0,0,0,0,0,0,0,0,1,0,1,0,2,2,0,0,0,1,2,3
wi15,151,MARSHALL,SOC,Sociology,0,0,0,0,1,1,1,2,3,3,5,8,7,10,17,0,0,0,11,18,29
wi15,151,MARSHALL,SOC,SocLawSoc,0,0,0,0,1,1,0,1,1,0,2,2,2,2,4,0,0,0,2,6,8
wi15,151,MARSHALL,SOC,SocSciMed,0,0,0,0,1,1,0,0,0,0,1,1,1,1,2,0,0,0,1,3,4
wi15,151,MARSHALL,SOC,SocSolneq,0,0,0,0,0,0,0,0,0,0,2,2,0,7,7,0,0,0,0,9,9
wi15,151,MARSHALL,THEA,Dance,0,0,0,0,1,1,0,0,0,0,0,0,0,1,1,0,0,0,0,2,2
wi15,151,MARSHALL,THEA,Theatre,0,0,0,0,2,2,0,0,0,0,2,2,1,2,3,0,0,0,1,6,7
wi15,151,MARSHALL,UNAF,UndecHumAr,0,0,0,0,1,1,0,1,1,0,0,0,0,0,0,0,0,0,0,2,2
wi15,151,MARSHALL,UNAF,Undeclared,0,0,0,23,21,44,17,11,28,0,0,0,0,0,0,0,0,0,40,32,72
wi15,151,MARSHALL,UNAF,UndecPhysS,0,0,0,2,1,3,0,2,2,1,0,1,0,0,0,0,0,0,3,3,6
wi15,151,MARSHALL,UNAF,UndecSocSc,0,0,0,4,3,7,0,3,3,0,0,0,0,0,0,0,0,0,4,6,10
wi15,151,MARSHALL,USP,Urb Stu&Pl,0,0,0,0,1,1,0,0,0,1,5,6,4,7,11,0,0,0,5,13,18
wi15,151,MARSHALL,VIS,Art Hst/Cr,0,0,0,0,0,0,0,0,0,0,2,2,0,2,2,0,0,0,0,4,4
wi15,151,MARSHALL,VIS,Media,0,0,0,0,2,2,1,0,1,1,6,7,7,8,15,0,0,0,9,16,25
wi15,151,MARSHALL,VIS,Studio VA,0,0,0,0,0,0,0,1,1,1,1,2,0,2,2,0,0,0,1,4,5
wi15,151,MARSHALL,VIS,VA-CompArt,0,0,0,0,0,0,0,2,2,2,6,8,1,3,4,0,0,0,3,11,14
wi15,151,MUIR,ANTH,Anth-Arch,0,0,0,1,0,1,0,1,1,0,1,1,2,4,6,0,0,0,3,6,9
wi15,151,MUIR,ANTH,Anth-Biol,0,0,0,0,1,1,0,0,0,1,1,2,0,13,13,0,0,0,1,15,16
wi15,151,MUIR,ANTH,Anth-Soci,0,0,0,0,0,0,1,2,3,0,3,3,1,2,3,0,0,0,2,7,9
wi15,151,MUIR,BENG,Bioen:Binf,0,0,0,0,0,0,1,2,3,2,3,5,8,3,11,0,0,0,11,8,19
wi15,151,MUIR,BENG,BioengBioS,0,0,0,0,1,1,4,1,5,4,2,6,0,0,0,0,0,0,8,4,12
wi15,151,MUIR,BENG,BioengBiot,0,0,0,1,1,2,5,6,11,5,4,9,9,5,14,0,0,0,20,16,36
wi15,151,MUIR,BENG,Bioengin,0,0,0,1,0,1,8,6,14,4,3,7,14,6,20,0,0,0,27,15,42
wi15,151,MUIR,BIOL,Bioc/CellB,0,0,0,3,16,19,22,36,58,20,39,59,43,45,88,0,0,0,88,136,224
wi15,151,MUIR,BIOL,BiolBioinf,0,0,0,1,2,3,2,0,2,1,0,1,1,0,1,0,0,0,5,2,7
wi15,151,MUIR,BIOL,Ec/Beh/Evo,0,0,0,1,2,3,0,5,5,1,4,5,6,11,17,0,0,0,8,22,30
wi15,151,MUIR,BIOL,Genl Biol,0,0,0,2,9,11,17,28,45,23,25,48,35,50,85,0,0,0,77,112,189
wi15,151,MUIR,BIOL,Human Bio,0,0,0,10,27,37,38,63,101,28,57,85,32,60,92,0,0,0,108,207,315
wi15,151,MUIR,BIOL,Microbiol,0,0,0,0,3,3,0,6,6,5,5,10,1,4,5,0,0,0,6,18,24
wi15,151,MUIR,BIOL,Molec Biol,0,0,0,3,2,5,7,4,11,5,6,11,6,10,16,0,0,0,21,22,43
wi15,151,MUIR,BIOL,PhyslNeuro,0,0,0,9,13,22,22,24,46,20,30,50,22,29,51,0,0,0,73,96,169
wi15,151,MUIR,CENG,Chem Engin,0,0,0,1,1,2,19,6,25,17,15,32,24,15,39,0,0,0,61,37,98
wi15,151,MUIR,CGS,CritGendSt,0,0,0,0,1,1,2,1,3,1,2,3,0,5,5,0,0,0,3,9,12
wi15,151,MUIR,CHEM,Bioch/Chem,0,0,0,1,1,2,6,7,13,9,10,19,13,16,29,0,0,0,29,34,63
wi15,151,MUIR,CHEM,Bioinform,0,0,0,0,0,0,0,0,0,1,0,1,1,0,1,0,0,0,2,0,2
wi15,151,MUIR,CHEM,Chem Educ,0,0,0,0,0,0,0,1,1,0,0,0,0,0,0,0,0,0,0,1,1
wi15,151,MUIR,CHEM,Chem Phys,0,0,0,0,0,0,0,0,0,0,0,0,0,1,1,0,0,0,0,1,1
wi15,151,MUIR,CHEM,Chemistry,0,0,0,2,3,5,7,5,12,1,3,4,4,3,7,0,0,0,14,14,28
wi15,151,MUIR,CHEM,Envir Chem,0,0,0,2,0,2,0,0,0,0,0,0,2,1,3,0,0,0,4,1,5
wi15,151,MUIR,CHEM,MolecSynth,0,0,0,0,0,0,1,0,1,1,0,1,1,1,2,0,0,0,3,1,4
wi15,151,MUIR,CHEM,Pharm Chem,0,0,0,1,3,4,4,7,11,4,8,12,8,17,25,0,0,0,17,35,52
wi15,151,MUIR,CLAS,Classic St,0,0,0,0,0,0,2,0,2,0,0,0,0,0,0,0,0,0,2,0,2
wi15,151,MUIR,COGS,Cog Sci,0,0,0,2,4,6,3,8,11,7,9,16,5,9,14,0,0,0,17,30,47
wi15,151,MUIR,COGS,CogSc/ClAs,0,0,0,0,1,1,0,1,1,0,1,1,1,0,1,0,0,0,1,3,4
wi15,151,MUIR,COGS,CogSc/Comp,0,0,0,0,0,0,0,1,1,1,0,1,1,0,1,0,0,0,2,1,3
wi15,151,MUIR,COGS,CogSc/HCI,0,0,0,2,1,3,2,1,3,3,7,10,4,6,10,0,0,0,11,15,26
wi15,151,MUIR,COGS,CogSc/HCog,0,0,0,0,0,0,0,1,1,2,0,2,0,3,3,0,0,0,2,4,6
wi15,151,MUIR,COGS,CogSc/Neur,0,0,0,0,1,1,1,4,5,1,6,7,10,17,27,0,0,0,12,28,40
wi15,151,MUIR,COMM,Communic,0,0,0,1,8,9,3,19,22,8,33,41,14,35,49,0,0,0,26,95,121
wi15,151,MUIR,CSE,Comp Sci,0,0,0,5,3,8,23,11,34,54,18,72,109,24,133,0,0,0,191,56,247
wi15,151,MUIR,CSE,CompEngCSE,0,0,0,1,0,1,10,1,11,8,0,8,14,1,15,0,0,0,33,2,35
wi15,151,MUIR,CSE,CompScBinf,0,0,0,0,0,0,2,3,5,0,1,1,6,1,7,0,0,0,8,5,13
wi15,151,MUIR,ECE,CompEngECE,0,0,0,0,0,0,7,1,8,9,2,11,7,1,8,0,0,0,23,4,27
wi15,151,MUIR,ECE,Electr Eng,0,0,0,3,2,5,19,1,20,31,1,32,35,8,43,0,0,0,88,12,100
wi15,151,MUIR,ECE,Pr-EngPhys,0,0,0,1,0,1,2,0,2,0,0,0,0,0,0,0,0,0,3,0,3
wi15,151,MUIR,ECON,Ec-Mth&Ecn,0,0,0,4,5,9,5,7,12,6,5,11,7,3,10,0,0,0,22,20,42
wi15,151,MUIR,ECON,Econ-MgtSc,0,0,0,6,8,14,10,10,20,26,15,41,30,25,55,0,0,0,72,58,130
wi15,151,MUIR,ECON,Economics,0,0,0,8,7,15,21,12,33,50,34,84,40,41,81,0,0,0,119,94,213
wi15,151,MUIR,ESYS,EnvSys(EB),0,0,0,1,0,1,0,5,5,3,4,7,8,6,14,0,0,0,12,15,27
wi15,151,MUIR,ESYS,EnvSys(EC),0,0,0,0,0,0,0,0,0,0,2,2,1,2,3,0,0,0,1,4,5
wi15,151,MUIR,ESYS,EnvSys(EP),0,0,0,0,2,2,1,0,1,2,0,2,1,1,2,0,0,0,4,3,7
wi15,151,MUIR,ESYS,EnvSys(ES),0,0,0,0,1,1,1,2,3,0,0,0,3,0,3,0,0,0,4,3,7
wi15,151,MUIR,ETHN,Ethnic St,0,0,0,0,0,0,1,3,4,0,3,3,2,1,3,0,0,0,3,7,10
wi15,151,MUIR,FPMU,Public Hlt,0,0,0,2,5,7,4,17,21,8,25,33,2,19,21,0,0,0,16,66,82
wi15,151,MUIR,GLBH,Global Hlt,0,0,0,1,1,2,0,3,3,1,2,3,0,1,1,0,0,0,2,7,9
wi15,151,MUIR,HDP,Human Dev,0,0,0,0,0,0,0,1,1,1,4,5,1,22,23,0,0,0,2,27,29
wi15,151,MUIR,HDP,Pr-HumnDev,0,0,0,0,2,2,0,9,9,1,12,13,0,3,3,0,0,0,1,26,27
wi15,151,MUIR,HIST,History,0,0,0,0,1,1,3,0,3,2,3,5,8,4,12,0,0,0,13,8,21
wi15,151,MUIR,INTL,IntSt-Anth,0,0,0,0,0,0,0,0,0,0,1,1,1,0,1,0,0,0,1,1,2
wi15,151,MUIR,INTL,IntSt-Econ,0,0,0,0,1,1,0,7,7,2,3,5,1,9,10,0,0,0,3,20,23
wi15,151,MUIR,INTL,IntSt-Hist,0,0,0,0,0,0,0,0,0,0,0,0,1,0,1,0,0,0,1,0,1
wi15,151,MUIR,INTL,IntSt-Ling,0,0,0,0,0,0,0,0,0,0,0,0,0,1,1,0,0,0,0,1,1
wi15,151,MUIR,INTL,IntSt-PolS,0,0,0,0,0,0,1,3,4,0,2,2,7,7,14,0,0,0,8,12,20
wi15,151,MUIR,INTL,IntSt-Soc,0,0,0,0,0,0,0,1,1,0,1,1,2,6,8,0,0,0,2,8,10
wi15,151,MUIR,ITAL,Italian St,0,0,0,0,0,0,0,0,0,0,1,1,0,0,0,0,0,0,0,1,1
wi15,151,MUIR,JAPN,JapaneseSt,0,0,0,0,0,0,0,0,0,0,1,1,0,2,2,0,0,0,0,3,3
wi15,151,MUIR,LING,Lang Stu,0,0,0,0,1,1,0,2,2,0,0,0,2,1,3,0,0,0,2,4,6
wi15,151,MUIR,LING,Ling-CogLn,0,0,0,0,0,0,1,0,1,1,1,2,2,3,5,0,0,0,4,4,8
wi15,151,MUIR,LING,Linguistcs,0,0,0,0,0,0,1,1,2,1,1,2,3,3,6,0,0,0,5,5,10
wi15,151,MUIR,LIT,Lit/Compos,0,0,0,0,1,1,0,0,0,0,0,0,0,0,0,0,0,0,0,1,1
wi15,151,MUIR,LIT,Lit/CultSt,0,0,0,0,0,0,0,0,0,0,0,0,0,1,1,0,0,0,0,1,1
wi15,151,MUIR,LIT,Lit/Engl,0,0,0,0,1,1,0,6,6,0,3,3,1,6,7,0,0,0,1,16,17
wi15,151,MUIR,LIT,Lit/World,0,0,0,0,0,0,0,0,0,1,2,3,1,0,1,0,0,0,2,2,4
wi15,151,MUIR,LIT,Lit/Writng,0,0,0,1,2,3,0,5,5,5,6,11,3,10,13,0,0,0,9,23,32
wi15,151,MUIR,LIT,Spanish Lt,0,0,0,0,1,1,0,1,1,0,0,0,0,5,5,0,0,0,0,7,7
wi15,151,MUIR,MAE,Aerosp Eng,0,0,0,2,0,2,7,1,8,5,1,6,13,3,16,0,0,0,27,5,32
wi15,151,MUIR,MAE,Engin Sci,0,0,0,0,0,0,0,0,0,0,0,0,1,0,1,0,0,0,1,0,1
wi15,151,MUIR,MAE,Envir Eng,0,0,0,3,1,4,10,8,18,6,4,10,12,11,23,0,0,0,31,24,55
wi15,151,MUIR,MAE,Mech Engin,0,0,0,2,1,3,8,1,9,12,3,15,22,6,28,0,0,0,44,11,55
wi15,151,MUIR,MATH,Appld Math,0,0,0,6,9,15,10,8,18,5,4,9,8,3,11,0,0,0,29,24,53
wi15,151,MUIR,MATH,Math/SecEd,0,0,0,0,1,1,0,1,1,1,0,1,1,5,6,0,0,0,2,7,9
wi15,151,MUIR,MATH,Mathematcs,0,0,0,3,3,6,6,3,9,6,2,8,8,3,11,0,0,0,23,11,34
wi15,151,MUIR,MATH,Mth-CompSc,0,0,0,5,3,8,4,3,7,4,0,4,4,1,5,0,0,0,17,7,24
wi15,151,MUIR,MATH,Mth-Mth&Ec,0,0,0,1,3,4,0,1,1,5,0,5,5,3,8,0,0,0,11,7,18
wi15,151,MUIR,MATH,Mth/ApldSc,0,0,0,0,2,2,2,0,2,1,1,2,0,0,0,0,0,0,3,3,6
wi15,151,MUIR,MATH,Prob&Stats,0,0,0,0,1,1,1,1,2,5,2,7,3,2,5,0,0,0,9,6,15
wi15,151,MUIR,MUS,Mu-CompArt,0,0,0,1,1,2,0,1,1,2,2,4,5,1,6,0,0,0,8,5,13
wi15,151,MUIR,MUS,Music,0,0,0,1,0,1,2,0,2,4,1,5,3,3,6,0,0,0,10,4,14
wi15,151,MUIR,MUS,Music Hum,0,0,0,0,0,0,0,0,0,0,0,0,1,0,1,0,0,0,1,0,1
wi15,151,MUIR,NENG,NanoEng,0,0,0,3,0,3,5,0,5,11,5,16,12,2,14,0,0,0,31,7,38
wi15,151,MUIR,PHIL,Philosophy,0,0,0,3,0,3,0,0,0,1,0,1,2,0,2,0,0,0,6,0,6
wi15,151,MUIR,PHYS,Biophysics,0,0,0,0,0,0,1,0,1,0,0,0,1,2,3,0,0,0,2,2,4
wi15,151,MUIR,PHYS,Phy/ErthSc,0,0,0,0,0,0,0,0,0,1,0,1,0,0,0,0,0,0,1,0,1
wi15,151,MUIR,PHYS,Phys/Astro,0,0,0,0,0,0,6,3,9,1,0,1,2,0,2,0,0,0,9,3,12
wi15,151,MUIR,PHYS,Phys/Comp,0,0,0,0,0,0,1,0,1,0,0,0,2,0,2,0,0,0,3,0,3
wi15,151,MUIR,PHYS,Phys/Mtrls,0,0,0,1,0,1,1,0,1,0,0,0,2,0,2,0,0,0,4,0,4
wi15,151,MUIR,PHYS,Physics,0,0,0,4,3,7,5,2,7,5,1,6,3,0,3,0,0,0,17,6,23
wi15,151,MUIR,POLI,Polit Sci,0,0,0,0,4,4,2,7,9,0,4,4,16,9,25,0,0,0,18,24,42
wi15,151,MUIR,POLI,PolSc-Amer,0,0,0,0,0,0,0,0,0,1,2,3,3,2,5,0,0,0,4,4,8
wi15,151,MUIR,POLI,PolSc-Comp,0,0,0,0,0,0,1,0,1,0,1,1,1,0,1,0,0,0,2,1,3
wi15,151,MUIR,POLI,PolSc-Intl,0,0,0,1,1,2,1,1,2,7,2,9,13,7,20,0,0,0,22,11,33
wi15,151,MUIR,POLI,PolSc-PLaw,0,0,0,1,0,1,1,1,2,2,8,10,9,5,14,0,0,0,13,14,27
wi15,151,MUIR,POLI,PolSc-PPol,0,0,0,1,0,1,0,0,0,2,2,4,0,1,1,0,0,0,3,3,6
wi15,151,MUIR,POLI,PolSc-Thry,0,0,0,0,1,1,0,0,0,0,0,0,0,1,1,0,0,0,0,2,2
wi15,151,MUIR,PSYC,Psychology,0,0,0,5,17,22,10,31,41,13,56,69,30,101,131,0,0,0,58,205,263
wi15,151,MUIR,RELI,Relig/Stu,0,0,0,1,0,1,0,0,0,0,0,0,0,0,0,0,0,0,1,0,1
wi15,151,MUIR,SE,Struct Eng,0,0,0,2,2,4,10,4,14,14,9,23,26,15,41,0,0,0,52,30,82
wi15,151,MUIR,SIO,Earth Sci,0,0,0,2,1,3,2,0,2,2,2,4,3,2,5,0,0,0,9,5,14
wi15,151,MUIR,SIO,Marine Bio,0,0,0,3,4,7,6,10,16,4,5,9,2,14,16,0,0,0,15,33,48
wi15,151,MUIR,SOC,SocCulCom,0,0,0,0,0,0,0,1,1,0,0,0,0,3,3,0,0,0,0,4,4
wi15,151,MUIR,SOC,SocEconSoc,0,0,0,0,0,0,0,1,1,0,0,0,0,0,0,0,0,0,0,1,1
wi15,151,MUIR,SOC,SocIntlStu,0,0,0,0,0,0,0,0,0,0,1,1,0,0,0,0,0,0,0,1,1
wi15,151,MUIR,SOC,Sociology,0,0,0,0,2,2,0,4,4,2,4,6,5,18,23,0,0,0,7,28,35
wi15,151,MUIR,SOC,SocLawSoc,0,0,0,0,5,5,1,2,3,0,2,2,1,7,8,0,0,0,2,16,18
wi15,151,MUIR,SOC,SocSciMed,0,0,0,0,0,0,0,1,1,0,1,1,0,0,0,0,0,0,0,2,2
wi15,151,MUIR,SOC,SocSolneq,0,0,0,0,2,2,0,0,0,2,4,6,1,4,5,0,0,0,3,10,13
wi15,151,MUIR,THEA,Dance,0,0,0,0,0,0,0,0,0,0,0,0,0,1,1,0,0,0,0,1,1
wi15,151,MUIR,THEA,Theatre,0,0,0,0,2,2,1,6,7,1,3,4,2,8,10,0,0,0,4,19,23
wi15,151,MUIR,UNAF,UndecHumAr,0,0,0,0,2,2,0,1,1,0,0,0,0,0,0,0,0,0,0,3,3
wi15,151,MUIR,UNAF,Undeclared,0,0,0,28,18,46,22,19,41,0,0,0,0,0,0,0,0,0,50,37,87
wi15,151,MUIR,UNAF,UndecPhysS,0,0,0,1,4,5,3,7,10,0,0,0,0,0,0,0,0,0,4,11,15
wi15,151,MUIR,UNAF,UndecSocSc,0,0,0,2,4,6,1,7,8,0,0,0,0,0,0,0,0,0,3,11,14
wi15,151,MUIR,USP,Urb Stu&Pl,0,0,0,1,1,2,1,3,4,1,2,3,7,9,16,0,0,0,10,15,25
wi15,151,MUIR,VIS,Art Hst/Cr,0,0,0,0,1,1,0,0,0,0,1,1,1,1,2,0,0,0,1,3,4
wi15,151,MUIR,VIS,Media,0,0,0,2,0,2,0,0,0,3,4,7,8,7,15,0,0,0,13,11,24
wi15,151,MUIR,VIS,Studio VA,0,0,0,1,0,1,0,1,1,0,4,4,0,7,7,0,0,0,1,12,13
wi15,151,MUIR,VIS,VA-CompArt,0,0,0,0,2,2,1,2,3,0,0,0,3,3,6,0,0,0,4,7,11
wi15,151,REVELLE,ANTH,Anth-Arch,0,0,0,0,0,0,0,0,0,1,1,2,0,1,1,0,0,0,1,2,3
wi15,151,REVELLE,ANTH,Anth-Biol,0,0,0,0,1,1,0,1,1,0,3,3,1,3,4,0,0,0,1,8,9
wi15,151,REVELLE,ANTH,Anth-Soci,0,0,0,0,0,0,0,0,0,0,1,1,0,1,1,0,0,0,0,2,2
wi15,151,REVELLE,BENG,Bioen:Binf,0,0,0,0,0,0,4,2,6,8,4,12,8,4,12,0,0,0,20,10,30
wi15,151,REVELLE,BENG,BioengBioS,0,0,0,2,0,2,3,1,4,5,4,9,1,0,1,0,0,0,11,5,16
wi15,151,REVELLE,BENG,BioengBiot,0,0,0,1,1,2,6,5,11,5,1,6,23,9,32,0,0,0,35,16,51
wi15,151,REVELLE,BENG,Bioengin,0,0,0,0,0,0,6,0,6,9,2,11,17,13,30,0,0,0,32,15,47
wi15,151,REVELLE,BIOL,Bioc/CellB,0,0,0,18,22,40,31,28,59,43,68,111,52,65,117,0,0,0,144,183,327
wi15,151,REVELLE,BIOL,BiolBioinf,0,0,0,0,1,1,1,5,6,1,0,1,1,1,2,0,0,0,3,7,10
wi15,151,REVELLE,BIOL,Ec/Beh/Evo,0,0,0,0,0,0,2,2,4,2,1,3,1,6,7,0,0,0,5,9,14
wi15,151,REVELLE,BIOL,Genl Biol,0,0,0,7,14,21,16,24,40,17,25,42,34,50,84,0,0,0,74,113,187
wi15,151,REVELLE,BIOL,Human Bio,0,0,0,9,28,37,29,64,93,46,81,127,58,78,136,0,0,0,142,251,393
wi15,151,REVELLE,BIOL,Microbiol,0,0,0,2,2,4,2,2,4,3,12,15,9,6,15,0,0,0,16,22,38
wi15,151,REVELLE,BIOL,Molec Biol,0,0,0,2,2,4,13,4,17,7,8,15,11,9,20,0,0,0,33,23,56
wi15,151,REVELLE,BIOL,PhyslNeuro,0,0,0,7,14,21,25,22,47,30,39,69,42,35,77,0,0,0,104,110,214
wi15,151,REVELLE,CENG,Chem Engin,0,0,0,3,2,5,22,11,33,37,15,52,67,23,90,0,0,0,129,51,180
wi15,151,REVELLE,CGS,CritGendSt,0,0,0,0,0,0,0,0,0,0,0,0,1,1,2,0,0,0,1,1,2
wi15,151,REVELLE,CHEM,Bioch/Chem,0,0,0,2,3,5,3,6,9,15,10,25,18,9,27,0,0,0,38,28,66
wi15,151,REVELLE,CHEM,Bioinform,0,0,0,0,0,0,0,0,0,1,0,1,0,1,1,0,0,0,1,1,2
wi15,151,REVELLE,CHEM,Chem Phys,0,0,0,0,0,0,1,1,2,0,0,0,3,1,4,0,0,0,4,2,6
wi15,151,REVELLE,CHEM,Chemistry,0,0,0,4,6,10,10,3,13,8,4,12,12,7,19,0,0,0,34,20,54
wi15,151,REVELLE,CHEM,Envir Chem,0,0,0,1,0,1,0,0,0,3,1,4,0,3,3,0,0,0,4,4,8
wi15,151,REVELLE,CHEM,MolecSynth,0,0,0,0,0,0,0,0,0,1,0,1,0,0,0,0,0,0,1,0,1
wi15,151,REVELLE,CHEM,Pharm Chem,0,0,0,4,6,10,9,9,18,11,10,21,16,16,32,0,0,0,40,41,81
wi15,151,REVELLE,CLAS,Classic St,0,0,0,0,0,0,0,1,1,0,0,0,0,0,0,0,0,0,0,1,1
wi15,151,REVELLE,COGS,Cog Sci,0,0,0,1,1,2,0,5,5,2,4,6,7,10,17,0,0,0,10,20,30
wi15,151,REVELLE,COGS,CogSc/ClAs,0,0,0,0,0,0,0,1,1,0,2,2,0,4,4,0,0,0,0,7,7
wi15,151,REVELLE,COGS,CogSc/Comp,0,0,0,1,0,1,1,0,1,1,0,1,1,1,2,0,0,0,4,1,5
wi15,151,REVELLE,COGS,CogSc/HCI,0,0,0,0,0,0,3,1,4,3,6,9,4,8,12,0,0,0,10,15,25
wi15,151,REVELLE,COGS,CogSc/HCog,0,0,0,0,1,1,2,0,2,0,1,1,0,1,1,0,0,0,2,3,5
wi15,151,REVELLE,COGS,CogSc/Neur,0,0,0,1,0,1,2,3,5,3,7,10,5,12,17,0,0,0,11,22,33
wi15,151,REVELLE,COMM,Communic,0,0,0,2,0,2,2,3,5,7,14,21,6,9,15,0,0,0,17,26,43
wi15,151,REVELLE,CSE,Comp Sci,0,0,0,2,0,2,21,2,23,57,12,69,124,20,144,0,0,0,204,34,238
wi15,151,REVELLE,CSE,CompEngCSE,0,0,0,0,0,0,7,0,7,7,2,9,17,3,20,0,0,0,31,5,36
wi15,151,REVELLE,CSE,CompScBinf,0,0,0,0,0,0,4,1,5,3,3,6,6,1,7,0,0,0,13,5,18
wi15,151,REVELLE,ECE,CompEngECE,0,0,0,3,0,3,11,3,14,12,2,14,9,0,9,0,0,0,35,5,40
wi15,151,REVELLE,ECE,Electr Eng,0,0,0,5,1,6,20,9,29,30,4,34,71,7,78,0,0,0,126,21,147
wi15,151,REVELLE,ECE,EleEng&Soc,0,0,0,0,0,0,0,0,0,1,0,1,0,0,0,0,0,0,1,0,1
wi15,151,REVELLE,ECE,Engin Phys,0,0,0,0,0,0,0,0,0,2,0,2,6,0,6,0,0,0,8,0,8
wi15,151,REVELLE,ECE,Pr-EngPhys,0,0,0,0,0,0,2,0,2,2,1,3,1,0,1,0,0,0,5,1,6
wi15,151,REVELLE,ECON,Ec-Mth&Ecn,0,0,0,4,4,8,10,5,15,5,2,7,9,2,11,0,0,0,28,13,41
wi15,151,REVELLE,ECON,Econ-MgtSc,0,0,0,2,2,4,11,7,18,18,19,37,28,11,39,0,0,0,59,39,98
wi15,151,REVELLE,ECON,Economics,0,0,0,10,4,14,14,11,25,55,25,80,45,19,64,0,0,0,124,59,183
wi15,151,REVELLE,ESYS,EnvSys(EB),0,0,0,0,0,0,0,3,3,0,3,3,4,2,6,0,0,0,4,8,12
wi15,151,REVELLE,ESYS,EnvSys(EC),0,0,0,0,0,0,0,0,0,1,1,2,1,0,1,0,0,0,2,1,3
wi15,151,REVELLE,ESYS,EnvSys(ES),0,0,0,1,1,2,0,0,0,1,0,1,3,0,3,0,0,0,5,1,6
wi15,151,REVELLE,ETHN,Ethnic St,0,0,0,0,0,0,0,0,0,0,0,0,1,4,5,0,0,0,1,4,5
wi15,151,REVELLE,FPMU,Public Hlt,0,0,0,1,2,3,2,13,15,4,18,22,4,26,30,0,0,0,11,59,70
wi15,151,REVELLE,GLBH,Global Hlt,0,0,0,0,0,0,0,1,1,1,1,2,0,0,0,0,0,0,1,2,3
wi15,151,REVELLE,HDP,Human Dev,0,0,0,0,0,0,0,0,0,1,1,2,0,10,10,0,0,0,1,11,12
wi15,151,REVELLE,HDP,Pr-HumnDev,0,0,0,0,2,2,0,2,2,0,4,4,1,0,1,0,0,0,1,8,9
wi15,151,REVELLE,HIST,History,0,0,0,0,1,1,1,1,2,4,1,5,0,3,3,0,0,0,5,6,11
wi15,151,REVELLE,INTL,IntSt-Econ,0,0,0,0,0,0,1,0,1,2,2,4,5,4,9,0,0,0,8,6,14
wi15,151,REVELLE,INTL,IntSt-Hist,0,0,0,0,0,0,0,0,0,0,1,1,0,0,0,0,0,0,0,1,1
wi15,151,REVELLE,INTL,IntSt-Ling,0,0,0,0,0,0,0,0,0,0,0,0,0,1,1,0,0,0,0,1,1
wi15,151,REVELLE,INTL,IntSt-Lit,0,0,0,0,0,0,0,0,0,0,1,1,0,0,0,0,0,0,0,1,1
wi15,151,REVELLE,INTL,IntSt-PolS,0,0,0,0,0,0,1,1,2,2,1,3,0,5,5,0,0,0,3,7,10
wi15,151,REVELLE,INTL,IntSt-Soc,0,0,0,0,0,0,0,0,0,0,0,0,0,1,1,0,0,0,0,1,1
wi15,151,REVELLE,LING,Lang Stu,0,0,0,0,0,0,0,0,0,1,1,2,0,0,0,0,0,0,1,1,2
wi15,151,REVELLE,LING,Ling-CogLn,0,0,0,0,0,0,0,1,1,0,0,0,0,0,0,0,0,0,0,1,1
wi15,151,REVELLE,LING,Ling-LSoc,0,0,0,0,0,0,0,0,0,0,1,1,0,0,0,0,0,0,0,1,1
wi15,151,REVELLE,LING,Linguistcs,0,0,0,0,0,0,0,0,0,1,0,1,1,3,4,0,0,0,2,3,5
wi15,151,REVELLE,LIT,Lit/CultSt,0,0,0,0,0,0,0,1,1,0,1,1,0,0,0,0,0,0,0,2,2
wi15,151,REVELLE,LIT,Lit/Engl,0,0,0,0,0,0,0,0,0,2,0,2,2,2,4,0,0,0,4,2,6
wi15,151,REVELLE,LIT,Lit/World,0,0,0,0,0,0,0,0,0,0,1,1,1,2,3,0,0,0,1,3,4
wi15,151,REVELLE,LIT,Lit/Writng,0,0,0,0,0,0,1,2,3,0,0,0,1,6,7,0,0,0,2,8,10
wi15,151,REVELLE,LIT,Spanish Lt,0,0,0,0,0,0,0,0,0,0,0,0,1,1,2,0,0,0,1,1,2
wi15,151,REVELLE,MAE,Aerosp Eng,0,0,0,4,0,4,7,0,7,12,2,14,25,4,29,0,0,0,48,6,54
wi15,151,REVELLE,MAE,Engin Sci,0,0,0,0,0,0,0,0,0,0,0,0,2,0,2,0,0,0,2,0,2
wi15,151,REVELLE,MAE,Envir Eng,0,0,0,4,0,4,5,3,8,7,8,15,11,5,16,0,0,0,27,16,43
wi15,151,REVELLE,MAE,Mech Engin,0,0,0,6,0,6,12,4,16,12,4,16,35,6,41,0,0,0,65,14,79
wi15,151,REVELLE,MATH,Appld Math,0,0,0,9,3,12,9,4,13,9,6,15,12,11,23,0,0,0,39,24,63
wi15,151,REVELLE,MATH,Math/SecEd,0,0,0,1,0,1,0,0,0,1,0,1,1,1,2,0,0,0,3,1,4
wi15,151,REVELLE,MATH,Mathematcs,0,0,0,8,3,11,4,3,7,5,1,6,7,4,11,0,0,0,24,11,35
wi15,151,REVELLE,MATH,Mth-CompSc,0,0,0,6,4,10,15,2,17,6,3,9,3,2,5,0,0,0,30,11,41
wi15,151,REVELLE,MATH,Mth-Mth&Ec,0,0,0,0,1,1,1,5,6,0,3,3,2,5,7,0,0,0,3,14,17
wi15,151,REVELLE,MATH,Mth-SciCom,0,0,0,0,0,0,0,0,0,2,0,2,0,0,0,0,0,0,2,0,2
wi15,151,REVELLE,MATH,Mth/ApldSc,0,0,0,3,1,4,0,1,1,3,1,4,2,0,2,0,0,0,8,3,11
wi15,151,REVELLE,MATH,Prob&Stats,0,0,0,0,2,2,0,2,2,4,6,10,4,2,6,0,0,0,8,12,20
wi15,151,REVELLE,MUS,Mu-CompArt,0,0,0,0,0,0,0,0,0,3,1,4,0,0,0,0,0,0,3,1,4
wi15,151,REVELLE,MUS,Music,0,0,0,0,0,0,0,0,0,0,0,0,1,2,3,0,0,0,1,2,3
wi15,151,REVELLE,NENG,NanoEng,0,0,0,2,1,3,3,3,6,19,4,23,27,8,35,0,0,0,51,16,67
wi15,151,REVELLE,PHIL,Philosophy,0,0,0,0,0,0,1,0,1,1,1,2,2,0,2,0,0,0,4,1,5
wi15,151,REVELLE,PHYS,Biophysics,0,0,0,0,0,0,1,1,2,2,0,2,2,1,3,0,0,0,5,2,7
wi15,151,REVELLE,PHYS,Gen Physcs,0,0,0,1,0,1,0,0,0,0,0,0,0,1,1,0,0,0,1,1,2
wi15,151,REVELLE,PHYS,Phy/ErthSc,0,0,0,0,0,0,0,0,0,0,0,0,1,0,1,0,0,0,1,0,1
wi15,151,REVELLE,PHYS,Phys/Astro,0,0,0,1,1,2,7,1,8,6,0,6,6,5,11,0,0,0,20,7,27
wi15,151,REVELLE,PHYS,Phys/Comp,0,0,0,0,0,0,1,0,1,2,0,2,2,0,2,0,0,0,5,0,5
wi15,151,REVELLE,PHYS,Phys/Mtrls,0,0,0,0,1,1,2,1,3,1,0,1,0,0,0,0,0,0,3,2,5
wi15,151,REVELLE,PHYS,Physics,0,0,0,10,0,10,8,3,11,9,3,12,14,4,18,0,0,0,41,10,51
wi15,151,REVELLE,POLI,Polit Sci,0,0,0,1,0,1,0,2,2,3,1,4,4,2,6,0,0,0,8,5,13
wi15,151,REVELLE,POLI,PolSc-Amer,0,0,0,1,0,1,0,0,0,0,0,0,2,0,2,0,0,0,3,0,3
wi15,151,REVELLE,POLI,PolSc-Intl,0,0,0,1,0,1,2,3,5,5,1,6,2,3,5,0,0,0,10,7,17
wi15,151,REVELLE,POLI,PolSc-PLaw,0,0,0,0,1,1,1,1,2,1,1,2,1,4,5,0,0,0,3,7,10
wi15,151,REVELLE,POLI,PolSc-PPol,0,0,0,0,0,0,0,0,0,0,0,0,1,0,1,0,0,0,1,0,1
wi15,151,REVELLE,POLI,PolSc-Thry,0,0,0,0,0,0,0,0,0,0,0,0,1,1,2,0,0,0,1,1,2
wi15,151,REVELLE,PSYC,Psychology,0,0,0,2,9,11,1,10,11,16,26,42,21,58,79,0,0,0,40,103,143
wi15,151,REVELLE,RELI,Relig/Stu,0,0,0,0,0,0,0,0,0,0,0,0,0,1,1,0,0,0,0,1,1
wi15,151,REVELLE,SE,Struct Eng,0,0,0,1,3,4,10,2,12,22,5,27,42,12,54,0,0,0,75,22,97
wi15,151,REVELLE,SIO,Earth Sci,0,0,0,0,1,1,1,1,2,0,2,2,5,2,7,0,0,0,6,6,12
wi15,151,REVELLE,SIO,Marine Bio,0,0,0,2,3,5,5,9,14,0,7,7,2,9,11,0,0,0,9,28,37
wi15,151,REVELLE,SOC,SocEconSoc,0,0,0,0,0,0,0,0,0,0,0,0,0,1,1,0,0,0,0,1,1
wi15,151,REVELLE,SOC,SocIntlStu,0,0,0,0,0,0,0,0,0,1,0,1,0,0,0,0,0,0,1,0,1
wi15,151,REVELLE,SOC,Sociology,0,0,0,0,1,1,0,2,2,1,2,3,3,4,7,0,0,0,4,9,13
wi15,151,REVELLE,SOC,SocLawSoc,0,0,0,0,1,1,0,0,0,0,1,1,0,1,1,0,0,0,0,3,3
wi15,151,REVELLE,SOC,SocSciMed,0,0,0,0,0,0,0,0,0,0,0,0,1,3,4,0,0,0,1,3,4
wi15,151,REVELLE,THEA,Dance,0,0,0,0,0,0,0,0,0,0,0,0,1,0,1,0,0,0,1,0,1
wi15,151,REVELLE,THEA,Theatre,0,0,0,1,1,2,0,1,1,1,3,4,0,3,3,0,0,0,2,8,10
wi15,151,REVELLE,UNAF,Limited St,0,0,0,0,0,0,0,0,0,0,0,0,0,0,0,3,1,4,3,1,4
wi15,151,REVELLE,UNAF,Spec-Emply,0,0,0,0,0,0,0,0,0,0,0,0,0,0,0,3,2,5,3,2,5
wi15,151,REVELLE,UNAF,UndecHumAr,0,0,0,1,2,3,0,0,0,0,1,1,0,0,0,0,0,0,1,3,4
wi15,151,REVELLE,UNAF,Undeclared,0,0,0,44,15,59,32,7,39,3,2,5,0,0,0,0,0,0,79,24,103
wi15,151,REVELLE,UNAF,UndecPhysS,0,0,0,7,3,10,1,2,3,0,0,0,0,0,0,0,0,0,8,5,13
wi15,151,REVELLE,UNAF,UndecSocSc,0,0,0,1,3,4,0,0,0,0,0,0,0,0,0,0,0,0,1,3,4
wi15,151,REVELLE,USP,Urb Stu&Pl,0,0,0,0,0,0,1,0,1,0,1,1,0,0,0,0,0,0,1,1,2
wi15,151,REVELLE,VIS,Art Hst/Cr,0,0,0,0,0,0,0,0,0,0,0,0,0,1,1,0,0,0,0,1,1
wi15,151,REVELLE,VIS,Media,0,0,0,0,1,1,1,1,2,0,3,3,2,2,4,0,0,0,3,7,10
wi15,151,REVELLE,VIS,Studio VA,0,0,0,0,0,0,0,0,0,1,1,2,0,0,0,0,0,0,1,1,2
wi15,151,REVELLE,VIS,VA-CompArt,0,0,0,1,2,3,1,2,3,3,5,8,3,1,4,0,0,0,8,10,18
wi15,151,ROOSEVELT,ANTH,Anth-Arch,0,0,0,0,1,1,0,0,0,1,2,3,3,6,9,0,0,0,4,9,13
wi15,151,ROOSEVELT,ANTH,Anth-Biol,0,0,0,0,2,2,0,1,1,0,3,3,1,6,7,0,0,0,1,12,13
wi15,151,ROOSEVELT,ANTH,Anth-Soci,0,0,0,0,1,1,1,1,2,0,6,6,3,6,9,0,0,0,4,14,18
wi15,151,ROOSEVELT,BENG,Bioen:Binf,0,0,0,0,0,0,2,0,2,6,3,9,3,5,8,0,0,0,11,8,19
wi15,151,ROOSEVELT,BENG,BioengBioS,0,0,0,0,0,0,1,2,3,2,3,5,1,0,1,0,0,0,4,5,9
wi15,151,ROOSEVELT,BENG,BioengBiot,0,0,0,0,0,0,0,2,2,3,1,4,2,2,4,0,0,0,5,5,10
wi15,151,ROOSEVELT,BENG,Bioengin,0,0,0,0,0,0,0,0,0,1,0,1,5,2,7,0,0,0,6,2,8
wi15,151,ROOSEVELT,BIOL,Bioc/CellB,0,0,0,4,11,15,23,28,51,13,22,35,35,44,79,0,0,0,75,105,180
wi15,151,ROOSEVELT,BIOL,BiolBioinf,0,0,0,0,5,5,1,1,2,1,0,1,1,2,3,0,0,0,3,8,11
wi15,151,ROOSEVELT,BIOL,Ec/Beh/Evo,0,0,0,2,1,3,0,3,3,0,1,1,10,7,17,0,0,0,12,12,24
wi15,151,ROOSEVELT,BIOL,Genl Biol,0,0,0,6,15,21,9,17,26,15,16,31,25,39,64,0,0,0,55,87,142
wi15,151,ROOSEVELT,BIOL,Human Bio,0,0,0,13,41,54,29,55,84,13,45,58,29,51,80,0,0,0,84,192,276
wi15,151,ROOSEVELT,BIOL,Microbiol,0,0,0,1,1,2,3,1,4,2,2,4,2,8,10,0,0,0,8,12,20
wi15,151,ROOSEVELT,BIOL,Molec Biol,0,0,0,1,1,2,1,5,6,0,5,5,3,5,8,0,0,0,5,16,21
wi15,151,ROOSEVELT,BIOL,PhyslNeuro,0,0,0,12,10,22,10,29,39,20,30,50,13,20,33,0,0,0,55,89,144
wi15,151,ROOSEVELT,CENG,Chem Engin,0,0,0,1,1,2,6,1,7,8,6,14,21,10,31,0,0,0,36,18,54
wi15,151,ROOSEVELT,CGS,CritGendSt,0,0,0,0,0,0,0,0,0,0,0,0,0,1,1,0,0,0,0,1,1
wi15,151,ROOSEVELT,CHEM,Bioch/Chem,0,0,0,3,5,8,9,6,15,4,7,11,10,4,14,0,0,0,26,22,48
wi15,151,ROOSEVELT,CHEM,Bioinform,0,0,0,1,0,1,0,0,0,0,0,0,0,0,0,0,0,0,1,0,1
wi15,151,ROOSEVELT,CHEM,Chem Phys,0,0,0,0,0,0,0,1,1,0,0,0,0,0,0,0,0,0,0,1,1
wi15,151,ROOSEVELT,CHEM,Chemistry,0,0,0,2,3,5,0,5,5,2,4,6,3,2,5,0,0,0,7,14,21
wi15,151,ROOSEVELT,CHEM,Envir Chem,0,0,0,0,3,3,0,1,1,0,0,0,2,1,3,0,0,0,2,5,7
wi15,151,ROOSEVELT,CHEM,Pharm Chem,0,0,0,2,4,6,4,10,14,4,3,7,10,12,22,0,0,0,20,29,49
wi15,151,ROOSEVELT,CHIN,Chinese St,0,0,0,0,0,0,0,1,1,0,1,1,0,0,0,0,0,0,0,2,2
wi15,151,ROOSEVELT,CLAS,Classic St,0,0,0,0,0,0,0,0,0,0,1,1,1,1,2,0,0,0,1,2,3
wi15,151,ROOSEVELT,COGS,Cog Sci,0,0,0,4,0,4,1,7,8,2,4,6,3,6,9,0,0,0,10,17,27
wi15,151,ROOSEVELT,COGS,CogSc/ClAs,0,0,0,0,0,0,0,0,0,0,0,0,0,2,2,0,0,0,0,2,2
wi15,151,ROOSEVELT,COGS,CogSc/Comp,0,0,0,1,1,2,0,0,0,0,0,0,0,1,1,0,0,0,1,2,3
wi15,151,ROOSEVELT,COGS,CogSc/HCI,0,0,0,1,0,1,2,3,5,1,3,4,3,7,10,0,0,0,7,13,20
wi15,151,ROOSEVELT,COGS,CogSc/HCog,0,0,0,0,0,0,0,2,2,0,2,2,0,2,2,0,0,0,0,6,6
wi15,151,ROOSEVELT,COGS,CogSc/Neur,0,0,0,1,0,1,1,3,4,0,3,3,7,7,14,0,0,0,9,13,22
wi15,151,ROOSEVELT,COMM,Communic,0,0,0,3,9,12,5,15,20,11,47,58,15,36,51,0,0,0,34,107,141
wi15,151,ROOSEVELT,CSE,Comp Sci,0,0,0,3,0,3,7,1,8,27,6,33,68,15,83,0,0,0,105,22,127
wi15,151,ROOSEVELT,CSE,CompEngCSE,0,1,1,3,1,4,1,1,2,8,2,10,10,1,11,0,0,0,22,6,28
wi15,151,ROOSEVELT,CSE,CompScBinf,0,0,0,0,0,0,4,0,4,2,0,2,4,2,6,0,0,0,10,2,12
wi15,151,ROOSEVELT,ECE,CompEngECE,0,0,0,0,2,2,7,0,7,11,3,14,4,0,4,0,0,0,22,5,27
wi15,151,ROOSEVELT,ECE,Electr Eng,0,0,0,4,0,4,12,3,15,25,7,32,46,8,54,0,0,0,87,18,105
wi15,151,ROOSEVELT,ECE,EleEng&Soc,0,0,0,0,0,0,1,0,1,1,0,1,0,0,0,0,0,0,2,0,2
wi15,151,ROOSEVELT,ECE,Engin Phys,0,0,0,0,0,0,0,0,0,1,0,1,1,0,1,0,0,0,2,0,2
wi15,151,ROOSEVELT,ECE,Pr-EngPhys,0,0,0,0,1,1,2,0,2,0,0,0,0,0,0,0,0,0,2,1,3
wi15,151,ROOSEVELT,ECON,Ec-Mth&Ecn,0,0,0,6,11,17,8,10,18,10,4,14,5,8,13,0,0,0,29,33,62
wi15,151,ROOSEVELT,ECON,Econ-MgtSc,0,0,0,10,9,19,19,14,33,23,14,37,41,29,70,0,0,0,93,66,159
wi15,151,ROOSEVELT,ECON,Economics,0,0,0,31,21,52,23,16,39,61,38,99,56,44,100,0,0,0,171,119,290
wi15,151,ROOSEVELT,ESYS,EnvSys(EB),0,0,0,1,1,2,1,1,2,0,5,5,2,3,5,0,0,0,4,10,14
wi15,151,ROOSEVELT,ESYS,EnvSys(EC),0,0,0,1,0,1,0,0,0,0,0,0,0,1,1,0,0,0,1,1,2
wi15,151,ROOSEVELT,ESYS,EnvSys(EP),0,0,0,0,1,1,4,1,5,1,1,2,1,1,2,0,0,0,6,4,10
wi15,151,ROOSEVELT,ESYS,EnvSys(ES),0,0,0,0,1,1,1,2,3,1,1,2,2,3,5,0,0,0,4,7,11
wi15,151,ROOSEVELT,ETHN,Ethnic St,0,0,0,0,0,0,0,1,1,0,0,0,1,1,2,0,0,0,1,2,3
wi15,151,ROOSEVELT,FPMU,Public Hlt,0,0,0,0,5,5,3,17,20,6,20,26,2,18,20,0,0,0,11,60,71
wi15,151,ROOSEVELT,GLBH,Global Hlt,0,0,0,0,1,1,0,4,4,2,4,6,0,2,2,0,0,0,2,11,13
wi15,151,ROOSEVELT,GMST,German Stu,0,0,0,0,0,0,0,0,0,0,0,0,1,0,1,0,0,0,1,0,1
wi15,151,ROOSEVELT,HDP,Human Dev,0,0,0,0,0,0,0,1,1,0,4,4,1,21,22,0,0,0,1,26,27
wi15,151,ROOSEVELT,HDP,Pr-HumnDev,0,0,0,0,5,5,0,7,7,1,9,10,1,2,3,0,0,0,2,23,25
wi15,151,ROOSEVELT,HIST,History,0,0,0,2,2,4,2,5,7,9,12,21,13,12,25,0,0,0,26,31,57
wi15,151,ROOSEVELT,INTL,Int-5yrEC,0,0,0,0,0,0,0,0,0,0,0,0,2,0,2,0,0,0,2,0,2
wi15,151,ROOSEVELT,INTL,Int-5yrPS,0,0,0,0,0,0,0,0,0,0,0,0,0,1,1,0,0,0,0,1,1
wi15,151,ROOSEVELT,INTL,IntSt-Anth,0,0,0,0,1,1,0,0,0,0,0,0,0,3,3,0,0,0,0,4,4
wi15,151,ROOSEVELT,INTL,IntSt-Econ,0,0,0,4,6,10,4,6,10,7,12,19,5,15,20,0,0,0,20,39,59
wi15,151,ROOSEVELT,INTL,IntSt-Hist,0,0,0,0,2,2,0,1,1,0,1,1,1,4,5,0,0,0,1,8,9
wi15,151,ROOSEVELT,INTL,IntSt-Ling,0,0,0,0,0,0,0,1,1,2,2,4,0,4,4,0,0,0,2,7,9
wi15,151,ROOSEVELT,INTL,IntSt-Lit,0,0,0,0,0,0,0,2,2,0,1,1,1,0,1,0,0,0,1,3,4
wi15,151,ROOSEVELT,INTL,IntSt-PolS,0,0,0,2,6,8,5,4,9,12,19,31,17,32,49,0,0,0,36,61,97
wi15,151,ROOSEVELT,INTL,IntSt-Soc,0,0,0,0,2,2,2,5,7,3,14,17,2,7,9,0,0,0,7,28,35
wi15,151,ROOSEVELT,JAPN,JapaneseSt,0,0,0,0,0,0,1,1,2,0,0,0,1,2,3,0,0,0,2,3,5
wi15,151,ROOSEVELT,LATI,LatinAm St,0,0,0,0,0,0,0,1,1,0,0,0,1,0,1,0,0,0,1,1,2
wi15,151,ROOSEVELT,LING,Lang Stu,0,0,0,0,0,0,0,2,2,0,3,3,2,0,2,0,0,0,2,5,7
wi15,151,ROOSEVELT,LING,Ling-CogLn,0,0,0,0,0,0,0,3,3,1,4,5,0,3,3,0,0,0,1,10,11
wi15,151,ROOSEVELT,LING,Ling-LSoc,0,0,0,1,1,2,0,1,1,0,3,3,2,1,3,0,0,0,3,6,9
wi15,151,ROOSEVELT,LING,Linguistcs,0,0,0,0,1,1,0,1,1,1,3,4,1,4,5,0,0,0,2,9,11
wi15,151,ROOSEVELT,LIT,French Lit,0,0,0,0,0,0,0,0,0,0,1,1,0,0,0,0,0,0,0,1,1
wi15,151,ROOSEVELT,LIT,Lit/Compos,0,0,0,1,0,1,0,0,0,0,1,1,0,0,0,0,0,0,1,1,2
wi15,151,ROOSEVELT,LIT,Lit/CultSt,0,0,0,0,0,0,0,0,0,0,1,1,0,2,2,0,0,0,0,3,3
wi15,151,ROOSEVELT,LIT,Lit/Engl,0,0,0,1,3,4,0,2,2,3,2,5,0,5,5,0,0,0,4,12,16
wi15,151,ROOSEVELT,LIT,Lit/World,0,0,0,0,1,1,0,0,0,0,0,0,0,3,3,0,0,0,0,4,4
wi15,151,ROOSEVELT,LIT,Lit/Writng,0,0,0,0,2,2,0,0,0,1,4,5,1,14,15,0,0,0,2,20,22
wi15,151,ROOSEVELT,LIT,Spanish Lt,0,0,0,1,1,2,0,0,0,0,1,1,0,1,1,0,0,0,1,3,4
wi15,151,ROOSEVELT,MAE,Aerosp Eng,0,0,0,0,0,0,2,2,4,0,0,0,7,0,7,0,0,0,9,2,11
wi15,151,ROOSEVELT,MAE,Engin Sci,0,0,0,0,0,0,0,0,0,0,0,0,3,0,3,0,0,0,3,0,3
wi15,151,ROOSEVELT,MAE,Envir Eng,0,0,0,3,2,5,5,0,5,3,5,8,6,6,12,0,0,0,17,13,30
wi15,151,ROOSEVELT,MAE,Mech Engin,0,0,0,2,0,2,0,2,2,2,0,2,7,2,9,0,0,0,11,4,15
wi15,151,ROOSEVELT,MATH,Appld Math,0,0,0,8,7,15,6,7,13,4,6,10,4,3,7,0,0,0,22,23,45
wi15,151,ROOSEVELT,MATH,Math/SecEd,0,0,0,0,0,0,0,1,1,0,2,2,1,2,3,0,0,0,1,5,6
wi15,151,ROOSEVELT,MATH,Mathematcs,0,0,0,2,2,4,4,1,5,2,2,4,1,2,3,0,0,0,9,7,16
wi15,151,ROOSEVELT,MATH,Mth-CompSc,0,0,0,14,2,16,12,3,15,4,0,4,2,1,3,0,0,0,32,6,38
wi15,151,ROOSEVELT,MATH,Mth-Mth&Ec,0,0,0,1,4,5,5,8,13,6,3,9,2,2,4,0,0,0,14,17,31
wi15,151,ROOSEVELT,MATH,Mth/ApldSc,0,0,0,3,3,6,1,1,2,2,1,3,0,0,0,0,0,0,6,5,11
wi15,151,ROOSEVELT,MATH,Prob&Stats,0,0,0,5,6,11,2,2,4,1,3,4,1,2,3,0,0,0,9,13,22
wi15,151,ROOSEVELT,MUS,Mu-CompArt,0,0,0,1,0,1,0,0,0,1,0,1,0,1,1,0,0,0,2,1,3
wi15,151,ROOSEVELT,MUS,Music,0,0,0,0,0,0,1,1,2,0,0,0,1,0,1,0,0,0,2,1,3
wi15,151,ROOSEVELT,MUS,Music Hum,0,0,0,0,0,0,0,0,0,0,0,0,0,1,1,0,0,0,0,1,1
wi15,151,ROOSEVELT,NENG,NanoEng,0,0,0,0,0,0,1,1,2,10,3,13,15,8,23,0,0,0,26,12,38
wi15,151,ROOSEVELT,PHIL,Philosophy,0,0,0,0,2,2,0,1,1,1,3,4,4,0,4,0,0,0,5,6,11
wi15,151,ROOSEVELT,PHYS,Biophysics,0,0,0,0,0,0,1,0,1,0,1,1,0,0,0,0,0,0,1,1,2
wi15,151,ROOSEVELT,PHYS,Phys/Astro,0,0,0,4,2,6,3,0,3,0,1,1,0,0,0,0,0,0,7,3,10
wi15,151,ROOSEVELT,PHYS,Phys/Comp,0,0,0,0,0,0,0,0,0,0,0,0,1,0,1,0,0,0,1,0,1
wi15,151,ROOSEVELT,PHYS,Phys/Mtrls,0,0,0,1,0,1,0,0,0,0,0,0,1,0,1,0,0,0,2,0,2
wi15,151,ROOSEVELT,PHYS,Physics,0,0,0,6,0,6,4,1,5,2,1,3,1,2,3,0,0,0,13,4,17
wi15,151,ROOSEVELT,POLI,Polit Sci,0,0,0,3,8,11,6,10,16,13,17,30,13,21,34,0,0,0,35,56,91
wi15,151,ROOSEVELT,POLI,PolSc-Amer,0,0,0,1,1,2,0,0,0,3,4,7,2,3,5,0,0,0,6,8,14
wi15,151,ROOSEVELT,POLI,PolSc-Comp,0,0,0,0,0,0,1,1,2,0,2,2,1,1,2,0,0,0,2,4,6
wi15,151,ROOSEVELT,POLI,PolSc-Intl,0,0,0,3,2,5,8,6,14,13,17,30,25,15,40,0,0,0,49,40,89
wi15,151,ROOSEVELT,POLI,PolSc-PLaw,0,0,0,1,0,1,0,6,6,4,8,12,7,7,14,0,0,0,12,21,33
wi15,151,ROOSEVELT,POLI,PolSc-PPol,0,0,0,0,0,0,0,0,0,3,1,4,2,3,5,0,0,0,5,4,9
wi15,151,ROOSEVELT,POLI,PolSc-Thry,0,0,0,0,0,0,1,0,1,0,0,0,0,1,1,0,0,0,1,1,2
wi15,151,ROOSEVELT,PSYC,Psychology,0,0,0,2,19,21,4,26,30,11,41,52,21,63,84,0,0,0,38,149,187
wi15,151,ROOSEVELT,SE,Engin Sci,0,0,0,1,1,2,1,0,1,0,0,0,0,0,0,0,0,0,2,1,3
wi15,151,ROOSEVELT,SE,Struct Eng,0,0,0,3,1,4,11,2,13,9,5,14,30,8,38,0,0,0,53,16,69
wi15,151,ROOSEVELT,SIO,Earth Sci,0,0,0,0,0,0,0,0,0,1,1,2,2,5,7,0,0,0,3,6,9
wi15,151,ROOSEVELT,SIO,Marine Bio,0,0,0,1,3,4,2,8,10,3,2,5,2,8,10,0,0,0,8,21,29
wi15,151,ROOSEVELT,SOC,SocCulCom,0,0,0,0,0,0,0,1,1,0,2,2,0,1,1,0,0,0,0,4,4
wi15,151,ROOSEVELT,SOC,SocEconSoc,0,0,0,0,0,0,0,0,0,0,0,0,1,1,2,0,0,0,1,1,2
wi15,151,ROOSEVELT,SOC,SocIntlStu,0,0,0,0,0,0,0,0,0,0,2,2,0,0,0,0,0,0,0,2,2
wi15,151,ROOSEVELT,SOC,Sociology,0,0,0,0,1,1,2,5,7,3,5,8,3,14,17,0,0,0,8,25,33
wi15,151,ROOSEVELT,SOC,SocLawSoc,0,0,0,0,0,0,0,1,1,0,3,3,4,1,5,0,0,0,4,5,9
wi15,151,ROOSEVELT,SOC,SocSciMed,0,0,0,0,0,0,1,0,1,0,1,1,0,1,1,0,0,0,1,2,3
wi15,151,ROOSEVELT,SOC,SocSolneq,0,0,0,0,0,0,0,0,0,0,0,0,0,3,3,0,0,0,0,3,3
wi15,151,ROOSEVELT,THEA,Dance,0,0,0,0,0,0,0,0,0,0,0,0,1,0,1,0,0,0,1,0,1
wi15,151,ROOSEVELT,THEA,Theatre,0,0,0,1,1,2,0,1,1,3,4,7,1,3,4,0,0,0,5,9,14
wi15,151,ROOSEVELT,TWS,ThirdWldSt,0,0,0,0,0,0,0,0,0,0,1,1,0,1,1,0,0,0,0,2,2
wi15,151,ROOSEVELT,UNAF,UndecHumAr,0,0,0,1,3,4,2,6,8,0,0,0,0,0,0,0,0,0,3,9,12
wi15,151,ROOSEVELT,UNAF,Undeclared,0,0,0,45,23,68,26,18,44,3,2,5,0,0,0,0,0,0,74,43,117
wi15,151,ROOSEVELT,UNAF,UndecPhysS,0,0,0,6,7,13,3,3,6,0,0,0,0,0,0,0,0,0,9,10,19
wi15,151,ROOSEVELT,UNAF,UndecSocSc,0,0,0,6,10,16,2,2,4,0,0,0,0,0,0,0,0,0,8,12,20
wi15,151,ROOSEVELT,USP,Urb Stu&Pl,0,0,0,0,0,0,1,0,1,1,2,3,1,2,3,0,0,0,3,4,7
wi15,151,ROOSEVELT,VIS,Art Hst/Cr,0,0,0,0,0,0,0,0,0,0,2,2,0,3,3,0,0,0,0,5,5
wi15,151,ROOSEVELT,VIS,Media,0,0,0,0,2,2,2,1,3,2,3,5,5,4,9,0,0,0,9,10,19
wi15,151,ROOSEVELT,VIS,Studio VA,0,0,0,0,0,0,1,3,4,0,0,0,1,5,6,0,0,0,2,8,10
wi15,151,ROOSEVELT,VIS,VA-CompArt,0,0,0,1,1,2,0,2,2,0,2,2,3,3,6,0,0,0,4,8,12
wi15,151,SIXTH,ANTH,Anth-Arch,0,0,0,0,0,0,0,0,0,0,2,2,1,1,2,0,0,0,1,3,4
wi15,151,SIXTH,ANTH,Anth-Biol,0,0,0,0,0,0,0,0,0,0,0,0,0,3,3,0,0,0,0,3,3
wi15,151,SIXTH,ANTH,Anth-Soci,0,0,0,0,0,0,0,0,0,2,1,3,0,5,5,0,0,0,2,6,8
wi15,151,SIXTH,BENG,Bioen:Binf,0,0,0,0,0,0,0,2,2,3,5,8,5,7,12,0,0,0,8,14,22
wi15,151,SIXTH,BENG,BioengBioS,0,0,0,0,1,1,3,1,4,2,5,7,0,0,0,0,0,0,5,7,12
wi15,151,SIXTH,BENG,BioengBiot,0,0,0,0,0,0,2,3,5,3,1,4,10,8,18,0,0,0,15,12,27
wi15,151,SIXTH,BENG,Bioengin,0,0,0,0,0,0,1,0,1,4,0,4,9,7,16,0,0,0,14,7,21
wi15,151,SIXTH,BIOL,Bioc/CellB,0,0,0,9,9,18,22,32,54,28,20,48,35,46,81,0,0,0,94,107,201
wi15,151,SIXTH,BIOL,BiolBioinf,0,0,0,1,0,1,2,1,3,2,1,3,2,0,2,0,0,0,7,2,9
wi15,151,SIXTH,BIOL,Ec/Beh/Evo,0,0,0,2,0,2,2,1,3,1,2,3,3,8,11,0,0,0,8,11,19
wi15,151,SIXTH,BIOL,Genl Biol,0,0,0,7,5,12,9,17,26,11,20,31,19,28,47,0,0,0,46,70,116
wi15,151,SIXTH,BIOL,Human Bio,0,0,0,13,24,37,27,32,59,30,30,60,42,43,85,0,0,0,112,129,241
wi15,151,SIXTH,BIOL,Microbiol,0,0,0,1,4,5,2,3,5,2,5,7,2,5,7,0,0,0,7,17,24
wi15,151,SIXTH,BIOL,Molec Biol,0,0,0,1,3,4,4,3,7,3,4,7,5,3,8,0,0,0,13,13,26
wi15,151,SIXTH,BIOL,PhyslNeuro,0,0,0,7,6,13,10,26,36,14,16,30,22,15,37,0,0,0,53,63,116
wi15,151,SIXTH,CENG,Chem Engin,0,0,0,0,0,0,14,5,19,21,16,37,23,10,33,0,0,0,58,31,89
wi15,151,SIXTH,CGS,CritGendSt,0,0,0,0,0,0,0,0,0,0,0,0,1,1,2,0,0,0,1,1,2
wi15,151,SIXTH,CHEM,Bioch/Chem,0,0,0,4,4,8,2,7,9,4,5,9,14,4,18,0,0,0,24,20,44
wi15,151,SIXTH,CHEM,Bioinform,0,0,0,0,0,0,1,1,2,1,0,1,0,0,0,0,0,0,2,1,3
wi15,151,SIXTH,CHEM,Chem Phys,0,0,0,0,0,0,0,0,0,0,0,0,1,0,1,0,0,0,1,0,1
wi15,151,SIXTH,CHEM,Chemistry,0,0,0,2,3,5,3,6,9,4,2,6,3,6,9,0,0,0,12,17,29
wi15,151,SIXTH,CHEM,Envir Chem,0,0,0,0,0,0,0,0,0,0,1,1,0,2,2,0,0,0,0,3,3
wi15,151,SIXTH,CHEM,MolecSynth,0,0,0,0,0,0,0,0,0,0,0,0,1,1,2,0,0,0,1,1,2
wi15,151,SIXTH,CHEM,Pharm Chem,0,0,0,1,6,7,2,13,15,5,10,15,16,13,29,0,0,0,24,42,66
wi15,151,SIXTH,COGS,Cog Sci,0,0,0,2,4,6,3,2,5,6,4,10,4,2,6,0,0,0,15,12,27
wi15,151,SIXTH,COGS,CogSc/ClAs,0,0,0,0,0,0,0,0,0,0,0,0,0,1,1,0,0,0,0,1,1
wi15,151,SIXTH,COGS,CogSc/Comp,0,0,0,3,1,4,1,1,2,0,0,0,0,2,2,0,0,0,4,4,8
wi15,151,SIXTH,COGS,CogSc/HCI,0,0,0,1,2,3,3,0,3,7,4,11,10,6,16,0,0,0,21,12,33
wi15,151,SIXTH,COGS,CogSc/HCog,0,0,0,0,0,0,1,0,1,1,0,1,1,2,3,0,0,0,3,2,5
wi15,151,SIXTH,COGS,CogSc/Neur,0,0,0,0,3,3,2,2,4,2,3,5,11,6,17,0,0,0,15,14,29
wi15,151,SIXTH,COMM,Communic,0,0,0,4,8,12,8,9,17,16,40,56,18,47,65,0,0,0,46,104,150
wi15,151,SIXTH,CSE,Comp Sci,0,0,0,4,3,7,27,9,36,101,19,120,151,38,189,0,0,0,283,69,352
wi15,151,SIXTH,CSE,CompEngCSE,0,0,0,1,0,1,8,0,8,17,2,19,31,2,33,0,0,0,57,4,61
wi15,151,SIXTH,CSE,CompScBinf,0,0,0,0,0,0,3,0,3,6,4,10,2,3,5,0,0,0,11,7,18
wi15,151,SIXTH,ECE,CompEngECE,0,0,0,5,0,5,18,0,18,21,6,27,8,0,8,0,0,0,52,6,58
wi15,151,SIXTH,ECE,Electr Eng,0,0,0,8,0,8,31,4,35,55,7,62,80,8,88,0,0,0,174,19,193
wi15,151,SIXTH,ECE,EleEng&Soc,0,0,0,0,0,0,0,0,0,0,0,0,1,0,1,0,0,0,1,0,1
wi15,151,SIXTH,ECE,Engin Phys,0,0,0,0,0,0,0,0,0,0,0,0,1,0,1,0,0,0,1,0,1
wi15,151,SIXTH,ECE,Pr-EngPhys,0,0,0,1,1,2,2,0,2,0,0,0,0,0,0,0,0,0,3,1,4
wi15,151,SIXTH,ECON,Ec-Mth&Ecn,0,0,0,6,6,12,4,8,12,10,7,17,8,1,9,0,0,0,28,22,50
wi15,151,SIXTH,ECON,Econ-MgtSc,0,0,0,2,3,5,18,10,28,39,16,55,34,18,52,0,0,0,93,47,140
wi15,151,SIXTH,ECON,Economics,0,0,0,16,7,23,22,12,34,51,27,78,43,27,70,0,0,0,132,73,205
wi15,151,SIXTH,ESYS,EnvSys(EB),0,0,0,1,0,1,0,2,2,2,1,3,2,6,8,0,0,0,5,9,14
wi15,151,SIXTH,ESYS,EnvSys(EC),0,0,0,0,1,1,1,1,2,0,0,0,1,0,1,0,0,0,2,2,4
wi15,151,SIXTH,ESYS,EnvSys(EP),0,0,0,0,0,0,2,0,2,1,0,1,0,3,3,0,0,0,3,3,6
wi15,151,SIXTH,ESYS,EnvSys(ES),0,0,0,1,0,1,0,2,2,1,2,3,1,4,5,0,0,0,3,8,11
wi15,151,SIXTH,ETHN,Ethnic St,0,0,0,0,0,0,0,0,0,0,1,1,2,0,2,0,0,0,2,1,3
wi15,151,SIXTH,FPMU,Public Hlt,0,0,0,1,6,7,1,6,7,6,17,23,2,13,15,0,0,0,10,42,52
wi15,151,SIXTH,GLBH,Global Hlt,0,0,0,0,0,0,0,2,2,0,1,1,0,0,0,0,0,0,0,3,3
wi15,151,SIXTH,HDP,Human Dev,0,0,0,0,0,0,0,2,2,1,3,4,4,18,22,0,0,0,5,23,28
wi15,151,SIXTH,HDP,Pr-HumnDev,0,0,0,0,3,3,0,2,2,1,8,9,0,2,2,0,0,0,1,15,16
wi15,151,SIXTH,HIST,History,0,0,0,0,1,1,2,0,2,1,1,2,5,5,10,0,0,0,8,7,15
wi15,151,SIXTH,INTL,IntSt-Anth,0,0,0,0,0,0,0,0,0,0,2,2,0,0,0,0,0,0,0,2,2
wi15,151,SIXTH,INTL,IntSt-Econ,0,0,0,1,2,3,1,5,6,7,1,8,2,9,11,0,0,0,11,17,28
wi15,151,SIXTH,INTL,IntSt-Hist,0,0,0,0,0,0,0,0,0,0,0,0,1,1,2,0,0,0,1,1,2
wi15,151,SIXTH,INTL,IntSt-Ling,0,0,0,0,1,1,0,0,0,0,2,2,0,1,1,0,0,0,0,4,4
wi15,151,SIXTH,INTL,IntSt-Lit,0,0,0,0,0,0,0,0,0,0,0,0,0,1,1,0,0,0,0,1,1
wi15,151,SIXTH,INTL,IntSt-PolS,0,0,0,1,0,1,1,2,3,0,3,3,2,6,8,0,0,0,4,11,15
wi15,151,SIXTH,INTL,IntSt-Soc,0,0,0,0,0,0,1,1,2,1,2,3,0,0,0,0,0,0,2,3,5
wi15,151,SIXTH,JUDA,Judaic Stu,0,0,0,0,0,0,0,0,0,0,0,0,0,1,1,0,0,0,0,1,1
wi15,151,SIXTH,LING,Lang Stu,0,0,0,0,0,0,1,0,1,0,0,0,0,2,2,0,0,0,1,2,3
wi15,151,SIXTH,LING,Ling-CogLn,0,0,0,0,0,0,0,1,1,0,0,0,1,2,3,0,0,0,1,3,4
wi15,151,SIXTH,LING,Ling-LSoc,0,0,0,0,0,0,0,0,0,0,1,1,0,2,2,0,0,0,0,3,3
wi15,151,SIXTH,LING,Linguistcs,0,0,0,0,0,0,0,0,0,1,2,3,2,1,3,0,0,0,3,3,6
wi15,151,SIXTH,LIT,Ital Lit,0,0,0,0,0,0,0,0,0,0,0,0,0,1,1,0,0,0,0,1,1
wi15,151,SIXTH,LIT,Lit/CultSt,0,0,0,0,0,0,0,0,0,0,0,0,0,1,1,0,0,0,0,1,1
wi15,151,SIXTH,LIT,Lit/Engl,0,0,0,0,1,1,1,0,1,0,2,2,1,3,4,0,0,0,2,6,8
wi15,151,SIXTH,LIT,Lit/Writng,0,0,0,0,2,2,0,5,5,5,5,10,2,3,5,0,0,0,7,15,22
wi15,151,SIXTH,MAE,Aerosp Eng,0,0,0,1,2,3,5,1,6,5,2,7,16,3,19,0,0,0,27,8,35
wi15,151,SIXTH,MAE,Engin Sci,0,0,0,0,0,0,0,0,0,0,0,0,4,0,4,0,0,0,4,0,4
wi15,151,SIXTH,MAE,Envir Eng,0,0,0,2,1,3,8,1,9,8,4,12,12,11,23,0,0,0,30,17,47
wi15,151,SIXTH,MAE,Mech Engin,0,0,0,2,1,3,6,1,7,14,4,18,28,7,35,0,0,0,50,13,63
wi15,151,SIXTH,MATH,Appld Math,0,0,0,2,7,9,7,8,15,9,5,14,7,9,16,0,0,0,25,29,54
wi15,151,SIXTH,MATH,Math/SecEd,0,0,0,0,0,0,0,0,0,1,2,3,0,1,1,0,0,0,1,3,4
wi15,151,SIXTH,MATH,Mathematcs,0,0,0,3,2,5,4,2,6,4,2,6,5,1,6,0,0,0,16,7,23
wi15,151,SIXTH,MATH,Mth-CompSc,0,0,0,16,5,21,23,6,29,8,3,11,4,4,8,0,0,0,51,18,69
wi15,151,SIXTH,MATH,Mth-Mth&Ec,0,0,0,2,1,3,2,1,3,6,3,9,3,4,7,0,0,0,13,9,22
wi15,151,SIXTH,MATH,Mth-SciCom,0,0,0,0,0,0,0,0,0,0,1,1,0,0,0,0,0,0,0,1,1
wi15,151,SIXTH,MATH,Mth/ApldSc,0,0,0,0,0,0,2,0,2,2,0,2,0,0,0,0,0,0,4,0,4
wi15,151,SIXTH,MATH,Prob&Stats,0,0,0,5,1,6,3,4,7,3,2,5,1,0,1,0,0,0,12,7,19
wi15,151,SIXTH,MUS,Mu-CompArt,0,0,0,2,0,2,0,2,2,4,3,7,14,0,14,0,0,0,20,5,25
wi15,151,SIXTH,MUS,Music,0,0,0,0,0,0,2,0,2,1,0,1,2,2,4,0,0,0,5,2,7
wi15,151,SIXTH,MUS,Music Hum,0,0,0,0,0,0,0,0,0,1,0,1,0,0,0,0,0,0,1,0,1
wi15,151,SIXTH,NENG,NanoEng,0,0,0,2,0,2,16,0,16,10,5,15,24,4,28,0,0,0,52,9,61
wi15,151,SIXTH,PHIL,Philosophy,0,0,0,1,0,1,2,1,3,1,2,3,2,0,2,0,0,0,6,3,9
wi15,151,SIXTH,PHYS,Biophysics,0,0,0,0,1,1,0,0,0,1,1,2,0,0,0,0,0,0,1,2,3
wi15,151,SIXTH,PHYS,Gen Physcs,0,0,0,1,0,1,0,0,0,1,0,1,0,0,0,0,0,0,2,0,2
wi15,151,SIXTH,PHYS,GenPys/SEd,0,0,0,0,0,0,0,0,0,1,0,1,0,0,0,0,0,0,1,0,1
wi15,151,SIXTH,PHYS,Phy/ErthSc,0,0,0,0,0,0,0,0,0,1,0,1,0,0,0,0,0,0,1,0,1
wi15,151,SIXTH,PHYS,Phys/Astro,0,0,0,1,1,2,0,1,1,2,2,4,3,2,5,0,0,0,6,6,12
wi15,151,SIXTH,PHYS,Phys/Comp,0,0,0,1,0,1,2,0,2,1,0,1,1,0,1,0,0,0,5,0,5
wi15,151,SIXTH,PHYS,Phys/Mtrls,0,0,0,2,2,4,1,0,1,1,0,1,1,0,1,0,0,0,5,2,7
wi15,151,SIXTH,PHYS,Physics,0,0,0,5,2,7,10,0,10,6,0,6,7,0,7,0,0,0,28,2,30
wi15,151,SIXTH,POLI,Polit Sci,0,0,0,1,2,3,3,4,7,6,7,13,6,7,13,0,0,0,16,20,36
wi15,151,SIXTH,POLI,PolSc-Amer,0,0,0,0,1,1,0,1,1,1,1,2,1,1,2,0,0,0,2,4,6
wi15,151,SIXTH,POLI,PolSc-Intl,0,0,0,0,0,0,1,0,1,3,4,7,5,7,12,0,0,0,9,11,20
wi15,151,SIXTH,POLI,PolSc-PLaw,0,0,0,0,2,2,1,0,1,0,4,4,3,5,8,0,0,0,4,11,15
wi15,151,SIXTH,POLI,PolSc-PPol,0,0,0,0,0,0,0,1,1,2,0,2,1,1,2,0,0,0,3,2,5
wi15,151,SIXTH,POLI,PolSc-Thry,0,0,0,0,0,0,0,0,0,0,1,1,1,0,1,0,0,0,1,1,2
wi15,151,SIXTH,PSYC,Psychology,0,0,0,1,7,8,4,12,16,14,36,50,21,69,90,0,0,0,40,124,164
wi15,151,SIXTH,RELI,Relig/Stu,0,0,0,0,0,0,0,0,0,0,0,0,1,0,1,0,0,0,1,0,1
wi15,151,SIXTH,SE,Engin Sci,0,0,0,0,0,0,1,0,1,0,0,0,0,0,0,0,0,0,1,0,1
wi15,151,SIXTH,SE,Struct Eng,0,0,0,3,5,8,23,3,26,29,16,45,49,13,62,0,0,0,104,37,141
wi15,151,SIXTH,SIO,Earth Sci,0,0,0,0,0,0,0,0,0,0,1,1,1,1,2,0,0,0,1,2,3
wi15,151,SIXTH,SIO,Marine Bio,0,0,0,1,3,4,2,8,10,0,5,5,4,5,9,0,0,0,7,21,28
wi15,151,SIXTH,SOC,SocCulCom,0,0,0,0,0,0,0,1,1,0,1,1,0,2,2,0,0,0,0,4,4
wi15,151,SIXTH,SOC,SocEconSoc,0,0,0,0,0,0,0,0,0,2,0,2,0,0,0,0,0,0,2,0,2
wi15,151,SIXTH,SOC,SocIntlStu,0,0,0,0,0,0,0,0,0,0,0,0,0,1,1,0,0,0,0,1,1
wi15,151,SIXTH,SOC,Sociology,0,0,0,0,2,2,3,1,4,2,7,9,3,7,10,0,0,0,8,17,25
wi15,151,SIXTH,SOC,SocLawSoc,0,0,0,0,0,0,1,0,1,0,0,0,1,4,5,0,0,0,2,4,6
wi15,151,SIXTH,SOC,SocSciMed,0,0,0,0,0,0,0,0,0,0,0,0,0,1,1,0,0,0,0,1,1
wi15,151,SIXTH,SOC,SocSolneq,0,0,0,0,0,0,0,0,0,0,2,2,0,2,2,0,0,0,0,4,4
wi15,151,SIXTH,THEA,Dance,0,0,0,0,0,0,0,0,0,0,0,0,0,2,2,0,0,0,0,2,2
wi15,151,SIXTH,THEA,Theatre,0,0,0,1,3,4,0,3,3,1,2,3,9,7,16,0,0,0,11,15,26
wi15,151,SIXTH,UNAF,UndecHumAr,0,0,0,1,1,2,2,2,4,0,0,0,0,0,0,0,0,0,3,3,6
wi15,151,SIXTH,UNAF,Undeclared,0,0,0,69,24,93,49,16,65,1,1,2,0,0,0,0,0,0,119,41,160
wi15,151,SIXTH,UNAF,UndecPhysS,0,0,0,5,3,8,2,4,6,0,0,0,0,0,0,0,0,0,7,7,14
wi15,151,SIXTH,UNAF,UndecSocSc,0,0,0,3,2,5,0,1,1,0,0,0,0,0,0,0,0,0,3,3,6
wi15,151,SIXTH,USP,Urb Stu&Pl,0,0,0,0,0,0,0,4,4,4,2,6,6,14,20,0,0,0,10,20,30
wi15,151,SIXTH,VIS,Art Hst/Cr,0,0,0,0,1,1,0,1,1,0,3,3,0,4,4,0,0,0,0,9,9
wi15,151,SIXTH,VIS,Media,0,0,0,6,2,8,7,7,14,16,15,31,14,18,32,0,0,0,43,42,85
wi15,151,SIXTH,VIS,Studio VA,0,0,0,0,2,2,1,2,3,4,6,10,1,13,14,0,0,0,6,23,29
wi15,151,SIXTH,VIS,VA-CompArt,0,0,0,3,4,7,3,12,15,8,12,20,2,6,8,0,0,0,16,34,50
wi15,151,WARREN,ANTH,Anth-Arch,0,0,0,0,0,0,0,1,1,0,0,0,1,1,2,0,0,0,1,2,3
wi15,151,WARREN,ANTH,Anth-Biol,0,0,0,0,0,0,0,0,0,1,0,1,0,2,2,0,0,0,1,2,3
wi15,151,WARREN,ANTH,Anth-Soci,0,0,0,0,0,0,0,0,0,0,1,1,0,2,2,0,0,0,0,3,3
wi15,151,WARREN,BENG,Bioen:Binf,0,0,0,0,0,0,6,2,8,7,10,17,5,8,13,0,0,0,18,20,38
wi15,151,WARREN,BENG,Bioeng:PM,0,0,0,0,0,0,0,0,0,0,0,0,0,1,1,0,0,0,0,1,1
wi15,151,WARREN,BENG,BioengBioS,0,0,0,1,0,1,2,1,3,5,0,5,1,0,1,0,0,0,9,1,10
wi15,151,WARREN,BENG,BioengBiot,0,0,0,2,1,3,9,7,16,8,10,18,27,23,50,0,0,0,46,41,87
wi15,151,WARREN,BENG,Bioengin,0,0,0,0,0,0,10,4,14,8,4,12,20,15,35,0,0,0,38,23,61
wi15,151,WARREN,BIOL,Bioc/CellB,0,0,0,5,12,17,13,19,32,18,23,41,43,47,90,0,0,0,79,101,180
wi15,151,WARREN,BIOL,BiolBioinf,0,0,0,0,0,0,1,0,1,2,1,3,0,0,0,0,0,0,3,1,4
wi15,151,WARREN,BIOL,Ec/Beh/Evo,0,0,0,0,0,0,0,1,1,3,2,5,2,8,10,0,0,0,5,11,16
wi15,151,WARREN,BIOL,Genl Biol,0,0,0,3,3,6,4,8,12,6,18,24,28,42,70,0,0,0,41,71,112
wi15,151,WARREN,BIOL,Human Bio,0,0,0,5,9,14,10,20,30,24,34,58,40,47,87,0,0,0,79,110,189
wi15,151,WARREN,BIOL,Microbiol,0,0,0,0,1,1,3,1,4,1,3,4,3,4,7,0,0,0,7,9,16
wi15,151,WARREN,BIOL,Molec Biol,0,0,0,0,0,0,3,1,4,4,1,5,11,5,16,0,0,0,18,7,25
wi15,151,WARREN,BIOL,PhyslNeuro,0,0,0,2,5,7,5,8,13,14,18,32,25,19,44,0,0,0,46,50,96
wi15,151,WARREN,CENG,Chem Engin,0,0,0,0,0,0,16,10,26,35,11,46,68,39,107,0,0,0,119,60,179
wi15,151,WARREN,CGS,CritGendSt,0,0,0,0,0,0,0,0,0,1,0,1,0,0,0,0,0,0,1,0,1
wi15,151,WARREN,CHEM,Bioch/Chem,0,0,0,3,4,7,4,4,8,5,6,11,6,14,20,0,0,0,18,28,46
wi15,151,WARREN,CHEM,Bioinform,0,0,0,0,0,0,0,0,0,0,1,1,0,0,0,0,0,0,0,1,1
wi15,151,WARREN,CHEM,Chemistry,0,0,0,3,2,5,0,2,2,1,6,7,3,8,11,0,0,0,7,18,25
wi15,151,WARREN,CHEM,Envir Chem,0,0,0,0,0,0,0,0,0,0,0,0,1,2,3,0,0,0,1,2,3
wi15,151,WARREN,CHEM,MolecSynth,0,0,0,0,0,0,0,0,0,0,0,0,2,0,2,0,0,0,2,0,2
wi15,151,WARREN,CHEM,Pharm Chem,0,0,0,0,1,1,1,5,6,3,5,8,7,19,26,0,0,0,11,30,41
wi15,151,WARREN,CHIN,Chinese St,0,0,0,0,0,0,0,0,0,0,1,1,0,1,1,0,0,0,0,2,2
wi15,151,WARREN,COGS,Cog Sci,0,0,0,0,2,2,2,2,4,2,6,8,3,4,7,0,0,0,7,14,21
wi15,151,WARREN,COGS,CogSc/ClAs,0,0,0,0,0,0,0,1,1,1,1,2,0,2,2,0,0,0,1,4,5
wi15,151,WARREN,COGS,CogSc/Comp,0,0,0,1,0,1,1,0,1,0,1,1,1,0,1,0,0,0,3,1,4
wi15,151,WARREN,COGS,CogSc/HCI,0,0,0,0,0,0,3,1,4,1,5,6,7,4,11,0,0,0,11,10,21
wi15,151,WARREN,COGS,CogSc/HCog,0,0,0,0,0,0,0,0,0,0,0,0,1,2,3,0,0,0,1,2,3
wi15,151,WARREN,COGS,CogSc/Neur,0,0,0,0,2,2,0,1,1,0,5,5,4,15,19,0,0,0,4,23,27
wi15,151,WARREN,COMM,Communic,0,0,0,1,5,6,2,9,11,7,11,18,16,33,49,0,0,0,26,58,84
wi15,151,WARREN,CSE,Comp Sci,0,0,0,11,2,13,72,17,89,123,20,143,219,48,267,0,0,0,425,87,512
wi15,151,WARREN,CSE,CompEngCSE,0,0,0,3,2,5,25,4,29,30,5,35,60,5,65,0,0,0,118,16,134
wi15,151,WARREN,CSE,CompScBinf,0,0,0,1,0,1,3,3,6,5,1,6,5,6,11,0,0,0,14,10,24
wi15,151,WARREN,ECE,CompEngECE,0,0,0,3,0,3,27,3,30,27,4,31,16,0,16,0,0,0,73,7,80
wi15,151,WARREN,ECE,Electr Eng,0,0,0,11,0,11,32,11,43,68,13,81,113,17,130,0,0,0,224,41,265
wi15,151,WARREN,ECE,Engin Phys,0,0,0,0,0,0,0,0,0,1,0,1,2,0,2,0,0,0,3,0,3
wi15,151,WARREN,ECE,Pr-EngPhys,0,0,0,0,0,0,3,0,3,0,0,0,1,0,1,0,0,0,4,0,4
wi15,151,WARREN,ECON,Ec-Mth&Ecn,0,0,0,1,1,2,6,2,8,7,2,9,7,0,7,0,0,0,21,5,26
wi15,151,WARREN,ECON,Econ-MgtSc,0,0,0,2,1,3,9,9,18,25,12,37,43,29,72,0,0,0,79,51,130
wi15,151,WARREN,ECON,Economics,0,0,0,6,6,12,15,9,24,55,21,76,71,40,111,0,0,0,147,76,223
wi15,151,WARREN,ESYS,EnvSys(EB),0,0,0,0,0,0,0,0,0,1,1,2,0,3,3,0,0,0,1,4,5
wi15,151,WARREN,ESYS,EnvSys(ES),0,0,0,0,0,0,0,1,1,0,0,0,1,1,2,0,0,0,1,2,3
wi15,151,WARREN,ETHN,Ethnic St,0,0,0,0,1,1,0,1,1,1,1,2,1,2,3,0,0,0,2,5,7
wi15,151,WARREN,FPMU,Public Hlt,0,0,0,0,2,2,3,2,5,1,6,7,3,9,12,0,0,0,7,19,26
wi15,151,WARREN,GLBH,Global Hlt,0,0,0,0,0,0,0,0,0,0,0,0,0,3,3,0,0,0,0,3,3
wi15,151,WARREN,HDP,Human Dev,0,0,0,0,0,0,0,1,1,1,2,3,0,18,18,0,0,0,1,21,22
wi15,151,WARREN,HDP,Pr-HumnDev,0,0,0,0,1,1,0,1,1,0,3,3,1,0,1,0,0,0,1,5,6
wi15,151,WARREN,HIST,History,0,0,0,0,1,1,0,0,0,3,1,4,6,3,9,0,0,0,9,5,14
wi15,151,WARREN,INTL,IntSt-Anth,0,0,0,0,0,0,0,0,0,1,0,1,0,0,0,0,0,0,1,0,1
wi15,151,WARREN,INTL,IntSt-Econ,0,0,0,0,1,1,0,1,1,1,2,3,0,3,3,0,0,0,1,7,8
wi15,151,WARREN,INTL,IntSt-Hist,0,0,0,0,0,0,0,0,0,0,0,0,1,0,1,0,0,0,1,0,1
wi15,151,WARREN,INTL,IntSt-Ling,0,0,0,0,0,0,0,1,1,0,0,0,0,1,1,0,0,0,0,2,2
wi15,151,WARREN,INTL,IntSt-PolS,0,0,0,2,1,3,0,0,0,0,4,4,4,2,6,0,0,0,6,7,13
wi15,151,WARREN,INTL,IntSt-Soc,0,0,0,0,0,0,0,0,0,0,2,2,0,2,2,0,0,0,0,4,4
wi15,151,WARREN,JAPN,JapaneseSt,0,0,0,0,0,0,0,0,0,0,0,0,1,0,1,0,0,0,1,0,1
wi15,151,WARREN,JUDA,Judaic Stu,0,0,0,0,0,0,0,0,0,0,0,0,1,0,1,0,0,0,1,0,1
wi15,151,WARREN,LATI,LatinAm St,0,0,0,0,0,0,1,0,1,0,0,0,0,0,0,0,0,0,1,0,1
wi15,151,WARREN,LING,Lang Stu,0,0,0,0,0,0,1,1,2,0,1,1,0,0,0,0,0,0,1,2,3
wi15,151,WARREN,LING,Ling-CogLn,0,0,0,0,0,0,1,0,1,0,0,0,0,1,1,0,0,0,1,1,2
wi15,151,WARREN,LING,Ling-LSoc,0,0,0,0,0,0,0,0,0,0,0,0,0,1,1,0,0,0,0,1,1
wi15,151,WARREN,LING,Linguistcs,0,0,0,0,0,0,1,1,2,1,1,2,1,2,3,0,0,0,3,4,7
wi15,151,WARREN,LIT,Lit/Compos,0,0,0,0,1,1,0,0,0,0,0,0,0,0,0,0,0,0,0,1,1
wi15,151,WARREN,LIT,Lit/Engl,0,0,0,0,0,0,1,0,1,0,0,0,0,5,5,0,0,0,1,5,6
wi15,151,WARREN,LIT,Lit/Writng,0,0,0,0,1,1,1,1,2,0,3,3,6,8,14,0,0,0,7,13,20
wi15,151,WARREN,LIT,Spanish Lt,0,0,0,0,0,0,0,0,0,0,1,1,1,1,2,0,0,0,1,2,3
wi15,151,WARREN,MAE,Aerosp Eng,0,0,0,3,3,6,19,1,20,21,4,25,26,7,33,0,0,0,69,15,84
wi15,151,WARREN,MAE,Engin Sci,0,0,0,0,0,0,0,0,0,0,0,0,6,0,6,0,0,0,6,0,6
wi15,151,WARREN,MAE,Envir Eng,0,0,0,2,4,6,4,7,11,15,8,23,15,6,21,0,0,0,36,25,61
wi15,151,WARREN,MAE,Mech Engin,0,0,0,3,1,4,25,6,31,41,7,48,57,18,75,0,0,0,126,32,158
wi15,151,WARREN,MATH,Appld Math,0,0,0,8,2,10,3,4,7,5,4,9,10,11,21,0,0,0,26,21,47
wi15,151,WARREN,MATH,Math/SecEd,0,0,0,0,0,0,0,1,1,0,2,2,0,2,2,0,0,0,0,5,5
wi15,151,WARREN,MATH,Mathematcs,0,0,0,0,3,3,3,3,6,3,2,5,6,6,12,0,0,0,12,14,26
wi15,151,WARREN,MATH,Mth-CompSc,0,0,0,11,4,15,10,3,13,4,1,5,5,2,7,0,0,0,30,10,40
wi15,151,WARREN,MATH,Mth-Mth&Ec,0,0,0,1,3,4,3,10,13,6,5,11,8,8,16,0,0,0,18,26,44
wi15,151,WARREN,MATH,Mth-SciCom,0,0,0,0,0,0,1,0,1,0,0,0,0,0,0,0,0,0,1,0,1
wi15,151,WARREN,MATH,Mth/ApldSc,0,0,0,0,2,2,2,1,3,0,0,0,1,3,4,0,0,0,3,6,9
wi15,151,WARREN,MATH,Prob&Stats,0,0,0,1,1,2,3,1,4,3,6,9,1,1,2,0,0,0,8,9,17
wi15,151,WARREN,MUS,Mu-CompArt,0,0,0,1,0,1,0,0,0,1,0,1,5,0,5,0,0,0,7,0,7
wi15,151,WARREN,MUS,Music,0,0,0,0,0,0,1,0,1,1,0,1,1,1,2,0,0,0,3,1,4
wi15,151,WARREN,NENG,NanoEng,0,0,0,0,0,0,9,3,12,16,3,19,38,7,45,0,0,0,63,13,76
wi15,151,WARREN,PHIL,Philosophy,0,0,0,0,1,1,0,0,0,3,4,7,4,1,5,0,0,0,7,6,13
wi15,151,WARREN,PHYS,Biophysics,0,0,0,0,1,1,1,0,1,1,2,3,2,2,4,0,0,0,4,5,9
wi15,151,WARREN,PHYS,Phys/Astro,0,0,0,1,1,2,0,1,1,1,1,2,0,2,2,0,0,0,2,5,7
wi15,151,WARREN,PHYS,Phys/Comp,0,0,0,1,0,1,1,0,1,0,0,0,1,0,1,0,0,0,3,0,3
wi15,151,WARREN,PHYS,Phys/Mtrls,0,0,0,1,0,1,1,0,1,1,0,1,0,0,0,0,0,0,3,0,3
wi15,151,WARREN,PHYS,Physics,0,0,0,5,1,6,3,1,4,2,0,2,8,1,9,0,0,0,18,3,21
wi15,151,WARREN,POLI,Polit Sci,0,0,0,3,1,4,4,3,7,9,6,15,24,19,43,0,0,0,40,29,69
wi15,151,WARREN,POLI,PolSc-Amer,0,0,0,1,0,1,0,0,0,1,1,2,6,2,8,0,0,0,8,3,11
wi15,151,WARREN,POLI,PolSc-Comp,0,0,0,0,0,0,1,0,1,0,0,0,0,2,2,0,0,0,1,2,3
wi15,151,WARREN,POLI,PolSc-Intl,0,0,0,1,1,2,1,2,3,5,4,9,7,3,10,0,0,0,14,10,24
wi15,151,WARREN,POLI,PolSc-PLaw,0,0,0,1,5,6,0,2,2,3,5,8,3,3,6,0,0,0,7,15,22
wi15,151,WARREN,POLI,PolSc-PPol,0,0,0,0,0,0,1,0,1,1,1,2,4,0,4,0,0,0,6,1,7
wi15,151,WARREN,POLI,PolSc-Thry,0,0,0,0,0,0,0,0,0,0,1,1,2,0,2,0,0,0,2,1,3
wi15,151,WARREN,PSYC,Psychology,0,0,0,2,2,4,5,10,15,7,21,28,29,55,84,0,0,0,43,88,131
wi15,151,WARREN,RELI,Relig/Stu,0,0,0,0,0,0,0,0,0,0,0,0,2,0,2,0,0,0,2,0,2
wi15,151,WARREN,RUSS,RusEE&EStd,0,0,0,0,0,0,0,0,0,0,0,0,0,1,1,0,0,0,0,1,1
wi15,151,WARREN,SE,Engin Sci,0,0,0,0,0,0,2,0,2,1,0,1,0,0,0,0,0,0,3,0,3
wi15,151,WARREN,SE,Struct Eng,0,0,0,3,3,6,19,10,29,35,13,48,76,25,101,0,0,0,133,51,184
wi15,151,WARREN,SIO,Earth Sci,0,0,0,0,0,0,0,0,0,0,1,1,1,1,2,0,0,0,1,2,3
wi15,151,WARREN,SIO,Marine Bio,0,0,0,0,2,2,0,1,1,0,0,0,1,4,5,0,0,0,1,7,8
wi15,151,WARREN,SOC,SocEconSoc,0,0,0,0,0,0,0,0,0,0,0,0,1,0,1,0,0,0,1,0,1
wi15,151,WARREN,SOC,Sociology,0,0,0,0,0,0,0,0,0,3,6,9,3,4,7,0,0,0,6,10,16
wi15,151,WARREN,SOC,SocLawSoc,0,0,0,0,1,1,0,0,0,2,2,4,3,5,8,0,0,0,5,8,13
wi15,151,WARREN,SOC,SocSolneq,0,0,0,0,0,0,0,0,0,0,2,2,0,1,1,0,0,0,0,3,3
wi15,151,WARREN,THEA,Dance,0,0,0,0,1,1,0,0,0,0,0,0,0,1,1,0,0,0,0,2,2
wi15,151,WARREN,THEA,Theatre,0,0,0,1,0,1,1,0,1,1,1,2,1,2,3,0,0,0,4,3,7
wi15,151,WARREN,UNAF,IntcampVis,0,0,0,0,0,0,0,2,2,0,0,0,0,1,1,0,0,0,0,3,3
wi15,151,WARREN,UNAF,Limited St,0,0,0,0,0,0,0,0,0,0,0,0,0,0,0,2,0,2,2,0,2
wi15,151,WARREN,UNAF,Undeclared,0,0,0,42,14,56,29,8,37,1,0,1,0,0,0,0,0,0,72,22,94
wi15,151,WARREN,UNAF,UndecPhysS,0,0,0,5,2,7,2,1,3,0,0,0,0,0,0,0,0,0,7,3,10
wi15,151,WARREN,UNAF,UndecSocSc,0,0,0,1,1,2,0,1,1,0,0,0,0,0,0,0,0,0,1,2,3
wi15,151,WARREN,USP,Urb Stu&Pl,0,0,0,0,0,0,1,0,1,0,2,2,2,1,3,0,0,0,3,3,6
wi15,151,WARREN,VIS,Media,0,0,0,1,0,1,0,0,0,3,2,5,4,4,8,0,0,0,8,6,14
wi15,151,WARREN,VIS,Studio VA,0,0,0,0,0,0,0,1,1,0,4,4,0,0,0,0,0,0,0,5,5
wi15,151,WARREN,VIS,VA-CompArt,0,0,0,0,0,0,0,0,0,0,2,2,1,1,2,0,0,0,1,3,4
wi12,121,MARSHALL,ANTH,Anth-Arch,0,0,0,0,1,1,1,0,1,1,2,3,2,1,3,0,0,0,4,4,8
wi12,121,MARSHALL,ANTH,Anth-Biol,0,0,0,0,2,2,0,2,2,5,3,8,2,4,6,0,0,0,7,11,18
wi12,121,MARSHALL,ANTH,Anth-Soci,0,0,0,0,1,1,0,2,2,0,3,3,1,6,7,0,0,0,1,12,13
wi12,121,MARSHALL,ANTH,Anthropol,0,0,0,0,0,0,0,0,0,0,0,0,0,1,1,0,0,0,0,1,1
wi12,121,MARSHALL,BENG,Bioen:Binf,0,0,0,2,0,2,2,0,2,2,3,5,3,2,5,0,0,0,9,5,14
wi12,121,MARSHALL,BENG,Bioeng:PM,0,0,0,0,0,0,0,0,0,0,1,1,8,4,12,0,0,0,8,5,13
wi12,121,MARSHALL,BENG,BioengBiot,0,0,0,0,0,0,0,3,3,3,3,6,20,10,30,0,0,0,23,16,39
wi12,121,MARSHALL,BENG,Bioengin,0,0,0,5,3,8,5,3,8,1,1,2,3,2,5,0,0,0,14,9,23
wi12,121,MARSHALL,BIOL,Bioc/CellB,0,0,0,3,5,8,9,10,19,6,22,28,43,42,85,0,0,0,61,79,140
wi12,121,MARSHALL,BIOL,BiolBioinf,0,0,0,1,0,1,0,0,0,1,0,1,0,0,0,0,0,0,2,0,2
wi12,121,MARSHALL,BIOL,Ec/Beh/Evo,0,0,0,0,0,0,1,1,2,1,2,3,5,8,13,0,0,0,7,11,18
wi12,121,MARSHALL,BIOL,Genl Biol,0,0,0,3,6,9,3,9,12,17,21,38,34,79,113,0,0,0,57,115,172
wi12,121,MARSHALL,BIOL,Human Bio,0,0,0,13,15,28,8,21,29,16,35,51,63,86,149,0,0,0,100,157,257
wi12,121,MARSHALL,BIOL,Microbiol,0,0,0,0,3,3,0,1,1,2,3,5,4,7,11,0,0,0,6,14,20
wi12,121,MARSHALL,BIOL,Molec Biol,0,0,0,0,2,2,0,1,1,1,1,2,4,6,10,0,0,0,5,10,15
wi12,121,MARSHALL,BIOL,PhyslNeuro,0,0,0,1,7,8,3,6,9,9,8,17,18,33,51,0,0,0,31,54,85
wi12,121,MARSHALL,CENG,Chem Engin,0,0,0,1,5,6,7,4,11,13,4,17,14,9,23,0,0,0,35,22,57
wi12,121,MARSHALL,CGS,CritGendSt,0,0,0,0,0,0,0,0,0,0,0,0,0,1,1,0,0,0,0,1,1
wi12,121,MARSHALL,CHEM,Bioch/Chem,0,0,0,2,5,7,7,8,15,19,29,48,19,27,46,0,0,0,47,69,116
wi12,121,MARSHALL,CHEM,Bioinform,0,0,0,0,1,1,1,0,1,1,1,2,0,0,0,0,0,0,2,2,4
wi12,121,MARSHALL,CHEM,Chem Phys,0,0,0,0,0,0,0,0,0,2,0,2,0,0,0,0,0,0,2,0,2
wi12,121,MARSHALL,CHEM,Chemistry,0,0,0,1,2,3,2,3,5,9,6,15,9,8,17,0,0,0,21,19,40
wi12,121,MARSHALL,CHEM,Envir Chem,0,0,0,0,0,0,0,0,0,0,1,1,2,0,2,0,0,0,2,1,3
wi12,121,MARSHALL,CHEM,Pharm Chem,0,0,0,2,3,5,2,6,8,7,16,23,13,15,28,0,0,0,24,40,64
wi12,121,MARSHALL,CHIN,Chinese St,0,0,0,0,0,0,0,0,0,0,0,0,1,0,1,0,0,0,1,0,1
wi12,121,MARSHALL,CLAS,Classic St,0,0,0,0,0,0,0,0,0,0,1,1,0,0,0,0,0,0,0,1,1
wi12,121,MARSHALL,COGS,Cog Sci,0,0,0,0,6,6,3,3,6,4,12,16,7,5,12,0,0,0,14,26,40
wi12,121,MARSHALL,COGS,CogSc/ClAs,0,0,0,0,0,0,0,0,0,0,2,2,0,6,6,0,0,0,0,8,8
wi12,121,MARSHALL,COGS,CogSc/Comp,0,0,0,0,0,0,0,1,1,0,0,0,1,0,1,0,0,0,1,1,2
wi12,121,MARSHALL,COGS,CogSc/HCI,0,0,0,0,1,1,1,1,2,3,1,4,4,1,5,0,0,0,8,4,12
wi12,121,MARSHALL,COGS,CogSc/HCog,0,0,0,1,1,2,0,1,1,1,0,1,1,1,2,0,0,0,3,3,6
wi12,121,MARSHALL,COGS,CogSc/Neur,0,0,0,0,0,0,1,5,6,6,5,11,3,15,18,0,0,0,10,25,35
wi12,121,MARSHALL,COMM,Communic,0,0,0,0,7,7,4,12,16,13,51,64,28,83,111,0,0,0,45,153,198
wi12,121,MARSHALL,CSE,Comp Sci,0,0,0,10,1,11,14,2,16,27,11,38,48,12,60,0,0,0,99,26,125
wi12,121,MARSHALL,CSE,CompEngCSE,0,0,0,1,3,4,4,0,4,7,1,8,8,2,10,0,0,0,20,6,26
wi12,121,MARSHALL,CSE,CompScBinf,0,0,0,0,0,0,0,0,0,2,1,3,2,1,3,0,0,0,4,2,6
wi12,121,MARSHALL,ECE,CompEngECE,0,0,0,2,0,2,0,0,0,0,0,0,3,0,3,0,0,0,5,0,5
wi12,121,MARSHALL,ECE,Electr Eng,0,0,0,6,0,6,7,2,9,23,5,28,32,6,38,0,0,0,68,13,81
wi12,121,MARSHALL,ECE,EleEng&Soc,0,0,0,0,0,0,0,0,0,0,0,0,1,0,1,0,0,0,1,0,1
wi12,121,MARSHALL,ECE,Engin Phys,0,0,0,0,0,0,0,0,0,0,0,0,1,0,1,0,0,0,1,0,1
wi12,121,MARSHALL,ECON,Ec-Mth&Ecn,0,0,0,2,0,2,1,1,2,3,3,6,7,5,12,0,0,0,13,9,22
wi12,121,MARSHALL,ECON,Econ-MgtSc,0,0,0,7,5,12,13,15,28,35,18,53,62,55,117,0,0,0,117,93,210
wi12,121,MARSHALL,ECON,Economics,0,0,0,8,12,20,18,5,23,68,51,119,90,66,156,0,0,0,184,134,318
wi12,121,MARSHALL,ESYS,EnvSys(EB),0,0,0,1,0,1,0,2,2,6,10,16,4,8,12,0,0,0,11,20,31
wi12,121,MARSHALL,ESYS,EnvSys(EC),0,0,0,0,0,0,0,0,0,0,0,0,2,0,2,0,0,0,2,0,2
wi12,121,MARSHALL,ESYS,EnvSys(EP),0,0,0,0,0,0,0,0,0,0,1,1,0,4,4,0,0,0,0,5,5
wi12,121,MARSHALL,ESYS,EnvSys(ES),0,0,0,0,0,0,0,1,1,1,2,3,5,0,5,0,0,0,6,3,9
wi12,121,MARSHALL,ETHN,Ethnic St,0,0,0,1,0,1,1,4,5,2,1,3,4,8,12,0,0,0,8,13,21
wi12,121,MARSHALL,GMST,German Stu,0,0,0,0,0,0,0,0,0,0,0,0,1,0,1,0,0,0,1,0,1
wi12,121,MARSHALL,HDP,Human Dev,0,0,0,0,0,0,1,0,1,2,8,10,1,22,23,0,0,0,4,30,34
wi12,121,MARSHALL,HDP,Pr-HumnDev,0,0,0,0,9,9,1,8,9,3,22,25,1,8,9,0,0,0,5,47,52
wi12,121,MARSHALL,HIST,History,0,0,0,0,1,1,2,1,3,13,10,23,17,12,29,0,0,0,32,24,56
wi12,121,MARSHALL,INTL,Int-5yrEC,0,0,0,0,0,0,0,0,0,0,0,0,2,1,3,0,0,0,2,1,3
wi12,121,MARSHALL,INTL,IntSt-Anth,0,0,0,0,0,0,0,3,3,0,1,1,0,0,0,0,0,0,0,4,4
wi12,121,MARSHALL,INTL,IntSt-Econ,0,0,0,2,7,9,0,6,6,8,8,16,17,15,32,0,0,0,27,36,63
wi12,121,MARSHALL,INTL,IntSt-Hist,0,0,0,0,0,0,0,0,0,1,0,1,0,2,2,0,0,0,1,2,3
wi12,121,MARSHALL,INTL,IntSt-Ling,0,0,0,0,0,0,0,1,1,1,4,5,0,0,0,0,0,0,1,5,6
wi12,121,MARSHALL,INTL,IntSt-Lit,0,0,0,0,0,0,0,0,0,0,0,0,0,2,2,0,0,0,0,2,2
wi12,121,MARSHALL,INTL,IntSt-PolS,0,0,0,0,1,1,2,1,3,3,12,15,4,11,15,0,0,0,9,25,34
wi12,121,MARSHALL,INTL,IntSt-Soc,0,0,0,1,3,4,0,3,3,2,4,6,0,7,7,0,0,0,3,17,20
wi12,121,MARSHALL,ITAL,Italian St,0,0,0,1,0,1,0,0,0,0,0,0,0,0,0,0,0,0,1,0,1
wi12,121,MARSHALL,JAPN,JapaneseSt,0,0,0,0,0,0,0,1,1,0,0,0,0,0,0,0,0,0,0,1,1
wi12,121,MARSHALL,LATI,LatinAm St,0,0,0,0,0,0,0,1,1,0,0,0,0,2,2,0,0,0,0,3,3
wi12,121,MARSHALL,LING,Lang Stu,0,0,0,0,0,0,0,0,0,1,0,1,0,1,1,0,0,0,1,1,2
wi12,121,MARSHALL,LING,Ling-CogLn,0,0,0,0,0,0,0,0,0,0,1,1,1,0,1,0,0,0,1,1,2
wi12,121,MARSHALL,LING,Ling-LSoc,0,0,0,0,0,0,0,1,1,0,1,1,0,2,2,0,0,0,0,4,4
wi12,121,MARSHALL,LING,Linguistcs,0,0,0,0,1,1,0,0,0,2,1,3,3,5,8,0,0,0,5,7,12
wi12,121,MARSHALL,LIT,Lit/CultSt,0,0,0,0,0,0,0,0,0,0,0,0,0,1,1,0,0,0,0,1,1
wi12,121,MARSHALL,LIT,Lit/Engl,0,0,0,0,1,1,0,2,2,2,3,5,5,9,14,0,0,0,7,15,22
wi12,121,MARSHALL,LIT,Lit/World,0,0,0,0,0,0,0,0,0,0,0,0,0,4,4,0,0,0,0,4,4
wi12,121,MARSHALL,LIT,Lit/Writng,0,0,0,0,0,0,0,1,1,2,4,6,4,8,12,0,0,0,6,13,19
wi12,121,MARSHALL,LIT,Pre-Lit/Wr,0,0,0,0,0,0,0,0,0,0,0,0,2,0,2,0,0,0,2,0,2
wi12,121,MARSHALL,LIT,Spanish Lt,0,0,0,0,0,0,0,0,0,1,1,2,0,2,2,0,0,0,1,3,4
wi12,121,MARSHALL,MAE,Aerosp Eng,0,0,0,2,0,2,5,1,6,8,3,11,13,5,18,0,0,0,28,9,37
wi12,121,MARSHALL,MAE,Engin Sci,0,0,0,1,0,1,0,2,2,3,0,3,1,0,1,0,0,0,5,2,7
wi12,121,MARSHALL,MAE,Envir Eng,0,0,0,1,1,2,4,1,5,4,3,7,4,3,7,0,0,0,13,8,21
wi12,121,MARSHALL,MAE,Mech Engin,0,0,0,3,0,3,7,1,8,7,3,10,45,6,51,0,0,0,62,10,72
wi12,121,MARSHALL,MATH,Appld Math,0,0,0,4,0,4,1,5,6,2,1,3,1,3,4,0,0,0,8,9,17
wi12,121,MARSHALL,MATH,Math/SecEd,0,0,0,0,0,0,0,0,0,3,1,4,1,1,2,0,0,0,4,2,6
wi12,121,MARSHALL,MATH,Mathematcs,0,0,0,1,2,3,1,2,3,4,3,7,8,9,17,0,0,0,14,16,30
wi12,121,MARSHALL,MATH,Mth-CompSc,0,0,0,0,0,0,0,0,0,0,0,0,2,1,3,0,0,0,2,1,3
wi12,121,MARSHALL,MATH,Mth-Mth&Ec,0,0,0,0,1,1,2,0,2,5,5,10,6,1,7,0,0,0,13,7,20
wi12,121,MARSHALL,MATH,Mth/ApldSc,0,0,0,0,1,1,0,0,0,1,0,1,0,0,0,0,0,0,1,1,2
wi12,121,MARSHALL,MATH,Pr-Math CS,0,0,0,0,0,0,0,1,1,0,0,0,0,0,0,0,0,0,0,1,1
wi12,121,MARSHALL,MATH,Prob&Stats,0,0,0,0,1,1,1,0,1,0,3,3,0,2,2,0,0,0,1,6,7
wi12,121,MARSHALL,MUS,Mu-CompArt,0,0,0,0,0,0,0,0,0,0,0,0,2,2,4,0,0,0,2,2,4
wi12,121,MARSHALL,MUS,Music,0,0,0,0,0,0,1,1,2,2,1,3,3,2,5,0,0,0,6,4,10
wi12,121,MARSHALL,NENG,NanoEng,0,0,0,2,0,2,2,0,2,2,2,4,5,2,7,0,0,0,11,4,15
wi12,121,MARSHALL,PHIL,Philosophy,0,0,0,0,1,1,0,0,0,7,2,9,6,2,8,0,0,0,13,5,18
wi12,121,MARSHALL,PHYS,Biophysics,0,0,0,0,0,0,0,0,0,0,0,0,3,2,5,0,0,0,3,2,5
wi12,121,MARSHALL,PHYS,Gen Physcs,0,0,0,0,0,0,0,0,0,1,0,1,0,0,0,0,0,0,1,0,1
wi12,121,MARSHALL,PHYS,Phy/ErthSc,0,0,0,0,0,0,0,0,0,1,0,1,0,0,0,0,0,0,1,0,1
wi12,121,MARSHALL,PHYS,Phys/Astro,0,0,0,0,1,1,0,0,0,0,0,0,1,1,2,0,0,0,1,2,3
wi12,121,MARSHALL,PHYS,Phys/Comp,0,0,0,0,0,0,1,0,1,0,0,0,0,1,1,0,0,0,1,1,2
wi12,121,MARSHALL,PHYS,Physics,0,0,0,0,0,0,1,0,1,0,0,0,7,2,9,0,0,0,8,2,10
wi12,121,MARSHALL,POLI,Polit Sci,0,0,0,2,2,4,6,3,9,19,17,36,31,30,61,0,0,0,58,52,110
wi12,121,MARSHALL,POLI,PolSc-Amer,0,0,0,2,0,2,0,0,0,0,4,4,6,3,9,0,0,0,8,7,15
wi12,121,MARSHALL,POLI,PolSc-Comp,0,0,0,0,0,0,0,0,0,0,1,1,0,5,5,0,0,0,0,6,6
wi12,121,MARSHALL,POLI,PolSc-Intl,0,0,0,1,3,4,2,4,6,14,9,23,15,9,24,0,0,0,32,25,57
wi12,121,MARSHALL,POLI,PolSc-PLaw,0,0,0,2,4,6,2,6,8,10,5,15,6,3,9,0,0,0,20,18,38
wi12,121,MARSHALL,POLI,PolSc-PPol,0,0,0,0,0,0,1,2,3,0,1,1,3,2,5,0,0,0,4,5,9
wi12,121,MARSHALL,POLI,PolSc-Thry,0,0,0,0,0,0,3,0,3,1,0,1,2,2,4,0,0,0,6,2,8
wi12,121,MARSHALL,PSYC,Psychology,0,0,0,7,12,19,7,26,33,33,75,108,52,97,149,0,0,0,99,210,309
wi12,121,MARSHALL,RELI,Relig/Stu,0,0,0,0,0,0,0,0,0,0,0,0,0,1,1,0,0,0,0,1,1
wi12,121,MARSHALL,SE,Engin Sci,0,0,0,0,1,1,0,0,0,0,0,0,0,0,0,0,0,0,0,1,1
wi12,121,MARSHALL,SE,Struct Eng,0,0,0,8,3,11,4,4,8,21,3,24,30,14,44,0,0,0,63,24,87
wi12,121,MARSHALL,SIO,Earth Sci,0,0,0,0,0,0,1,1,2,0,1,1,3,0,3,0,0,0,4,2,6
wi12,121,MARSHALL,SOC,SocAmSt,0,0,0,0,0,0,0,0,0,1,0,1,0,0,0,0,0,0,1,0,1
wi12,121,MARSHALL,SOC,SocCulCom,0,0,0,0,0,0,0,0,0,0,0,0,0,1,1,0,0,0,0,1,1
wi12,121,MARSHALL,SOC,SocEconSoc,0,0,0,0,0,0,0,0,0,2,3,5,0,2,2,0,0,0,2,5,7
wi12,121,MARSHALL,SOC,SocIntlStu,0,0,0,0,0,0,0,1,1,0,0,0,0,2,2,0,0,0,0,3,3
wi12,121,MARSHALL,SOC,Sociology,0,0,0,1,0,1,1,1,2,11,34,45,9,28,37,0,0,0,22,63,85
wi12,121,MARSHALL,SOC,SocLawSoc,0,0,0,0,0,0,1,0,1,1,2,3,3,5,8,0,0,0,5,7,12
wi12,121,MARSHALL,SOC,SocSciMed,0,0,0,0,0,0,0,0,0,2,3,5,1,1,2,0,0,0,3,4,7
wi12,121,MARSHALL,SOC,SocSolneq,0,0,0,0,0,0,0,0,0,0,1,1,1,2,3,0,0,0,1,3,4
wi12,121,MARSHALL,THEA,Dance,0,0,0,1,0,1,0,0,0,0,1,1,0,1,1,0,0,0,1,2,3
wi12,121,MARSHALL,THEA,Theatre,0,0,0,0,0,0,1,0,1,1,2,3,3,4,7,0,0,0,5,6,11
wi12,121,MARSHALL,UNAF,UndecHumAr,0,0,0,0,0,0,0,3,3,0,0,0,0,0,0,0,0,0,0,3,3
wi12,121,MARSHALL,UNAF,Undeclared,0,0,0,16,18,34,6,15,21,1,1,2,0,0,0,0,0,0,23,34,57
wi12,121,MARSHALL,UNAF,UndecPhysS,0,0,0,3,3,6,3,2,5,0,1,1,0,0,0,0,0,0,6,6,12
wi12,121,MARSHALL,UNAF,UndecSocSc,0,0,0,2,2,4,1,3,4,0,0,0,0,0,0,0,0,0,3,5,8
wi12,121,MARSHALL,USP,Urb Stu&Pl,0,0,0,0,0,0,0,1,1,8,8,16,6,17,23,0,0,0,14,26,40
wi12,121,MARSHALL,VIS,Art Hst/Cr,0,0,0,0,1,1,0,0,0,0,0,0,0,6,6,0,0,0,0,7,7
wi12,121,MARSHALL,VIS,Media,0,0,0,0,0,0,2,0,2,9,4,13,9,5,14,0,0,0,20,9,29
wi12,121,MARSHALL,VIS,Studio VA,0,0,0,0,0,0,0,2,2,0,5,5,0,6,6,0,0,0,0,13,13
wi12,121,MARSHALL,VIS,VA-CompArt,0,0,0,0,0,0,0,0,0,0,2,2,3,1,4,0,0,0,3,3,6
wi12,121,MUIR,ANTH,Anth-Arch,0,0,0,1,1,2,0,4,4,1,3,4,0,3,3,0,0,0,2,11,13
wi12,121,MUIR,ANTH,Anth-Biol,0,0,0,1,1,2,0,4,4,0,2,2,0,3,3,0,0,0,1,10,11
wi12,121,MUIR,ANTH,Anth-Soci,0,0,0,0,1,1,0,2,2,1,5,6,5,9,14,0,0,0,6,17,23
wi12,121,MUIR,BENG,Bioen:Binf,0,0,0,0,1,1,1,0,1,1,0,1,1,1,2,0,0,0,3,2,5
wi12,121,MUIR,BENG,Bioeng:PM,0,0,0,0,0,0,0,0,0,1,0,1,5,2,7,0,0,0,6,2,8
wi12,121,MUIR,BENG,BioengBiot,0,0,0,2,1,3,2,3,5,4,2,6,10,11,21,0,0,0,18,17,35
wi12,121,MUIR,BENG,Bioengin,0,0,0,1,3,4,2,3,5,6,1,7,19,5,24,0,0,0,28,12,40
wi12,121,MUIR,BENG,Pr-BioenPM,0,0,0,1,0,1,0,0,0,0,1,1,1,0,1,0,0,0,2,1,3
wi12,121,MUIR,BIOL,Bioc/CellB,0,0,0,3,8,11,4,3,7,12,9,21,34,60,94,0,0,0,53,80,133
wi12,121,MUIR,BIOL,BiolBioinf,0,0,0,0,0,0,0,1,1,0,1,1,1,0,1,0,0,0,1,2,3
wi12,121,MUIR,BIOL,Ec/Beh/Evo,0,0,0,2,1,3,0,4,4,3,5,8,7,17,24,0,0,0,12,27,39
wi12,121,MUIR,BIOL,Genl Biol,0,0,0,4,14,18,7,12,19,7,26,33,32,70,102,0,0,0,50,122,172
wi12,121,MUIR,BIOL,Human Bio,0,0,0,5,18,23,17,31,48,17,28,45,52,71,123,0,0,0,91,148,239
wi12,121,MUIR,BIOL,Microbiol,0,0,0,1,0,1,1,2,3,5,2,7,7,3,10,0,0,0,14,7,21
wi12,121,MUIR,BIOL,Molec Biol,0,0,0,0,2,2,0,3,3,2,3,5,13,11,24,0,0,0,15,19,34
wi12,121,MUIR,BIOL,PhyslNeuro,0,0,0,4,8,12,6,10,16,13,11,24,30,33,63,0,0,0,53,62,115
wi12,121,MUIR,CENG,Chem Engin,0,0,0,4,2,6,5,3,8,9,6,15,15,12,27,0,0,0,33,23,56
wi12,121,MUIR,CGS,CritGendSt,0,0,0,0,1,1,0,0,0,0,0,0,1,1,2,0,0,0,1,2,3
wi12,121,MUIR,CHEM,Bioch/Chem,0,0,0,1,6,7,6,11,17,20,18,38,26,20,46,0,0,0,53,55,108
wi12,121,MUIR,CHEM,Chem Educ,0,0,0,0,0,0,0,0,0,0,0,0,0,1,1,0,0,0,0,1,1
wi12,121,MUIR,CHEM,Chem Phys,0,0,0,0,0,0,0,0,0,1,0,1,0,0,0,0,0,0,1,0,1
wi12,121,MUIR,CHEM,Chemistry,0,0,0,1,1,2,5,1,6,6,6,12,10,6,16,0,0,0,22,14,36
wi12,121,MUIR,CHEM,Envir Chem,0,0,0,0,0,0,0,0,0,1,1,2,1,0,1,0,0,0,2,1,3
wi12,121,MUIR,CHEM,MolecSynth,0,0,0,0,1,1,0,0,0,1,0,1,0,1,1,0,0,0,1,2,3
wi12,121,MUIR,CHEM,Pharm Chem,0,0,0,1,6,7,7,6,13,12,8,20,8,20,28,0,0,0,28,40,68
wi12,121,MUIR,CHIN,Chinese St,0,0,0,0,0,0,0,0,0,1,1,2,1,0,1,0,0,0,2,1,3
wi12,121,MUIR,CLAS,Classic St,0,0,0,0,0,0,0,0,0,0,0,0,0,2,2,0,0,0,0,2,2
wi12,121,MUIR,COGS,Cog Sci,0,0,0,2,3,5,1,9,10,7,7,14,6,12,18,0,0,0,16,31,47
wi12,121,MUIR,COGS,CogSc/ClAs,0,0,0,0,1,1,0,2,2,0,4,4,0,3,3,0,0,0,0,10,10
wi12,121,MUIR,COGS,CogSc/Comp,0,0,0,0,0,0,2,0,2,0,1,1,3,0,3,0,0,0,5,1,6
wi12,121,MUIR,COGS,CogSc/HCI,0,0,0,0,1,1,2,2,4,2,3,5,3,3,6,0,0,0,7,9,16
wi12,121,MUIR,COGS,CogSc/HCog,0,0,0,0,1,1,1,0,1,1,0,1,0,3,3,0,0,0,2,4,6
wi12,121,MUIR,COGS,CogSc/Neur,0,0,0,2,1,3,1,5,6,7,20,27,13,15,28,0,0,0,23,41,64
wi12,121,MUIR,COMM,Communic,0,0,0,0,8,8,7,13,20,12,29,41,23,60,83,0,0,0,42,110,152
wi12,121,MUIR,CSE,Comp Sci,0,0,0,3,4,7,14,6,20,37,7,44,42,17,59,0,0,0,96,34,130
wi12,121,MUIR,CSE,CompEngCSE,0,0,0,2,1,3,4,1,5,12,2,14,9,0,9,0,0,0,27,4,31
wi12,121,MUIR,CSE,CompScBinf,0,0,0,1,0,1,1,0,1,2,0,2,4,1,5,0,0,0,8,1,9
wi12,121,MUIR,ECE,CompEngECE,0,0,0,1,0,1,0,0,0,2,1,3,2,0,2,0,0,0,5,1,6
wi12,121,MUIR,ECE,Electr Eng,0,0,0,6,1,7,6,4,10,16,4,20,23,1,24,0,0,0,51,10,61
wi12,121,MUIR,ECE,Pr-EngPhys,0,0,0,0,0,0,0,0,0,1,0,1,0,0,0,0,0,0,1,0,1
wi12,121,MUIR,ECON,Ec-Mth&Ecn,0,0,0,4,3,7,3,3,6,5,3,8,2,2,4,0,0,0,14,11,25
wi12,121,MUIR,ECON,Econ-MgtSc,0,0,0,3,10,13,14,9,23,28,23,51,51,27,78,0,0,0,96,69,165
wi12,121,MUIR,ECON,Economics,0,0,0,8,11,19,18,17,35,48,29,77,67,43,110,0,0,0,141,100,241
wi12,121,MUIR,ESYS,EnvSys(EB),0,0,0,0,5,5,3,11,14,9,8,17,8,21,29,0,0,0,20,45,65
wi12,121,MUIR,ESYS,EnvSys(EC),0,0,0,0,1,1,0,1,1,0,2,2,0,1,1,0,0,0,0,5,5
wi12,121,MUIR,ESYS,EnvSys(EP),0,0,0,0,1,1,0,0,0,0,6,6,3,2,5,0,0,0,3,9,12
wi12,121,MUIR,ESYS,EnvSys(ES),0,0,0,0,0,0,3,0,3,0,0,0,1,3,4,0,0,0,4,3,7
wi12,121,MUIR,ETHN,Ethnic St,0,0,0,0,0,0,0,0,0,2,1,3,1,7,8,0,0,0,3,8,11
wi12,121,MUIR,HDP,Human Dev,0,0,0,0,0,0,1,0,1,1,3,4,6,22,28,0,0,0,8,25,33
wi12,121,MUIR,HDP,Pr-HumnDev,0,0,0,0,3,3,2,10,12,2,16,18,0,7,7,0,0,0,4,36,40
wi12,121,MUIR,HIST,History,0,0,0,0,0,0,1,2,3,5,5,10,16,19,35,0,0,0,22,26,48
wi12,121,MUIR,INTL,IntSt-Anth,0,0,0,0,1,1,1,1,2,0,0,0,0,3,3,0,0,0,1,5,6
wi12,121,MUIR,INTL,IntSt-Econ,0,0,0,2,1,3,4,4,8,1,9,10,8,14,22,0,0,0,15,28,43
wi12,121,MUIR,INTL,IntSt-Hist,0,0,0,0,0,0,0,0,0,2,0,2,2,0,2,0,0,0,4,0,4
wi12,121,MUIR,INTL,IntSt-Ling,0,0,0,0,0,0,0,1,1,0,1,1,0,0,0,0,0,0,0,2,2
wi12,121,MUIR,INTL,IntSt-Lit,0,0,0,0,1,1,0,2,2,0,0,0,0,1,1,0,0,0,0,4,4
wi12,121,MUIR,INTL,IntSt-PolS,0,0,0,1,1,2,2,2,4,3,4,7,2,16,18,0,0,0,8,23,31
wi12,121,MUIR,INTL,IntSt-Soc,0,0,0,0,1,1,0,1,1,1,5,6,2,9,11,0,0,0,3,16,19
wi12,121,MUIR,JAPN,JapaneseSt,0,0,0,0,0,0,1,1,2,1,0,1,2,1,3,0,0,0,4,2,6
wi12,121,MUIR,LATI,LatinAm St,0,0,0,0,0,0,0,0,0,1,0,1,0,1,1,0,0,0,1,1,2
wi12,121,MUIR,LING,Lang Stu,0,0,0,0,0,0,0,1,1,1,1,2,0,0,0,0,0,0,1,2,3
wi12,121,MUIR,LING,Ling-CogLn,0,0,0,0,2,2,0,0,0,0,2,2,2,1,3,0,0,0,2,5,7
wi12,121,MUIR,LING,Ling-LSoc,0,0,0,0,0,0,0,0,0,2,3,5,0,0,0,0,0,0,2,3,5
wi12,121,MUIR,LING,Linguistcs,0,0,0,0,1,1,1,1,2,4,3,7,2,5,7,0,0,0,7,10,17
wi12,121,MUIR,LIT,Lit/Compos,0,0,0,0,0,0,0,0,0,0,0,0,0,1,1,0,0,0,0,1,1
wi12,121,MUIR,LIT,Lit/CultSt,0,0,0,0,0,0,0,1,1,0,0,0,0,1,1,0,0,0,0,2,2
wi12,121,MUIR,LIT,Lit/Engl,0,0,0,0,0,0,0,4,4,1,4,5,5,8,13,0,0,0,6,16,22
wi12,121,MUIR,LIT,Lit/World,0,0,0,0,0,0,0,0,0,0,2,2,0,2,2,0,0,0,0,4,4
wi12,121,MUIR,LIT,Lit/Writng,0,0,0,0,3,3,0,4,4,5,6,11,4,14,18,0,0,0,9,27,36
wi12,121,MUIR,LIT,Pre-Lit/Wr,0,0,0,0,0,0,0,0,0,0,0,0,1,0,1,0,0,0,1,0,1
wi12,121,MUIR,LIT,Spanish Lt,0,0,0,0,1,1,1,1,2,0,0,0,1,3,4,0,0,0,2,5,7
wi12,121,MUIR,MAE,Aerosp Eng,0,0,0,1,0,1,6,2,8,9,2,11,19,4,23,0,0,0,35,8,43
wi12,121,MUIR,MAE,Engin Sci,0,0,0,1,0,1,3,0,3,0,1,1,3,0,3,0,0,0,7,1,8
wi12,121,MUIR,MAE,Envir Eng,0,0,0,5,2,7,6,7,13,8,6,14,9,7,16,0,0,0,28,22,50
wi12,121,MUIR,MAE,Mech Engin,0,0,0,4,1,5,4,0,4,9,1,10,45,5,50,0,0,0,62,7,69
wi12,121,MUIR,MATH,Appld Math,0,0,0,4,0,4,3,2,5,1,4,5,1,3,4,0,0,0,9,9,18
wi12,121,MUIR,MATH,Math/SecEd,0,0,0,0,3,3,0,2,2,1,3,4,2,1,3,0,0,0,3,9,12
wi12,121,MUIR,MATH,Mathematcs,0,0,0,3,3,6,0,1,1,4,1,5,9,6,15,0,0,0,16,11,27
wi12,121,MUIR,MATH,Mth-CompSc,0,0,0,0,0,0,1,0,1,0,0,0,2,0,2,0,0,0,3,0,3
wi12,121,MUIR,MATH,Mth-Mth&Ec,0,0,0,3,4,7,1,1,2,8,3,11,1,4,5,0,0,0,13,12,25
wi12,121,MUIR,MATH,Mth/ApldSc,0,0,0,1,0,1,0,0,0,1,0,1,2,0,2,0,0,0,4,0,4
wi12,121,MUIR,MATH,Prob&Stats,0,0,0,0,0,0,0,0,0,1,1,2,7,0,7,0,0,0,8,1,9
wi12,121,MUIR,MUS,Mu-CompArt,0,0,0,1,1,2,2,0,2,3,0,3,8,0,8,0,0,0,14,1,15
wi12,121,MUIR,MUS,Music,0,0,0,1,1,2,1,1,2,1,1,2,1,3,4,0,0,0,4,6,10
wi12,121,MUIR,MUS,Music Hum,0,0,0,0,0,0,0,0,0,1,0,1,0,0,0,0,0,0,1,0,1
wi12,121,MUIR,NENG,NanoEng,0,0,0,2,0,2,3,0,3,10,3,13,1,1,2,0,0,0,16,4,20
wi12,121,MUIR,PHIL,Philosophy,0,0,0,1,0,1,1,0,1,7,4,11,3,3,6,0,0,0,12,7,19
wi12,121,MUIR,PHYS,Biophysics,0,0,0,0,0,0,1,0,1,0,1,1,4,1,5,0,0,0,5,2,7
wi12,121,MUIR,PHYS,Phy/ErthSc,0,0,0,0,0,0,0,0,0,0,0,0,0,1,1,0,0,0,0,1,1
wi12,121,MUIR,PHYS,Phys/Astro,0,0,0,0,0,0,0,0,0,3,0,3,4,0,4,0,0,0,7,0,7
wi12,121,MUIR,PHYS,Physics,0,0,0,1,0,1,1,0,1,3,0,3,13,1,14,0,0,0,18,1,19
wi12,121,MUIR,POLI,Polit Sci,0,0,0,3,0,3,5,9,14,20,11,31,26,23,49,0,0,0,54,43,97
wi12,121,MUIR,POLI,PolSc-Amer,0,0,0,0,0,0,0,1,1,3,2,5,2,0,2,0,0,0,5,3,8
wi12,121,MUIR,POLI,PolSc-Comp,0,0,0,0,0,0,0,0,0,0,0,0,0,1,1,0,0,0,0,1,1
wi12,121,MUIR,POLI,PolSc-Intl,0,0,0,0,2,2,1,7,8,4,7,11,17,9,26,0,0,0,22,25,47
wi12,121,MUIR,POLI,PolSc-PLaw,0,0,0,1,0,1,7,2,9,6,4,10,5,5,10,0,0,0,19,11,30
wi12,121,MUIR,POLI,PolSc-PPol,0,0,0,0,1,1,1,1,2,1,0,1,3,0,3,0,0,0,5,2,7
wi12,121,MUIR,POLI,PolSc-Thry,0,0,0,1,0,1,0,0,0,1,0,1,0,0,0,0,0,0,2,0,2
wi12,121,MUIR,PSYC,Psychology,0,0,0,6,41,47,14,34,48,21,78,99,44,104,148,0,0,0,85,257,342
wi12,121,MUIR,RELI,Relig/Stu,0,0,0,0,0,0,0,0,0,0,0,0,3,1,4,0,0,0,3,1,4
wi12,121,MUIR,RUSS,Russ&SovSt,0,0,0,0,0,0,0,0,0,0,1,1,0,0,0,0,0,0,0,1,1
wi12,121,MUIR,SE,Struct Eng,0,0,0,9,3,12,9,5,14,15,5,20,24,10,34,0,0,0,57,23,80
wi12,121,MUIR,SIO,Earth Sci,0,0,0,1,1,2,0,1,1,1,1,2,4,2,6,0,0,0,6,5,11
wi12,121,MUIR,SIO,ErSc-Geol,0,0,0,0,0,0,0,0,0,0,0,0,2,0,2,0,0,0,2,0,2
wi12,121,MUIR,SOC,SocAmSt,0,0,0,0,0,0,0,1,1,0,0,0,0,0,0,0,0,0,0,1,1
wi12,121,MUIR,SOC,SocCulCom,0,0,0,0,0,0,1,0,1,2,2,4,1,3,4,0,0,0,4,5,9
wi12,121,MUIR,SOC,SocEconSoc,0,0,0,0,0,0,0,0,0,1,0,1,0,1,1,0,0,0,1,1,2
wi12,121,MUIR,SOC,SocIntlStu,0,0,0,0,0,0,0,0,0,0,1,1,0,2,2,0,0,0,0,3,3
wi12,121,MUIR,SOC,Sociology,0,0,0,2,2,4,4,5,9,10,16,26,9,23,32,0,0,0,25,46,71
wi12,121,MUIR,SOC,SocLawSoc,0,0,0,0,1,1,1,3,4,1,2,3,3,3,6,0,0,0,5,9,14
wi12,121,MUIR,SOC,SocSciMed,0,0,0,0,0,0,0,0,0,1,2,3,0,5,5,0,0,0,1,7,8
wi12,121,MUIR,SOC,SocSolneq,0,0,0,0,1,1,0,1,1,0,1,1,0,3,3,0,0,0,0,6,6
wi12,121,MUIR,THEA,Dance,0,0,0,0,1,1,1,0,1,0,1,1,0,2,2,0,0,0,1,4,5
wi12,121,MUIR,THEA,Theatre,0,0,0,1,5,6,1,1,2,1,3,4,3,9,12,0,0,0,6,18,24
wi12,121,MUIR,TWS,ThirdWldSt,0,0,0,0,0,0,0,1,1,0,0,0,0,0,0,0,0,0,0,1,1
wi12,121,MUIR,UNAF,Limited St,0,0,0,0,0,0,0,0,0,0,0,0,0,0,0,0,1,1,0,1,1
wi12,121,MUIR,UNAF,UndecHumAr,0,0,0,1,3,4,0,1,1,1,0,1,0,0,0,0,0,0,2,4,6
wi12,121,MUIR,UNAF,Undeclared,0,0,0,23,33,56,15,17,32,5,4,9,0,0,0,0,0,0,43,54,97
wi12,121,MUIR,UNAF,UndecPhysS,0,0,0,2,2,4,3,1,4,0,0,0,0,0,0,0,0,0,5,3,8
wi12,121,MUIR,UNAF,UndecSocSc,0,0,0,1,4,5,2,2,4,0,0,0,0,0,0,0,0,0,3,6,9
wi12,121,MUIR,USP,Urb Stu&Pl,0,0,0,0,0,0,1,1,2,6,7,13,5,9,14,0,0,0,12,17,29
wi12,121,MUIR,VIS,Art Hst/Cr,0,0,0,0,0,0,1,0,1,0,3,3,1,2,3,0,0,0,2,5,7
wi12,121,MUIR,VIS,Media,0,0,0,0,1,1,2,3,5,11,7,18,7,16,23,0,0,0,20,27,47
wi12,121,MUIR,VIS,Studio VA,0,0,0,0,0,0,0,4,4,1,2,3,3,8,11,0,0,0,4,14,18
wi12,121,MUIR,VIS,VA-CompArt,0,0,0,0,0,0,1,0,1,1,3,4,6,3,9,0,0,0,8,6,14
wi12,121,REVELLE,ANTH,Anth-Arch,0,0,0,0,1,1,0,1,1,0,1,1,1,1,2,0,0,0,1,4,5
wi12,121,REVELLE,ANTH,Anth-Biol,0,0,0,0,2,2,1,0,1,2,1,3,1,5,6,0,0,0,4,8,12
wi12,121,REVELLE,ANTH,Anth-Soci,0,0,0,0,0,0,0,2,2,0,1,1,2,8,10,0,0,0,2,11,13
wi12,121,REVELLE,BENG,Bioen:Binf,0,0,0,6,4,10,1,4,5,3,0,3,2,3,5,0,0,0,12,11,23
wi12,121,REVELLE,BENG,Bioeng:PM,0,0,0,0,0,0,0,0,0,0,0,0,15,4,19,0,0,0,15,4,19
wi12,121,REVELLE,BENG,BioengBiot,0,0,0,3,2,5,2,3,5,8,1,9,26,14,40,0,0,0,39,20,59
wi12,121,REVELLE,BENG,Bioengin,0,0,0,1,4,5,8,7,15,2,4,6,19,6,25,0,0,0,30,21,51
wi12,121,REVELLE,BIOL,Bioc/CellB,0,0,0,5,12,17,4,12,16,21,12,33,70,55,125,0,0,0,100,91,191
wi12,121,REVELLE,BIOL,BiolBioinf,0,0,0,0,1,1,0,1,1,0,0,0,1,0,1,0,0,0,1,2,3
wi12,121,REVELLE,BIOL,Ec/Beh/Evo,0,0,0,1,1,2,1,1,2,2,3,5,3,10,13,0,0,0,7,15,22
wi12,121,REVELLE,BIOL,Genl Biol,0,0,0,1,11,12,6,6,12,13,29,42,44,92,136,0,0,0,64,138,202
wi12,121,REVELLE,BIOL,Human Bio,0,0,0,15,21,36,11,34,45,27,51,78,98,104,202,0,0,0,151,210,361
wi12,121,REVELLE,BIOL,Microbiol,0,0,0,2,1,3,2,1,3,4,2,6,6,9,15,0,0,0,14,13,27
wi12,121,REVELLE,BIOL,Molec Biol,0,0,0,0,1,1,1,1,2,2,4,6,10,12,22,0,0,0,13,18,31
wi12,121,REVELLE,BIOL,PhyslNeuro,0,0,0,3,10,13,5,7,12,9,13,22,32,39,71,0,0,0,49,69,118
wi12,121,REVELLE,CENG,Chem Engin,0,0,0,8,1,9,11,4,15,11,8,19,23,8,31,0,0,0,53,21,74
wi12,121,REVELLE,CGS,CritGendSt,0,0,0,0,0,0,0,0,0,0,0,0,1,1,2,0,0,0,1,1,2
wi12,121,REVELLE,CHEM,Bioch/Chem,0,0,0,6,7,13,9,10,19,17,20,37,23,19,42,0,0,0,55,56,111
wi12,121,REVELLE,CHEM,Bioinform,0,0,0,1,1,2,0,0,0,0,0,0,0,0,0,0,0,0,1,1,2
wi12,121,REVELLE,CHEM,Chem Educ,0,0,0,0,0,0,0,0,0,0,0,0,0,1,1,0,0,0,0,1,1
wi12,121,REVELLE,CHEM,Chem Phys,0,0,0,0,0,0,0,0,0,3,1,4,0,0,0,0,0,0,3,1,4
wi12,121,REVELLE,CHEM,Chemistry,0,0,0,3,3,6,4,4,8,10,10,20,10,11,21,0,0,0,27,28,55
wi12,121,REVELLE,CHEM,Envir Chem,0,0,0,0,0,0,0,0,0,0,2,2,1,1,2,0,0,0,1,3,4
wi12,121,REVELLE,CHEM,MolecSynth,0,0,0,0,0,0,1,0,1,1,0,1,3,0,3,0,0,0,5,0,5
wi12,121,REVELLE,CHEM,Pharm Chem,0,0,0,5,6,11,6,11,17,14,25,39,25,40,65,0,0,0,50,82,132
wi12,121,REVELLE,CLAS,Classic St,0,0,0,0,0,0,0,0,0,0,0,0,0,1,1,0,0,0,0,1,1
wi12,121,REVELLE,COGS,Cog Sci,0,0,0,0,3,3,6,4,10,9,5,14,4,4,8,0,0,0,19,16,35
wi12,121,REVELLE,COGS,CogSc/ClAs,0,0,0,1,0,1,0,0,0,0,4,4,1,4,5,0,0,0,2,8,10
wi12,121,REVELLE,COGS,CogSc/Comp,0,0,0,0,0,0,0,0,0,1,2,3,1,0,1,0,0,0,2,2,4
wi12,121,REVELLE,COGS,CogSc/HCI,0,0,0,0,0,0,0,1,1,2,0,2,1,0,1,0,0,0,3,1,4
wi12,121,REVELLE,COGS,CogSc/HCog,0,0,0,0,0,0,1,1,2,0,3,3,1,2,3,0,0,0,2,6,8
wi12,121,REVELLE,COGS,CogSc/Neur,0,0,0,2,1,3,2,11,13,5,10,15,3,18,21,0,0,0,12,40,52
wi12,121,REVELLE,COMM,Communic,0,0,0,2,2,4,4,4,8,6,15,21,9,12,21,0,0,0,21,33,54
wi12,121,REVELLE,CSE,Comp Sci,0,0,0,9,3,12,19,2,21,33,3,36,54,8,62,0,0,0,115,16,131
wi12,121,REVELLE,CSE,CompEngCSE,0,0,0,9,0,9,4,0,4,6,2,8,10,0,10,0,0,0,29,2,31
wi12,121,REVELLE,CSE,CompScBinf,0,0,0,0,1,1,0,1,1,3,0,3,2,3,5,0,0,0,5,5,10
wi12,121,REVELLE,ECE,CompEngECE,0,0,0,2,0,2,3,1,4,2,0,2,2,0,2,0,0,0,9,1,10
wi12,121,REVELLE,ECE,Electr Eng,0,0,0,16,3,19,5,1,6,23,2,25,27,7,34,0,0,0,71,13,84
wi12,121,REVELLE,ECE,Engin Phys,0,0,0,0,0,0,1,0,1,2,0,2,1,0,1,0,0,0,4,0,4
wi12,121,REVELLE,ECE,Pr-EngPhys,0,0,0,2,0,2,1,0,1,0,0,0,0,0,0,0,0,0,3,0,3
wi12,121,REVELLE,ECON,Ec-Mth&Ecn,0,0,0,3,2,5,2,1,3,3,2,5,6,3,9,0,0,0,14,8,22
wi12,121,REVELLE,ECON,Econ-MgtSc,0,0,0,6,7,13,5,5,10,18,6,24,34,7,41,0,0,0,63,25,88
wi12,121,REVELLE,ECON,Economics,0,0,0,8,3,11,7,3,10,40,21,61,40,29,69,0,0,0,95,56,151
wi12,121,REVELLE,ESYS,EnvSys(EB),0,0,0,0,0,0,4,3,7,5,15,20,3,4,7,0,0,0,12,22,34
wi12,121,REVELLE,ESYS,EnvSys(EC),0,0,0,0,0,0,0,0,0,0,1,1,0,1,1,0,0,0,0,2,2
wi12,121,REVELLE,ESYS,EnvSys(EP),0,0,0,0,0,0,0,1,1,0,1,1,1,2,3,0,0,0,1,4,5
wi12,121,REVELLE,ESYS,EnvSys(ES),0,0,0,1,1,2,1,0,1,1,0,1,1,1,2,0,0,0,4,2,6
wi12,121,REVELLE,ETHN,Ethnic St,0,0,0,0,0,0,0,1,1,1,1,2,1,4,5,0,0,0,2,6,8
wi12,121,REVELLE,HDP,Human Dev,0,0,0,0,0,0,0,0,0,1,3,4,1,13,14,0,0,0,2,16,18
wi12,121,REVELLE,HDP,Pr-HumnDev,0,0,0,3,1,4,0,4,4,0,6,6,0,1,1,0,0,0,3,12,15
wi12,121,REVELLE,HIST,History,0,0,0,0,1,1,0,1,1,6,3,9,6,10,16,0,0,0,12,15,27
wi12,121,REVELLE,INTD,Rev Ind Mj,0,0,0,0,0,0,0,0,0,0,0,0,1,1,2,0,0,0,1,1,2
wi12,121,REVELLE,INTL,IntSt-Anth,0,0,0,0,0,0,0,0,0,1,0,1,1,0,1,0,0,0,2,0,2
wi12,121,REVELLE,INTL,IntSt-Econ,0,0,0,1,3,4,0,3,3,5,5,10,9,2,11,0,0,0,15,13,28
wi12,121,REVELLE,INTL,IntSt-Hist,0,0,0,0,0,0,0,0,0,0,3,3,0,2,2,0,0,0,0,5,5
wi12,121,REVELLE,INTL,IntSt-Ling,0,0,0,0,1,1,0,1,1,0,1,1,1,0,1,0,0,0,1,3,4
wi12,121,REVELLE,INTL,IntSt-PolS,0,0,0,0,1,1,0,2,2,0,2,2,6,6,12,0,0,0,6,11,17
wi12,121,REVELLE,INTL,IntSt-Soc,0,0,0,0,1,1,0,1,1,0,1,1,0,4,4,0,0,0,0,7,7
wi12,121,REVELLE,JAPN,JapaneseSt,0,0,0,0,0,0,0,0,0,1,0,1,1,1,2,0,0,0,2,1,3
wi12,121,REVELLE,JUDA,Judaic Stu,0,0,0,0,0,0,0,0,0,0,0,0,1,0,1,0,0,0,1,0,1
wi12,121,REVELLE,LING,Lang Stu,0,0,0,0,0,0,0,0,0,1,0,1,0,1,1,0,0,0,1,1,2
wi12,121,REVELLE,LING,Ling-CogLn,0,0,0,1,0,1,0,1,1,1,1,2,1,3,4,0,0,0,3,5,8
wi12,121,REVELLE,LING,Ling-LSoc,0,0,0,0,0,0,0,1,1,0,0,0,0,1,1,0,0,0,0,2,2
wi12,121,REVELLE,LING,Linguistcs,0,0,0,0,0,0,0,1,1,1,2,3,1,1,2,0,0,0,2,4,6
wi12,121,REVELLE,LIT,Ital Lit,0,0,0,0,0,0,0,0,0,0,0,0,0,1,1,0,0,0,0,1,1
wi12,121,REVELLE,LIT,Lit/Compos,0,0,0,0,0,0,0,0,0,1,1,2,1,0,1,0,0,0,2,1,3
wi12,121,REVELLE,LIT,Lit/Engl,0,0,0,0,2,2,0,2,2,1,1,2,1,0,1,0,0,0,2,5,7
wi12,121,REVELLE,LIT,Lit/World,0,0,0,0,0,0,0,0,0,0,0,0,1,1,2,0,0,0,1,1,2
wi12,121,REVELLE,LIT,Lit/Writng,0,0,0,0,0,0,0,2,2,0,6,6,0,4,4,0,0,0,0,12,12
wi12,121,REVELLE,LIT,Pre-Lit/Wr,0,0,0,0,0,0,0,0,0,0,0,0,1,2,3,0,0,0,1,2,3
wi12,121,REVELLE,LIT,Spanish Lt,0,0,0,1,0,1,0,1,1,0,1,1,1,0,1,0,0,0,2,2,4
wi12,121,REVELLE,MAE,Aerosp Eng,0,0,0,1,2,3,5,2,7,8,1,9,15,5,20,0,0,0,29,10,39
wi12,121,REVELLE,MAE,Engin Sci,0,0,0,0,0,0,2,1,3,5,0,5,5,2,7,0,0,0,12,3,15
wi12,121,REVELLE,MAE,Envir Eng,0,0,0,4,3,7,5,6,11,10,0,10,6,3,9,0,0,0,25,12,37
wi12,121,REVELLE,MAE,Mech Engin,0,0,0,5,0,5,8,2,10,13,1,14,41,11,52,0,0,0,67,14,81
wi12,121,REVELLE,MATH,Appld Math,0,0,0,3,0,3,3,0,3,6,3,9,1,3,4,0,0,0,13,6,19
wi12,121,REVELLE,MATH,Math/SecEd,0,0,0,1,0,1,1,0,1,0,0,0,3,2,5,0,0,0,5,2,7
wi12,121,REVELLE,MATH,Mathematcs,0,0,0,5,5,10,1,1,2,4,2,6,6,6,12,0,0,0,16,14,30
wi12,121,REVELLE,MATH,Mth-CompSc,0,0,0,0,0,0,0,0,0,0,0,0,3,2,5,0,0,0,3,2,5
wi12,121,REVELLE,MATH,Mth-Mth&Ec,0,0,0,0,3,3,0,1,1,0,2,2,6,1,7,0,0,0,6,7,13
wi12,121,REVELLE,MATH,Mth-SciCom,0,0,0,0,0,0,0,0,0,0,1,1,0,0,0,0,0,0,0,1,1
wi12,121,REVELLE,MATH,Mth/ApldSc,0,0,0,0,0,0,0,0,0,2,0,2,0,1,1,0,0,0,2,1,3
wi12,121,REVELLE,MATH,Prob&Stats,0,0,0,0,0,0,0,0,0,3,2,5,3,0,3,0,0,0,6,2,8
wi12,121,REVELLE,MUS,Mu-CompArt,0,0,0,0,0,0,0,0,0,3,0,3,5,0,5,0,0,0,8,0,8
wi12,121,REVELLE,MUS,Music,0,0,0,1,0,1,0,0,0,2,0,2,4,2,6,0,0,0,7,2,9
wi12,121,REVELLE,NENG,NanoEng,0,0,0,5,1,6,5,3,8,15,5,20,10,2,12,0,0,0,35,11,46
wi12,121,REVELLE,PHIL,Philosophy,0,0,0,1,0,1,1,1,2,4,0,4,6,1,7,0,0,0,12,2,14
wi12,121,REVELLE,PHYS,Biophysics,0,0,0,1,0,1,1,0,1,3,2,5,2,2,4,0,0,0,7,4,11
wi12,121,REVELLE,PHYS,GenPys/SEd,0,0,0,0,0,0,0,0,0,1,0,1,0,0,0,0,0,0,1,0,1
wi12,121,REVELLE,PHYS,Phy/ErthSc,0,0,0,0,0,0,0,0,0,0,0,0,1,0,1,0,0,0,1,0,1
wi12,121,REVELLE,PHYS,Phys/Astro,0,0,0,0,2,2,2,0,2,1,0,1,3,1,4,0,0,0,6,3,9
wi12,121,REVELLE,PHYS,Phys/Comp,0,0,0,0,0,0,1,0,1,1,0,1,0,0,0,0,0,0,2,0,2
wi12,121,REVELLE,PHYS,Phys/Mtrls,0,0,0,1,0,1,0,1,1,1,0,1,1,0,1,0,0,0,3,1,4
wi12,121,REVELLE,PHYS,Physics,0,0,0,0,3,3,4,1,5,4,0,4,9,2,11,0,0,0,17,6,23
wi12,121,REVELLE,POLI,Polit Sci,0,0,0,0,1,1,1,3,4,1,6,7,14,11,25,0,0,0,16,21,37
wi12,121,REVELLE,POLI,PolSc-Amer,0,0,0,1,0,1,0,1,1,2,2,4,4,4,8,0,0,0,7,7,14
wi12,121,REVELLE,POLI,PolSc-Comp,0,0,0,0,0,0,0,0,0,0,0,0,0,1,1,0,0,0,0,1,1
wi12,121,REVELLE,POLI,PolSc-Intl,0,0,0,0,1,1,1,5,6,3,2,5,6,4,10,0,0,0,10,12,22
wi12,121,REVELLE,POLI,PolSc-PLaw,0,0,0,0,3,3,1,3,4,2,1,3,5,5,10,0,0,0,8,12,20
wi12,121,REVELLE,POLI,PolSc-PPol,0,0,0,0,0,0,1,0,1,1,2,3,0,0,0,0,0,0,2,2,4
wi12,121,REVELLE,POLI,PolSc-Thry,0,0,0,0,0,0,0,0,0,2,1,3,0,0,0,0,0,0,2,1,3
wi12,121,REVELLE,PSYC,Psychology,0,0,0,9,23,32,6,16,22,22,52,74,33,81,114,0,0,0,70,172,242
wi12,121,REVELLE,RELI,Relig/Stu,0,0,0,0,0,0,0,1,1,0,0,0,0,1,1,0,0,0,0,2,2
wi12,121,REVELLE,SE,Engin Sci,0,0,0,1,0,1,0,0,0,0,0,0,0,0,0,0,0,0,1,0,1
wi12,121,REVELLE,SE,Struct Eng,0,0,0,8,1,9,14,2,16,14,6,20,25,8,33,0,0,0,61,17,78
wi12,121,REVELLE,SIO,Earth Sci,0,0,0,0,1,1,0,2,2,1,1,2,2,3,5,0,0,0,3,7,10
wi12,121,REVELLE,SIO,ErSc-Geol,0,0,0,0,0,0,0,0,0,0,0,0,1,0,1,0,0,0,1,0,1
wi12,121,REVELLE,SOC,SocCulCom,0,0,0,0,0,0,0,0,0,0,0,0,0,2,2,0,0,0,0,2,2
wi12,121,REVELLE,SOC,SocEconSoc,0,0,0,0,0,0,0,0,0,0,1,1,1,2,3,0,0,0,1,3,4
wi12,121,REVELLE,SOC,Sociology,0,0,0,1,2,3,0,1,1,3,4,7,3,5,8,0,0,0,7,12,19
wi12,121,REVELLE,SOC,SocLawSoc,0,0,0,0,1,1,1,0,1,0,1,1,1,2,3,0,0,0,2,4,6
wi12,121,REVELLE,SOC,SocSciMed,0,0,0,0,1,1,0,2,2,0,2,2,0,3,3,0,0,0,0,8,8
wi12,121,REVELLE,SOC,SocSolneq,0,0,0,0,0,0,0,1,1,0,0,0,0,0,0,0,0,0,0,1,1
wi12,121,REVELLE,THEA,Dance,0,0,0,0,0,0,0,0,0,0,2,2,0,1,1,0,0,0,0,3,3
wi12,121,REVELLE,THEA,Theatre,0,0,0,0,1,1,0,0,0,1,1,2,1,4,5,0,0,0,2,6,8
wi12,121,REVELLE,TWS,ThirdWldSt,0,0,0,0,0,0,0,0,0,0,1,1,0,1,1,0,0,0,0,2,2
wi12,121,REVELLE,UNAF,Limited St,0,0,0,0,0,0,0,0,0,0,0,0,0,0,0,6,9,15,6,9,15
wi12,121,REVELLE,UNAF,Spec-Emply,0,0,0,0,0,0,0,0,0,0,0,0,0,0,0,1,1,2,1,1,2
wi12,121,REVELLE,UNAF,UndecHumAr,0,0,0,2,0,2,0,1,1,0,1,1,0,0,0,0,0,0,2,2,4
wi12,121,REVELLE,UNAF,Undeclared,0,0,0,23,23,46,11,18,29,1,6,7,0,0,0,0,0,0,35,47,82
wi12,121,REVELLE,UNAF,UndecPhysS,0,0,0,0,2,2,0,2,2,0,0,0,0,0,0,0,0,0,0,4,4
wi12,121,REVELLE,UNAF,UndecSocSc,0,0,0,0,3,3,0,0,0,0,0,0,0,0,0,0,0,0,0,3,3
wi12,121,REVELLE,USP,Urb Stu&Pl,0,0,0,0,0,0,1,1,2,2,0,2,3,2,5,0,0,0,6,3,9
wi12,121,REVELLE,VIS,Art Hst/Cr,0,0,0,0,0,0,0,0,0,0,0,0,0,2,2,0,0,0,0,2,2
wi12,121,REVELLE,VIS,Media,0,0,0,0,0,0,0,1,1,2,3,5,2,4,6,0,0,0,4,8,12
wi12,121,REVELLE,VIS,Studio VA,0,0,0,0,2,2,0,0,0,0,2,2,3,4,7,0,0,0,3,8,11
wi12,121,REVELLE,VIS,VA-CompArt,0,0,0,0,0,0,1,0,1,2,1,3,3,3,6,0,0,0,6,4,10
wi12,121,ROOSEVELT,ANTH,Anth-Arch,0,0,0,0,0,0,1,3,4,0,3,3,0,5,5,0,0,0,1,11,12
wi12,121,ROOSEVELT,ANTH,Anth-Biol,0,0,0,0,1,1,0,0,0,1,3,4,0,6,6,0,0,0,1,10,11
wi12,121,ROOSEVELT,ANTH,Anth-Soci,0,0,0,0,1,1,0,1,1,6,6,12,0,6,6,0,0,0,6,14,20
wi12,121,ROOSEVELT,BENG,Bioen:Binf,0,0,0,1,2,3,1,3,4,4,0,4,0,2,2,0,0,0,6,7,13
wi12,121,ROOSEVELT,BENG,Bioeng:PM,0,0,0,0,0,0,0,0,0,1,0,1,9,4,13,0,0,0,10,4,14
wi12,121,ROOSEVELT,BENG,BioengBiot,0,0,0,0,1,1,3,0,3,2,2,4,15,6,21,0,0,0,20,9,29
wi12,121,ROOSEVELT,BENG,Bioengin,0,0,0,2,1,3,0,4,4,2,0,2,4,7,11,0,0,0,8,12,20
wi12,121,ROOSEVELT,BIOL,Bioc/CellB,0,0,0,2,2,4,10,5,15,4,6,10,16,30,46,0,0,0,32,43,75
wi12,121,ROOSEVELT,BIOL,Ec/Beh/Evo,0,0,0,0,3,3,0,1,1,3,0,3,2,9,11,0,0,0,5,13,18
wi12,121,ROOSEVELT,BIOL,Genl Biol,0,0,0,6,8,14,3,5,8,17,14,31,30,52,82,0,0,0,56,79,135
wi12,121,ROOSEVELT,BIOL,Human Bio,0,0,0,4,16,20,8,23,31,19,21,40,40,73,113,0,0,0,71,133,204
wi12,121,ROOSEVELT,BIOL,Microbiol,0,0,0,0,3,3,0,2,2,0,0,0,2,3,5,0,0,0,2,8,10
wi12,121,ROOSEVELT,BIOL,Molec Biol,0,0,0,1,1,2,2,2,4,0,3,3,4,4,8,0,0,0,7,10,17
wi12,121,ROOSEVELT,BIOL,PhyslNeuro,0,0,0,2,11,13,1,7,8,5,7,12,16,18,34,0,0,0,24,43,67
wi12,121,ROOSEVELT,CENG,Chem Engin,0,0,0,0,1,1,7,4,11,9,2,11,7,3,10,0,0,0,23,10,33
wi12,121,ROOSEVELT,CGS,CritGendSt,0,0,0,0,0,0,0,0,0,0,1,1,0,0,0,0,0,0,0,1,1
wi12,121,ROOSEVELT,CHEM,Bioch/Chem,0,0,0,1,6,7,5,6,11,17,24,41,9,16,25,0,0,0,32,52,84
wi12,121,ROOSEVELT,CHEM,Chem Educ,0,0,0,1,0,1,0,0,0,0,0,0,0,0,0,0,0,0,1,0,1
wi12,121,ROOSEVELT,CHEM,Chemistry,0,0,0,3,2,5,3,1,4,6,4,10,7,2,9,0,0,0,19,9,28
wi12,121,ROOSEVELT,CHEM,Envir Chem,0,0,0,0,0,0,0,0,0,2,0,2,1,1,2,0,0,0,3,1,4
wi12,121,ROOSEVELT,CHEM,MolecSynth,0,0,0,0,0,0,0,0,0,0,1,1,0,1,1,0,0,0,0,2,2
wi12,121,ROOSEVELT,CHEM,Pharm Chem,0,0,0,3,5,8,8,5,13,5,6,11,14,14,28,0,0,0,30,30,60
wi12,121,ROOSEVELT,CHIN,Chinese St,0,0,0,0,1,1,0,2,2,1,2,3,0,1,1,0,0,0,1,6,7
wi12,121,ROOSEVELT,CLAS,Classic St,0,0,0,0,0,0,0,1,1,0,1,1,0,1,1,0,0,0,0,3,3
wi12,121,ROOSEVELT,COGS,Cog Sci,0,0,0,1,3,4,0,3,3,2,5,7,5,7,12,0,0,0,8,18,26
wi12,121,ROOSEVELT,COGS,CogSc/ClAs,0,0,0,0,0,0,0,3,3,1,3,4,0,0,0,0,0,0,1,6,7
wi12,121,ROOSEVELT,COGS,CogSc/Comp,0,0,0,0,0,0,0,0,0,0,0,0,0,1,1,0,0,0,0,1,1
wi12,121,ROOSEVELT,COGS,CogSc/HCI,0,0,0,0,0,0,0,0,0,0,3,3,4,2,6,0,0,0,4,5,9
wi12,121,ROOSEVELT,COGS,CogSc/HCog,0,0,0,1,1,2,1,0,1,1,2,3,1,1,2,0,0,0,4,4,8
wi12,121,ROOSEVELT,COGS,CogSc/Neur,0,0,0,0,2,2,3,4,7,3,16,19,5,12,17,0,0,0,11,34,45
wi12,121,ROOSEVELT,COMM,Communic,0,0,0,3,6,9,2,14,16,9,42,51,26,60,86,0,0,0,40,122,162
wi12,121,ROOSEVELT,CSE,Comp Sci,0,0,0,3,0,3,10,2,12,15,2,17,36,10,46,0,0,0,64,14,78
wi12,121,ROOSEVELT,CSE,CompEngCSE,0,0,0,6,1,7,1,0,1,4,1,5,5,0,5,0,0,0,16,2,18
wi12,121,ROOSEVELT,CSE,CompScBinf,0,0,0,0,0,0,0,0,0,0,1,1,0,1,1,0,0,0,0,2,2
wi12,121,ROOSEVELT,ECE,CompEngECE,0,0,0,2,1,3,1,0,1,1,0,1,2,0,2,0,0,0,6,1,7
wi12,121,ROOSEVELT,ECE,Electr Eng,0,0,0,7,1,8,12,1,13,12,5,17,15,2,17,0,0,0,46,9,55
wi12,121,ROOSEVELT,ECE,Engin Phys,0,0,0,0,0,0,1,0,1,1,0,1,0,0,0,0,0,0,2,0,2
wi12,121,ROOSEVELT,ECON,Ec-Mth&Ecn,0,0,0,0,2,2,3,3,6,4,3,7,7,3,10,0,0,0,14,11,25
wi12,121,ROOSEVELT,ECON,Econ-MgtSc,0,0,0,6,3,9,10,8,18,24,17,41,43,26,69,0,0,0,83,54,137
wi12,121,ROOSEVELT,ECON,Economics,0,0,0,7,6,13,6,11,17,46,35,81,52,43,95,0,0,0,111,95,206
wi12,121,ROOSEVELT,ESYS,EnvSys(EB),0,0,0,1,3,4,1,4,5,2,12,14,4,14,18,0,0,0,8,33,41
wi12,121,ROOSEVELT,ESYS,EnvSys(EC),0,0,0,0,0,0,0,0,0,1,3,4,0,2,2,0,0,0,1,5,6
wi12,121,ROOSEVELT,ESYS,EnvSys(EP),0,0,0,0,0,0,0,0,0,0,0,0,1,3,4,0,0,0,1,3,4
wi12,121,ROOSEVELT,ESYS,EnvSys(ES),0,0,0,0,1,1,0,0,0,0,3,3,1,3,4,0,0,0,1,7,8
wi12,121,ROOSEVELT,ETHN,Ethnic St,0,0,0,0,0,0,0,0,0,0,2,2,1,7,8,0,0,0,1,9,10
wi12,121,ROOSEVELT,HDP,Human Dev,0,0,0,0,0,0,0,2,2,1,6,7,3,20,23,0,0,0,4,28,32
wi12,121,ROOSEVELT,HDP,Pr-HumnDev,0,0,0,0,2,2,0,8,8,0,7,7,0,3,3,0,0,0,0,20,20
wi12,121,ROOSEVELT,HIST,History,0,0,0,1,3,4,5,5,10,14,13,27,10,20,30,0,0,0,30,41,71
wi12,121,ROOSEVELT,INTL,Int-5yrEC,0,0,0,0,0,0,0,0,0,0,0,0,0,1,1,0,0,0,0,1,1
wi12,121,ROOSEVELT,INTL,IntSt-Anth,0,0,0,0,0,0,0,2,2,0,1,1,2,8,10,0,0,0,2,11,13
wi12,121,ROOSEVELT,INTL,IntSt-Econ,0,0,0,2,4,6,6,12,18,5,9,14,10,25,35,0,0,0,23,50,73
wi12,121,ROOSEVELT,INTL,IntSt-Hist,0,0,0,0,0,0,0,1,1,3,6,9,5,11,16,0,0,0,8,18,26
wi12,121,ROOSEVELT,INTL,IntSt-Ling,0,0,0,1,0,1,0,5,5,1,3,4,1,5,6,0,0,0,3,13,16
wi12,121,ROOSEVELT,INTL,IntSt-Lit,0,0,0,0,1,1,0,0,0,0,2,2,0,0,0,0,0,0,0,3,3
wi12,121,ROOSEVELT,INTL,IntSt-PolS,0,0,0,0,7,7,5,8,13,15,21,36,16,53,69,0,0,0,36,89,125
wi12,121,ROOSEVELT,INTL,IntSt-Soc,0,0,0,0,4,4,4,5,9,1,14,15,2,21,23,0,0,0,7,44,51
wi12,121,ROOSEVELT,ITAL,Italian St,0,0,0,1,0,1,0,0,0,0,0,0,0,1,1,0,0,0,1,1,2
wi12,121,ROOSEVELT,JAPN,JapaneseSt,0,0,0,0,0,0,0,0,0,1,1,2,2,1,3,0,0,0,3,2,5
wi12,121,ROOSEVELT,LATI,LatinAm St,0,0,0,0,0,0,0,0,0,0,1,1,1,2,3,0,0,0,1,3,4
wi12,121,ROOSEVELT,LING,Lang Stu,0,0,0,0,1,1,1,1,2,0,1,1,0,1,1,0,0,0,1,4,5
wi12,121,ROOSEVELT,LING,Ling-CogLn,0,0,0,0,0,0,0,2,2,0,1,1,0,0,0,0,0,0,0,3,3
wi12,121,ROOSEVELT,LING,Ling-LSoc,0,0,0,0,0,0,1,0,1,0,2,2,0,4,4,0,0,0,1,6,7
wi12,121,ROOSEVELT,LING,Linguistcs,0,0,0,0,0,0,0,0,0,2,3,5,1,5,6,0,0,0,3,8,11
wi12,121,ROOSEVELT,LIT,Lit/Compos,0,0,0,0,0,0,0,0,0,0,0,0,1,0,1,0,0,0,1,0,1
wi12,121,ROOSEVELT,LIT,Lit/CultSt,0,0,0,0,0,0,0,1,1,1,1,2,0,1,1,0,0,0,1,3,4
wi12,121,ROOSEVELT,LIT,Lit/Engl,0,0,0,0,0,0,0,3,3,1,5,6,3,7,10,0,0,0,4,15,19
wi12,121,ROOSEVELT,LIT,Lit/World,0,0,0,0,1,1,0,1,1,0,0,0,3,4,7,0,0,0,3,6,9
wi12,121,ROOSEVELT,LIT,Lit/Writng,0,0,0,0,2,2,2,5,7,2,8,10,9,15,24,0,0,0,13,30,43
wi12,121,ROOSEVELT,LIT,Pre-Lit/Wr,0,0,0,0,0,0,0,0,0,0,1,1,1,2,3,0,0,0,1,3,4
wi12,121,ROOSEVELT,LIT,Spanish Lt,0,0,0,0,0,0,1,0,1,1,0,1,1,1,2,0,0,0,3,1,4
wi12,121,ROOSEVELT,MAE,Aerosp Eng,0,0,0,1,0,1,3,1,4,3,1,4,17,4,21,0,0,0,24,6,30
wi12,121,ROOSEVELT,MAE,Engin Sci,0,0,0,1,0,1,1,1,2,2,0,2,3,0,3,0,0,0,7,1,8
wi12,121,ROOSEVELT,MAE,Envir Eng,0,0,0,3,2,5,2,1,3,8,2,10,3,2,5,0,0,0,16,7,23
wi12,121,ROOSEVELT,MAE,Mech Engin,0,0,0,3,1,4,2,0,2,9,0,9,34,5,39,0,0,0,48,6,54
wi12,121,ROOSEVELT,MATH,Appld Math,0,0,0,0,0,0,0,1,1,0,1,1,0,1,1,0,0,0,0,3,3
wi12,121,ROOSEVELT,MATH,Math/SecEd,0,0,0,1,0,1,0,0,0,0,1,1,0,1,1,0,0,0,1,2,3
wi12,121,ROOSEVELT,MATH,Mathematcs,0,0,0,0,1,1,3,0,3,5,2,7,1,3,4,0,0,0,9,6,15
wi12,121,ROOSEVELT,MATH,Mth-CompSc,0,0,0,0,0,0,0,0,0,0,0,0,1,0,1,0,0,0,1,0,1
wi12,121,ROOSEVELT,MATH,Mth-Mth&Ec,0,0,0,3,2,5,1,6,7,2,3,5,6,1,7,0,0,0,12,12,24
wi12,121,ROOSEVELT,MATH,Mth/ApldSc,0,0,0,0,1,1,0,0,0,0,0,0,0,0,0,0,0,0,0,1,1
wi12,121,ROOSEVELT,MATH,Pr-Math CS,0,0,0,0,0,0,0,0,0,0,0,0,0,1,1,0,0,0,0,1,1
wi12,121,ROOSEVELT,MATH,Prob&Stats,0,0,0,0,1,1,0,0,0,0,1,1,0,1,1,0,0,0,0,3,3
wi12,121,ROOSEVELT,MUS,Mu-CompArt,0,0,0,0,0,0,0,1,1,1,0,1,0,0,0,0,0,0,1,1,2
wi12,121,ROOSEVELT,MUS,Music,0,0,0,0,0,0,0,0,0,1,1,2,2,3,5,0,0,0,3,4,7
wi12,121,ROOSEVELT,NENG,NanoEng,0,0,0,1,1,2,7,2,9,6,2,8,5,1,6,0,0,0,19,6,25
wi12,121,ROOSEVELT,PHIL,Philosophy,0,0,0,0,0,0,1,0,1,6,2,8,3,2,5,0,0,0,10,4,14
wi12,121,ROOSEVELT,PHYS,Biophysics,0,0,0,0,0,0,0,1,1,0,1,1,1,1,2,0,0,0,1,3,4
wi12,121,ROOSEVELT,PHYS,Phy/ErthSc,0,0,0,0,0,0,0,0,0,0,0,0,0,1,1,0,0,0,0,1,1
wi12,121,ROOSEVELT,PHYS,Phys/Astro,0,0,0,0,0,0,0,0,0,0,1,1,1,0,1,0,0,0,1,1,2
wi12,121,ROOSEVELT,PHYS,Phys/Mtrls,0,0,0,0,0,0,0,1,1,0,0,0,0,0,0,0,0,0,0,1,1
wi12,121,ROOSEVELT,PHYS,Physics,0,0,0,0,0,0,2,1,3,0,0,0,3,0,3,0,0,0,5,1,6
wi12,121,ROOSEVELT,POLI,Polit Sci,0,0,0,3,6,9,6,8,14,21,15,36,34,27,61,0,0,0,64,56,120
wi12,121,ROOSEVELT,POLI,PolSc-Amer,0,0,0,1,0,1,0,1,1,3,4,7,6,5,11,0,0,0,10,10,20
wi12,121,ROOSEVELT,POLI,PolSc-Comp,0,0,0,0,0,0,0,0,0,0,0,0,4,3,7,0,0,0,4,3,7
wi12,121,ROOSEVELT,POLI,PolSc-Intl,0,0,0,0,1,1,3,6,9,20,25,45,20,21,41,0,0,0,43,53,96
wi12,121,ROOSEVELT,POLI,PolSc-PLaw,0,0,0,4,1,5,1,4,5,7,9,16,8,3,11,0,0,0,20,17,37
wi12,121,ROOSEVELT,POLI,PolSc-PPol,0,0,0,0,0,0,0,0,0,0,1,1,1,0,1,0,0,0,1,1,2
wi12,121,ROOSEVELT,POLI,PolSc-Thry,0,0,0,0,0,0,0,1,1,1,0,1,1,0,1,0,0,0,2,1,3
wi12,121,ROOSEVELT,PSYC,Psychology,0,0,0,5,12,17,8,28,36,26,53,79,40,106,146,0,0,0,79,199,278
wi12,121,ROOSEVELT,RELI,Relig/Stu,0,0,0,0,0,0,0,0,0,0,3,3,0,1,1,0,0,0,0,4,4
wi12,121,ROOSEVELT,SE,Engin Sci,0,0,0,0,0,0,0,0,0,2,0,2,0,0,0,0,0,0,2,0,2
wi12,121,ROOSEVELT,SE,Struct Eng,0,0,0,2,3,5,3,3,6,11,3,14,28,5,33,0,0,0,44,14,58
wi12,121,ROOSEVELT,SIO,Earth Sci,0,0,0,0,1,1,0,0,0,0,0,0,0,1,1,0,0,0,0,2,2
wi12,121,ROOSEVELT,SIO,ErSc-Geol,0,0,0,0,0,0,0,1,1,0,0,0,0,0,0,0,0,0,0,1,1
wi12,121,ROOSEVELT,SOC,SocAmSt,0,0,0,0,0,0,0,0,0,0,1,1,0,1,1,0,0,0,0,2,2
wi12,121,ROOSEVELT,SOC,SocCulCom,0,0,0,0,0,0,0,0,0,0,2,2,2,2,4,0,0,0,2,4,6
wi12,121,ROOSEVELT,SOC,SocEconSoc,0,0,0,0,0,0,0,0,0,1,1,2,0,0,0,0,0,0,1,1,2
wi12,121,ROOSEVELT,SOC,SocIntlStu,0,0,0,0,0,0,0,0,0,1,0,1,2,2,4,0,0,0,3,2,5
wi12,121,ROOSEVELT,SOC,Sociology,0,0,0,1,5,6,3,3,6,6,14,20,6,26,32,0,0,0,16,48,64
wi12,121,ROOSEVELT,SOC,SocLawSoc,0,0,0,0,1,1,0,2,2,0,1,1,3,2,5,0,0,0,3,6,9
wi12,121,ROOSEVELT,SOC,SocSciMed,0,0,0,0,1,1,0,1,1,1,1,2,1,2,3,0,0,0,2,5,7
wi12,121,ROOSEVELT,SOC,SocSolneq,0,0,0,0,0,0,0,0,0,0,1,1,0,2,2,0,0,0,0,3,3
wi12,121,ROOSEVELT,THEA,Dance,0,0,0,0,0,0,0,0,0,0,0,0,0,1,1,0,0,0,0,1,1
wi12,121,ROOSEVELT,THEA,Theatre,0,0,0,0,1,1,1,3,4,2,5,7,5,9,14,0,0,0,8,18,26
wi12,121,ROOSEVELT,TWS,ThirdWldSt,0,0,0,0,0,0,1,0,1,0,2,2,0,1,1,0,0,0,1,3,4
wi12,121,ROOSEVELT,UNAF,UndecHumAr,0,0,0,1,5,6,0,2,2,0,0,0,0,0,0,0,0,0,1,7,8
wi12,121,ROOSEVELT,UNAF,Undeclared,0,0,0,18,27,45,18,28,46,1,2,3,0,0,0,0,0,0,37,57,94
wi12,121,ROOSEVELT,UNAF,UndecPhysS,0,0,0,4,2,6,1,2,3,0,0,0,0,0,0,0,0,0,5,4,9
wi12,121,ROOSEVELT,UNAF,UndecSocSc,0,0,0,2,7,9,1,2,3,0,0,0,0,0,0,0,0,0,3,9,12
wi12,121,ROOSEVELT,USP,Urb Stu&Pl,0,0,0,0,1,1,1,3,4,3,8,11,10,15,25,0,0,0,14,27,41
wi12,121,ROOSEVELT,VIS,Art Hst/Cr,0,0,0,0,0,0,0,0,0,0,2,2,2,3,5,0,0,0,2,5,7
wi12,121,ROOSEVELT,VIS,Media,0,0,0,0,0,0,2,2,4,1,5,6,9,13,22,0,0,0,12,20,32
wi12,121,ROOSEVELT,VIS,Studio VA,0,0,0,1,0,1,0,1,1,1,2,3,2,4,6,0,0,0,4,7,11
wi12,121,ROOSEVELT,VIS,VA-CompArt,0,0,0,0,0,0,1,0,1,2,0,2,1,4,5,0,0,0,4,4,8
wi12,121,SIXTH,ANTH,Anth-Arch,0,0,0,0,0,0,0,1,1,0,1,1,1,3,4,0,0,0,1,5,6
wi12,121,SIXTH,ANTH,Anth-Biol,0,0,0,0,0,0,0,2,2,2,4,6,2,7,9,0,0,0,4,13,17
wi12,121,SIXTH,ANTH,Anth-Soci,0,0,0,0,2,2,0,0,0,0,5,5,0,5,5,0,0,0,0,12,12
wi12,121,SIXTH,BENG,Bioen:Binf,0,0,0,1,1,2,2,1,3,3,1,4,4,1,5,0,0,0,10,4,14
wi12,121,SIXTH,BENG,Bioeng:PM,0,0,0,0,0,0,0,0,0,1,0,1,11,1,12,0,0,0,12,1,13
wi12,121,SIXTH,BENG,BioengBiot,0,0,0,3,1,4,4,1,5,6,2,8,14,5,19,0,0,0,27,9,36
wi12,121,SIXTH,BENG,Bioengin,0,0,0,0,0,0,4,4,8,6,1,7,7,3,10,0,0,0,17,8,25
wi12,121,SIXTH,BIOL,Bioc/CellB,0,0,0,7,10,17,5,10,15,6,12,18,32,30,62,0,0,0,50,62,112
wi12,121,SIXTH,BIOL,Ec/Beh/Evo,0,0,0,0,0,0,0,2,2,2,1,3,2,4,6,0,0,0,4,7,11
wi12,121,SIXTH,BIOL,Genl Biol,0,0,0,2,6,8,2,9,11,8,8,16,24,38,62,0,0,0,36,61,97
wi12,121,SIXTH,BIOL,Human Bio,0,0,0,6,13,19,10,10,20,19,17,36,44,38,82,0,0,0,79,78,157
wi12,121,SIXTH,BIOL,Microbiol,0,0,0,1,0,1,0,2,2,1,1,2,3,3,6,0,0,0,5,6,11
wi12,121,SIXTH,BIOL,Molec Biol,0,0,0,1,0,1,1,2,3,3,2,5,6,3,9,0,0,0,11,7,18
wi12,121,SIXTH,BIOL,PhyslNeuro,0,0,0,1,2,3,5,7,12,7,8,15,14,20,34,0,0,0,27,37,64
wi12,121,SIXTH,CENG,Chem Engin,0,0,0,4,1,5,2,3,5,11,5,16,18,0,18,0,0,0,35,9,44
wi12,121,SIXTH,CGS,CritGendSt,0,0,0,0,0,0,0,0,0,1,1,2,0,0,0,0,0,0,1,1,2
wi12,121,SIXTH,CHEM,Bioch/Chem,0,0,0,3,7,10,9,12,21,26,14,40,17,12,29,0,0,0,55,45,100
wi12,121,SIXTH,CHEM,Bioinform,0,0,0,0,0,0,1,0,1,1,0,1,0,0,0,0,0,0,2,0,2
wi12,121,SIXTH,CHEM,Chemistry,0,0,0,2,4,6,2,3,5,4,6,10,5,4,9,0,0,0,13,17,30
wi12,121,SIXTH,CHEM,Envir Chem,0,0,0,0,0,0,0,1,1,0,1,1,0,2,2,0,0,0,0,4,4
wi12,121,SIXTH,CHEM,MolecSynth,0,0,0,0,0,0,1,0,1,1,0,1,0,1,1,0,0,0,2,1,3
wi12,121,SIXTH,CHEM,Pharm Chem,0,0,0,4,6,10,15,6,21,13,17,30,9,13,22,0,0,0,41,42,83
wi12,121,SIXTH,CHIN,Chinese St,0,0,0,0,0,0,0,0,0,1,1,2,0,0,0,0,0,0,1,1,2
wi12,121,SIXTH,CLAS,Classic St,0,0,0,0,0,0,0,0,0,0,0,0,0,1,1,0,0,0,0,1,1
wi12,121,SIXTH,COGS,Cog Sci,0,0,0,0,1,1,2,3,5,6,6,12,7,2,9,0,0,0,15,12,27
wi12,121,SIXTH,COGS,CogSc/ClAs,0,0,0,0,0,0,0,1,1,0,1,1,0,3,3,0,0,0,0,5,5
wi12,121,SIXTH,COGS,CogSc/Comp,0,0,0,0,0,0,0,1,1,2,0,2,1,1,2,0,0,0,3,2,5
wi12,121,SIXTH,COGS,CogSc/HCI,0,0,0,0,0,0,1,0,1,2,3,5,4,3,7,0,0,0,7,6,13
wi12,121,SIXTH,COGS,CogSc/HCog,0,0,0,0,0,0,0,0,0,1,1,2,1,0,1,0,0,0,2,1,3
wi12,121,SIXTH,COGS,CogSc/Neur,0,0,0,1,2,3,2,3,5,10,11,21,6,12,18,0,0,0,19,28,47
wi12,121,SIXTH,COMM,Communic,0,0,0,2,12,14,6,22,28,15,51,66,25,46,71,0,0,0,48,131,179
wi12,121,SIXTH,CSE,Comp Sci,0,0,0,19,5,24,32,8,40,48,13,61,73,15,88,0,0,0,172,41,213
wi12,121,SIXTH,CSE,CompEngCSE,0,0,0,4,4,8,8,3,11,9,0,9,14,0,14,0,0,0,35,7,42
wi12,121,SIXTH,CSE,CompScBinf,0,0,0,1,1,2,1,1,2,1,0,1,5,0,5,0,0,0,8,2,10
wi12,121,SIXTH,ECE,CompEngECE,0,0,0,4,0,4,3,0,3,1,0,1,4,0,4,0,0,0,12,0,12
wi12,121,SIXTH,ECE,Electr Eng,0,0,0,13,2,15,10,2,12,21,2,23,43,3,46,0,0,0,87,9,96
wi12,121,SIXTH,ECE,Engin Phys,0,0,0,0,0,0,0,0,0,0,0,0,1,1,2,0,0,0,1,1,2
wi12,121,SIXTH,ECE,Pr-EngPhys,0,0,0,1,0,1,0,0,0,1,0,1,0,0,0,0,0,0,2,0,2
wi12,121,SIXTH,ECON,Ec-Mth&Ecn,0,0,0,0,1,1,1,1,2,5,1,6,4,2,6,0,0,0,10,5,15
wi12,121,SIXTH,ECON,Econ-MgtSc,0,0,0,4,4,8,20,16,36,19,21,40,39,29,68,0,0,0,82,70,152
wi12,121,SIXTH,ECON,Economics,0,0,0,7,2,9,7,11,18,47,26,73,73,31,104,0,0,0,134,70,204
wi12,121,SIXTH,ESYS,EnvSys(EB),0,0,0,0,2,2,0,2,2,4,14,18,3,11,14,0,0,0,7,29,36
wi12,121,SIXTH,ESYS,EnvSys(EC),0,0,0,0,0,0,1,2,3,3,0,3,0,0,0,0,0,0,4,2,6
wi12,121,SIXTH,ESYS,EnvSys(EP),0,0,0,0,1,1,1,4,5,1,4,5,0,1,1,0,0,0,2,10,12
wi12,121,SIXTH,ESYS,EnvSys(ES),0,0,0,0,0,0,0,1,1,0,0,0,2,2,4,0,0,0,2,3,5
wi12,121,SIXTH,ETHN,Ethnic St,0,0,0,0,0,0,1,1,2,1,2,3,3,4,7,0,0,0,5,7,12
wi12,121,SIXTH,HDP,Human Dev,0,0,0,0,0,0,0,1,1,1,7,8,1,21,22,0,0,0,2,29,31
wi12,121,SIXTH,HDP,Pr-HumnDev,0,0,0,1,1,2,0,7,7,3,5,8,0,3,3,0,0,0,4,16,20
wi12,121,SIXTH,HIST,History,0,0,0,1,1,2,4,3,7,6,5,11,6,4,10,0,0,0,17,13,30
wi12,121,SIXTH,INTL,Int-5yrEC,0,0,0,0,0,0,0,0,0,0,0,0,2,0,2,0,0,0,2,0,2
wi12,121,SIXTH,INTL,IntSt-Anth,0,0,0,0,0,0,1,1,2,0,1,1,1,2,3,0,0,0,2,4,6
wi12,121,SIXTH,INTL,IntSt-Econ,0,0,0,0,1,1,3,4,7,4,6,10,4,14,18,0,0,0,11,25,36
wi12,121,SIXTH,INTL,IntSt-Hist,0,0,0,1,0,1,0,1,1,0,0,0,1,3,4,0,0,0,2,4,6
wi12,121,SIXTH,INTL,IntSt-Ling,0,0,0,0,0,0,0,0,0,1,5,6,1,0,1,0,0,0,2,5,7
wi12,121,SIXTH,INTL,IntSt-PolS,0,0,0,0,2,2,0,1,1,6,8,14,6,12,18,0,0,0,12,23,35
wi12,121,SIXTH,INTL,IntSt-Soc,0,0,0,0,1,1,1,1,2,0,4,4,0,5,5,0,0,0,1,11,12
wi12,121,SIXTH,ITAL,Italian St,0,0,0,0,0,0,0,0,0,0,0,0,0,2,2,0,0,0,0,2,2
wi12,121,SIXTH,JAPN,JapaneseSt,0,0,0,0,0,0,0,0,0,1,1,2,0,1,1,0,0,0,1,2,3
wi12,121,SIXTH,LING,Lang Stu,0,0,0,0,0,0,0,1,1,0,1,1,1,1,2,0,0,0,1,3,4
wi12,121,SIXTH,LING,Ling-CogLn,0,0,0,0,0,0,0,2,2,1,0,1,2,0,2,0,0,0,3,2,5
wi12,121,SIXTH,LING,Ling-LSoc,0,0,0,0,0,0,0,2,2,0,0,0,0,1,1,0,0,0,0,3,3
wi12,121,SIXTH,LING,Linguistcs,0,0,0,0,0,0,0,0,0,0,2,2,2,4,6,0,0,0,2,6,8
wi12,121,SIXTH,LIT,French Lit,0,0,0,0,0,0,0,0,0,0,0,0,1,1,2,0,0,0,1,1,2
wi12,121,SIXTH,LIT,Lit/CultSt,0,0,0,1,0,1,0,0,0,0,0,0,0,0,0,0,0,0,1,0,1
wi12,121,SIXTH,LIT,Lit/Engl,0,0,0,1,2,3,0,0,0,0,3,3,2,1,3,0,0,0,3,6,9
wi12,121,SIXTH,LIT,Lit/World,0,0,0,0,0,0,0,0,0,0,1,1,0,2,2,0,0,0,0,3,3
wi12,121,SIXTH,LIT,Lit/Writng,0,0,0,0,0,0,0,2,2,1,5,6,4,13,17,0,0,0,5,20,25
wi12,121,SIXTH,LIT,Pre-Lit/Wr,0,0,0,0,0,0,0,0,0,0,1,1,0,0,0,0,0,0,0,1,1
wi12,121,SIXTH,LIT,Spanish Lt,0,0,0,0,0,0,0,0,0,0,0,0,0,1,1,0,0,0,0,1,1
wi12,121,SIXTH,MAE,Aerosp Eng,0,0,0,4,2,6,8,1,9,10,3,13,31,4,35,0,0,0,53,10,63
wi12,121,SIXTH,MAE,Engin Sci,0,0,0,1,0,1,3,0,3,3,0,3,5,0,5,0,0,0,12,0,12
wi12,121,SIXTH,MAE,Envir Eng,0,0,0,1,2,3,10,6,16,3,4,7,8,7,15,0,0,0,22,19,41
wi12,121,SIXTH,MAE,Mech Engin,0,0,0,5,2,7,13,2,15,13,2,15,66,9,75,0,0,0,97,15,112
wi12,121,SIXTH,MATH,Appld Math,0,0,0,3,1,4,1,1,2,3,0,3,1,2,3,0,0,0,8,4,12
wi12,121,SIXTH,MATH,Math/SecEd,0,0,0,0,0,0,0,0,0,0,1,1,0,2,2,0,0,0,0,3,3
wi12,121,SIXTH,MATH,Mathematcs,0,0,0,2,2,4,2,0,2,3,1,4,8,6,14,0,0,0,15,9,24
wi12,121,SIXTH,MATH,Mth-CompSc,0,0,0,0,0,0,0,1,1,0,1,1,1,0,1,0,0,0,1,2,3
wi12,121,SIXTH,MATH,Mth-Mth&Ec,0,0,0,1,1,2,2,1,3,4,1,5,2,3,5,0,0,0,9,6,15
wi12,121,SIXTH,MATH,Mth-SciCom,0,0,0,0,0,0,0,0,0,1,0,1,0,1,1,0,0,0,1,1,2
wi12,121,SIXTH,MATH,Mth/ApldSc,0,0,0,0,0,0,1,0,1,0,0,0,1,0,1,0,0,0,2,0,2
wi12,121,SIXTH,MATH,Pr-Math CS,0,0,0,0,0,0,3,0,3,1,0,1,0,0,0,0,0,0,4,0,4
wi12,121,SIXTH,MATH,Prob&Stats,0,0,0,0,0,0,0,0,0,2,2,4,1,1,2,0,0,0,3,3,6
wi12,121,SIXTH,MUS,Mu-CompArt,0,0,0,0,0,0,2,0,2,10,2,12,13,1,14,0,0,0,25,3,28
wi12,121,SIXTH,MUS,Music,0,0,0,1,2,3,2,0,2,4,4,8,9,2,11,0,0,0,16,8,24
wi12,121,SIXTH,MUS,Music Hum,0,0,0,0,0,0,0,0,0,0,1,1,0,1,1,0,0,0,0,2,2
wi12,121,SIXTH,NENG,NanoEng,0,0,0,5,1,6,5,0,5,10,1,11,5,1,6,0,0,0,25,3,28
wi12,121,SIXTH,PHIL,Philosophy,0,0,0,0,0,0,0,0,0,2,2,4,5,1,6,0,0,0,7,3,10
wi12,121,SIXTH,PHYS,Biophysics,0,0,0,0,0,0,1,0,1,3,0,3,3,0,3,0,0,0,7,0,7
wi12,121,SIXTH,PHYS,Gen Physcs,0,0,0,1,0,1,0,0,0,0,0,0,0,0,0,0,0,0,1,0,1
wi12,121,SIXTH,PHYS,Phys/Astro,0,0,0,0,0,0,0,1,1,0,0,0,1,0,1,0,0,0,1,1,2
wi12,121,SIXTH,PHYS,Phys/Mtrls,0,0,0,0,0,0,0,0,0,1,0,1,0,0,0,0,0,0,1,0,1
wi12,121,SIXTH,PHYS,Physics,0,0,0,1,0,1,0,0,0,3,0,3,10,1,11,0,0,0,14,1,15
wi12,121,SIXTH,POLI,Polit Sci,0,0,0,0,0,0,4,3,7,9,10,19,16,6,22,0,0,0,29,19,48
wi12,121,SIXTH,POLI,PolSc-Amer,0,0,0,1,1,2,0,0,0,0,1,1,4,3,7,0,0,0,5,5,10
wi12,121,SIXTH,POLI,PolSc-Comp,0,0,0,0,0,0,0,0,0,0,1,1,0,0,0,0,0,0,0,1,1
wi12,121,SIXTH,POLI,PolSc-Intl,0,0,0,0,2,2,3,3,6,6,6,12,7,5,12,0,0,0,16,16,32
wi12,121,SIXTH,POLI,PolSc-PLaw,0,0,0,2,2,4,3,0,3,4,2,6,3,5,8,0,0,0,12,9,21
wi12,121,SIXTH,POLI,PolSc-PPol,0,0,0,0,0,0,1,0,1,1,0,1,1,0,1,0,0,0,3,0,3
wi12,121,SIXTH,POLI,PolSc-Thry,0,0,0,0,0,0,0,0,0,1,0,1,1,1,2,0,0,0,2,1,3
wi12,121,SIXTH,PSYC,Psychology,0,0,0,6,15,21,13,19,32,26,35,61,34,48,82,0,0,0,79,117,196
wi12,121,SIXTH,RUSS,Russ&SovSt,0,0,0,0,0,0,0,0,0,0,0,0,0,1,1,0,0,0,0,1,1
wi12,121,SIXTH,SE,Engin Sci,0,0,0,0,0,0,0,2,2,1,0,1,0,0,0,0,0,0,1,2,3
wi12,121,SIXTH,SE,Struct Eng,0,0,0,7,6,13,13,1,14,25,3,28,29,12,41,0,0,0,74,22,96
wi12,121,SIXTH,SIO,Earth Sci,0,0,0,1,0,1,0,0,0,0,2,2,3,0,3,0,0,0,4,2,6
wi12,121,SIXTH,SIO,ErSc-Geoph,0,0,0,0,0,0,0,0,0,0,0,0,0,1,1,0,0,0,0,1,1
wi12,121,SIXTH,SOC,SocCulCom,0,0,0,0,0,0,0,0,0,0,3,3,0,3,3,0,0,0,0,6,6
wi12,121,SIXTH,SOC,SocEconSoc,0,0,0,0,0,0,0,0,0,1,0,1,2,2,4,0,0,0,3,2,5
wi12,121,SIXTH,SOC,SocIntlStu,0,0,0,0,1,1,0,0,0,0,1,1,0,2,2,0,0,0,0,4,4
wi12,121,SIXTH,SOC,Sociology,0,0,0,0,1,1,0,4,4,5,9,14,5,6,11,0,0,0,10,20,30
wi12,121,SIXTH,SOC,SocLawSoc,0,0,0,0,0,0,0,1,1,1,2,3,0,3,3,0,0,0,1,6,7
wi12,121,SIXTH,SOC,SocSciMed,0,0,0,0,0,0,0,0,0,3,2,5,0,2,2,0,0,0,3,4,7
wi12,121,SIXTH,SOC,SocSolneq,0,0,0,0,0,0,0,1,1,0,1,1,0,0,0,0,0,0,0,2,2
wi12,121,SIXTH,THEA,Dance,0,0,0,0,0,0,1,0,1,0,0,0,0,1,1,0,0,0,1,1,2
wi12,121,SIXTH,THEA,Theatre,0,0,0,2,0,2,0,4,4,0,6,6,5,6,11,0,0,0,7,16,23
wi12,121,SIXTH,TWS,ThirdWldSt,0,0,0,0,1,1,0,0,0,0,1,1,0,0,0,0,0,0,0,2,2
wi12,121,SIXTH,UNAF,UndecHumAr,0,0,0,0,2,2,0,0,0,0,1,1,0,0,0,0,0,0,0,3,3
wi12,121,SIXTH,UNAF,Undeclared,0,0,0,18,21,39,8,15,23,5,2,7,0,0,0,0,0,0,31,38,69
wi12,121,SIXTH,UNAF,UndecPhysS,0,0,0,1,2,3,3,1,4,0,0,0,0,0,0,0,0,0,4,3,7
wi12,121,SIXTH,UNAF,UndecSocSc,0,0,0,0,1,1,0,0,0,0,0,0,0,0,0,0,0,0,0,1,1
wi12,121,SIXTH,USP,Urb Stu&Pl,0,0,0,0,1,1,0,4,4,7,4,11,2,6,8,0,0,0,9,15,24
wi12,121,SIXTH,VIS,Art Hst/Cr,0,0,0,0,1,1,0,2,2,1,3,4,1,8,9,0,0,0,2,14,16
wi12,121,SIXTH,VIS,Media,0,0,0,2,7,9,5,2,7,8,13,21,19,25,44,0,0,0,34,47,81
wi12,121,SIXTH,VIS,Studio VA,0,0,0,2,3,5,2,4,6,2,9,11,7,5,12,0,0,0,13,21,34
wi12,121,SIXTH,VIS,VA-CompArt,0,0,0,0,3,3,2,2,4,5,2,7,9,8,17,0,0,0,16,15,31
wi12,121,WARREN,ANTH,Anth-Arch,0,0,0,0,0,0,0,0,0,0,0,0,2,1,3,0,0,0,2,1,3
wi12,121,WARREN,ANTH,Anth-Biol,0,0,0,0,0,0,0,0,0,1,3,4,0,1,1,0,0,0,1,4,5
wi12,121,WARREN,ANTH,Anth-Soci,0,0,0,0,1,1,0,1,1,1,5,6,1,2,3,0,0,0,2,9,11
wi12,121,WARREN,BENG,Bioen:Binf,0,0,0,1,0,1,1,8,9,2,3,5,3,0,3,0,0,0,7,11,18
wi12,121,WARREN,BENG,Bioeng:PM,0,0,0,0,0,0,0,0,0,1,1,2,18,6,24,0,0,0,19,7,26
wi12,121,WARREN,BENG,BioengBiot,0,0,0,2,1,3,8,10,18,8,9,17,40,19,59,0,0,0,58,39,97
wi12,121,WARREN,BENG,Bioengin,0,0,0,4,2,6,13,3,16,11,6,17,25,10,35,0,0,0,53,21,74
wi12,121,WARREN,BIOL,Bioc/CellB,0,0,0,3,5,8,5,7,12,11,11,22,41,43,84,0,0,0,60,66,126
wi12,121,WARREN,BIOL,BiolBioinf,0,0,0,0,0,0,0,0,0,0,1,1,0,0,0,0,0,0,0,1,1
wi12,121,WARREN,BIOL,Ec/Beh/Evo,0,0,0,0,1,1,2,1,3,2,1,3,8,6,14,0,0,0,12,9,21
wi12,121,WARREN,BIOL,Genl Biol,0,0,0,1,1,2,6,6,12,13,15,28,34,57,91,0,0,0,54,79,133
wi12,121,WARREN,BIOL,Human Bio,0,0,0,7,15,22,8,14,22,20,27,47,48,62,110,0,0,0,83,118,201
wi12,121,WARREN,BIOL,Microbiol,0,0,0,1,0,1,0,1,1,5,2,7,4,6,10,0,0,0,10,9,19
wi12,121,WARREN,BIOL,Molec Biol,0,0,0,0,0,0,3,0,3,3,1,4,7,5,12,0,0,0,13,6,19
wi12,121,WARREN,BIOL,PhyslNeuro,0,0,0,3,6,9,3,11,14,5,4,9,33,22,55,0,0,0,44,43,87
wi12,121,WARREN,CENG,Chem Engin,0,0,0,2,3,5,15,8,23,21,11,32,35,10,45,0,0,0,73,32,105
wi12,121,WARREN,CGS,CritGendSt,0,0,0,1,0,1,0,0,0,0,0,0,0,1,1,0,0,0,1,1,2
wi12,121,WARREN,CHEM,Bioch/Chem,0,0,0,2,6,8,16,10,26,22,22,44,23,15,38,0,0,0,63,53,116
wi12,121,WARREN,CHEM,Chemistry,0,0,0,0,2,2,4,5,9,5,6,11,8,8,16,0,0,0,17,21,38
wi12,121,WARREN,CHEM,MolecSynth,0,0,0,0,0,0,1,0,1,0,0,0,1,1,2,0,0,0,2,1,3
wi12,121,WARREN,CHEM,Pharm Chem,0,0,0,2,4,6,5,12,17,17,17,34,14,16,30,0,0,0,38,49,87
wi12,121,WARREN,CHIN,Chinese St,0,0,0,0,0,0,0,0,0,0,0,0,1,1,2,0,0,0,1,1,2
wi12,121,WARREN,COGS,Cog Sci,0,0,0,1,2,3,3,4,7,4,5,9,1,5,6,0,0,0,9,16,25
wi12,121,WARREN,COGS,CogSc/ClAs,0,0,0,0,1,1,0,1,1,1,1,2,1,3,4,0,0,0,2,6,8
wi12,121,WARREN,COGS,CogSc/Comp,0,0,0,0,1,1,1,0,1,0,0,0,2,0,2,0,0,0,3,1,4
wi12,121,WARREN,COGS,CogSc/HCI,0,0,0,0,1,1,1,0,1,3,2,5,5,6,11,0,0,0,9,9,18
wi12,121,WARREN,COGS,CogSc/HCog,0,0,0,0,0,0,0,2,2,1,2,3,1,3,4,0,0,0,2,7,9
wi12,121,WARREN,COGS,CogSc/Neur,0,0,0,0,2,2,1,6,7,4,12,16,9,12,21,0,0,0,14,32,46
wi12,121,WARREN,COMM,Communic,0,0,0,2,4,6,2,8,10,5,27,32,17,27,44,0,0,0,26,66,92
wi12,121,WARREN,CSE,Comp Sci,0,0,0,16,1,17,39,8,47,72,17,89,87,20,107,0,0,0,214,46,260
wi12,121,WARREN,CSE,CompEngCSE,0,0,0,14,1,15,9,4,13,24,2,26,22,2,24,0,0,0,69,9,78
wi12,121,WARREN,CSE,CompScBinf,0,0,0,0,0,0,3,0,3,2,1,3,4,4,8,0,0,0,9,5,14
wi12,121,WARREN,ECE,CompEngECE,0,0,0,5,3,8,3,0,3,8,0,8,3,0,3,0,0,0,19,3,22
wi12,121,WARREN,ECE,Electr Eng,0,0,0,16,2,18,23,2,25,48,5,53,53,7,60,0,0,0,140,16,156
wi12,121,WARREN,ECE,Engin Phys,0,0,0,1,0,1,0,0,0,0,0,0,4,0,4,0,0,0,5,0,5
wi12,121,WARREN,ECE,Pr-EngPhys,0,0,0,0,0,0,0,0,0,0,0,0,2,0,2,0,0,0,2,0,2
wi12,121,WARREN,ECON,Ec-Mth&Ecn,0,0,0,2,5,7,2,2,4,1,2,3,11,3,14,0,0,0,16,12,28
wi12,121,WARREN,ECON,Econ-MgtSc,0,0,0,4,3,7,14,8,22,20,18,38,32,18,50,0,0,0,70,47,117
wi12,121,WARREN,ECON,Economics,0,0,0,3,8,11,10,7,17,62,34,96,70,33,103,0,0,0,145,82,227
wi12,121,WARREN,ESYS,EnvSys(EB),0,0,0,0,0,0,0,4,4,2,6,8,2,8,10,0,0,0,4,18,22
wi12,121,WARREN,ESYS,EnvSys(EC),0,0,0,0,0,0,0,0,0,0,0,0,0,1,1,0,0,0,0,1,1
wi12,121,WARREN,ESYS,EnvSys(EP),0,0,0,0,1,1,1,0,1,0,1,1,1,1,2,0,0,0,2,3,5
wi12,121,WARREN,ESYS,EnvSys(ES),0,0,0,1,1,2,0,0,0,0,0,0,2,0,2,0,0,0,3,1,4
wi12,121,WARREN,ETHN,Ethnic St,0,0,0,1,0,1,0,1,1,0,1,1,1,4,5,0,0,0,2,6,8
wi12,121,WARREN,HDP,Human Dev,0,0,0,0,0,0,0,1,1,0,7,7,0,14,14,0,0,0,0,22,22
wi12,121,WARREN,HDP,Pr-HumnDev,0,0,0,1,2,3,0,2,2,0,6,6,1,2,3,0,0,0,2,12,14
wi12,121,WARREN,HIST,History,0,0,0,1,1,2,0,1,1,11,3,14,16,5,21,0,0,0,28,10,38
wi12,121,WARREN,INTD,Wa Ind St,0,0,0,0,0,0,0,0,0,0,0,0,0,1,1,0,0,0,0,1,1
wi12,121,WARREN,INTL,IntSt-Econ,0,0,0,0,2,2,0,3,3,2,7,9,11,7,18,0,0,0,13,19,32
wi12,121,WARREN,INTL,IntSt-Hist,0,0,0,0,0,0,1,1,2,0,0,0,1,1,2,0,0,0,2,2,4
wi12,121,WARREN,INTL,IntSt-Ling,0,0,0,0,1,1,0,0,0,1,0,1,0,1,1,0,0,0,1,2,3
wi12,121,WARREN,INTL,IntSt-Lit,0,0,0,0,0,0,0,0,0,0,0,0,0,1,1,0,0,0,0,1,1
wi12,121,WARREN,INTL,IntSt-PolS,0,0,0,1,0,1,0,1,1,2,3,5,5,9,14,0,0,0,8,13,21
wi12,121,WARREN,INTL,IntSt-Soc,0,0,0,1,0,1,0,0,0,0,3,3,0,4,4,0,0,0,1,7,8
wi12,121,WARREN,ITAL,Italian St,0,0,0,0,0,0,0,0,0,0,0,0,1,0,1,0,0,0,1,0,1
wi12,121,WARREN,JAPN,JapaneseSt,0,0,0,0,0,0,0,0,0,1,0,1,2,0,2,0,0,0,3,0,3
wi12,121,WARREN,LATI,LatinAm St,0,0,0,0,0,0,0,0,0,0,0,0,0,1,1,0,0,0,0,1,1
wi12,121,WARREN,LING,Lang Stu,0,0,0,0,0,0,0,0,0,0,1,1,0,0,0,0,0,0,0,1,1
wi12,121,WARREN,LING,Ling-CogLn,0,0,0,0,0,0,0,0,0,0,1,1,0,2,2,0,0,0,0,3,3
wi12,121,WARREN,LING,Ling-LSoc,0,0,0,0,0,0,0,0,0,0,0,0,1,1,2,0,0,0,1,1,2
wi12,121,WARREN,LING,Linguistcs,0,0,0,0,0,0,0,0,0,0,1,1,0,3,3,0,0,0,0,4,4
wi12,121,WARREN,LIT,French Lit,0,0,0,0,0,0,0,0,0,0,0,0,1,0,1,0,0,0,1,0,1
wi12,121,WARREN,LIT,Lit/Engl,0,0,0,0,2,2,0,0,0,0,3,3,2,7,9,0,0,0,2,12,14
wi12,121,WARREN,LIT,Lit/World,0,0,0,0,0,0,0,0,0,0,0,0,0,1,1,0,0,0,0,1,1
wi12,121,WARREN,LIT,Lit/Writng,0,0,0,0,1,1,0,2,2,1,3,4,7,9,16,0,0,0,8,15,23
wi12,121,WARREN,LIT,Spanish Lt,0,0,0,0,0,0,1,0,1,1,0,1,0,1,1,0,0,0,2,1,3
wi12,121,WARREN,MAE,Aerosp Eng,0,0,0,4,7,11,7,0,7,14,0,14,31,7,38,0,0,0,56,14,70
wi12,121,WARREN,MAE,Engin Sci,0,0,0,4,1,5,3,1,4,8,1,9,3,0,3,0,0,0,18,3,21
wi12,121,WARREN,MAE,Envir Eng,0,0,0,5,0,5,5,2,7,8,9,17,12,7,19,0,0,0,30,18,48
wi12,121,WARREN,MAE,Mech Engin,0,0,0,11,2,13,11,7,18,27,2,29,99,12,111,0,0,0,148,23,171
wi12,121,WARREN,MATH,Appld Math,0,0,0,0,0,0,2,1,3,3,1,4,3,1,4,0,0,0,8,3,11
wi12,121,WARREN,MATH,Math/SecEd,0,0,0,0,0,0,0,1,1,0,1,1,1,2,3,0,0,0,1,4,5
wi12,121,WARREN,MATH,Mathematcs,0,0,0,1,2,3,0,4,4,5,3,8,8,3,11,0,0,0,14,12,26
wi12,121,WARREN,MATH,Mth-CompSc,0,0,0,0,0,0,0,1,1,2,0,2,1,1,2,0,0,0,3,2,5
wi12,121,WARREN,MATH,Mth-Mth&Ec,0,0,0,1,3,4,0,1,1,7,4,11,4,1,5,0,0,0,12,9,21
wi12,121,WARREN,MATH,Mth/ApldSc,0,0,0,0,0,0,0,1,1,0,1,1,2,1,3,0,0,0,2,3,5
wi12,121,WARREN,MATH,Prob&Stats,0,0,0,0,0,0,2,0,2,1,1,2,0,4,4,0,0,0,3,5,8
wi12,121,WARREN,MUS,Mu-CompArt,0,0,0,0,0,0,2,1,3,1,0,1,6,0,6,0,0,0,9,1,10
wi12,121,WARREN,MUS,Music,0,0,0,0,0,0,1,0,1,3,0,3,2,5,7,0,0,0,6,5,11
wi12,121,WARREN,MUS,Music Hum,0,0,0,0,0,0,0,0,0,1,0,1,1,0,1,0,0,0,2,0,2
wi12,121,WARREN,NENG,NanoEng,0,0,0,3,0,3,17,0,17,14,4,18,8,0,8,0,0,0,42,4,46
wi12,121,WARREN,PHIL,Philosophy,0,0,0,1,0,1,1,1,2,9,2,11,9,1,10,0,0,0,20,4,24
wi12,121,WARREN,PHYS,Biophysics,0,0,0,0,0,0,0,1,1,0,0,0,0,0,0,0,0,0,0,1,1
wi12,121,WARREN,PHYS,Phys/Astro,0,0,0,0,0,0,0,0,0,1,0,1,3,0,3,0,0,0,4,0,4
wi12,121,WARREN,PHYS,Phys/Comp,0,0,0,0,0,0,1,0,1,0,0,0,1,0,1,0,0,0,2,0,2
wi12,121,WARREN,PHYS,Phys/Mtrls,0,0,0,0,0,0,0,0,0,1,0,1,0,0,0,0,0,0,1,0,1
wi12,121,WARREN,PHYS,Physics,0,0,0,2,1,3,2,1,3,3,0,3,6,2,8,0,0,0,13,4,17
wi12,121,WARREN,POLI,Polit Sci,0,0,0,3,3,6,9,8,17,17,15,32,24,24,48,0,0,0,53,50,103
wi12,121,WARREN,POLI,PolSc-Amer,0,0,0,0,0,0,1,2,3,2,3,5,6,6,12,0,0,0,9,11,20
wi12,121,WARREN,POLI,PolSc-Comp,0,0,0,0,0,0,0,1,1,0,1,1,1,2,3,0,0,0,1,4,5
wi12,121,WARREN,POLI,PolSc-Intl,0,0,0,3,0,3,2,4,6,6,3,9,14,17,31,0,0,0,25,24,49
wi12,121,WARREN,POLI,PolSc-PLaw,0,0,0,1,5,6,3,8,11,5,10,15,5,9,14,0,0,0,14,32,46
wi12,121,WARREN,POLI,PolSc-PPol,0,0,0,0,0,0,1,1,2,2,2,4,0,2,2,0,0,0,3,5,8
wi12,121,WARREN,POLI,PolSc-Thry,0,0,0,0,0,0,0,0,0,2,0,2,1,1,2,0,0,0,3,1,4
wi12,121,WARREN,PSYC,Psychology,0,0,0,8,20,28,12,22,34,14,41,55,21,82,103,0,0,0,55,165,220
wi12,121,WARREN,RELI,Relig/Stu,0,0,0,0,0,0,1,1,2,1,0,1,0,1,1,0,0,0,2,2,4
wi12,121,WARREN,SE,Engin Sci,0,0,0,0,0,0,0,1,1,0,0,0,0,0,0,0,0,0,0,1,1
wi12,121,WARREN,SE,Struct Eng,0,0,0,16,9,25,26,8,34,31,5,36,51,25,76,0,0,0,124,47,171
wi12,121,WARREN,SIO,Earth Sci,0,0,0,1,0,1,1,1,2,4,1,5,1,2,3,0,0,0,7,4,11
wi12,121,WARREN,SOC,SocAmSt,0,0,0,0,0,0,0,0,0,0,0,0,0,1,1,0,0,0,0,1,1
wi12,121,WARREN,SOC,SocCulCom,0,0,0,0,0,0,0,1,1,1,0,1,0,1,1,0,0,0,1,2,3
wi12,121,WARREN,SOC,SocEconSoc,0,0,0,0,0,0,0,0,0,0,1,1,0,0,0,0,0,0,0,1,1
wi12,121,WARREN,SOC,SocIntlStu,0,0,0,0,0,0,0,0,0,0,0,0,2,0,2,0,0,0,2,0,2
wi12,121,WARREN,SOC,Sociology,0,0,0,0,2,2,0,2,2,2,9,11,4,14,18,0,0,0,6,27,33
wi12,121,WARREN,SOC,SocLawSoc,0,0,0,0,1,1,0,1,1,3,2,5,1,3,4,0,0,0,4,7,11
wi12,121,WARREN,SOC,SocSciMed,0,0,0,0,0,0,0,1,1,0,0,0,1,1,2,0,0,0,1,2,3
wi12,121,WARREN,SOC,SocSolneq,0,0,0,0,0,0,0,0,0,0,0,0,1,3,4,0,0,0,1,3,4
wi12,121,WARREN,THEA,Dance,0,0,0,0,0,0,0,0,0,0,0,0,1,1,2,0,0,0,1,1,2
wi12,121,WARREN,THEA,Theatre,0,0,0,1,1,2,1,0,1,4,1,5,0,3,3,0,0,0,6,5,11
wi12,121,WARREN,TWS,ThirdWldSt,0,0,0,0,0,0,0,0,0,0,0,0,0,1,1,0,0,0,0,1,1
wi12,121,WARREN,UNAF,IntcampVis,0,0,0,1,0,1,0,0,0,1,1,2,0,0,0,0,0,0,2,1,3
wi12,121,WARREN,UNAF,Limited St,0,0,0,0,0,0,0,0,0,0,0,0,0,0,0,3,3,6,3,3,6
wi12,121,WARREN,UNAF,UndecHumAr,0,0,0,1,0,1,0,1,1,0,0,0,0,0,0,0,0,0,1,1,2
wi12,121,WARREN,UNAF,Undeclared,0,0,0,17,21,38,9,16,25,0,4,4,0,0,0,0,0,0,26,41,67
wi12,121,WARREN,UNAF,UndecPhysS,0,0,0,1,4,5,1,2,3,0,0,0,0,0,0,0,0,0,2,6,8
wi12,121,WARREN,UNAF,UndecSocSc,0,0,0,3,0,3,0,0,0,0,0,0,0,0,0,0,0,0,3,0,3
wi12,121,WARREN,USP,Urb Stu&Pl,0,0,0,0,0,0,1,0,1,3,3,6,5,9,14,0,0,0,9,12,21
wi12,121,WARREN,VIS,Art Hst/Cr,0,0,0,0,0,0,1,0,1,0,0,0,2,0,2,0,0,0,3,0,3
wi12,121,WARREN,VIS,Media,0,0,0,0,0,0,0,1,1,4,3,7,8,7,15,0,0,0,12,11,23
wi12,121,WARREN,VIS,Studio VA,0,0,0,0,0,0,2,1,3,1,0,1,1,3,4,0,0,0,4,4,8
wi12,121,WARREN,VIS,VA-CompArt,0,0,0,0,0,0,0,0,0,1,0,1,1,0,1,0,0,0,2,0,2
fa08,83,MARSHALL,ANTH,Anth-Arch,1,0,1,0,0,0,0,2,2,1,2,3,0,1,1,0,0,0,2,5,7
fa08,83,MARSHALL,ANTH,Anth-Biol,0,0,0,0,0,0,0,1,1,2,1,3,0,4,4,0,0,0,2,6,8
fa08,83,MARSHALL,ANTH,Anth-Soci,0,2,2,0,0,0,1,0,1,1,2,3,2,5,7,0,0,0,4,9,13
fa08,83,MARSHALL,ANTH,Anthropol,0,0,0,0,0,0,0,0,0,1,1,2,0,2,2,0,0,0,1,3,4
fa08,83,MARSHALL,BENG,Bioen:Binf,0,0,0,0,0,0,0,0,0,1,0,1,0,0,0,0,0,0,1,0,1
fa08,83,MARSHALL,BENG,Bioeng:PM,0,0,0,0,0,0,0,0,0,7,0,7,13,5,18,0,0,0,20,5,25
fa08,83,MARSHALL,BENG,BioengBiot,6,1,7,0,0,0,1,1,2,3,0,3,6,5,11,0,0,0,16,7,23
fa08,83,MARSHALL,BENG,Bioengin,5,1,6,0,0,0,0,2,2,1,1,2,3,4,7,0,0,0,9,8,17
fa08,83,MARSHALL,BENG,Pr-BioenPM,12,8,20,0,0,0,4,1,5,1,0,1,0,0,0,0,0,0,17,9,26
fa08,83,MARSHALL,BIOL,Anml Physl,0,1,1,0,0,0,0,0,0,0,0,0,3,3,6,0,0,0,3,4,7
fa08,83,MARSHALL,BIOL,Bioc/CellB,5,14,19,0,1,1,6,13,19,19,34,53,42,33,75,0,0,0,72,95,167
fa08,83,MARSHALL,BIOL,BiolBioinf,0,0,0,0,0,0,0,0,0,0,0,0,1,0,1,0,0,0,1,0,1
fa08,83,MARSHALL,BIOL,Ec/Beh/Evo,1,3,4,0,0,0,1,1,2,5,1,6,1,8,9,0,0,0,8,13,21
fa08,83,MARSHALL,BIOL,Genl Biol,11,18,29,0,3,3,6,22,28,33,37,70,33,38,71,0,0,0,83,118,201
fa08,83,MARSHALL,BIOL,Human Bio,23,48,71,3,4,7,19,41,60,38,61,99,38,58,96,0,0,0,121,212,333
fa08,83,MARSHALL,BIOL,Microbiol,2,1,3,0,0,0,1,5,6,3,3,6,2,2,4,0,0,0,8,11,19
fa08,83,MARSHALL,BIOL,Molec Biol,1,7,8,0,0,0,4,3,7,4,4,8,3,4,7,0,0,0,12,18,30
fa08,83,MARSHALL,BIOL,PhyslNeuro,3,9,12,0,1,1,6,14,20,7,14,21,15,13,28,0,0,0,31,51,82
fa08,83,MARSHALL,BIOL,Pr-BioBinf,0,0,0,0,0,0,0,1,1,1,0,1,1,1,2,0,0,0,2,2,4
fa08,83,MARSHALL,CENG,Chem Engin,5,4,9,0,1,1,1,0,1,7,5,12,9,5,14,0,0,0,22,15,37
fa08,83,MARSHALL,CGS,CritGendSt,0,0,0,0,0,0,0,1,1,0,2,2,0,1,1,0,0,0,0,4,4
fa08,83,MARSHALL,CHEM,Bioch/Chem,4,17,21,0,2,2,5,5,10,7,10,17,11,9,20,0,0,0,27,43,70
fa08,83,MARSHALL,CHEM,Chemistry,2,3,5,1,0,1,2,2,4,4,4,8,5,3,8,0,0,0,14,12,26
fa08,83,MARSHALL,CHEM,Pharm Chem,4,13,17,0,2,2,2,3,5,5,9,14,10,14,24,0,0,0,21,41,62
fa08,83,MARSHALL,CHIN,Chinese St,0,0,0,0,0,0,0,0,0,0,0,0,0,2,2,0,0,0,0,2,2
fa08,83,MARSHALL,CLAS,Classic St,0,0,0,0,0,0,0,0,0,0,0,0,1,1,2,0,0,0,1,1,2
fa08,83,MARSHALL,COGS,Cog Sci,0,3,3,0,0,0,4,3,7,1,1,2,5,4,9,0,0,0,10,11,21
fa08,83,MARSHALL,COGS,CogSc/ClAs,0,0,0,0,0,0,0,0,0,0,1,1,0,2,2,0,0,0,0,3,3
fa08,83,MARSHALL,COGS,CogSc/Comp,1,0,1,0,0,0,0,0,0,0,0,0,1,0,1,0,0,0,2,0,2
fa08,83,MARSHALL,COGS,CogSc/HCI,0,0,0,0,0,0,0,0,0,1,2,3,5,0,5,0,0,0,6,2,8
fa08,83,MARSHALL,COGS,CogSc/HCog,0,0,0,0,0,0,0,0,0,0,0,0,0,1,1,0,0,0,0,1,1
fa08,83,MARSHALL,COGS,CogSc/Neur,1,0,1,0,0,0,1,2,3,3,7,10,6,3,9,0,0,0,11,12,23
fa08,83,MARSHALL,COMM,Communic,2,21,23,1,1,2,5,15,20,17,33,50,12,52,64,0,0,0,37,122,159
fa08,83,MARSHALL,CSE,Comp Sci,7,5,12,1,0,1,7,0,7,12,3,15,21,1,22,0,0,0,48,9,57
fa08,83,MARSHALL,CSE,CompEngCSE,9,2,11,0,0,0,5,0,5,6,1,7,7,0,7,0,0,0,27,3,30
fa08,83,MARSHALL,ECE,CompEngECE,1,1,2,0,0,0,0,0,0,2,0,2,1,0,1,0,0,0,4,1,5
fa08,83,MARSHALL,ECE,Electr Eng,16,4,20,1,0,1,6,0,6,16,3,19,19,8,27,0,0,0,58,15,73
fa08,83,MARSHALL,ECE,Engin Phys,0,0,0,0,0,0,0,0,0,0,0,0,1,0,1,0,0,0,1,0,1
fa08,83,MARSHALL,ECE,Pr-ElecEng,0,0,0,0,0,0,0,1,1,0,0,0,0,0,0,0,0,0,0,1,1
fa08,83,MARSHALL,ECE,Pr-EngPhys,2,0,2,0,0,0,0,0,0,0,0,0,0,0,0,0,0,0,2,0,2
fa08,83,MARSHALL,ECON,Ec-Mth&Ecn,6,4,10,0,0,0,2,2,4,5,3,8,3,0,3,0,0,0,16,9,25
fa08,83,MARSHALL,ECON,Econ-MgtSc,11,13,24,2,1,3,8,11,19,46,30,76,53,29,82,0,0,0,120,84,204
fa08,83,MARSHALL,ECON,Economics,18,17,35,6,1,7,25,14,39,97,46,143,84,42,126,0,0,0,230,120,350
fa08,83,MARSHALL,ESYS,EnvSys(EB),2,0,2,0,0,0,0,1,1,1,5,6,3,4,7,0,0,0,6,10,16
fa08,83,MARSHALL,ESYS,EnvSys(EC),0,0,0,0,0,0,0,0,0,0,0,0,2,0,2,0,0,0,2,0,2
fa08,83,MARSHALL,ESYS,EnvSys(EP),1,0,1,0,0,0,0,2,2,0,0,0,0,1,1,0,0,0,1,3,4
fa08,83,MARSHALL,ESYS,EnvSys(ES),1,0,1,0,0,0,0,0,0,0,1,1,1,0,1,0,0,0,2,1,3
fa08,83,MARSHALL,ETHN,Ethnic St,0,0,0,0,0,0,1,6,7,0,7,7,2,17,19,0,0,0,3,30,33
fa08,83,MARSHALL,HDP,Human Dev,0,0,0,0,0,0,1,0,1,0,12,12,1,24,25,0,0,0,2,36,38
fa08,83,MARSHALL,HDP,Pr-HumnDev,0,4,4,0,0,0,0,19,19,0,10,10,1,7,8,0,0,0,1,40,41
fa08,83,MARSHALL,HIST,History,2,6,8,2,0,2,1,5,6,17,7,24,10,17,27,0,0,0,32,35,67
fa08,83,MARSHALL,INTD,Mar Ind St,0,0,0,0,0,0,0,0,0,0,0,0,0,1,1,0,0,0,0,1,1
fa08,83,MARSHALL,INTL,Int-5yrEC,0,1,1,0,0,0,0,0,0,0,0,0,0,0,0,0,0,0,0,1,1
fa08,83,MARSHALL,INTL,IntSt-Anth,0,0,0,0,0,0,0,0,0,0,3,3,0,2,2,0,0,0,0,5,5
fa08,83,MARSHALL,INTL,IntSt-Econ,7,9,16,1,1,2,2,2,4,5,10,15,6,9,15,0,0,0,21,31,52
fa08,83,MARSHALL,INTL,IntSt-Hist,0,0,0,0,0,0,0,0,0,1,2,3,1,0,1,0,0,0,2,2,4
fa08,83,MARSHALL,INTL,IntSt-Ling,0,3,3,0,0,0,0,0,0,1,3,4,0,1,1,0,0,0,1,7,8
fa08,83,MARSHALL,INTL,IntSt-Lit,0,0,0,0,0,0,0,1,1,0,0,0,0,0,0,0,0,0,0,1,1
fa08,83,MARSHALL,INTL,IntSt-PolS,0,5,5,0,0,0,5,5,10,5,7,12,3,14,17,0,0,0,13,31,44
fa08,83,MARSHALL,INTL,IntSt-Soc,0,1,1,0,0,0,0,2,2,2,8,10,3,7,10,0,0,0,5,18,23
fa08,83,MARSHALL,JAPN,JapaneseSt,0,1,1,0,0,0,0,1,1,1,0,1,0,2,2,0,0,0,1,4,5
fa08,83,MARSHALL,JUDA,Judaic Stu,0,0,0,0,0,0,1,1,2,0,0,0,0,0,0,0,0,0,1,1,2
fa08,83,MARSHALL,LATI,LatinAm St,0,0,0,0,0,0,0,1,1,1,2,3,0,1,1,0,0,0,1,4,5
fa08,83,MARSHALL,LING,Lang Stu,1,1,2,0,0,0,0,0,0,0,1,1,0,0,0,0,0,0,1,2,3
fa08,83,MARSHALL,LING,Ling-LSoc,0,1,1,0,0,0,0,0,0,1,0,1,0,0,0,0,0,0,1,1,2
fa08,83,MARSHALL,LING,Linguistcs,1,1,2,0,1,1,0,1,1,0,2,2,1,1,2,0,0,0,2,6,8
fa08,83,MARSHALL,LIT,Lit/Compos,0,0,0,0,0,0,0,0,0,0,1,1,0,0,0,0,0,0,0,1,1
fa08,83,MARSHALL,LIT,Lit/CultSt,0,0,0,0,0,0,0,0,0,0,1,1,0,0,0,0,0,0,0,1,1
fa08,83,MARSHALL,LIT,Lit/Engl,1,5,6,0,0,0,1,0,1,2,3,5,1,7,8,0,0,0,5,15,20
fa08,83,MARSHALL,LIT,Lit/World,0,0,0,0,0,0,0,1,1,1,3,4,0,2,2,0,0,0,1,6,7
fa08,83,MARSHALL,LIT,Lit/Writng,0,0,0,0,0,0,0,1,1,1,3,4,2,3,5,0,0,0,3,7,10
fa08,83,MARSHALL,LIT,Pre-Lit/Wr,0,4,4,0,0,0,1,3,4,4,0,4,0,2,2,0,0,0,5,9,14
fa08,83,MARSHALL,LIT,Spanish Lt,0,1,1,0,0,0,0,1,1,0,2,2,0,1,1,0,0,0,0,5,5
fa08,83,MARSHALL,MAE,Aerosp Eng,9,1,10,0,0,0,2,0,2,7,2,9,22,1,23,0,0,0,40,4,44
fa08,83,MARSHALL,MAE,Engin Sci,0,0,0,0,0,0,1,0,1,0,0,0,1,0,1,0,0,0,2,0,2
fa08,83,MARSHALL,MAE,Envir Eng,1,2,3,0,0,0,1,1,2,0,1,1,0,0,0,0,0,0,2,4,6
fa08,83,MARSHALL,MAE,Mech Engin,14,1,15,2,0,2,13,3,16,30,1,31,44,3,47,0,0,0,103,8,111
fa08,83,MARSHALL,MATH,Appld Math,0,1,1,0,0,0,0,1,1,2,1,3,1,2,3,0,0,0,3,5,8
fa08,83,MARSHALL,MATH,Math/SecEd,1,3,4,0,0,0,1,0,1,1,0,1,2,2,4,0,0,0,5,5,10
fa08,83,MARSHALL,MATH,Mathematcs,4,3,7,1,0,1,3,3,6,1,3,4,4,2,6,0,0,0,13,11,24
fa08,83,MARSHALL,MATH,Mth-CompSc,0,0,0,0,0,0,0,0,0,0,0,0,0,1,1,0,0,0,0,1,1
fa08,83,MARSHALL,MATH,Mth-Mth&Ec,3,1,4,0,0,0,0,1,1,3,1,4,4,1,5,0,0,0,10,4,14
fa08,83,MARSHALL,MATH,Mth-SciCom,0,0,0,0,0,0,0,1,1,0,0,0,0,0,0,0,0,0,0,1,1
fa08,83,MARSHALL,MATH,Mth/ApldSc,0,2,2,0,0,0,0,1,1,0,0,0,0,1,1,0,0,0,0,4,4
fa08,83,MARSHALL,MATH,Pr-Math CS,0,0,0,0,0,0,0,1,1,1,0,1,0,0,0,0,0,0,1,1,2
fa08,83,MARSHALL,MATH,Prob&Stats,0,0,0,0,0,0,0,0,0,0,1,1,1,1,2,0,0,0,1,2,3
fa08,83,MARSHALL,MUS,Mu-CompArt,1,0,1,0,0,0,0,0,0,1,0,1,2,0,2,0,0,0,4,0,4
fa08,83,MARSHALL,MUS,Music,0,1,1,1,0,1,0,1,1,2,2,4,2,2,4,0,0,0,5,6,11
fa08,83,MARSHALL,MUS,Music Hum,0,0,0,0,0,0,0,0,0,0,1,1,0,1,1,0,0,0,0,2,2
fa08,83,MARSHALL,PHIL,Philosophy,1,0,1,0,0,0,2,1,3,4,2,6,4,3,7,0,0,0,11,6,17
fa08,83,MARSHALL,PHYS,Biophysics,1,0,1,0,0,0,0,0,0,0,0,0,0,1,1,0,0,0,1,1,2
fa08,83,MARSHALL,PHYS,Gen Physcs,0,0,0,0,0,0,0,0,0,0,0,0,1,1,2,0,0,0,1,1,2
fa08,83,MARSHALL,PHYS,Phys/Astro,0,0,0,0,0,0,1,1,2,0,0,0,2,3,5,0,0,0,3,4,7
fa08,83,MARSHALL,PHYS,Phys/Comp,0,0,0,0,0,0,0,0,0,0,0,0,1,0,1,0,0,0,1,0,1
fa08,83,MARSHALL,PHYS,Physics,3,0,3,0,0,0,0,0,0,2,0,2,3,0,3,0,0,0,8,0,8
fa08,83,MARSHALL,POLI,Polit Sci,8,11,19,1,1,2,9,11,20,31,21,52,18,13,31,0,0,0,67,57,124
fa08,83,MARSHALL,POLI,PolSc-Amer,0,0,0,0,1,1,1,0,1,4,1,5,2,1,3,0,0,0,7,3,10
fa08,83,MARSHALL,POLI,PolSc-Comp,0,0,0,0,0,0,0,0,0,1,0,1,0,2,2,0,0,0,1,2,3
fa08,83,MARSHALL,POLI,PolSc-Intl,1,6,7,1,3,4,5,6,11,17,7,24,7,13,20,0,0,0,31,35,66
fa08,83,MARSHALL,POLI,PolSc-PLaw,5,6,11,1,0,1,7,4,11,9,8,17,4,2,6,0,0,0,26,20,46
fa08,83,MARSHALL,POLI,PolSc-PPol,0,1,1,0,0,0,0,0,0,0,1,1,0,1,1,0,0,0,0,3,3
fa08,83,MARSHALL,POLI,PolSc-Thry,0,1,1,0,0,0,0,0,0,1,0,1,2,0,2,0,0,0,3,1,4
fa08,83,MARSHALL,PSYC,Psychology,4,39,43,0,2,2,10,29,39,25,70,95,27,55,82,0,0,0,66,195,261
fa08,83,MARSHALL,RELI,Relig/Stu,0,0,0,0,0,0,0,0,0,2,0,2,0,2,2,0,0,0,2,2,4
fa08,83,MARSHALL,SE,Struct Eng,4,5,9,0,0,0,7,2,9,8,8,16,16,7,23,0,0,0,35,22,57
fa08,83,MARSHALL,SOC,Sociology,0,6,6,0,1,1,1,6,7,13,31,44,10,19,29,0,0,0,24,63,87
fa08,83,MARSHALL,THEA,Dance,0,0,0,0,0,0,0,0,0,0,1,1,0,0,0,0,0,0,0,1,1
fa08,83,MARSHALL,THEA,Theatre,0,2,2,0,0,0,0,2,2,1,3,4,3,5,8,0,0,0,4,12,16
fa08,83,MARSHALL,TWS,ThirdWldSt,0,0,0,0,0,0,0,0,0,0,1,1,0,1,1,0,0,0,0,2,2
fa08,83,MARSHALL,UNAF,UndecBiolS,9,18,27,0,1,1,6,11,17,1,3,4,0,0,0,0,0,0,16,33,49
fa08,83,MARSHALL,UNAF,UndecHumAr,3,10,13,0,0,0,2,8,10,0,1,1,0,0,0,0,0,0,5,19,24
fa08,83,MARSHALL,UNAF,Undeclared,34,64,98,2,3,5,11,19,30,2,0,2,0,1,1,0,0,0,49,87,136
fa08,83,MARSHALL,UNAF,UndecPhysS,4,3,7,0,0,0,1,1,2,1,0,1,0,0,0,0,0,0,6,4,10
fa08,83,MARSHALL,UNAF,UndecSocSc,9,18,27,1,4,5,0,8,8,1,0,1,0,0,0,0,0,0,11,30,41
fa08,83,MARSHALL,USP,Urb Stu&Pl,2,0,2,0,0,0,1,3,4,4,5,9,3,10,13,0,0,0,10,18,28
fa08,83,MARSHALL,VIS,Art Hst/Cr,0,0,0,0,0,0,0,1,1,0,4,4,0,4,4,0,0,0,0,9,9
fa08,83,MARSHALL,VIS,Media,3,7,10,0,0,0,5,6,11,5,3,8,7,4,11,0,0,0,20,20,40
fa08,83,MARSHALL,VIS,Studio VA,0,2,2,1,0,1,1,1,2,2,2,4,2,5,7,0,0,0,6,10,16
fa08,83,MARSHALL,VIS,VA-CompArt,0,0,0,0,0,0,0,0,0,0,0,0,1,0,1,0,0,0,1,0,1
fa08,83,MUIR,ANTH,Anth-Arch,0,1,1,0,0,0,0,0,0,4,2,6,2,5,7,0,0,0,6,8,14
fa08,83,MUIR,ANTH,Anth-Biol,0,0,0,0,0,0,0,0,0,1,3,4,2,11,13,0,0,0,3,14,17
fa08,83,MUIR,ANTH,Anth-Soci,1,3,4,0,0,0,0,0,0,3,2,5,1,2,3,0,0,0,5,7,12
fa08,83,MUIR,ANTH,Anthropol,0,0,0,0,0,0,0,0,0,0,1,1,0,1,1,0,0,0,0,2,2
fa08,83,MUIR,BENG,Bioen:Binf,0,0,0,0,0,0,0,0,0,0,0,0,1,0,1,0,0,0,1,0,1
fa08,83,MUIR,BENG,Bioeng:PM,0,0,0,0,0,0,1,1,2,3,2,5,12,11,23,0,0,0,16,14,30
fa08,83,MUIR,BENG,BioengBiot,3,5,8,0,0,0,2,1,3,4,1,5,8,3,11,0,0,0,17,10,27
fa08,83,MUIR,BENG,Bioengin,11,7,18,0,0,0,4,1,5,5,3,8,7,6,13,0,0,0,27,17,44
fa08,83,MUIR,BENG,Pr-BioenPM,11,8,19,0,1,1,6,3,9,5,1,6,2,0,2,0,0,0,24,13,37
fa08,83,MUIR,BIOL,Anml Physl,0,0,0,0,0,0,0,0,0,0,0,0,2,5,7,0,0,0,2,5,7
fa08,83,MUIR,BIOL,Bioc/CellB,7,21,28,0,1,1,15,12,27,36,18,54,39,53,92,0,0,0,97,105,202
fa08,83,MUIR,BIOL,Ec/Beh/Evo,1,4,5,0,0,0,1,3,4,2,7,9,2,17,19,0,0,0,6,31,37
fa08,83,MUIR,BIOL,Genl Biol,8,26,34,0,0,0,6,15,21,24,40,64,31,46,77,0,0,0,69,127,196
fa08,83,MUIR,BIOL,Human Bio,25,58,83,1,2,3,27,34,61,42,56,98,53,65,118,0,0,0,148,215,363
fa08,83,MUIR,BIOL,Microbiol,2,1,3,0,0,0,1,2,3,1,2,3,5,5,10,0,0,0,9,10,19
fa08,83,MUIR,BIOL,Molec Biol,6,7,13,0,0,0,1,1,2,7,7,14,6,7,13,0,0,0,20,22,42
fa08,83,MUIR,BIOL,PhyslNeuro,7,11,18,0,1,1,4,8,12,15,15,30,19,20,39,0,0,0,45,55,100
fa08,83,MUIR,BIOL,Pr-BioBinf,0,0,0,0,0,0,0,0,0,0,0,0,0,1,1,0,0,0,0,1,1
fa08,83,MUIR,CENG,Chem Engin,7,4,11,0,1,1,1,3,4,10,5,15,12,2,14,0,0,0,30,15,45
fa08,83,MUIR,CGS,CritGendSt,0,0,0,0,0,0,0,0,0,0,3,3,0,3,3,0,0,0,0,6,6
fa08,83,MUIR,CHEM,Bioch/Chem,5,9,14,1,1,2,7,5,12,5,11,16,27,12,39,0,0,0,45,38,83
fa08,83,MUIR,CHEM,Chem Educ,0,0,0,0,0,0,0,0,0,0,0,0,1,1,2,0,0,0,1,1,2
fa08,83,MUIR,CHEM,Chem Phys,0,0,0,0,0,0,0,0,0,1,0,1,0,0,0,0,0,0,1,0,1
fa08,83,MUIR,CHEM,Chemistry,4,5,9,0,0,0,2,2,4,4,4,8,2,5,7,0,0,0,12,16,28
fa08,83,MUIR,CHEM,Envir Chem,0,0,0,0,0,0,0,0,0,2,0,2,0,0,0,0,0,0,2,0,2
fa08,83,MUIR,CHEM,MolecSynth,0,0,0,0,0,0,0,0,0,0,0,0,2,2,4,0,0,0,2,2,4
fa08,83,MUIR,CHEM,Pharm Chem,6,9,15,1,0,1,4,3,7,7,10,17,10,12,22,0,0,0,28,34,62
fa08,83,MUIR,CHIN,Chinese St,0,0,0,1,0,1,0,0,0,0,0,0,0,3,3,0,0,0,1,3,4
fa08,83,MUIR,CLAS,Classic St,0,0,0,0,0,0,0,0,0,0,2,2,1,0,1,0,0,0,1,2,3
fa08,83,MUIR,COGS,Cog Sci,2,2,4,0,0,0,2,4,6,12,7,19,12,9,21,0,0,0,28,22,50
fa08,83,MUIR,COGS,CogSc/ClAs,0,0,0,0,0,0,0,0,0,1,3,4,2,4,6,0,0,0,3,7,10
fa08,83,MUIR,COGS,CogSc/Comp,0,0,0,0,0,0,1,0,1,1,0,1,0,0,0,0,0,0,2,0,2
fa08,83,MUIR,COGS,CogSc/HCI,0,0,0,0,0,0,0,0,0,1,1,2,8,2,10,0,0,0,9,3,12
fa08,83,MUIR,COGS,CogSc/HCog,0,0,0,0,0,0,0,1,1,0,1,1,2,0,2,0,0,0,2,2,4
fa08,83,MUIR,COGS,CogSc/Neur,0,3,3,0,0,0,4,1,5,0,4,4,5,4,9,0,0,0,9,12,21
fa08,83,MUIR,COMM,Communic,2,19,21,1,2,3,1,15,16,12,55,67,25,49,74,0,0,0,41,140,181
fa08,83,MUIR,CSE,Comp Sci,5,2,7,0,1,1,4,2,6,16,3,19,24,0,24,0,0,0,49,8,57
fa08,83,MUIR,CSE,CompEngCSE,4,3,7,0,0,0,3,0,3,6,0,6,5,0,5,0,0,0,18,3,21
fa08,83,MUIR,CSE,CompScBinf,0,0,0,0,0,0,0,0,0,0,0,0,1,0,1,0,0,0,1,0,1
fa08,83,MUIR,ECE,CompEngECE,3,1,4,0,0,0,1,1,2,4,0,4,2,0,2,0,0,0,10,2,12
fa08,83,MUIR,ECE,Electr Eng,8,1,9,0,0,0,3,0,3,6,1,7,13,6,19,0,0,0,30,8,38
fa08,83,MUIR,ECE,Pr-EngPhys,1,1,2,0,0,0,0,0,0,0,1,1,1,0,1,0,0,0,2,2,4
fa08,83,MUIR,ECON,Ec-Mth&Ecn,3,3,6,0,0,0,4,1,5,4,2,6,1,1,2,0,0,0,12,7,19
fa08,83,MUIR,ECON,Econ-MgtSc,8,2,10,0,1,1,14,11,25,31,21,52,31,27,58,0,0,0,84,62,146
fa08,83,MUIR,ECON,Economics,17,15,32,3,1,4,25,8,33,56,48,104,56,27,83,0,0,0,157,99,256
fa08,83,MUIR,ERTH,ErSc-GeoCh,0,0,0,0,0,0,0,1,1,0,0,0,0,1,1,0,0,0,0,2,2
fa08,83,MUIR,ESYS,EnvSys(EB),1,4,5,0,0,0,0,1,1,0,6,6,5,9,14,0,0,0,6,20,26
fa08,83,MUIR,ESYS,EnvSys(EC),0,0,0,0,0,0,0,1,1,0,0,0,2,1,3,0,0,0,2,2,4
fa08,83,MUIR,ESYS,EnvSys(EP),1,5,6,0,0,0,0,0,0,0,4,4,2,2,4,0,0,0,3,11,14
fa08,83,MUIR,ESYS,EnvSys(ES),1,0,1,0,0,0,0,0,0,3,0,3,1,0,1,0,0,0,5,0,5
fa08,83,MUIR,ETHN,Ethnic St,0,0,0,0,1,1,0,5,5,1,5,6,4,6,10,0,0,0,5,17,22
fa08,83,MUIR,HDP,Human Dev,0,0,0,0,0,0,0,0,0,0,9,9,1,12,13,0,0,0,1,21,22
fa08,83,MUIR,HDP,Pr-HumnDev,0,3,3,1,3,4,1,6,7,0,12,12,0,7,7,0,0,0,2,31,33
fa08,83,MUIR,HIST,History,2,6,8,1,0,1,2,1,3,8,9,17,15,9,24,0,0,0,28,25,53
fa08,83,MUIR,INTL,IntSt-Anth,0,1,1,0,0,0,0,0,0,1,1,2,2,4,6,0,0,0,3,6,9
fa08,83,MUIR,INTL,IntSt-Econ,2,2,4,0,1,1,2,5,7,11,8,19,6,9,15,0,0,0,21,25,46
fa08,83,MUIR,INTL,IntSt-Hist,0,0,0,0,0,0,1,1,2,2,2,4,0,1,1,0,0,0,3,4,7
fa08,83,MUIR,INTL,IntSt-Ling,1,1,2,0,0,0,0,2,2,2,1,3,0,2,2,0,0,0,3,6,9
fa08,83,MUIR,INTL,IntSt-Lit,0,1,1,0,0,0,0,0,0,1,0,1,0,1,1,0,0,0,1,2,3
fa08,83,MUIR,INTL,IntSt-PolS,1,6,7,0,0,0,1,4,5,5,11,16,4,14,18,0,0,0,11,35,46
fa08,83,MUIR,INTL,IntSt-Soc,0,0,0,0,0,0,0,2,2,0,8,8,4,6,10,0,0,0,4,16,20
fa08,83,MUIR,JAPN,JapaneseSt,0,2,2,0,1,1,1,0,1,3,4,7,1,0,1,0,0,0,5,7,12
fa08,83,MUIR,LATI,LatinAm St,1,0,1,0,0,0,0,0,0,1,1,2,1,2,3,0,0,0,3,3,6
fa08,83,MUIR,LING,Lang Stu,0,1,1,0,0,0,0,0,0,1,3,4,0,2,2,0,0,0,1,6,7
fa08,83,MUIR,LING,Ling-CogLn,0,0,0,0,0,0,1,0,1,0,2,2,0,0,0,0,0,0,1,2,3
fa08,83,MUIR,LING,Ling-LSoc,0,0,0,0,0,0,0,0,0,0,1,1,0,1,1,0,0,0,0,2,2
fa08,83,MUIR,LING,Linguistcs,1,4,5,0,0,0,1,0,1,0,2,2,0,3,3,0,0,0,2,9,11
fa08,83,MUIR,LIT,French Lit,0,0,0,0,0,0,0,0,0,0,0,0,0,1,1,0,0,0,0,1,1
fa08,83,MUIR,LIT,Lit/Compos,0,1,1,0,0,0,0,0,0,0,0,0,0,1,1,0,0,0,0,2,2
fa08,83,MUIR,LIT,Lit/CultSt,0,0,0,0,0,0,0,0,0,0,1,1,0,1,1,0,0,0,0,2,2
fa08,83,MUIR,LIT,Lit/Engl,2,4,6,0,0,0,1,4,5,3,8,11,7,7,14,0,0,0,13,23,36
fa08,83,MUIR,LIT,Lit/World,0,1,1,0,0,0,0,1,1,1,2,3,2,11,13,0,0,0,3,15,18
fa08,83,MUIR,LIT,Lit/Writng,0,0,0,0,0,0,0,0,0,1,1,2,4,18,22,0,0,0,5,19,24
fa08,83,MUIR,LIT,Pre-Lit/Wr,1,6,7,0,0,0,1,4,5,6,8,14,6,5,11,0,0,0,14,23,37
fa08,83,MUIR,LIT,Spanish Lt,0,0,0,1,0,1,0,0,0,2,3,5,2,2,4,0,0,0,5,5,10
fa08,83,MUIR,MAE,Aerosp Eng,9,2,11,0,0,0,6,0,6,7,2,9,13,4,17,0,0,0,35,8,43
fa08,83,MUIR,MAE,Engin Sci,0,0,0,0,0,0,0,0,0,0,0,0,1,0,1,0,0,0,1,0,1
fa08,83,MUIR,MAE,Envir Eng,3,2,5,0,0,0,0,1,1,1,1,2,2,3,5,0,0,0,6,7,13
fa08,83,MUIR,MAE,Mech Engin,16,1,17,1,0,1,10,2,12,21,2,23,39,5,44,0,0,0,87,10,97
fa08,83,MUIR,MATH,Appld Math,0,0,0,0,0,0,3,0,3,3,1,4,1,3,4,0,0,0,7,4,11
fa08,83,MUIR,MATH,Math/SecEd,1,3,4,0,0,0,0,1,1,0,2,2,3,0,3,0,0,0,4,6,10
fa08,83,MUIR,MATH,Mathematcs,3,4,7,2,1,3,2,4,6,5,5,10,8,8,16,0,0,0,20,22,42
fa08,83,MUIR,MATH,Mth-CompSc,0,0,0,0,0,0,0,0,0,1,0,1,1,2,3,0,0,0,2,2,4
fa08,83,MUIR,MATH,Mth-Mth&Ec,1,2,3,0,0,0,1,1,2,2,3,5,7,3,10,0,0,0,11,9,20
fa08,83,MUIR,MATH,Mth-SciCom,1,0,1,0,0,0,0,0,0,1,1,2,1,0,1,0,0,0,3,1,4
fa08,83,MUIR,MATH,Mth/ApldSc,0,0,0,0,0,0,0,0,0,0,1,1,0,1,1,0,0,0,0,2,2
fa08,83,MUIR,MATH,Pr-Math CS,1,0,1,0,0,0,0,0,0,0,0,0,0,0,0,0,0,0,1,0,1
fa08,83,MUIR,MUS,Mu-CompArt,1,0,1,0,0,0,4,0,4,3,0,3,4,4,8,0,0,0,12,4,16
fa08,83,MUIR,MUS,Music,0,0,0,0,0,0,1,3,4,4,1,5,2,5,7,0,0,0,7,9,16
fa08,83,MUIR,MUS,Music Hum,1,1,2,0,0,0,0,0,0,0,1,1,0,0,0,0,0,0,1,2,3
fa08,83,MUIR,PHIL,Philosophy,0,1,1,0,0,0,0,0,0,6,3,9,3,3,6,0,0,0,9,7,16
fa08,83,MUIR,PHYS,Biophysics,0,0,0,0,0,0,0,0,0,0,0,0,4,2,6,0,0,0,4,2,6
fa08,83,MUIR,PHYS,Gen Physcs,1,0,1,1,0,1,0,0,0,0,0,0,0,0,0,0,0,0,2,0,2
fa08,83,MUIR,PHYS,Phys/Astro,2,1,3,0,0,0,1,1,2,0,0,0,1,1,2,0,0,0,4,3,7
fa08,83,MUIR,PHYS,Phys/Mtrls,1,0,1,0,0,0,0,0,0,0,0,0,0,0,0,0,0,0,1,0,1
fa08,83,MUIR,PHYS,Physics,6,0,6,0,0,0,0,1,1,4,0,4,6,0,6,0,0,0,16,1,17
fa08,83,MUIR,POLI,Polit Sci,4,9,13,0,0,0,3,7,10,20,13,33,19,17,36,0,0,0,46,46,92
fa08,83,MUIR,POLI,PolSc-Amer,0,0,0,1,0,1,1,0,1,2,2,4,1,1,2,0,0,0,5,3,8
fa08,83,MUIR,POLI,PolSc-Comp,0,0,0,0,0,0,0,0,0,1,0,1,0,0,0,0,0,0,1,0,1
fa08,83,MUIR,POLI,PolSc-Intl,2,3,5,1,0,1,4,2,6,8,4,12,10,14,24,0,0,0,25,23,48
fa08,83,MUIR,POLI,PolSc-PLaw,2,3,5,0,0,0,4,5,9,4,5,9,9,2,11,0,0,0,19,15,34
fa08,83,MUIR,POLI,PolSc-PPol,1,0,1,0,0,0,1,1,2,1,0,1,2,0,2,0,0,0,5,1,6
fa08,83,MUIR,POLI,PolSc-Thry,0,0,0,0,0,0,0,0,0,3,1,4,1,1,2,0,0,0,4,2,6
fa08,83,MUIR,PSYC,Psychology,8,33,41,1,3,4,10,35,45,30,80,110,29,87,116,0,0,0,78,238,316
fa08,83,MUIR,RELI,Relig/Stu,0,1,1,0,0,0,1,0,1,3,0,3,2,1,3,0,0,0,6,2,8
fa08,83,MUIR,SE,Engin Sci,1,0,1,0,0,0,1,0,1,0,0,0,0,0,0,0,0,0,2,0,2
fa08,83,MUIR,SE,Struct Eng,6,4,10,1,1,2,10,1,11,12,6,18,23,8,31,0,0,0,52,20,72
fa08,83,MUIR,SIO,ErSc-Geol,1,0,1,0,0,0,0,0,0,0,0,0,0,0,0,0,0,0,1,0,1
fa08,83,MUIR,SOC,Sociology,1,4,5,0,0,0,1,7,8,2,20,22,7,23,30,0,0,0,11,54,65
fa08,83,MUIR,THEA,Dance,0,0,0,0,0,0,0,0,0,1,3,4,1,2,3,0,0,0,2,5,7
fa08,83,MUIR,THEA,Theatre,1,3,4,0,0,0,2,0,2,2,4,6,6,6,12,0,0,0,11,13,24
fa08,83,MUIR,TWS,ThirdWldSt,0,0,0,0,0,0,0,1,1,0,0,0,0,0,0,0,0,0,0,1,1
fa08,83,MUIR,UNAF,UndecBiolS,15,28,43,1,0,1,5,9,14,1,1,2,0,0,0,0,0,0,22,38,60
fa08,83,MUIR,UNAF,UndecHumAr,5,8,13,0,0,0,0,4,4,0,0,0,0,0,0,0,0,0,5,12,17
fa08,83,MUIR,UNAF,Undeclared,39,61,100,5,4,9,22,24,46,1,3,4,0,0,0,0,0,0,67,92,159
fa08,83,MUIR,UNAF,UndecPhysS,7,9,16,2,0,2,2,3,5,1,0,1,0,0,0,0,0,0,12,12,24
fa08,83,MUIR,UNAF,UndecSocSc,9,10,19,2,0,2,4,7,11,0,0,0,0,0,0,0,0,0,15,17,32
fa08,83,MUIR,USP,Urb Stu&Pl,0,1,1,0,0,0,0,0,0,5,6,11,6,4,10,0,0,0,11,11,22
fa08,83,MUIR,VIS,Art Hst/Cr,1,1,2,0,0,0,0,3,3,0,4,4,0,9,9,0,0,0,1,17,18
fa08,83,MUIR,VIS,Media,0,4,4,0,0,0,3,7,10,10,15,25,15,8,23,0,0,0,28,34,62
fa08,83,MUIR,VIS,Studio VA,1,1,2,0,0,0,1,0,1,0,3,3,2,7,9,0,0,0,4,11,15
fa08,83,MUIR,VIS,VA-CompArt,0,0,0,2,0,2,1,1,2,6,4,10,1,0,1,0,0,0,10,5,15
fa08,83,REVELLE,ANTH,Anth-Arch,0,0,0,0,0,0,0,0,0,0,1,1,0,1,1,0,0,0,0,2,2
fa08,83,REVELLE,ANTH,Anth-Biol,0,0,0,0,0,0,0,0,0,1,1,2,1,3,4,0,0,0,2,4,6
fa08,83,REVELLE,ANTH,Anth-Soci,1,2,3,0,0,0,1,0,1,0,4,4,1,0,1,0,0,0,3,6,9
fa08,83,REVELLE,ANTH,Anthropol,0,0,0,0,0,0,0,0,0,0,0,0,0,2,2,0,0,0,0,2,2
fa08,83,REVELLE,BENG,Bioen:Binf,0,0,0,0,0,0,0,0,0,0,0,0,1,0,1,0,0,0,1,0,1
fa08,83,REVELLE,BENG,Bioeng:PM,0,0,0,0,0,0,0,2,2,11,3,14,27,14,41,0,0,0,38,19,57
fa08,83,REVELLE,BENG,BioengBiot,7,5,12,0,0,0,2,1,3,4,3,7,14,8,22,0,0,0,27,17,44
fa08,83,REVELLE,BENG,Bioengin,8,2,10,0,1,1,3,2,5,5,5,10,13,6,19,0,0,0,29,16,45
fa08,83,REVELLE,BENG,Pr-BioenBf,0,0,0,0,0,0,0,0,0,1,0,1,0,0,0,0,0,0,1,0,1
fa08,83,REVELLE,BENG,Pr-BioenPM,22,14,36,1,1,2,11,6,17,11,4,15,1,2,3,0,0,0,46,27,73
fa08,83,REVELLE,BIOL,Anml Physl,0,0,0,0,0,0,0,0,0,0,0,0,1,2,3,0,0,0,1,2,3
fa08,83,REVELLE,BIOL,Bioc/CellB,20,28,48,0,1,1,25,23,48,41,49,90,65,73,138,0,0,0,151,174,325
fa08,83,REVELLE,BIOL,BiolBioinf,0,0,0,0,0,0,0,0,0,0,0,0,1,0,1,0,0,0,1,0,1
fa08,83,REVELLE,BIOL,Ec/Beh/Evo,0,3,3,0,0,0,1,1,2,2,3,5,5,6,11,0,0,0,8,13,21
fa08,83,REVELLE,BIOL,Genl Biol,21,27,48,2,1,3,14,38,52,24,38,62,40,69,109,0,0,0,101,173,274
fa08,83,REVELLE,BIOL,Human Bio,37,77,114,1,9,10,33,62,95,61,90,151,69,84,153,0,0,0,201,322,523
fa08,83,REVELLE,BIOL,Microbiol,2,2,4,1,0,1,4,1,5,5,8,13,4,10,14,0,0,0,16,21,37
fa08,83,REVELLE,BIOL,Molec Biol,4,2,6,0,0,0,6,4,10,14,5,19,11,17,28,0,0,0,35,28,63
fa08,83,REVELLE,BIOL,PhyslNeuro,11,10,21,0,1,1,6,20,26,17,17,34,16,33,49,0,0,0,50,81,131
fa08,83,REVELLE,BIOL,Pr-BioBinf,0,0,0,0,0,0,0,0,0,0,0,0,1,0,1,0,0,0,1,0,1
fa08,83,REVELLE,CENG,Chem Engin,7,3,10,0,0,0,3,4,7,11,4,15,10,8,18,0,0,0,31,19,50
fa08,83,REVELLE,CGS,CritGendSt,0,0,0,0,0,0,0,0,0,0,1,1,0,2,2,0,0,0,0,3,3
fa08,83,REVELLE,CHEM,Bioch/Chem,15,15,30,0,1,1,8,16,24,16,21,37,20,23,43,0,0,0,59,76,135
fa08,83,REVELLE,CHEM,Chem Phys,0,0,0,0,0,0,0,0,0,1,0,1,4,0,4,0,0,0,5,0,5
fa08,83,REVELLE,CHEM,Chemistry,1,8,9,0,0,0,4,3,7,11,4,15,6,7,13,0,0,0,22,22,44
fa08,83,REVELLE,CHEM,Chm/ErthSc,0,0,0,0,0,0,0,0,0,0,1,1,0,0,0,0,0,0,0,1,1
fa08,83,REVELLE,CHEM,Envir Chem,0,0,0,0,0,0,1,0,1,0,0,0,0,1,1,0,0,0,1,1,2
fa08,83,REVELLE,CHEM,MolecSynth,0,0,0,0,0,0,0,0,0,1,0,1,1,1,2,0,0,0,2,1,3
fa08,83,REVELLE,CHEM,Pharm Chem,7,14,21,0,3,3,6,8,14,9,14,23,18,23,41,0,0,0,40,62,102
fa08,83,REVELLE,CHIN,Chinese St,0,0,0,0,0,0,0,0,0,0,0,0,0,3,3,0,0,0,0,3,3
fa08,83,REVELLE,CLAS,Classic St,0,1,1,0,0,0,0,0,0,0,0,0,1,0,1,0,0,0,1,1,2
fa08,83,REVELLE,COGS,Cog Sci,0,5,5,0,0,0,2,3,5,3,0,3,2,3,5,0,0,0,7,11,18
fa08,83,REVELLE,COGS,CogSc/ClAs,0,0,0,0,0,0,1,0,1,1,0,1,0,0,0,0,0,0,2,0,2
fa08,83,REVELLE,COGS,CogSc/HCI,0,0,0,0,0,0,0,1,1,1,0,1,6,2,8,0,0,0,7,3,10
fa08,83,REVELLE,COGS,CogSc/HCog,0,0,0,0,0,0,0,0,0,1,1,2,0,1,1,0,0,0,1,2,3
fa08,83,REVELLE,COGS,CogSc/Neur,0,1,1,0,0,0,0,2,2,2,2,4,4,8,12,0,0,0,6,13,19
fa08,83,REVELLE,COMM,Communic,1,4,5,0,3,3,3,3,6,8,17,25,6,14,20,0,0,0,18,41,59
fa08,83,REVELLE,CSE,Comp Sci,9,3,12,0,0,0,8,0,8,12,2,14,24,1,25,0,0,0,53,6,59
fa08,83,REVELLE,CSE,CompEngCSE,10,0,10,0,1,1,5,0,5,5,0,5,4,1,5,0,0,0,24,2,26
fa08,83,REVELLE,CSE,CompScBinf,0,0,0,0,0,0,0,0,0,0,0,0,1,0,1,0,0,0,1,0,1
fa08,83,REVELLE,ECE,CompEngECE,1,0,1,1,0,1,1,0,1,2,0,2,2,0,2,0,0,0,7,0,7
fa08,83,REVELLE,ECE,Electr Eng,4,0,4,0,0,0,2,0,2,15,0,15,31,3,34,0,0,0,52,3,55
fa08,83,REVELLE,ECE,Engin Phys,0,0,0,0,0,0,0,0,0,1,0,1,0,0,0,0,0,0,1,0,1
fa08,83,REVELLE,ECE,Pr-ElecEng,0,0,0,0,0,0,0,0,0,0,0,0,1,0,1,0,0,0,1,0,1
fa08,83,REVELLE,ECE,Pr-EngPhys,0,0,0,0,0,0,1,0,1,0,0,0,1,0,1,0,0,0,2,0,2
fa08,83,REVELLE,ECON,Ec-Mth&Ecn,5,1,6,0,0,0,1,0,1,3,2,5,4,0,4,0,0,0,13,3,16
fa08,83,REVELLE,ECON,Econ-MgtSc,4,2,6,0,0,0,8,8,16,21,14,35,31,24,55,0,0,0,64,48,112
fa08,83,REVELLE,ECON,Economics,9,4,13,1,1,2,11,3,14,37,17,54,32,20,52,0,0,0,90,45,135
fa08,83,REVELLE,ERTH,ErSc-GeoPh,0,0,0,0,0,0,0,0,0,0,0,0,1,0,1,0,0,0,1,0,1
fa08,83,REVELLE,ERTH,ErthSc-Phy,0,0,0,0,0,0,0,0,0,0,0,0,1,0,1,0,0,0,1,0,1
fa08,83,REVELLE,ESYS,EnvSys(EB),0,1,1,0,0,0,0,1,1,0,6,6,3,5,8,0,0,0,3,13,16
fa08,83,REVELLE,ESYS,EnvSys(EC),0,0,0,0,0,0,0,0,0,1,0,1,0,0,0,0,0,0,1,0,1
fa08,83,REVELLE,ESYS,EnvSys(EP),1,0,1,0,0,0,0,1,1,1,0,1,1,2,3,0,0,0,3,3,6
fa08,83,REVELLE,ESYS,EnvSys(ES),1,0,1,0,0,0,1,0,1,0,0,0,2,1,3,0,0,0,4,1,5
fa08,83,REVELLE,ETHN,Ethnic St,0,0,0,0,0,0,0,0,0,0,0,0,0,3,3,0,0,0,0,3,3
fa08,83,REVELLE,GMST,German Stu,0,1,1,0,0,0,0,0,0,0,0,0,0,1,1,0,0,0,0,2,2
fa08,83,REVELLE,HDP,Human Dev,0,0,0,0,0,0,0,0,0,0,2,2,2,9,11,0,0,0,2,11,13
fa08,83,REVELLE,HDP,Pr-HumnDev,0,1,1,0,0,0,0,2,2,1,14,15,1,4,5,0,0,0,2,21,23
fa08,83,REVELLE,HIST,History,2,2,4,0,0,0,1,2,3,5,4,9,12,2,14,0,0,0,20,10,30
fa08,83,REVELLE,INTL,IntSt-Anth,0,0,0,0,0,0,0,0,0,0,0,0,0,3,3,0,0,0,0,3,3
fa08,83,REVELLE,INTL,IntSt-Econ,1,6,7,1,0,1,1,3,4,5,5,10,3,5,8,0,0,0,11,19,30
fa08,83,REVELLE,INTL,IntSt-Hist,0,0,0,0,0,0,0,0,0,0,1,1,1,1,2,0,0,0,1,2,3
fa08,83,REVELLE,INTL,IntSt-Ling,0,0,0,0,0,0,1,1,2,0,0,0,0,1,1,0,0,0,1,2,3
fa08,83,REVELLE,INTL,IntSt-Lit,0,0,0,0,0,0,0,0,0,0,0,0,0,1,1,0,0,0,0,1,1
fa08,83,REVELLE,INTL,IntSt-PolS,0,0,0,0,0,0,0,0,0,2,5,7,1,5,6,0,0,0,3,10,13
fa08,83,REVELLE,INTL,IntSt-Soc,0,1,1,0,0,0,0,4,4,0,1,1,0,2,2,0,0,0,0,8,8
fa08,83,REVELLE,ITAL,Italian St,0,0,0,0,0,0,0,0,0,0,0,0,0,1,1,0,0,0,0,1,1
fa08,83,REVELLE,JAPN,JapaneseSt,0,0,0,0,0,0,0,0,0,0,0,0,3,0,3,0,0,0,3,0,3
fa08,83,REVELLE,LING,Lang Stu,0,1,1,0,0,0,0,1,1,0,0,0,0,1,1,0,0,0,0,3,3
fa08,83,REVELLE,LING,Ling-CogLn,0,0,0,0,0,0,0,0,0,1,1,2,0,0,0,0,0,0,1,1,2
fa08,83,REVELLE,LING,Linguistcs,0,1,1,0,0,0,0,1,1,1,0,1,1,0,1,0,0,0,2,2,4
fa08,83,REVELLE,LIT,Lit/Compos,0,1,1,0,0,0,0,1,1,0,0,0,0,0,0,0,0,0,0,2,2
fa08,83,REVELLE,LIT,Lit/Engl,0,1,1,0,0,0,2,1,3,1,8,9,2,4,6,0,0,0,5,14,19
fa08,83,REVELLE,LIT,Lit/World,0,0,0,0,0,0,0,1,1,1,3,4,0,0,0,0,0,0,1,4,5
fa08,83,REVELLE,LIT,Lit/Writng,0,0,0,0,0,0,0,0,0,0,1,1,3,8,11,0,0,0,3,9,12
fa08,83,REVELLE,LIT,Pre-Lit/Wr,3,4,7,0,0,0,4,1,5,0,3,3,3,1,4,0,0,0,10,9,19
fa08,83,REVELLE,LIT,Russian Lt,0,0,0,0,0,0,0,0,0,0,0,0,0,1,1,0,0,0,0,1,1
fa08,83,REVELLE,LIT,Spanish Lt,0,0,0,0,0,0,0,2,2,0,1,1,0,2,2,0,0,0,0,5,5
fa08,83,REVELLE,MAE,Aerosp Eng,14,4,18,1,0,1,4,0,4,10,1,11,24,7,31,0,0,0,53,12,65
fa08,83,REVELLE,MAE,Engin Sci,0,1,1,0,0,0,0,0,0,1,0,1,0,0,0,0,0,0,1,1,2
fa08,83,REVELLE,MAE,Envir Eng,0,0,0,0,0,0,1,0,1,2,1,3,0,2,2,0,0,0,3,3,6
fa08,83,REVELLE,MAE,Mech Engin,13,4,17,0,0,0,8,1,9,16,2,18,44,9,53,0,0,0,81,16,97
fa08,83,REVELLE,MATH,Appld Math,0,1,1,0,0,0,0,0,0,1,1,2,2,0,2,0,0,0,3,2,5
fa08,83,REVELLE,MATH,Math/SecEd,1,1,2,0,0,0,1,1,2,1,1,2,0,2,2,0,0,0,3,5,8
fa08,83,REVELLE,MATH,Mathematcs,0,1,1,0,0,0,6,2,8,4,8,12,7,6,13,0,0,0,17,17,34
fa08,83,REVELLE,MATH,Mth-CompSc,0,0,0,0,0,0,0,0,0,0,0,0,1,0,1,0,0,0,1,0,1
fa08,83,REVELLE,MATH,Mth-Mth&Ec,1,0,1,0,0,0,4,0,4,2,0,2,6,1,7,0,0,0,13,1,14
fa08,83,REVELLE,MATH,Mth-SciCom,0,0,0,0,0,0,0,0,0,0,1,1,1,0,1,0,0,0,1,1,2
fa08,83,REVELLE,MATH,Mth/ApldSc,2,0,2,0,0,0,0,1,1,0,0,0,0,0,0,0,0,0,2,1,3
fa08,83,REVELLE,MATH,Pr-Math CS,1,0,1,0,0,0,0,0,0,2,0,2,0,0,0,0,0,0,3,0,3
fa08,83,REVELLE,MATH,Prob&Stats,0,0,0,0,0,0,1,0,1,0,1,1,0,0,0,0,0,0,1,1,2
fa08,83,REVELLE,MUS,Mu-CompArt,0,0,0,0,0,0,1,0,1,1,0,1,4,0,4,0,0,0,6,0,6
fa08,83,REVELLE,MUS,Music,3,0,3,0,0,0,1,0,1,0,1,1,2,1,3,0,0,0,6,2,8
fa08,83,REVELLE,MUS,Music Hum,0,0,0,0,0,0,0,0,0,1,0,1,0,0,0,0,0,0,1,0,1
fa08,83,REVELLE,PHIL,Philosophy,2,0,2,0,0,0,1,1,2,3,1,4,1,2,3,0,0,0,7,4,11
fa08,83,REVELLE,PHYS,Biophysics,0,0,0,0,0,0,0,0,0,1,1,2,1,0,1,0,0,0,2,1,3
fa08,83,REVELLE,PHYS,Gen Physcs,2,0,2,0,0,0,0,0,0,2,0,2,0,0,0,0,0,0,4,0,4
fa08,83,REVELLE,PHYS,Phy/ErthSc,0,1,1,0,0,0,0,0,0,0,0,0,0,0,0,0,0,0,0,1,1
fa08,83,REVELLE,PHYS,Phys/Astro,1,0,1,0,0,0,0,1,1,2,1,3,2,3,5,0,0,0,5,5,10
fa08,83,REVELLE,PHYS,Phys/Comp,0,0,0,0,0,0,1,0,1,0,0,0,0,0,0,0,0,0,1,0,1
fa08,83,REVELLE,PHYS,Phys/Mtrls,0,0,0,0,0,0,0,0,0,0,0,0,1,0,1,0,0,0,1,0,1
fa08,83,REVELLE,PHYS,Physics,7,0,7,0,0,0,2,0,2,2,1,3,6,1,7,0,0,0,17,2,19
fa08,83,REVELLE,POLI,Polit Sci,0,4,4,0,0,0,5,2,7,5,4,9,9,5,14,0,0,0,19,15,34
fa08,83,REVELLE,POLI,PolSc-Amer,1,1,2,0,0,0,0,2,2,0,1,1,3,2,5,0,0,0,4,6,10
fa08,83,REVELLE,POLI,PolSc-Comp,0,0,0,0,0,0,0,0,0,0,1,1,1,0,1,0,0,0,1,1,2
fa08,83,REVELLE,POLI,PolSc-Intl,1,1,2,0,0,0,2,3,5,2,3,5,9,3,12,0,0,0,14,10,24
fa08,83,REVELLE,POLI,PolSc-PLaw,1,0,1,0,0,0,1,3,4,0,1,1,1,4,5,0,0,0,3,8,11
fa08,83,REVELLE,POLI,PolSc-PPol,0,1,1,0,0,0,0,1,1,0,0,0,0,0,0,0,0,0,0,2,2
fa08,83,REVELLE,POLI,PolSc-Thry,0,0,0,0,0,0,0,0,0,0,0,0,0,1,1,0,0,0,0,1,1
fa08,83,REVELLE,PSYC,Psychology,6,17,23,1,3,4,11,23,34,20,55,75,27,70,97,0,0,0,65,168,233
fa08,83,REVELLE,RELI,Relig/Stu,0,1,1,0,0,0,0,0,0,0,0,0,0,0,0,0,0,0,0,1,1
fa08,83,REVELLE,SE,Engin Sci,0,0,0,0,0,0,0,0,0,0,0,0,1,0,1,0,0,0,1,0,1
fa08,83,REVELLE,SE,Struct Eng,8,3,11,1,0,1,6,6,12,13,5,18,18,4,22,0,0,0,46,18,64
fa08,83,REVELLE,SIO,ErSc-Geol,0,0,0,0,0,0,0,0,0,0,1,1,1,1,2,0,0,0,1,2,3
fa08,83,REVELLE,SOC,Sociology,1,1,2,0,0,0,1,3,4,2,7,9,2,7,9,0,0,0,6,18,24
fa08,83,REVELLE,THEA,Dance,0,0,0,0,0,0,0,0,0,0,2,2,1,0,1,0,0,0,1,2,3
fa08,83,REVELLE,THEA,Theatre,0,0,0,0,1,1,0,0,0,2,3,5,1,2,3,0,0,0,3,6,9
fa08,83,REVELLE,UNAF,Limited St,0,0,0,0,0,0,0,0,0,0,0,0,0,0,0,9,12,21,9,12,21
fa08,83,REVELLE,UNAF,Spec-Emply,0,0,0,0,0,0,0,0,0,0,0,0,0,0,0,4,4,8,4,4,8
fa08,83,REVELLE,UNAF,UndecBiolS,16,23,39,0,1,1,14,9,23,5,2,7,0,0,0,0,0,0,35,35,70
fa08,83,REVELLE,UNAF,UndecHumAr,1,8,9,0,0,0,1,4,5,0,0,0,0,0,0,0,0,0,2,12,14
fa08,83,REVELLE,UNAF,Undeclared,29,33,62,1,4,5,14,20,34,6,2,8,0,0,0,0,0,0,50,59,109
fa08,83,REVELLE,UNAF,UndecPhysS,4,3,7,0,0,0,1,2,3,2,0,2,0,0,0,0,0,0,7,5,12
fa08,83,REVELLE,UNAF,UndecSocSc,4,1,5,1,0,1,2,1,3,0,2,2,0,0,0,0,0,0,7,4,11
fa08,83,REVELLE,USP,Urb Stu&Pl,0,0,0,0,0,0,0,1,1,2,1,3,4,3,7,0,0,0,6,5,11
fa08,83,REVELLE,VIS,Art Hst/Cr,0,2,2,0,0,0,0,0,0,0,3,3,1,3,4,0,0,0,1,8,9
fa08,83,REVELLE,VIS,Media,0,1,1,0,0,0,2,2,4,1,3,4,7,3,10,0,0,0,10,9,19
fa08,83,REVELLE,VIS,Studio VA,0,1,1,0,0,0,0,0,0,0,1,1,1,3,4,0,0,0,1,5,6
fa08,83,REVELLE,VIS,VA-CompArt,1,0,1,0,0,0,0,0,0,0,0,0,0,0,0,0,0,0,1,0,1
fa08,83,ROOSEVELT,ANTH,Anth-Arch,0,5,5,0,0,0,0,1,1,3,4,7,0,5,5,0,0,0,3,15,18
fa08,83,ROOSEVELT,ANTH,Anth-Biol,0,1,1,0,0,0,0,0,0,1,2,3,2,12,14,0,0,0,3,15,18
fa08,83,ROOSEVELT,ANTH,Anth-Soci,0,2,2,0,0,0,0,0,0,0,1,1,0,2,2,0,0,0,0,5,5
fa08,83,ROOSEVELT,ANTH,Anthropol,0,0,0,0,0,0,0,0,0,0,0,0,0,2,2,0,0,0,0,2,2
fa08,83,ROOSEVELT,BENG,Bioeng:PM,0,0,0,0,0,0,0,0,0,1,0,1,4,5,9,0,0,0,5,5,10
fa08,83,ROOSEVELT,BENG,BioengBiot,2,4,6,0,0,0,1,0,1,0,0,0,4,3,7,0,0,0,7,7,14
fa08,83,ROOSEVELT,BENG,Bioengin,4,1,5,0,0,0,0,0,0,3,2,5,3,0,3,0,0,0,10,3,13
fa08,83,ROOSEVELT,BENG,Pr-BioenBf,0,1,1,0,0,0,0,0,0,0,0,0,0,0,0,0,0,0,0,1,1
fa08,83,ROOSEVELT,BENG,Pr-BioenPM,10,9,19,1,0,1,5,2,7,3,1,4,2,0,2,0,0,0,21,12,33
fa08,83,ROOSEVELT,BIOL,Anml Physl,0,0,0,0,0,0,0,1,1,0,1,1,1,2,3,0,0,0,1,4,5
fa08,83,ROOSEVELT,BIOL,Bioc/CellB,5,15,20,0,3,3,8,12,20,8,20,28,21,28,49,0,0,0,42,78,120
fa08,83,ROOSEVELT,BIOL,Ec/Beh/Evo,2,2,4,1,0,1,1,1,2,0,8,8,5,3,8,0,0,0,9,14,23
fa08,83,ROOSEVELT,BIOL,Genl Biol,9,16,25,0,0,0,6,11,17,17,23,40,18,33,51,0,0,0,50,83,133
fa08,83,ROOSEVELT,BIOL,Human Bio,17,37,54,1,4,5,13,32,45,20,29,49,21,47,68,0,0,0,72,149,221
fa08,83,ROOSEVELT,BIOL,Microbiol,0,0,0,0,0,0,1,3,4,2,0,2,2,6,8,0,0,0,5,9,14
fa08,83,ROOSEVELT,BIOL,Molec Biol,2,6,8,0,0,0,0,3,3,3,4,7,6,5,11,0,0,0,11,18,29
fa08,83,ROOSEVELT,BIOL,PhyslNeuro,5,12,17,0,0,0,1,2,3,7,11,18,8,14,22,0,0,0,21,39,60
fa08,83,ROOSEVELT,CENG,Chem Engin,4,1,5,0,0,0,0,2,2,2,3,5,1,6,7,0,0,0,7,12,19
fa08,83,ROOSEVELT,CGS,CritGendSt,0,0,0,0,0,0,0,0,0,0,2,2,0,1,1,0,0,0,0,3,3
fa08,83,ROOSEVELT,CHEM,Bioch/Chem,5,6,11,1,0,1,2,6,8,11,6,17,3,8,11,0,0,0,22,26,48
fa08,83,ROOSEVELT,CHEM,Chem Phys,1,0,1,0,0,0,0,0,0,0,0,0,0,0,0,0,0,0,1,0,1
fa08,83,ROOSEVELT,CHEM,Chemistry,3,6,9,0,0,0,1,2,3,2,2,4,4,1,5,0,0,0,10,11,21
fa08,83,ROOSEVELT,CHEM,Envir Chem,1,0,1,0,0,0,0,0,0,1,0,1,0,0,0,0,0,0,2,0,2
fa08,83,ROOSEVELT,CHEM,MolecSynth,0,0,0,0,0,0,0,0,0,0,0,0,1,0,1,0,0,0,1,0,1
fa08,83,ROOSEVELT,CHEM,Pharm Chem,2,11,13,0,0,0,0,3,3,2,4,6,11,6,17,0,0,0,15,24,39
fa08,83,ROOSEVELT,CHEM,Pr-Bioinf,0,0,0,0,0,0,0,0,0,1,0,1,0,0,0,0,0,0,1,0,1
fa08,83,ROOSEVELT,CHIN,Chinese St,0,2,2,0,0,0,0,0,0,1,0,1,3,2,5,0,0,0,4,4,8
fa08,83,ROOSEVELT,CLAS,Classic St,0,1,1,0,0,0,0,1,1,0,0,0,1,0,1,0,0,0,1,2,3
fa08,83,ROOSEVELT,COGS,Cog Sci,2,2,4,0,0,0,0,7,7,6,4,10,1,7,8,0,0,0,9,20,29
fa08,83,ROOSEVELT,COGS,CogSc/Comp,1,0,1,0,0,0,0,0,0,1,0,1,0,1,1,0,0,0,2,1,3
fa08,83,ROOSEVELT,COGS,CogSc/HCI,0,0,0,0,0,0,0,0,0,2,2,4,1,3,4,0,0,0,3,5,8
fa08,83,ROOSEVELT,COGS,CogSc/HCog,0,0,0,0,0,0,0,0,0,0,0,0,1,1,2,0,0,0,1,1,2
fa08,83,ROOSEVELT,COGS,CogSc/Neur,0,1,1,0,0,0,0,3,3,0,5,5,2,2,4,0,0,0,2,11,13
fa08,83,ROOSEVELT,COMM,Communic,5,19,24,1,0,1,6,20,26,19,55,74,10,48,58,0,0,0,41,142,183
fa08,83,ROOSEVELT,CSE,Comp Sci,11,1,12,1,0,1,2,0,2,8,0,8,16,3,19,0,0,0,38,4,42
fa08,83,ROOSEVELT,CSE,CompEngCSE,3,2,5,0,0,0,2,1,3,5,0,5,3,1,4,0,0,0,13,4,17
fa08,83,ROOSEVELT,CSE,Pr-Comp Sc,0,1,1,0,0,0,0,0,0,0,0,0,0,0,0,0,0,0,0,1,1
fa08,83,ROOSEVELT,ECE,CompEngECE,2,0,2,0,0,0,1,0,1,2,0,2,0,0,0,0,0,0,5,0,5
fa08,83,ROOSEVELT,ECE,Electr Eng,8,3,11,1,0,1,1,2,3,11,2,13,21,4,25,0,0,0,42,11,53
fa08,83,ROOSEVELT,ECE,Pr-EngPhys,2,0,2,0,0,0,0,0,0,0,0,0,0,0,0,0,0,0,2,0,2
fa08,83,ROOSEVELT,ECON,Ec-Mth&Ecn,5,1,6,0,0,0,0,2,2,3,0,3,0,4,4,0,0,0,8,7,15
fa08,83,ROOSEVELT,ECON,Econ-MgtSc,11,8,19,2,0,2,10,13,23,27,21,48,45,27,72,0,0,0,95,69,164
fa08,83,ROOSEVELT,ECON,Economics,24,15,39,1,1,2,10,8,18,62,31,93,45,31,76,0,0,0,142,86,228
fa08,83,ROOSEVELT,ERTH,ErSc-Geol,0,0,0,0,0,0,0,0,0,0,1,1,1,0,1,0,0,0,1,1,2
fa08,83,ROOSEVELT,ESYS,EnvSys(EB),0,3,3,0,0,0,0,2,2,0,2,2,3,3,6,0,0,0,3,10,13
fa08,83,ROOSEVELT,ESYS,EnvSys(EC),0,1,1,0,0,0,0,0,0,1,1,2,2,1,3,0,0,0,3,3,6
fa08,83,ROOSEVELT,ESYS,EnvSys(EP),0,3,3,0,0,0,1,1,2,1,2,3,0,1,1,0,0,0,2,7,9
fa08,83,ROOSEVELT,ESYS,EnvSys(ES),1,2,3,0,0,0,1,0,1,1,0,1,2,1,3,0,0,0,5,3,8
fa08,83,ROOSEVELT,ETHN,Ethnic St,0,0,0,0,0,0,0,3,3,0,6,6,3,8,11,0,0,0,3,17,20
fa08,83,ROOSEVELT,GMST,German Stu,0,0,0,0,0,0,0,1,1,0,0,0,0,0,0,0,0,0,0,1,1
fa08,83,ROOSEVELT,HDP,Human Dev,0,0,0,0,0,0,0,0,0,1,8,9,1,12,13,0,0,0,2,20,22
fa08,83,ROOSEVELT,HDP,Pr-HumnDev,0,0,0,0,0,0,0,6,6,1,5,6,0,4,4,0,0,0,1,15,16
fa08,83,ROOSEVELT,HIST,History,7,3,10,0,0,0,3,7,10,12,13,25,17,21,38,0,0,0,39,44,83
fa08,83,ROOSEVELT,INTL,Int-5yrEC,0,0,0,0,0,0,0,1,1,0,0,0,0,0,0,0,0,0,0,1,1
fa08,83,ROOSEVELT,INTL,IntSt-Anth,0,3,3,0,0,0,0,2,2,0,3,3,0,7,7,0,0,0,0,15,15
fa08,83,ROOSEVELT,INTL,IntSt-Econ,9,13,22,0,0,0,7,15,22,16,26,42,10,24,34,0,0,0,42,78,120
fa08,83,ROOSEVELT,INTL,IntSt-Hist,1,5,6,0,0,0,1,2,3,1,6,7,3,5,8,0,0,0,6,18,24
fa08,83,ROOSEVELT,INTL,IntSt-Ling,0,1,1,0,0,0,1,2,3,0,4,4,0,3,3,0,0,0,1,10,11
fa08,83,ROOSEVELT,INTL,IntSt-Lit,0,0,0,0,0,0,0,3,3,0,3,3,0,1,1,0,0,0,0,7,7
fa08,83,ROOSEVELT,INTL,IntSt-PolS,2,13,15,0,1,1,3,13,16,15,23,38,14,36,50,0,0,0,34,86,120
fa08,83,ROOSEVELT,INTL,IntSt-Soc,0,7,7,0,0,0,0,12,12,1,15,16,2,12,14,0,0,0,3,46,49
fa08,83,ROOSEVELT,JAPN,JapaneseSt,0,1,1,0,0,0,0,1,1,2,1,3,2,4,6,0,0,0,4,7,11
fa08,83,ROOSEVELT,JUDA,Judaic Stu,1,1,2,0,0,0,0,0,0,0,1,1,0,0,0,0,0,0,1,2,3
fa08,83,ROOSEVELT,LATI,LatinAm St,0,0,0,0,0,0,0,0,0,0,1,1,0,0,0,0,0,0,0,1,1
fa08,83,ROOSEVELT,LING,Lang Stu,0,2,2,0,0,0,0,3,3,0,0,0,2,1,3,0,0,0,2,6,8
fa08,83,ROOSEVELT,LING,Ling-LSoc,1,0,1,0,0,0,0,0,0,1,2,3,2,2,4,0,0,0,4,4,8
fa08,83,ROOSEVELT,LING,Linguistcs,0,1,1,0,0,0,1,1,2,2,3,5,3,4,7,0,0,0,6,9,15
fa08,83,ROOSEVELT,LIT,French Lit,0,0,0,0,0,0,0,0,0,0,0,0,0,1,1,0,0,0,0,1,1
fa08,83,ROOSEVELT,LIT,Lit/Compos,0,1,1,0,0,0,1,1,2,0,1,1,0,0,0,0,0,0,1,3,4
fa08,83,ROOSEVELT,LIT,Lit/CultSt,0,0,0,0,0,0,0,0,0,0,0,0,0,1,1,0,0,0,0,1,1
fa08,83,ROOSEVELT,LIT,Lit/Engl,2,7,9,0,0,0,1,2,3,1,4,5,3,6,9,0,0,0,7,19,26
fa08,83,ROOSEVELT,LIT,Lit/World,0,1,1,0,0,0,0,0,0,0,1,1,0,3,3,0,0,0,0,5,5
fa08,83,ROOSEVELT,LIT,Lit/Writng,0,0,0,0,0,0,0,0,0,1,1,2,3,3,6,0,0,0,4,4,8
fa08,83,ROOSEVELT,LIT,Pre-Lit/Wr,2,7,9,0,0,0,1,4,5,1,7,8,3,4,7,0,0,0,7,22,29
fa08,83,ROOSEVELT,LIT,Spanish Lt,0,2,2,0,0,0,0,0,0,0,2,2,1,3,4,0,0,0,1,7,8
fa08,83,ROOSEVELT,MAE,Aerosp Eng,7,2,9,0,0,0,5,1,6,5,2,7,9,3,12,0,0,0,26,8,34
fa08,83,ROOSEVELT,MAE,Engin Sci,1,0,1,0,0,0,0,0,0,0,0,0,0,0,0,0,0,0,1,0,1
fa08,83,ROOSEVELT,MAE,Envir Eng,4,0,4,0,0,0,0,0,0,1,2,3,0,0,0,0,0,0,5,2,7
fa08,83,ROOSEVELT,MAE,Mech Engin,12,2,14,1,0,1,6,0,6,8,3,11,21,9,30,0,0,0,48,14,62
fa08,83,ROOSEVELT,MATH,Appld Math,3,0,3,0,0,0,0,0,0,0,1,1,3,0,3,0,0,0,6,1,7
fa08,83,ROOSEVELT,MATH,Math/SecEd,0,1,1,0,0,0,0,1,1,0,0,0,0,1,1,0,0,0,0,3,3
fa08,83,ROOSEVELT,MATH,Mathematcs,3,1,4,0,0,0,0,1,1,4,3,7,3,3,6,0,0,0,10,8,18
fa08,83,ROOSEVELT,MATH,Mth-CompSc,0,0,0,0,0,0,1,0,1,1,1,2,0,0,0,0,0,0,2,1,3
fa08,83,ROOSEVELT,MATH,Mth-Mth&Ec,2,0,2,0,1,1,1,0,1,2,2,4,4,4,8,0,0,0,9,7,16
fa08,83,ROOSEVELT,MATH,Mth-SciCom,0,0,0,0,0,0,0,0,0,0,0,0,0,1,1,0,0,0,0,1,1
fa08,83,ROOSEVELT,MATH,Mth/ApldSc,0,0,0,0,0,0,0,0,0,0,0,0,1,1,2,0,0,0,1,1,2
fa08,83,ROOSEVELT,MATH,Pr-Math CS,1,0,1,0,0,0,0,0,0,0,0,0,0,0,0,0,0,0,1,0,1
fa08,83,ROOSEVELT,MUS,Mu-CompArt,0,1,1,0,0,0,2,0,2,4,0,4,3,0,3,0,0,0,9,1,10
fa08,83,ROOSEVELT,MUS,Music,2,0,2,0,0,0,0,0,0,3,3,6,1,0,1,0,0,0,6,3,9
fa08,83,ROOSEVELT,MUS,Music Hum,0,1,1,0,0,0,0,0,0,0,0,0,0,0,0,0,0,0,0,1,1
fa08,83,ROOSEVELT,PHIL,Philosophy,2,1,3,0,0,0,1,0,1,3,2,5,3,0,3,0,0,0,9,3,12
fa08,83,ROOSEVELT,PHYS,Biophysics,0,1,1,0,0,0,0,0,0,0,1,1,2,0,2,0,0,0,2,2,4
fa08,83,ROOSEVELT,PHYS,Phys/Astro,1,0,1,0,0,0,0,0,0,1,1,2,0,0,0,0,0,0,2,1,3
fa08,83,ROOSEVELT,PHYS,Phys/Comp,0,0,0,0,0,0,0,0,0,1,1,2,1,0,1,0,0,0,2,1,3
fa08,83,ROOSEVELT,PHYS,Physics,1,0,1,0,0,0,2,1,3,2,1,3,1,0,1,0,0,0,6,2,8
fa08,83,ROOSEVELT,POLI,Polit Sci,3,9,12,0,2,2,3,10,13,17,26,43,24,21,45,0,0,0,47,68,115
fa08,83,ROOSEVELT,POLI,PolSc-Amer,1,2,3,0,0,0,2,1,3,1,2,3,0,2,2,0,0,0,4,7,11
fa08,83,ROOSEVELT,POLI,PolSc-Comp,1,0,1,0,0,0,0,0,0,0,1,1,3,2,5,0,0,0,4,3,7
fa08,83,ROOSEVELT,POLI,PolSc-Intl,5,12,17,0,1,1,4,15,19,11,21,32,14,20,34,0,0,0,34,69,103
fa08,83,ROOSEVELT,POLI,PolSc-PLaw,3,4,7,1,1,2,1,10,11,8,8,16,3,4,7,0,0,0,16,27,43
fa08,83,ROOSEVELT,POLI,PolSc-PPol,0,1,1,0,0,0,0,0,0,0,0,0,2,2,4,0,0,0,2,3,5
fa08,83,ROOSEVELT,POLI,PolSc-Thry,0,0,0,0,0,0,0,0,0,0,4,4,0,1,1,0,0,0,0,5,5
fa08,83,ROOSEVELT,PSYC,Psychology,7,27,34,1,1,2,9,31,40,20,65,85,15,54,69,0,0,0,52,178,230
fa08,83,ROOSEVELT,RELI,Relig/Stu,0,1,1,0,0,0,0,0,0,1,0,1,0,1,1,0,0,0,1,2,3
fa08,83,ROOSEVELT,RUSS,Russ&SovSt,1,0,1,0,0,0,0,0,0,1,0,1,0,1,1,0,0,0,2,1,3
fa08,83,ROOSEVELT,SE,Engin Sci,1,1,2,0,0,0,0,0,0,0,0,0,0,0,0,0,0,0,1,1,2
fa08,83,ROOSEVELT,SE,Struct Eng,12,1,13,1,0,1,6,2,8,8,2,10,16,6,22,0,0,0,43,11,54
fa08,83,ROOSEVELT,SIO,ErSc-Geoch,1,0,1,0,0,0,0,0,0,0,0,0,0,0,0,0,0,0,1,0,1
fa08,83,ROOSEVELT,SIO,ErSc-Geol,2,1,3,0,0,0,0,0,0,0,0,0,0,0,0,0,0,0,2,1,3
fa08,83,ROOSEVELT,SOC,Sociology,2,5,7,0,1,1,0,4,4,9,27,36,3,13,16,0,0,0,14,50,64
fa08,83,ROOSEVELT,THEA,Dance,0,0,0,0,0,0,0,0,0,1,0,1,0,1,1,0,0,0,1,1,2
fa08,83,ROOSEVELT,THEA,Theatre,1,4,5,0,1,1,1,1,2,1,6,7,2,6,8,0,0,0,5,18,23
fa08,83,ROOSEVELT,TWS,ThirdWldSt,0,3,3,0,0,0,0,1,1,0,2,2,0,2,2,0,0,0,0,8,8
fa08,83,ROOSEVELT,UNAF,UndecBiolS,9,19,28,0,0,0,3,8,11,1,2,3,0,0,0,0,0,0,13,29,42
fa08,83,ROOSEVELT,UNAF,UndecHumAr,1,19,20,0,0,0,0,8,8,1,1,2,0,0,0,0,0,0,2,28,30
fa08,83,ROOSEVELT,UNAF,Undeclared,34,78,112,2,2,4,19,23,42,2,3,5,0,0,0,0,0,0,57,106,163
fa08,83,ROOSEVELT,UNAF,UndecPhysS,7,7,14,1,0,1,1,1,2,0,0,0,0,0,0,0,0,0,9,8,17
fa08,83,ROOSEVELT,UNAF,UndecSocSc,2,13,15,0,0,0,5,5,10,1,1,2,0,0,0,0,0,0,8,19,27
fa08,83,ROOSEVELT,USP,Urb Stu&Pl,0,1,1,0,0,0,0,4,4,4,3,7,6,5,11,0,0,0,10,13,23
fa08,83,ROOSEVELT,VIS,Art Hst/Cr,0,3,3,0,0,0,0,1,1,1,11,12,0,6,6,0,0,0,1,21,22
fa08,83,ROOSEVELT,VIS,Media,1,2,3,0,2,2,4,3,7,8,9,17,10,5,15,0,0,0,23,21,44
fa08,83,ROOSEVELT,VIS,Studio VA,1,3,4,0,0,0,0,6,6,1,2,3,1,2,3,0,0,0,3,13,16
fa08,83,ROOSEVELT,VIS,VA-CompArt,0,1,1,1,0,1,0,2,2,2,0,2,1,1,2,0,0,0,4,4,8
fa08,83,SIXTH,ANTH,Anth-Arch,0,0,0,0,0,0,0,0,0,2,2,4,0,0,0,0,0,0,2,2,4
fa08,83,SIXTH,ANTH,Anth-Biol,0,2,2,0,1,1,0,1,1,1,3,4,2,2,4,0,0,0,3,9,12
fa08,83,SIXTH,ANTH,Anth-Soci,0,0,0,0,0,0,1,1,2,1,1,2,2,1,3,0,0,0,4,3,7
fa08,83,SIXTH,ANTH,Anthropol,0,0,0,0,0,0,0,0,0,1,0,1,0,2,2,0,0,0,1,2,3
fa08,83,SIXTH,BENG,Bioen:Binf,0,0,0,0,0,0,0,0,0,0,0,0,1,0,1,0,0,0,1,0,1
fa08,83,SIXTH,BENG,Bioeng:PM,0,0,0,0,0,0,1,0,1,2,1,3,7,4,11,0,0,0,10,5,15
fa08,83,SIXTH,BENG,BioengBiot,8,2,10,0,0,0,1,0,1,2,1,3,6,3,9,0,0,0,17,6,23
fa08,83,SIXTH,BENG,Bioengin,1,1,2,0,0,0,3,1,4,2,1,3,8,3,11,0,0,0,14,6,20
fa08,83,SIXTH,BENG,Pr-Bioeng,1,0,1,0,0,0,0,0,0,0,0,0,0,0,0,0,0,0,1,0,1
fa08,83,SIXTH,BENG,Pr-BioenPM,8,3,11,1,1,2,4,0,4,7,0,7,1,0,1,0,0,0,21,4,25
fa08,83,SIXTH,BIOL,Anml Physl,0,0,0,0,0,0,0,0,0,0,1,1,2,0,2,0,0,0,2,1,3
fa08,83,SIXTH,BIOL,Bioc/CellB,10,4,14,0,0,0,12,8,20,19,19,38,17,26,43,0,0,0,58,57,115
fa08,83,SIXTH,BIOL,BiolBioinf,0,0,0,0,0,0,0,0,0,0,0,0,1,1,2,0,0,0,1,1,2
fa08,83,SIXTH,BIOL,Ec/Beh/Evo,1,3,4,0,0,0,1,5,6,2,4,6,2,5,7,0,0,0,6,17,23
fa08,83,SIXTH,BIOL,Genl Biol,6,9,15,0,1,1,8,15,23,30,19,49,19,23,42,0,0,0,63,67,130
fa08,83,SIXTH,BIOL,Human Bio,23,32,55,1,3,4,19,21,40,28,45,73,20,23,43,0,0,0,91,124,215
fa08,83,SIXTH,BIOL,Microbiol,0,2,2,1,0,1,1,4,5,2,3,5,1,1,2,0,0,0,5,10,15
fa08,83,SIXTH,BIOL,Molec Biol,0,5,5,0,0,0,5,2,7,7,2,9,5,3,8,0,0,0,17,12,29
fa08,83,SIXTH,BIOL,PhyslNeuro,6,5,11,1,1,2,3,4,7,9,8,17,10,3,13,0,0,0,29,21,50
fa08,83,SIXTH,CENG,Chem Engin,3,0,3,1,0,1,1,0,1,8,2,10,5,3,8,0,0,0,18,5,23
fa08,83,SIXTH,CGS,CritGendSt,0,0,0,0,0,0,0,1,1,0,0,0,0,0,0,0,0,0,0,1,1
fa08,83,SIXTH,CHEM,Bioch/Chem,5,7,12,0,2,2,2,3,5,6,6,12,8,5,13,0,0,0,21,23,44
fa08,83,SIXTH,CHEM,Chem Educ,0,0,0,0,0,0,1,0,1,0,0,0,1,0,1,0,0,0,2,0,2
fa08,83,SIXTH,CHEM,Chemistry,3,3,6,0,0,0,3,2,5,5,4,9,3,1,4,0,0,0,14,10,24
fa08,83,SIXTH,CHEM,Envir Chem,0,1,1,0,0,0,0,0,0,0,1,1,1,0,1,0,0,0,1,2,3
fa08,83,SIXTH,CHEM,MolecSynth,0,0,0,0,0,0,1,0,1,1,1,2,0,0,0,0,0,0,2,1,3
fa08,83,SIXTH,CHEM,Pharm Chem,5,11,16,0,1,1,3,10,13,4,10,14,7,6,13,0,0,0,19,38,57
fa08,83,SIXTH,CHIN,Chinese St,0,0,0,0,0,0,1,0,1,0,0,0,0,1,1,0,0,0,1,1,2
fa08,83,SIXTH,CLAS,Classic St,0,0,0,0,0,0,0,0,0,1,0,1,0,0,0,0,0,0,1,0,1
fa08,83,SIXTH,COGS,Cog Sci,1,1,2,1,1,2,3,0,3,6,5,11,6,3,9,0,0,0,17,10,27
fa08,83,SIXTH,COGS,CogSc/ClAs,0,1,1,0,0,0,0,0,0,0,0,0,0,0,0,0,0,0,0,1,1
fa08,83,SIXTH,COGS,CogSc/Comp,0,0,0,0,0,0,0,0,0,0,0,0,1,0,1,0,0,0,1,0,1
fa08,83,SIXTH,COGS,CogSc/HCI,0,0,0,0,0,0,1,1,2,3,0,3,5,2,7,0,0,0,9,3,12
fa08,83,SIXTH,COGS,CogSc/HCog,0,0,0,0,0,0,0,1,1,0,0,0,1,0,1,0,0,0,1,1,2
fa08,83,SIXTH,COGS,CogSc/Neur,0,0,0,0,0,0,0,2,2,0,1,1,2,1,3,0,0,0,2,4,6
fa08,83,SIXTH,COMM,Communic,3,14,17,2,0,2,8,13,21,17,45,62,17,18,35,0,0,0,47,90,137
fa08,83,SIXTH,CSE,Comp Sci,21,4,25,2,0,2,12,4,16,23,5,28,30,8,38,0,0,0,88,21,109
fa08,83,SIXTH,CSE,CompEngCSE,9,0,9,5,0,5,9,0,9,12,0,12,10,2,12,0,0,0,45,2,47
fa08,83,SIXTH,CSE,CompScBinf,0,0,0,0,0,0,0,0,0,0,1,1,0,0,0,0,0,0,0,1,1
fa08,83,SIXTH,ECE,CompEngECE,2,0,2,2,0,2,3,0,3,4,0,4,5,0,5,0,0,0,16,0,16
fa08,83,SIXTH,ECE,Electr Eng,17,4,21,0,0,0,8,2,10,15,3,18,20,4,24,0,0,0,60,13,73
fa08,83,SIXTH,ECE,Engin Phys,0,0,0,0,0,0,0,0,0,1,0,1,1,0,1,0,0,0,2,0,2
fa08,83,SIXTH,ECE,Pr-CmEnECE,0,1,1,0,0,0,0,0,0,0,0,0,0,0,0,0,0,0,0,1,1
fa08,83,SIXTH,ECE,Pr-ElecEng,0,0,0,0,0,0,0,0,0,0,0,0,1,0,1,0,0,0,1,0,1
fa08,83,SIXTH,ECE,Pr-EngPhys,1,0,1,0,0,0,0,0,0,1,1,2,0,0,0,0,0,0,2,1,3
fa08,83,SIXTH,ECON,Ec-Mth&Ecn,0,2,2,0,0,0,2,0,2,3,1,4,3,0,3,0,0,0,8,3,11
fa08,83,SIXTH,ECON,Econ-MgtSc,4,3,7,1,0,1,17,9,26,41,18,59,30,11,41,0,0,0,93,41,134
fa08,83,SIXTH,ECON,Economics,19,9,28,6,3,9,13,8,21,68,35,103,36,20,56,0,0,0,142,75,217
fa08,83,SIXTH,ERTH,ErSc-Geol,0,0,0,0,0,0,0,0,0,0,0,0,1,0,1,0,0,0,1,0,1
fa08,83,SIXTH,ESYS,EnvSys(EB),0,0,0,0,0,0,2,3,5,1,2,3,3,3,6,0,0,0,6,8,14
fa08,83,SIXTH,ESYS,EnvSys(EC),0,0,0,0,0,0,0,0,0,2,0,2,0,0,0,0,0,0,2,0,2
fa08,83,SIXTH,ESYS,EnvSys(EP),0,3,3,0,0,0,1,3,4,1,1,2,2,1,3,0,0,0,4,8,12
fa08,83,SIXTH,ESYS,EnvSys(ES),0,0,0,0,0,0,0,1,1,0,1,1,0,1,1,0,0,0,0,3,3
fa08,83,SIXTH,ETHN,Ethnic St,0,0,0,0,0,0,1,0,1,3,2,5,2,4,6,0,0,0,6,6,12
fa08,83,SIXTH,HDP,Human Dev,0,0,0,0,0,0,0,0,0,1,3,4,0,5,5,0,0,0,1,8,9
fa08,83,SIXTH,HDP,Pr-HumnDev,0,2,2,0,1,1,0,7,7,1,7,8,0,0,0,0,0,0,1,17,18
fa08,83,SIXTH,HIST,History,2,0,2,0,0,0,2,1,3,4,3,7,6,3,9,0,0,0,14,7,21
fa08,83,SIXTH,INTL,IntSt-Anth,0,0,0,0,0,0,0,0,0,1,0,1,2,1,3,0,0,0,3,1,4
fa08,83,SIXTH,INTL,IntSt-Econ,1,4,5,2,0,2,0,8,8,14,7,21,7,6,13,0,0,0,24,25,49
fa08,83,SIXTH,INTL,IntSt-Hist,0,1,1,1,0,1,0,1,1,1,2,3,0,0,0,0,0,0,2,4,6
fa08,83,SIXTH,INTL,IntSt-Ling,1,0,1,0,0,0,1,1,2,5,0,5,0,2,2,0,0,0,7,3,10
fa08,83,SIXTH,INTL,IntSt-Lit,0,0,0,0,0,0,0,1,1,0,0,0,0,2,2,0,0,0,0,3,3
fa08,83,SIXTH,INTL,IntSt-PolS,0,2,2,0,1,1,2,4,6,6,6,12,3,5,8,0,0,0,11,18,29
fa08,83,SIXTH,INTL,IntSt-Soc,0,3,3,0,0,0,0,1,1,2,2,4,1,3,4,0,0,0,3,9,12
fa08,83,SIXTH,JAPN,JapaneseSt,0,1,1,0,0,0,0,0,0,2,1,3,1,0,1,0,0,0,3,2,5
fa08,83,SIXTH,LING,Lang Stu,1,1,2,0,0,0,0,1,1,0,0,0,0,1,1,0,0,0,1,3,4
fa08,83,SIXTH,LING,Ling-CogLn,0,0,0,0,0,0,0,1,1,0,1,1,1,0,1,0,0,0,1,2,3
fa08,83,SIXTH,LING,Ling-LSoc,0,1,1,0,0,0,0,0,0,1,0,1,0,1,1,0,0,0,1,2,3
fa08,83,SIXTH,LING,Linguistcs,0,1,1,0,1,1,0,0,0,0,0,0,0,3,3,0,0,0,0,5,5
fa08,83,SIXTH,LIT,French Lit,0,0,0,0,0,0,0,0,0,0,1,1,0,0,0,0,0,0,0,1,1
fa08,83,SIXTH,LIT,Lit/Compos,0,0,0,0,0,0,0,0,0,0,0,0,0,1,1,0,0,0,0,1,1
fa08,83,SIXTH,LIT,Lit/CultSt,0,0,0,0,0,0,0,1,1,0,1,1,0,0,0,0,0,0,0,2,2
fa08,83,SIXTH,LIT,Lit/Engl,1,2,3,0,0,0,1,2,3,1,3,4,1,2,3,0,0,0,4,9,13
fa08,83,SIXTH,LIT,Lit/World,0,0,0,0,0,0,0,0,0,1,1,2,1,0,1,0,0,0,2,1,3
fa08,83,SIXTH,LIT,Lit/Writng,0,0,0,0,0,0,0,0,0,0,0,0,1,9,10,0,0,0,1,9,10
fa08,83,SIXTH,LIT,Pre-Lit/Wr,0,3,3,0,0,0,0,4,4,8,5,13,1,3,4,0,0,0,9,15,24
fa08,83,SIXTH,LIT,Spanish Lt,0,0,0,0,0,0,0,0,0,0,0,0,1,1,2,0,0,0,1,1,2
fa08,83,SIXTH,MAE,Aerosp Eng,16,1,17,2,0,2,10,2,12,11,1,12,21,3,24,0,0,0,60,7,67
fa08,83,SIXTH,MAE,Engin Sci,2,0,2,0,0,0,0,0,0,0,1,1,0,0,0,0,0,0,2,1,3
fa08,83,SIXTH,MAE,Envir Eng,3,5,8,0,0,0,1,0,1,0,0,0,1,4,5,0,0,0,5,9,14
fa08,83,SIXTH,MAE,Mech Engin,18,5,23,1,0,1,18,3,21,29,7,36,46,4,50,0,0,0,112,19,131
fa08,83,SIXTH,MATH,Appld Math,1,2,3,0,0,0,3,0,3,0,0,0,2,2,4,0,0,0,6,4,10
fa08,83,SIXTH,MATH,Math/SecEd,0,0,0,1,0,1,1,2,3,0,1,1,0,1,1,0,0,0,2,4,6
fa08,83,SIXTH,MATH,Mathematcs,4,0,4,0,0,0,1,5,6,6,1,7,4,1,5,0,0,0,15,7,22
fa08,83,SIXTH,MATH,Mth-CompSc,0,0,0,0,0,0,0,0,0,1,0,1,0,0,0,0,0,0,1,0,1
fa08,83,SIXTH,MATH,Mth-Mth&Ec,1,2,3,0,0,0,1,0,1,1,2,3,0,1,1,0,0,0,3,5,8
fa08,83,SIXTH,MATH,Mth-SciCom,0,1,1,0,0,0,0,0,0,0,0,0,0,0,0,0,0,0,0,1,1
fa08,83,SIXTH,MATH,Mth/ApldSc,2,0,2,0,0,0,0,0,0,0,0,0,0,0,0,0,0,0,2,0,2
fa08,83,SIXTH,MATH,Pr-Math CS,0,0,0,0,0,0,0,1,1,1,0,1,0,0,0,0,0,0,1,1,2
fa08,83,SIXTH,MUS,Mu-CompArt,3,3,6,0,0,0,3,1,4,9,0,9,4,1,5,0,0,0,19,5,24
fa08,83,SIXTH,MUS,Music,2,0,2,0,0,0,2,0,2,4,2,6,2,5,7,0,0,0,10,7,17
fa08,83,SIXTH,MUS,Music Hum,0,0,0,0,0,0,0,0,0,0,0,0,0,1,1,0,0,0,0,1,1
fa08,83,SIXTH,PHIL,Philosophy,2,0,2,1,0,1,0,0,0,2,3,5,4,3,7,0,0,0,9,6,15
fa08,83,SIXTH,PHYS,Biophysics,2,0,2,0,0,0,0,0,0,2,0,2,1,0,1,0,0,0,5,0,5
fa08,83,SIXTH,PHYS,Phys/Astro,3,0,3,1,0,1,1,0,1,0,0,0,0,0,0,0,0,0,5,0,5
fa08,83,SIXTH,PHYS,Phys/Mtrls,1,0,1,0,0,0,1,0,1,0,0,0,1,0,1,0,0,0,3,0,3
fa08,83,SIXTH,PHYS,Physics,3,0,3,0,0,0,3,0,3,4,1,5,6,2,8,0,0,0,16,3,19
fa08,83,SIXTH,POLI,Polit Sci,0,1,1,0,1,1,9,6,15,14,9,23,4,3,7,0,0,0,27,20,47
fa08,83,SIXTH,POLI,PolSc-Amer,0,1,1,0,0,0,0,0,0,2,2,4,2,1,3,0,0,0,4,4,8
fa08,83,SIXTH,POLI,PolSc-Comp,0,0,0,0,0,0,0,0,0,0,0,0,0,1,1,0,0,0,0,1,1
fa08,83,SIXTH,POLI,PolSc-Intl,1,1,2,0,0,0,7,3,10,7,6,13,6,6,12,0,0,0,21,16,37
fa08,83,SIXTH,POLI,PolSc-PLaw,2,0,2,1,0,1,1,1,2,4,5,9,1,4,5,0,0,0,9,10,19
fa08,83,SIXTH,POLI,PolSc-PPol,0,0,0,1,0,1,1,0,1,0,0,0,1,1,2,0,0,0,3,1,4
fa08,83,SIXTH,POLI,PolSc-Thry,0,0,0,0,0,0,0,0,0,0,0,0,0,1,1,0,0,0,0,1,1
fa08,83,SIXTH,PSYC,Psychology,7,14,21,3,3,6,6,23,29,20,37,57,15,29,44,0,0,0,51,106,157
fa08,83,SIXTH,RELI,Relig/Stu,0,0,0,0,0,0,0,0,0,1,0,1,0,0,0,0,0,0,1,0,1
fa08,83,SIXTH,SE,Engin Sci,1,1,2,0,0,0,0,0,0,0,0,0,1,0,1,0,0,0,2,1,3
fa08,83,SIXTH,SE,Struct Eng,10,4,14,2,0,2,11,6,17,16,6,22,13,8,21,0,0,0,52,24,76
fa08,83,SIXTH,SIO,ErSc-Geol,0,0,0,0,0,0,1,0,1,0,0,0,0,0,0,0,0,0,1,0,1
fa08,83,SIXTH,SOC,Sociology,1,2,3,1,1,2,0,9,9,7,19,26,3,10,13,0,0,0,12,41,53
fa08,83,SIXTH,THEA,Dance,0,0,0,0,0,0,0,0,0,0,2,2,1,3,4,0,0,0,1,5,6
fa08,83,SIXTH,THEA,Theatre,0,1,1,0,0,0,0,1,1,1,5,6,1,3,4,0,0,0,2,10,12
fa08,83,SIXTH,TWS,ThirdWldSt,0,0,0,0,0,0,0,2,2,0,2,2,0,0,0,0,0,0,0,4,4
fa08,83,SIXTH,UNAF,UndecBiolS,6,7,13,0,0,0,1,5,6,2,0,2,0,0,0,0,0,0,9,12,21
fa08,83,SIXTH,UNAF,UndecHumAr,5,5,10,0,0,0,2,2,4,0,1,1,0,0,0,0,0,0,7,8,15
fa08,83,SIXTH,UNAF,Undeclared,32,54,86,3,2,5,21,16,37,3,0,3,0,0,0,0,0,0,59,72,131
fa08,83,SIXTH,UNAF,UndecPhysS,2,7,9,2,0,2,2,2,4,0,0,0,0,0,0,0,0,0,6,9,15
fa08,83,SIXTH,UNAF,UndecSocSc,3,9,12,0,2,2,0,2,2,0,0,0,0,0,0,0,0,0,3,13,16
fa08,83,SIXTH,USP,Urb Stu&Pl,1,0,1,0,1,1,2,1,3,3,3,6,4,1,5,0,0,0,10,6,16
fa08,83,SIXTH,VIS,Art Hst/Cr,0,1,1,0,0,0,0,3,3,0,4,4,2,7,9,0,0,0,2,15,17
fa08,83,SIXTH,VIS,Media,6,5,11,0,0,0,5,8,13,16,20,36,16,9,25,0,0,0,43,42,85
fa08,83,SIXTH,VIS,Studio VA,1,4,5,1,0,1,0,0,0,5,6,11,4,8,12,0,0,0,11,18,29
fa08,83,SIXTH,VIS,VA-CompArt,5,2,7,0,0,0,3,6,9,5,7,12,5,2,7,0,0,0,18,17,35
fa08,83,WARREN,ANTH,Anth-Arch,0,2,2,0,0,0,0,0,0,1,1,2,1,3,4,0,0,0,2,6,8
fa08,83,WARREN,ANTH,Anth-Biol,0,1,1,0,0,0,0,2,2,1,1,2,1,8,9,0,0,0,2,12,14
fa08,83,WARREN,ANTH,Anth-Soci,0,0,0,0,0,0,0,1,1,0,0,0,0,1,1,0,0,0,0,2,2
fa08,83,WARREN,ANTH,Anthropol,0,0,0,0,0,0,0,0,0,0,0,0,0,4,4,0,0,0,0,4,4
fa08,83,WARREN,BENG,Bioen:Binf,0,0,0,0,0,0,0,0,0,0,0,0,2,2,4,0,0,0,2,2,4
fa08,83,WARREN,BENG,Bioeng:PM,0,0,0,0,0,0,1,4,5,10,4,14,23,10,33,0,0,0,34,18,52
fa08,83,WARREN,BENG,BioengBiot,15,2,17,0,0,0,4,3,7,13,2,15,14,11,25,0,0,0,46,18,64
fa08,83,WARREN,BENG,Bioengin,16,6,22,0,0,0,3,1,4,8,2,10,14,9,23,0,0,0,41,18,59
fa08,83,WARREN,BENG,Pr-BioenBf,0,0,0,0,0,0,0,0,0,1,0,1,0,0,0,0,0,0,1,0,1
fa08,83,WARREN,BENG,Pr-BioenPM,20,12,32,0,1,1,6,4,10,10,8,18,2,0,2,0,0,0,38,25,63
fa08,83,WARREN,BIOL,Anml Physl,0,0,0,0,0,0,0,0,0,0,0,0,0,2,2,0,0,0,0,2,2
fa08,83,WARREN,BIOL,Bioc/CellB,8,7,15,0,1,1,11,21,32,29,30,59,46,60,106,0,0,0,94,119,213
fa08,83,WARREN,BIOL,BiolBioinf,1,0,1,0,0,0,0,0,0,1,0,1,0,0,0,0,0,0,2,0,2
fa08,83,WARREN,BIOL,Ec/Beh/Evo,1,0,1,0,0,0,3,6,9,1,4,5,3,5,8,0,0,0,8,15,23
fa08,83,WARREN,BIOL,Genl Biol,9,12,21,0,1,1,7,11,18,14,30,44,38,45,83,0,0,0,68,99,167
fa08,83,WARREN,BIOL,Human Bio,20,38,58,4,5,9,15,35,50,39,58,97,44,81,125,0,0,0,122,217,339
fa08,83,WARREN,BIOL,Microbiol,0,2,2,0,0,0,0,2,2,4,4,8,5,7,12,0,0,0,9,15,24
fa08,83,WARREN,BIOL,Molec Biol,2,3,5,0,0,0,2,2,4,12,8,20,9,6,15,0,0,0,25,19,44
fa08,83,WARREN,BIOL,PhyslNeuro,6,10,16,0,0,0,2,9,11,10,17,27,14,13,27,0,0,0,32,49,81
fa08,83,WARREN,BIOL,Pr-BiochCB,0,0,0,0,0,0,0,0,0,0,0,0,1,0,1,0,0,0,1,0,1
fa08,83,WARREN,CENG,Chem Engin,14,1,15,2,0,2,5,3,8,13,5,18,18,9,27,0,0,0,52,18,70
fa08,83,WARREN,CGS,CritGendSt,0,0,0,0,1,1,0,0,0,0,2,2,0,1,1,0,0,0,0,4,4
fa08,83,WARREN,CHEM,Bioch/Chem,5,7,12,0,0,0,5,3,8,13,7,20,14,26,40,0,0,0,37,43,80
fa08,83,WARREN,CHEM,Chem Phys,0,0,0,0,0,0,0,0,0,1,0,1,0,0,0,0,0,0,1,0,1
fa08,83,WARREN,CHEM,Chemistry,3,4,7,0,0,0,2,3,5,2,2,4,8,5,13,0,0,0,15,14,29
fa08,83,WARREN,CHEM,Chm/ErthSc,1,0,1,0,0,0,0,0,0,0,0,0,0,0,0,0,0,0,1,0,1
fa08,83,WARREN,CHEM,Envir Chem,0,0,0,0,0,0,0,0,0,0,0,0,1,0,1,0,0,0,1,0,1
fa08,83,WARREN,CHEM,MolecSynth,0,0,0,0,0,0,1,0,1,2,0,2,1,0,1,0,0,0,4,0,4
fa08,83,WARREN,CHEM,Pharm Chem,1,7,8,0,1,1,3,9,12,11,11,22,18,24,42,0,0,0,33,52,85
fa08,83,WARREN,CHIN,Chinese St,0,0,0,0,0,0,0,0,0,0,1,1,0,6,6,0,0,0,0,7,7
fa08,83,WARREN,CLAS,Classic St,0,0,0,0,0,0,0,0,0,0,0,0,1,0,1,0,0,0,1,0,1
fa08,83,WARREN,COGS,Cog Sci,0,3,3,0,0,0,2,4,6,6,4,10,3,5,8,0,0,0,11,16,27
fa08,83,WARREN,COGS,CogSc/Clin,0,0,0,0,0,0,0,1,1,0,0,0,0,0,0,0,0,0,0,1,1
fa08,83,WARREN,COGS,CogSc/HCI,1,0,1,0,0,0,1,0,1,1,1,2,4,1,5,0,0,0,7,2,9
fa08,83,WARREN,COGS,CogSc/HCog,0,0,0,0,0,0,1,0,1,0,0,0,0,0,0,0,0,0,1,0,1
fa08,83,WARREN,COGS,CogSc/Neur,0,0,0,1,0,1,2,0,2,1,1,2,2,2,4,0,0,0,6,3,9
fa08,83,WARREN,COMM,Communic,2,11,13,0,2,2,6,15,21,15,34,49,12,33,45,0,0,0,35,95,130
fa08,83,WARREN,CSE,Comp Sci,13,6,19,1,0,1,18,2,20,24,7,31,35,9,44,0,0,0,91,24,115
fa08,83,WARREN,CSE,CompEngCSE,14,0,14,2,0,2,7,3,10,9,0,9,11,4,15,0,0,0,43,7,50
fa08,83,WARREN,CSE,CompScBinf,0,0,0,0,0,0,0,0,0,0,0,0,2,0,2,0,0,0,2,0,2
fa08,83,WARREN,ECE,CompEngECE,5,2,7,0,0,0,4,0,4,2,0,2,7,1,8,0,0,0,18,3,21
fa08,83,WARREN,ECE,Electr Eng,10,4,14,1,0,1,9,1,10,36,7,43,59,5,64,0,0,0,115,17,132
fa08,83,WARREN,ECE,Engin Phys,0,0,0,0,0,0,0,0,0,0,0,0,3,0,3,0,0,0,3,0,3
fa08,83,WARREN,ECE,Pr-ElecEng,1,0,1,0,0,0,0,0,0,0,0,0,0,0,0,0,0,0,1,0,1
fa08,83,WARREN,ECE,Pr-EngPhys,5,0,5,1,0,1,0,0,0,3,0,3,2,0,2,0,0,0,11,0,11
fa08,83,WARREN,ECON,Ec-Mth&Ecn,5,2,7,1,0,1,2,1,3,7,1,8,5,3,8,0,0,0,20,7,27
fa08,83,WARREN,ECON,Econ-MgtSc,4,8,12,0,0,0,10,11,21,34,24,58,44,34,78,0,0,0,92,77,169
fa08,83,WARREN,ECON,Economics,15,6,21,1,1,2,15,10,25,55,16,71,61,36,97,0,0,0,147,69,216
fa08,83,WARREN,ESYS,EnvSys(EB),0,0,0,0,0,0,0,0,0,1,2,3,0,2,2,0,0,0,1,4,5
fa08,83,WARREN,ESYS,EnvSys(EC),0,0,0,0,0,0,0,0,0,1,1,2,0,0,0,0,0,0,1,1,2
fa08,83,WARREN,ESYS,EnvSys(EP),0,0,0,0,0,0,0,0,0,2,2,4,0,1,1,0,0,0,2,3,5
fa08,83,WARREN,ESYS,EnvSys(ES),0,0,0,0,0,0,1,0,1,1,0,1,1,2,3,0,0,0,3,2,5
fa08,83,WARREN,ETHN,Ethnic St,0,0,0,0,0,0,1,2,3,1,0,1,0,1,1,0,0,0,2,3,5
fa08,83,WARREN,GMST,German Stu,0,0,0,0,0,0,0,0,0,1,0,1,1,0,1,0,0,0,2,0,2
fa08,83,WARREN,HDP,Human Dev,0,0,0,0,0,0,0,0,0,1,8,9,1,13,14,0,0,0,2,21,23
fa08,83,WARREN,HDP,Pr-HumnDev,0,0,0,0,0,0,1,4,5,4,7,11,1,3,4,0,0,0,6,14,20
fa08,83,WARREN,HIST,History,1,1,2,0,0,0,5,5,10,11,7,18,13,15,28,0,0,0,30,28,58
fa08,83,WARREN,INTD,Wa Ind St,0,0,0,0,0,0,0,0,0,0,0,0,0,2,2,0,0,0,0,2,2
fa08,83,WARREN,INTL,Int-5yrPS,0,0,0,0,0,0,0,0,0,0,1,1,0,0,0,0,0,0,0,1,1
fa08,83,WARREN,INTL,IntSt-Anth,0,1,1,0,0,0,0,1,1,0,1,1,1,0,1,0,0,0,1,3,4
fa08,83,WARREN,INTL,IntSt-Econ,3,3,6,0,0,0,1,1,2,3,6,9,3,10,13,0,0,0,10,20,30
fa08,83,WARREN,INTL,IntSt-Hist,0,0,0,0,0,0,0,0,0,1,0,1,2,2,4,0,0,0,3,2,5
fa08,83,WARREN,INTL,IntSt-Ling,0,1,1,0,0,0,0,0,0,0,1,1,1,0,1,0,0,0,1,2,3
fa08,83,WARREN,INTL,IntSt-Lit,0,1,1,0,0,0,0,1,1,0,0,0,1,0,1,0,0,0,1,2,3
fa08,83,WARREN,INTL,IntSt-PolS,0,3,3,0,1,1,2,3,5,3,2,5,3,11,14,0,0,0,8,20,28
fa08,83,WARREN,INTL,IntSt-Soc,0,0,0,0,1,1,0,4,4,1,4,5,1,4,5,0,0,0,2,13,15
fa08,83,WARREN,ITAL,Italian St,0,0,0,0,0,0,0,0,0,0,0,0,1,0,1,0,0,0,1,0,1
fa08,83,WARREN,JAPN,JapaneseSt,0,0,0,0,0,0,0,0,0,0,0,0,1,1,2,0,0,0,1,1,2
fa08,83,WARREN,LATI,LatinAm St,0,0,0,0,0,0,0,0,0,0,0,0,0,1,1,0,0,0,0,1,1
fa08,83,WARREN,LING,Lang Stu,0,0,0,0,0,0,0,0,0,0,1,1,0,0,0,0,0,0,0,1,1
fa08,83,WARREN,LING,Ling-CogLn,0,0,0,0,0,0,0,1,1,0,0,0,0,0,0,0,0,0,0,1,1
fa08,83,WARREN,LING,Ling-LSoc,0,1,1,0,0,0,0,0,0,0,0,0,0,1,1,0,0,0,0,2,2
fa08,83,WARREN,LING,Linguistcs,0,1,1,0,0,0,0,0,0,0,1,1,0,0,0,0,0,0,0,2,2
fa08,83,WARREN,LIT,French Lit,0,0,0,0,0,0,0,0,0,1,0,1,0,0,0,0,0,0,1,0,1
fa08,83,WARREN,LIT,German Lit,0,0,0,0,0,0,0,0,0,0,0,0,0,1,1,0,0,0,0,1,1
fa08,83,WARREN,LIT,Lit/CultSt,0,0,0,0,0,0,0,1,1,0,0,0,0,0,0,0,0,0,0,1,1
fa08,83,WARREN,LIT,Lit/Engl,0,2,2,0,0,0,0,4,4,1,3,4,1,5,6,0,0,0,2,14,16
fa08,83,WARREN,LIT,Lit/World,0,0,0,0,0,0,0,0,0,0,1,1,1,1,2,0,0,0,1,2,3
fa08,83,WARREN,LIT,Lit/Writng,0,0,0,0,0,0,0,0,0,0,1,1,2,2,4,0,0,0,2,3,5
fa08,83,WARREN,LIT,Pre-Lit/Wr,1,2,3,0,0,0,2,4,6,1,4,5,0,1,1,0,0,0,4,11,15
fa08,83,WARREN,LIT,Spanish Lt,0,0,0,0,0,0,0,0,0,0,0,0,4,4,8,0,0,0,4,4,8
fa08,83,WARREN,MAE,Aerosp Eng,13,4,17,0,1,1,9,0,9,16,4,20,39,3,42,0,0,0,77,12,89
fa08,83,WARREN,MAE,Engin Sci,2,0,2,0,0,0,0,1,1,0,0,0,2,0,2,0,0,0,4,1,5
fa08,83,WARREN,MAE,Envir Eng,4,2,6,0,0,0,0,1,1,1,2,3,4,2,6,0,0,0,9,7,16
fa08,83,WARREN,MAE,Mech Engin,30,2,32,5,0,5,22,5,27,35,7,42,84,8,92,0,0,0,176,22,198
fa08,83,WARREN,MATH,Appld Math,0,1,1,0,0,0,2,3,5,2,3,5,2,4,6,0,0,0,6,11,17
fa08,83,WARREN,MATH,Math/SecEd,0,0,0,0,0,0,0,0,0,0,0,0,1,3,4,0,0,0,1,3,4
fa08,83,WARREN,MATH,Mathematcs,2,2,4,0,0,0,0,1,1,6,3,9,5,4,9,0,0,0,13,10,23
fa08,83,WARREN,MATH,Mth-CompSc,0,0,0,0,0,0,0,1,1,3,0,3,3,2,5,0,0,0,6,3,9
fa08,83,WARREN,MATH,Mth-Mth&Ec,2,0,2,0,0,0,0,0,0,5,2,7,4,2,6,0,0,0,11,4,15
fa08,83,WARREN,MATH,Mth-SciCom,0,0,0,0,0,0,0,0,0,1,0,1,0,3,3,0,0,0,1,3,4
fa08,83,WARREN,MATH,Mth/ApldSc,1,0,1,0,0,0,0,0,0,2,0,2,1,0,1,0,0,0,4,0,4
fa08,83,WARREN,MATH,Prob&Stats,0,0,0,0,0,0,2,0,2,1,0,1,4,0,4,0,0,0,7,0,7
fa08,83,WARREN,MUS,Mu-CompArt,0,0,0,0,0,0,1,0,1,5,1,6,4,3,7,0,0,0,10,4,14
fa08,83,WARREN,MUS,Music,0,1,1,0,0,0,1,0,1,3,1,4,7,0,7,0,0,0,11,2,13
fa08,83,WARREN,MUS,Music Hum,0,0,0,0,0,0,0,0,0,0,0,0,0,1,1,0,0,0,0,1,1
fa08,83,WARREN,PHIL,Philosophy,2,0,2,0,0,0,1,2,3,5,3,8,5,6,11,0,0,0,13,11,24
fa08,83,WARREN,PHYS,Biophysics,0,0,0,0,0,0,0,0,0,2,0,2,6,2,8,0,0,0,8,2,10
fa08,83,WARREN,PHYS,Gen Physcs,1,0,1,0,0,0,0,0,0,0,0,0,0,0,0,0,0,0,1,0,1
fa08,83,WARREN,PHYS,GenPys/SEd,0,0,0,0,0,0,0,0,0,0,0,0,1,0,1,0,0,0,1,0,1
fa08,83,WARREN,PHYS,Phy/ErthSc,0,0,0,0,0,0,0,0,0,0,0,0,1,0,1,0,0,0,1,0,1
fa08,83,WARREN,PHYS,Phys/Astro,2,0,2,1,0,1,0,0,0,2,0,2,2,0,2,0,0,0,7,0,7
fa08,83,WARREN,PHYS,Phys/Comp,0,0,0,0,0,0,0,0,0,0,0,0,2,0,2,0,0,0,2,0,2
fa08,83,WARREN,PHYS,Phys/Mtrls,0,0,0,0,0,0,0,0,0,0,0,0,2,0,2,0,0,0,2,0,2
fa08,83,WARREN,PHYS,Physics,0,1,1,0,0,0,0,0,0,3,0,3,1,0,1,0,0,0,4,1,5
fa08,83,WARREN,POLI,Polit Sci,5,3,8,0,0,0,7,7,14,20,15,35,20,20,40,0,0,0,52,45,97
fa08,83,WARREN,POLI,PolSc-Amer,2,1,3,0,0,0,0,1,1,3,2,5,2,2,4,0,0,0,7,6,13
fa08,83,WARREN,POLI,PolSc-Comp,0,0,0,0,0,0,2,0,2,0,2,2,0,0,0,0,0,0,2,2,4
fa08,83,WARREN,POLI,PolSc-Intl,0,2,2,0,0,0,7,3,10,16,14,30,9,12,21,0,0,0,32,31,63
fa08,83,WARREN,POLI,PolSc-PLaw,5,7,12,0,0,0,2,8,10,5,8,13,5,9,14,0,0,0,17,32,49
fa08,83,WARREN,POLI,PolSc-PPol,0,0,0,0,0,0,1,3,4,0,1,1,0,1,1,0,0,0,1,5,6
fa08,83,WARREN,POLI,PolSc-Thry,1,0,1,0,0,0,0,1,1,3,1,4,0,0,0,0,0,0,4,2,6
fa08,83,WARREN,PSYC,Psychology,7,15,22,1,4,5,6,27,33,18,42,60,28,50,78,0,0,0,60,138,198
fa08,83,WARREN,RELI,Relig/Stu,0,0,0,0,0,0,0,0,0,0,0,0,3,1,4,0,0,0,3,1,4
fa08,83,WARREN,SE,Engin Sci,0,0,0,0,0,0,1,0,1,0,0,0,0,0,0,0,0,0,1,0,1
fa08,83,WARREN,SE,Struct Eng,11,4,15,2,0,2,21,5,26,24,15,39,56,20,76,0,0,0,114,44,158
fa08,83,WARREN,SIO,ErSc-Geoch,0,0,0,0,0,0,0,0,0,0,1,1,0,0,0,0,0,0,0,1,1
fa08,83,WARREN,SIO,ErSc-Geol,1,0,1,0,0,0,0,0,0,0,0,0,0,0,0,0,0,0,1,0,1
fa08,83,WARREN,SOC,Sociology,2,2,4,1,0,1,0,5,5,6,13,19,7,17,24,0,0,0,16,37,53
fa08,83,WARREN,THEA,Dance,0,0,0,0,0,0,1,0,1,0,1,1,1,1,2,0,0,0,2,2,4
fa08,83,WARREN,THEA,Theatre,0,0,0,0,0,0,0,1,1,2,3,5,3,5,8,0,0,0,5,9,14
fa08,83,WARREN,TWS,ThirdWldSt,0,1,1,0,0,0,0,0,0,0,0,0,0,0,0,0,0,0,0,1,1
fa08,83,WARREN,UNAF,IntcampVis,0,0,0,0,1,1,1,0,1,1,1,2,1,1,2,0,0,0,3,3,6
fa08,83,WARREN,UNAF,Limited St,0,0,0,0,0,0,0,0,0,0,0,0,0,0,0,2,0,2,2,0,2
fa08,83,WARREN,UNAF,Spec-Emply,0,0,0,0,0,0,0,0,0,0,0,0,0,0,0,0,1,1,0,1,1
fa08,83,WARREN,UNAF,UndecBiolS,2,13,15,2,0,2,4,5,9,1,0,1,0,0,0,0,0,0,9,18,27
fa08,83,WARREN,UNAF,UndecHumAr,2,8,10,0,0,0,0,1,1,0,0,0,0,0,0,0,0,0,2,9,11
fa08,83,WARREN,UNAF,Undeclared,14,34,48,2,4,6,11,10,21,2,4,6,0,0,0,0,0,0,29,52,81
fa08,83,WARREN,UNAF,UndecPhysS,4,2,6,0,0,0,1,1,2,0,0,0,0,0,0,0,0,0,5,3,8
fa08,83,WARREN,UNAF,UndecSocSc,5,7,12,0,0,0,1,3,4,0,0,0,0,0,0,0,0,0,6,10,16
fa08,83,WARREN,USP,Urb Stu&Pl,2,2,4,0,0,0,0,0,0,3,2,5,7,5,12,0,0,0,12,9,21
fa08,83,WARREN,VIS,Art Hst/Cr,0,0,0,0,0,0,0,1,1,0,3,3,1,5,6,0,0,0,1,9,10
fa08,83,WARREN,VIS,Media,0,2,2,0,0,0,1,5,6,9,3,12,4,5,9,0,0,0,14,15,29
fa08,83,WARREN,VIS,Studio VA,0,2,2,0,0,0,1,0,1,2,3,5,2,7,9,0,0,0,5,12,17
fa08,83,WARREN,VIS,VA-CompArt,0,2,2,0,0,0,0,1,1,3,0,3,0,1,1,0,0,0,3,4,7
